Date;Customer;TipoDocumento;Num;Producto;Descripcion;Qty;SalesPrice;Amount;Balance;Class;SalesRep;TipoCliente;ID;Month
2025-05-29;Bravo   Francisco Diaz;Invoice;008-05631;Spices:AS Chicken Base;1 / 30 lb. (box or pail);1.0;39.0;39.0;4319546.96;American Spice;Lisset Limpio -020;RETAIL  DSD;1388875;May
2025-05-29;Bravo   Francisco Diaz;Invoice;008-05631;Spices:AS Meat Tenderizer;12 / 4.5 oz;1.0;25.0;25.0;4319571.96;American Spice;Lisset Limpio -020;RETAIL  DSD;1388876;May
2025-05-29;Bravo   Francisco Diaz;Invoice;008-05631;Arroz a Granel:Largo Fino 50 LB -Bolsa Dos Hermanos.;;3.0;27.85;83.55;4319655.51;Bulk Rice;Lisset Limpio -020;RETAIL  DSD;1388877;May
2025-05-29;Bravo   Francisco Diaz;Invoice;008-05631;Spices:AS Sazon (for all);1 / 30 lb (box or pail);1.0;51.0;51.0;4319706.51;American Spice;Lisset Limpio -020;RETAIL  DSD;1388878;May
2025-05-29;Sedanos Supermarkets #33;Invoice;008-05632;Arroz a Granel:Parboiled 50 LB -Bolsa Dos Hermanos.;;4.0;28.25;113.0;4319819.51;Bulk Rice;Keila Alfaro-Visvikis;RETAIL SEDANOS;1388879;May
2025-05-29;Sedanos Supermarkets #33;Invoice;008-05632;;Discount;;;-2.26;4319817.25;;Keila Alfaro-Visvikis;RETAIL SEDANOS;1388880;May
2025-05-29;El Palacio de los jugos / Divan and Denise Food;Invoice;008-05633;Arroz a Granel:Largo Fino 50 LB -Bolsa Dos Hermanos.;;2.0;27.85;55.7;4319872.95;Bulk Rice;Lisset Limpio -020;Cafeteria;1388881;May
2025-05-29;El Palacio de los jugos / Divan and Denise Food;Invoice;008-05633;Arroz a Granel:Parboiled 50 LB -Bolsa Dos Hermanos.;;4.0;26.75;107.0;4319979.95;Bulk Rice;Lisset Limpio -020;Cafeteria;1388882;May
2025-05-29;El Palacio de los jugos / Divan and Denise Food;Invoice;008-05633;Dry Beans:Dry Beans - Black Beans 50;Dry Black Beans 50 lb;1.0;34.0;34.0;4320013.95;Dry Beans;Lisset Limpio -020;Cafeteria;1388883;May
2025-05-29;El Palacio de los jugos / Lita Foods Inc.;Invoice;008-05634;Dry Beans:Dry Beans - Black Beans 50;Dry Black Beans 50 lb;1.0;34.0;34.0;4320047.95;Dry Beans;Lisset Limpio -020;Cafeteria;1388884;May
2025-05-29;El Palacio de los jugos / Lita Foods Inc.;Invoice;008-05634;Arroz a Granel:Parboiled 50 LB -Bolsa Dos Hermanos.;;12.0;26.75;321.0;4320368.95;Bulk Rice;Lisset Limpio -020;Cafeteria;1388885;May
2025-05-29;Sedanos Supermarkets #18;Invoice;008-05635;Arroz a Granel:Parboiled 50 LB -Bolsa Dos Hermanos.;;10.0;28.25;282.5;4320651.45;Bulk Rice;Keila Alfaro-Visvikis;RETAIL SEDANOS;1388886;May
2025-05-29;Sedanos Supermarkets #18;Invoice;008-05635;;Discount;;;-5.65;4320645.8;;Keila Alfaro-Visvikis;RETAIL SEDANOS;1388887;May
2025-05-29;Sedanos Supermarkets  #37;Invoice;008-05636;Spanish Style Yellow Rice:AS Spanish Style Yellow Rice;AS Spanish Style Yellow Rice 6 / 3.25 oz;1.0;34.5;34.5;4320680.3;American Spice;Keila Alfaro-Visvikis;RETAIL SEDANOS;1388888;May
2025-05-29;Sedanos Supermarkets  #37;Invoice;008-05636;Arroz Envasado:Largo Fino 1kg (Long grain rice) Dos Hermanos;;1.0;17.5;17.5;4320697.8;Branded Rice;Keila Alfaro-Visvikis;RETAIL SEDANOS;1388889;May
2025-05-29;Sedanos Supermarkets  #37;Invoice;008-05636;Arroz Envasado:Parboiled 5KG Dos Hermanos.;6  11lbs;15.0;40.5;607.5;4321305.3;Branded Rice;Keila Alfaro-Visvikis;RETAIL SEDANOS;1388890;May
2025-05-29;Sedanos Supermarkets  #37;Invoice;008-05636;Arroz Envasado:Parboiled 5KG Dos Hermanos.;6  11lbs;3.0;40.5;121.5;4321426.8;Branded Rice;Keila Alfaro-Visvikis;RETAIL SEDANOS;1388891;May
2025-05-29;Sedanos Supermarkets  #37;Invoice;008-05636;;Discount;;;-13.19;4321413.61;;Keila Alfaro-Visvikis;RETAIL SEDANOS;1388892;May
2025-05-29;El Palacio de Los Jugos / Casa mía Food Restaurant inc;Invoice;008-05637;Spices:AS Sazon (for all);1 / 30 lb (box or pail);2.0;51.0;102.0;4321515.61;American Spice;Lisset Limpio -020;Cafeteria;1388893;May
2025-05-29;El Palacio de Los Jugos / Casa mía Food Restaurant inc;Invoice;008-05637;Spices:AS Chicken Base;1 / 30 lb. (box or pail);1.0;39.0;39.0;4321554.61;American Spice;Lisset Limpio -020;Cafeteria;1388894;May
2025-05-29;El Palacio de Los Jugos / Casa mía Food Restaurant inc;Invoice;008-05637;Arroz a Granel:Parboiled 50 LB -Bolsa Dos Hermanos.;;8.0;26.75;214.0;4321768.61;Bulk Rice;Lisset Limpio -020;Cafeteria;1388895;May
2025-05-29;Sedanos Supermarkets #32;Invoice;008-05638;Arroz a Granel:Largo Fino 50 LB -Bolsa Dos Hermanos.;;4.0;27.85;111.4;4321880.01;Bulk Rice;Keila Alfaro-Visvikis;RETAIL SEDANOS;1388896;May
2025-05-29;Sedanos Supermarkets #32;Invoice;008-05638;;Discount;;;-2.23;4321877.78;;Keila Alfaro-Visvikis;RETAIL SEDANOS;1388897;May
2025-05-29;El Palacio de los jugos / Caribe Tropical;Invoice;008-05639;Arroz a Granel:Parboiled 50 LB -Bolsa Dos Hermanos.;;6.0;26.75;160.5;4322038.28;Bulk Rice;Lisset Limpio -020;Cafeteria;1388898;May
2025-05-29;El Palacio de los jugos / Rodriguez Foods;Invoice;008-05640;Arroz a Granel:Parboiled 50 LB -Bolsa Dos Hermanos.;;6.0;26.75;160.5;4322198.78;Bulk Rice;Lisset Limpio -020;Cafeteria;1388899;May
2025-05-29;Bravo   Francisco Diaz;Invoice;008-05641;Spanish Style Yellow Rice:AS Spanish Style Yellow Rice;AS Spanish Style Yellow Rice 6 / 3.25 oz;1.0;34.5;34.5;4322233.28;American Spice;Lisset Limpio -020;RETAIL  DSD;1388900;May
2025-05-29;El Gallego Supermarket;Invoice;008-05642;Dry Beans:Dry Beans - Black Beans 50;Dry Black Beans 50 lb;2.0;35.0;70.0;4322303.28;Dry Beans;Lisset Limpio -020;RETAIL  DSD;1388901;May
2025-05-29;El Gallego Supermarket;Invoice;008-05642;Liquids:AS Bitter Orange;;2.0;14.0;28.0;4322331.28;American Spice;Lisset Limpio -020;RETAIL  DSD;1388902;May
2025-05-29;El Gallego Supermarket;Invoice;008-05642;Liquids:AS Cooking Wine;4 1 Gl.;1.0;17.5;17.5;4322348.78;American Spice;Lisset Limpio -020;RETAIL  DSD;1388903;May
2025-05-29;El Gallego Supermarket;Invoice;008-05642;Arroz a Granel:Parboiled 50 LB -Bolsa Dos Hermanos.;;3.0;28.25;84.75;4322433.53;Bulk Rice;Lisset Limpio -020;RETAIL  DSD;1388904;May
2025-05-29;VIÑA & SONS FOOD DIST.CORP;Invoice;008-05643;Arroz a Granel:Parboiled 50 LB -Bolsa Dos Hermanos.;;25.0;27.75;693.75;4323127.28;Bulk Rice;Keila Alfaro-Visvikis;CAFETERIA y RESTAURANTS;1388905;May
2025-05-29;VIÑA & SONS FOOD DIST.CORP;Invoice;008-05643;Arroz Envasado:Parboiled 5KG Dos Hermanos.;6  11lbs;2.0;40.5;81.0;4323208.28;Branded Rice;Keila Alfaro-Visvikis;CAFETERIA y RESTAURANTS;1388906;May
2025-05-29;Sedanos Supermarkets #42;Invoice;008-05644;Arroz a Granel:Parboiled 50 LB -Bolsa Dos Hermanos.;;5.0;28.25;141.25;4323349.53;Bulk Rice;Keila Alfaro-Visvikis;RETAIL SEDANOS;1388907;May
2025-05-29;Sedanos Supermarkets #42;Invoice;008-05644;;Discount;;;-2.83;4323346.7;;Keila Alfaro-Visvikis;RETAIL SEDANOS;1388908;May
2025-05-29;Sedanos Supermarkets #42;Credit Memo;008-05645;Varios:Producto vencido/deteriorado (no impacta en inventario);13 salami 6 ham;-19.0;1.32;-25.08;4323321.62;Puffed Products;Keila Alfaro-Visvikis;RETAIL SEDANOS;1388909;May
2025-05-29;Sedanos Supermarkets #42;Credit Memo;008-05645;Varios:Producto vencido/deteriorado (no impacta en inventario);12 units parboiled 5k;-12.0;3.37;-40.44;4323281.18;Branded Rice;Keila Alfaro-Visvikis;RETAIL SEDANOS;1388910;May
2025-05-29;Sedanos Supermarkets  #37;Credit Memo;008-05670;Varios:Promotional Allowance;Arroz Envasado:Parboiled 5KG Dos Hermanos.;-3.0;40.5;-121.5;4323159.68;Branded Rice;Keila Alfaro-Visvikis;RETAIL SEDANOS;1388911;May
2025-05-30;American Spice Trading Co, Inc.;Invoice;008-05646;Arroz a Granel:Parboiled 50 LB -Bolsa Dos Hermanos.;;1100.0;26.0;28600.0;4351759.68;Bulk Rice;Armando Carpio - 017;WHOLESALER MANUFACTURY;1388912;May
2025-05-30;American Spice Trading Co, Inc.;Invoice;008-05647;Arroz a Granel:Parboiled 50 LB -Bolsa Dos Hermanos.;;1100.0;26.0;28600.0;4380359.68;Bulk Rice;Armando Carpio - 017;WHOLESALER MANUFACTURY;1388913;May
2025-05-30;Sedanos Supermarkets #29;Invoice;008-05648;Arroz Envasado:Parboiled 5KG Dos Hermanos.;6  11lbs;15.0;40.5;607.5;4380967.18;Branded Rice;Keila Alfaro-Visvikis;RETAIL SEDANOS;1388914;May
2025-05-30;Sedanos Supermarkets #29;Invoice;008-05648;Spanish Style Yellow Rice:AS Spanish Style Yellow Rice;AS Spanish Style Yellow Rice 6 / 3.25 oz;1.0;34.5;34.5;4381001.68;American Spice;Keila Alfaro-Visvikis;RETAIL SEDANOS;1388915;May
2025-05-30;Sedanos Supermarkets #29;Invoice;008-05648;Arroz Envasado:Parboiled 5KG Dos Hermanos.;6  11lbs;4.0;40.5;162.0;4381163.68;Branded Rice;Keila Alfaro-Visvikis;RETAIL SEDANOS;1388916;May
2025-05-30;Sedanos Supermarkets #29;Invoice;008-05648;;Discount;;;-12.84;4381150.84;;Keila Alfaro-Visvikis;RETAIL SEDANOS;1388917;May
2025-05-30;Sedanos Supermarkets #21;Invoice;008-05649;Spanish Style Yellow Rice:AS Spanish Style Yellow Rice;AS Spanish Style Yellow Rice 6 / 3.25 oz;1.0;34.5;34.5;4381185.34;American Spice;Keila Alfaro-Visvikis;RETAIL SEDANOS;1388918;May
2025-05-30;Sedanos Supermarkets #21;Invoice;008-05649;;Discount;;;-0.69;4381184.65;;Keila Alfaro-Visvikis;RETAIL SEDANOS;1388919;May
2025-05-30;Sedanos Supermarkets #31;Invoice;008-05650;Arroz a Granel:Parboiled 50 LB -Bolsa Dos Hermanos.;;6.0;28.25;169.5;4381354.15;Bulk Rice;Keila Alfaro-Visvikis;RETAIL SEDANOS;1388920;May
2025-05-30;Sedanos Supermarkets #31;Invoice;008-05650;;Discount;;;-3.39;4381350.76;;Keila Alfaro-Visvikis;RETAIL SEDANOS;1388921;May
2025-05-30;Sedanos Supermarkets #31;Invoice;008-05651;Arroz Envasado:Largo Fino 1kg (Long grain rice) Dos Hermanos;;2.0;17.5;35.0;4381385.76;Branded Rice;Keila Alfaro-Visvikis;RETAIL SEDANOS;1388922;May
2025-05-30;Sedanos Supermarkets #31;Invoice;008-05651;Spanish Style Yellow Rice:AS Spanish Style Yellow Rice;AS Spanish Style Yellow Rice 6 / 3.25 oz;1.0;34.5;34.5;4381420.26;American Spice;Keila Alfaro-Visvikis;RETAIL SEDANOS;1388923;May
2025-05-30;Sedanos Supermarkets #31;Invoice;008-05651;;Discount;;;-1.05;4381419.21;;Keila Alfaro-Visvikis;RETAIL SEDANOS;1388924;May
2025-05-30;Sedanos Supermarkets #29;Credit Memo;008-05671;Varios:Promotional Allowance;Arroz Envasado:Parboiled 5KG Dos Hermanos.;-4.0;40.5;-162.0;4381257.21;Branded Rice;Keila Alfaro-Visvikis;RETAIL SEDANOS;1388925;May
2025-06-01;El Palacio de los jugos / J Mena Corp.;Invoice;008-05652;Dry Beans:Dry Beans - Black Beans 50;Dry Black Beans 50 lb;1.0;34.0;34.0;4381291.21;Dry Beans;Lisset Limpio -020;Cafeteria;1388926;Jun
2025-06-01;El Palacio de los jugos / J Mena Corp.;Invoice;008-05652;Arroz a Granel:Parboiled 50 LB -Bolsa Dos Hermanos.;;10.0;26.75;267.5;4381558.71;Bulk Rice;Lisset Limpio -020;Cafeteria;1388927;Jun
2025-06-01;Bravo   Francisco Diaz;Invoice;008-05653;Arroz a Granel:Largo Fino 50 LB -Bolsa Dos Hermanos.;;3.0;27.85;83.55;4381642.26;Bulk Rice;Lisset Limpio -020;RETAIL  DSD;1388928;Jun
2025-06-01;Bravo   Francisco Diaz;Invoice;008-05653;Dry Beans:Dry Beans - Black Beans 50;Dry Black Beans 50 lb;1.0;35.0;35.0;4381677.26;Dry Beans;Lisset Limpio -020;RETAIL  DSD;1388929;Jun
2025-06-01;Soriano Brothers PB;Invoice;008-05654;Spices:AS Sazon (for all);1 / 30 lb (box or pail);2.0;51.0;102.0;4381779.26;American Spice;Lisset Limpio -020;CAFETERIA y RESTAURANTS;1388930;Jun
2025-06-01;Soriano Brothers PB;Invoice;008-05654;Arroz a Granel:Largo Fino 50 LB -Bolsa Dos Hermanos.;;12.0;27.85;334.2;4382113.46;Bulk Rice;Lisset Limpio -020;CAFETERIA y RESTAURANTS;1388931;Jun
2025-06-01;Soriano Brothers PB;Invoice;008-05654;Arroz a Granel:Parboiled 50 LB -Bolsa Dos Hermanos.;;17.0;26.75;454.75;4382568.21;Bulk Rice;Lisset Limpio -020;CAFETERIA y RESTAURANTS;1388932;Jun
2025-06-01;Soriano Brothers PB;Invoice;008-05654;Dry Beans:Dry Beans - Black Beans 50;Dry Black Beans 50 lb;2.0;34.0;68.0;4382636.21;Dry Beans;Lisset Limpio -020;CAFETERIA y RESTAURANTS;1388933;Jun
2025-06-01;Fritanga Momotombo;Invoice;008-05655;Arroz a Granel:Largo Fino 50 LB -Bolsa Dos Hermanos.;;5.0;27.85;139.25;4382775.46;Bulk Rice;Lisset Limpio -020;CAFETERIA y RESTAURANTS;1388934;Jun
2025-06-01;Fritanga Momotombo;Invoice;008-05655;Spices:AS Chicken Base;1 / 30 lb. (box or pail);1.0;39.0;39.0;4382814.46;American Spice;Lisset Limpio -020;CAFETERIA y RESTAURANTS;1388935;Jun
2025-06-01;ALS Foods;Invoice;008-05656;Liquids:AS Cooking Wine;4 1 Gl.;2.0;17.5;35.0;4382849.46;American Spice;Lisset Limpio -020;CAFETERIA y RESTAURANTS;1388936;Jun
2025-06-01;ALS Foods;Invoice;008-05656;Arroz a Granel:Largo Fino 50 LB -Bolsa Dos Hermanos.;;7.0;27.85;194.95;4383044.41;Bulk Rice;Lisset Limpio -020;CAFETERIA y RESTAURANTS;1388937;Jun
2025-06-01;ALS Foods;Invoice;008-05656;Arroz a Granel:Parboiled 50 LB -Bolsa Dos Hermanos.;;11.0;26.75;294.25;4383338.66;Bulk Rice;Lisset Limpio -020;CAFETERIA y RESTAURANTS;1388938;Jun
2025-06-01;El Palacio de Los Jugos / Casa mía Food Restaurant inc;Invoice;008-05657;Liquids:AS Marinating Sauce (Mojo);;1.0;17.0;17.0;4383355.66;American Spice;Lisset Limpio -020;Cafeteria;1388939;Jun
2025-06-01;El Palacio de Los Jugos / Casa mía Food Restaurant inc;Invoice;008-05657;Liquids:AS Lemon Juice 4/1 Gl;;1.0;14.95;14.95;4383370.61;American Spice;Lisset Limpio -020;Cafeteria;1388940;Jun
2025-06-01;El Palacio de Los Jugos / Casa mía Food Restaurant inc;Invoice;008-05657;Arroz a Granel:Parboiled 50 LB -Bolsa Dos Hermanos.;;8.0;26.75;214.0;4383584.61;Bulk Rice;Lisset Limpio -020;Cafeteria;1388941;Jun
2025-06-01;El Palacio de los jugos /  Nanos Latin Foods;Invoice;008-05658;Arroz a Granel:Largo Fino 50 LB -Bolsa Dos Hermanos.;;5.0;27.85;139.25;4383723.86;Bulk Rice;Lisset Limpio -020;Cafeteria;1388942;Jun
2025-06-01;El Palacio de los jugos /  Nanos Latin Foods;Invoice;008-05658;Arroz a Granel:Parboiled 50 LB -Bolsa Dos Hermanos.;;10.0;26.75;267.5;4383991.36;Bulk Rice;Lisset Limpio -020;Cafeteria;1388943;Jun
2025-06-01;El Palacio de los jugos / Rodriguez Foods;Invoice;008-05659;Arroz a Granel:Parboiled 50 LB -Bolsa Dos Hermanos.;;6.0;26.75;160.5;4384151.86;Bulk Rice;Lisset Limpio -020;Cafeteria;1388944;Jun
2025-06-01;El Palacio de los jugos / Delicias Criollas (DIAGO FOOD_MILLER);Invoice;008-05660;Arroz a Granel:Parboiled 50 LB -Bolsa Dos Hermanos.;;14.0;26.75;374.5;4384526.36;Bulk Rice;Lisset Limpio -020;Cafeteria;1388945;Jun
2025-06-01;El Palacio de los jugos / Delicias Criollas (DIAGO FOOD_MILLER);Invoice;008-05660;Dry Beans:Dry Beans - Black Beans 50;Dry Black Beans 50 lb;1.0;34.0;34.0;4384560.36;Dry Beans;Lisset Limpio -020;Cafeteria;1388946;Jun
2025-06-01;El Palacio de los jugos / Caribe Tropical;Invoice;008-05661;Dry Beans:Dry Beans - Black Beans 50;Dry Black Beans 50 lb;3.0;34.0;102.0;4384662.36;Dry Beans;Lisset Limpio -020;Cafeteria;1388947;Jun
2025-06-01;El Palacio de los jugos / Caribe Tropical;Invoice;008-05661;Arroz a Granel:Parboiled 50 LB -Bolsa Dos Hermanos.;;8.0;26.75;214.0;4384876.36;Bulk Rice;Lisset Limpio -020;Cafeteria;1388948;Jun
2025-06-01;El Palacio de los jugos / Divan and Denise Food;Invoice;008-05662;Dry Beans:Dry Beans - Black Beans 50;Dry Black Beans 50 lb;1.0;34.0;34.0;4384910.36;Dry Beans;Lisset Limpio -020;Cafeteria;1388949;Jun
2025-06-01;El Palacio de los jugos / Divan and Denise Food;Invoice;008-05662;Arroz a Granel:Largo Fino 50 LB -Bolsa Dos Hermanos.;;9.0;27.85;250.65;4385161.01;Bulk Rice;Lisset Limpio -020;Cafeteria;1388950;Jun
2025-06-01;El Palacio de los jugos / Divan and Denise Food;Invoice;008-05662;Arroz a Granel:Parboiled 50 LB -Bolsa Dos Hermanos.;;7.0;26.75;187.25;4385348.26;Bulk Rice;Lisset Limpio -020;Cafeteria;1388951;Jun
2025-06-01;JMN Dely Corp;Invoice;008-05663;Dry Beans:Dry Beans - Black Beans 50;Dry Black Beans 50 lb;1.0;45.7;45.7;4385393.96;Dry Beans;Keila Alfaro-Visvikis;CAFETERIA y RESTAURANTS;1388952;Jun
2025-06-01;JMN Dely Corp;Invoice;008-05663;Arroz a Granel:Largo Fino 50 LB -Bolsa Dos Hermanos.;;2.0;27.85;55.7;4385449.66;Bulk Rice;Keila Alfaro-Visvikis;CAFETERIA y RESTAURANTS;1388953;Jun
2025-06-01;JMN Dely Corp;Invoice;008-05663;Arroz a Granel:Parboiled 50 LB -Bolsa Dos Hermanos.;;2.0;27.75;55.5;4385505.16;Bulk Rice;Keila Alfaro-Visvikis;CAFETERIA y RESTAURANTS;1388954;Jun
2025-06-01;Sedanos Supermarkets #31;Credit Memo;008-05664;Varios:Producto vencido/deteriorado (no impacta en inventario);5 unid 5kg;-5.0;3.37;-16.85;4385488.31;Branded Rice;Keila Alfaro-Visvikis;RETAIL SEDANOS;1388955;Jun
2025-06-04;Ideal Food Basket Davie Cafeteria;Invoice;008-05672;Arroz a Granel:Largo Fino 50 LB -Bolsa Dos Hermanos.;;8.0;27.85;222.8;4385711.11;Bulk Rice;Keila Alfaro-Visvikis;CAFETERIA y RESTAURANTS;1388956;Jun
2025-06-04;Key Food Pembroke;Invoice;008-05673;Arroz Envasado:Largo Fino 1kg (Long grain rice) Dos Hermanos;;1.0;18.0;18.0;4385729.11;Branded Rice;Keila Alfaro-Visvikis;RETAIL  DSD;1388957;Jun
2025-06-04;Key Food Pembroke;Invoice;008-05673;Arroz Envasado:Parboiled 1kg Bolsa Dos Hermanos.;.;1.0;19.9;19.9;4385749.01;Branded Rice;Keila Alfaro-Visvikis;RETAIL  DSD;1388958;Jun
2025-06-04;Sedanos Supermarkets #24;Invoice;008-05674;Arroz a Granel:Parboiled 50 LB -Bolsa Dos Hermanos.;;8.0;28.25;226.0;4385975.01;Bulk Rice;Keila Alfaro-Visvikis;RETAIL SEDANOS;1388959;Jun
2025-06-04;Sedanos Supermarkets #24;Invoice;008-05674;;Discount;;;-4.52;4385970.49;;Keila Alfaro-Visvikis;RETAIL SEDANOS;1388960;Jun
2025-06-04;Chavez Distributors Inc.;Invoice;008-05675;Arroz a Granel:Parboiled 50 LB -Bolsa Dos Hermanos.;;55.0;27.75;1526.25;4387496.74;Bulk Rice;Keila Alfaro-Visvikis;WHOLESALER;1388961;Jun
2025-06-04;Los Caringas Latin America  Foods;Invoice;008-05676;Arroz a Granel:Largo Fino 50 LB -Bolsa Dos Hermanos.;;3.0;27.85;83.55;4387580.29;Bulk Rice;Lisset Limpio -020;CAFETERIA y RESTAURANTS;1388962;Jun
2025-06-04;Los Caringas Latin America  Foods;Invoice;008-05676;Arroz a Granel:Parboiled 50 LB -Bolsa Dos Hermanos.;;3.0;28.25;84.75;4387665.04;Bulk Rice;Lisset Limpio -020;CAFETERIA y RESTAURANTS;1388963;Jun
2025-06-04;Los Mejores Tamales de Miami;Invoice;008-05677;Arroz a Granel:Parboiled 50 LB -Bolsa Dos Hermanos.;;5.0;28.25;141.25;4387806.29;Bulk Rice;Lisset Limpio -020;CAFETERIA y RESTAURANTS;1388964;Jun
2025-06-04;Aries Supermarket & Cafeteria;Invoice;008-05678;Arroz a Granel:Parboiled 50 LB -Bolsa Dos Hermanos.;;10.0;28.25;282.5;4388088.79;Bulk Rice;Keila Alfaro-Visvikis;CAFETERIA y RESTAURANTS;1388965;Jun
2025-06-04;Aries Supermarket & Cafeteria;Invoice;008-05678;Dry Beans:Dry Beans - Black Beans 50;Dry Black Beans 50 lb;5.0;45.7;228.5;4388317.29;Dry Beans;Keila Alfaro-Visvikis;CAFETERIA y RESTAURANTS;1388966;Jun
2025-06-04;Sedanos Supermarkets #43;Invoice;008-05679;Arroz a Granel:Parboiled 50 LB -Bolsa Dos Hermanos.;;5.0;28.25;141.25;4388458.54;Bulk Rice;Keila Alfaro-Visvikis;RETAIL SEDANOS;1388967;Jun
2025-06-04;Sedanos Supermarkets #43;Invoice;008-05679;;Discount;;;-2.83;4388455.71;;Keila Alfaro-Visvikis;RETAIL SEDANOS;1388968;Jun
2025-06-04;Sedanos Supermarkets #26;Invoice;008-05680;Arroz a Granel:Parboiled 50 LB -Bolsa Dos Hermanos.;;5.0;28.25;141.25;4388596.96;Bulk Rice;Keila Alfaro-Visvikis;RETAIL SEDANOS;1388969;Jun
2025-06-04;El Palacio de los jugos /  EMMA FOOD CORP;Invoice;008-05681;Arroz a Granel:Parboiled 50 LB -Bolsa Dos Hermanos.;;6.0;26.75;160.5;4388757.46;Bulk Rice;Lisset Limpio -020;Cafeteria;1388970;Jun
2025-06-04;El Palacio de los jugos /  EMMA FOOD CORP;Invoice;008-05681;Arroz a Granel:Largo Fino 50 LB -Bolsa Dos Hermanos.;;6.0;27.85;167.1;4388924.56;Bulk Rice;Lisset Limpio -020;Cafeteria;1388971;Jun
2025-06-05;Soriano Brothers Diaz Food Service,Inc;Invoice;008-05682;Dry Beans:Dry Beans - Black Beans 50;Dry Black Beans 50 lb;5.0;36.75;183.75;4389108.31;Dry Beans;Lisset Limpio -020;CAFETERIA y RESTAURANTS;1388972;Jun
2025-06-05;Soriano Brothers Diaz Food Service,Inc;Invoice;008-05682;Arroz a Granel:Parboiled 50 LB -Bolsa Dos Hermanos.;;40.0;26.75;1070.0;4390178.31;Bulk Rice;Lisset Limpio -020;CAFETERIA y RESTAURANTS;1388973;Jun
2025-06-05;Sedanos Supermarkets  #11;Invoice;008-05683;Arroz Envasado:Parboiled 5KG Dos Hermanos.;6  11lbs;5.0;40.5;202.5;4390380.81;Branded Rice;Keila Alfaro-Visvikis;RETAIL SEDANOS;1388974;Jun
2025-06-05;Sedanos Supermarkets  #11;Invoice;008-05683;Arroz Envasado:Largo Fino 1kg (Long grain rice) Dos Hermanos;;1.0;17.5;17.5;4390398.31;Branded Rice;Keila Alfaro-Visvikis;RETAIL SEDANOS;1388975;Jun
2025-06-05;Sedanos Supermarkets  #11;Invoice;008-05683;Spanish Style Yellow Rice:AS Spanish Style Yellow Rice;AS Spanish Style Yellow Rice 6 / 3.25 oz;1.0;34.5;34.5;4390432.81;American Spice;Keila Alfaro-Visvikis;RETAIL SEDANOS;1388976;Jun
2025-06-05;Sedanos Supermarkets  #11;Invoice;008-05683;Arroz Envasado:Parboiled 5KG Dos Hermanos.;6  11lbs;2.0;40.5;81.0;4390513.81;Branded Rice;Keila Alfaro-Visvikis;RETAIL SEDANOS;1388977;Jun
2025-06-05;Sedanos Supermarkets  #11;Invoice;008-05683;;Discount;;;-5.09;4390508.72;;Keila Alfaro-Visvikis;RETAIL SEDANOS;1388978;Jun
2025-06-05;Diaz Grocers, Inc;Invoice;008-05684;Arroz Envasado:Parboiled 5KG Dos Hermanos.;6  11lbs;10.0;46.5;465.0;4390973.72;Branded Rice;Lisset Limpio -020;RETAIL  DSD;1388979;Jun
2025-06-05;Diaz Grocers, Inc;Invoice;008-05684;Arroz Envasado:Parboiled 5KG Dos Hermanos.;6  11lbs;2.0;46.5;93.0;4391066.72;Branded Rice;Lisset Limpio -020;RETAIL  DSD;1388980;Jun
2025-06-05;El Palacio de los jugos /  Mires Restaurants;Invoice;008-05685;Liquids:AS Marinating Sauce (Mojo);;1.0;18.5;18.5;4391085.22;American Spice;Lisset Limpio -020;Cafeteria;1388981;Jun
2025-06-05;El Palacio de los jugos /  Mires Restaurants;Invoice;008-05685;Arroz a Granel:Parboiled 50 LB -Bolsa Dos Hermanos.;;11.0;27.75;305.25;4391390.47;Bulk Rice;Lisset Limpio -020;Cafeteria;1388982;Jun
2025-06-05;El Palacio de los jugos /  Mires Restaurants;Invoice;008-05685;Arroz a Granel:Parboiled 50 LB -Bolsa Dos Hermanos.;;1.0;27.75;27.75;4391418.22;Bulk Rice;Lisset Limpio -020;Cafeteria;1388983;Jun
2025-06-05;El Palacio de los jugos / Rodriguez Foods;Invoice;008-05686;Arroz a Granel:Parboiled 50 LB -Bolsa Dos Hermanos.;;6.0;26.75;160.5;4391578.72;Bulk Rice;Lisset Limpio -020;Cafeteria;1388984;Jun
2025-06-05;El Palacio de los jugos /  EMMA FOOD CORP;Invoice;008-05687;Arroz a Granel:Largo Fino 50 LB -Bolsa Dos Hermanos.;;5.0;27.85;139.25;4391717.97;Bulk Rice;Lisset Limpio -020;Cafeteria;1388985;Jun
2025-06-05;El Palacio de los jugos /  EMMA FOOD CORP;Invoice;008-05687;Arroz a Granel:Parboiled 50 LB -Bolsa Dos Hermanos.;;6.0;26.75;160.5;4391878.47;Bulk Rice;Lisset Limpio -020;Cafeteria;1388986;Jun
2025-06-05;El Palacio de los jugos / Leti Corp.;Invoice;008-05688;Arroz a Granel:Parboiled 50 LB -Bolsa Dos Hermanos.;;8.0;26.75;214.0;4392092.47;Bulk Rice;Lisset Limpio -020;Cafeteria;1388987;Jun
2025-06-05;El Palacio de los jugos /  Nanos Latin Foods;Invoice;008-05689;Arroz a Granel:Parboiled 50 LB -Bolsa Dos Hermanos.;;12.0;26.75;321.0;4392413.47;Bulk Rice;Lisset Limpio -020;Cafeteria;1388988;Jun
2025-06-05;El Palacio de los jugos /  Nanos Latin Foods;Invoice;008-05689;Dry Beans:Dry Beans - Black Beans 50;Dry Black Beans 50 lb;1.0;34.0;34.0;4392447.47;Dry Beans;Lisset Limpio -020;Cafeteria;1388989;Jun
2025-06-05;Sedanos Supermarkets #18;Invoice;008-05690;Spanish Style Yellow Rice:AS Spanish Style Yellow Rice;AS Spanish Style Yellow Rice 6 / 3.25 oz;1.0;34.5;34.5;4392481.97;American Spice;Keila Alfaro-Visvikis;RETAIL SEDANOS;1388990;Jun
2025-06-05;Sedanos Supermarkets #18;Invoice;008-05690;Arroz Envasado:Parboiled 1kg Bolsa Dos Hermanos.;.;1.0;19.9;19.9;4392501.87;Branded Rice;Keila Alfaro-Visvikis;RETAIL SEDANOS;1388991;Jun
2025-06-05;Sedanos Supermarkets #18;Invoice;008-05690;Arroz Envasado:Largo Fino 1kg (Long grain rice) Dos Hermanos;;1.0;17.5;17.5;4392519.37;Branded Rice;Keila Alfaro-Visvikis;RETAIL SEDANOS;1388992;Jun
2025-06-05;Sedanos Supermarkets #18;Invoice;008-05690;;Discount;;;-1.44;4392517.93;;Keila Alfaro-Visvikis;RETAIL SEDANOS;1388993;Jun
2025-06-05;Sedanos Supermarkets #18;Invoice;008-05691;Spices:AS Chicken Base;1 / 30 lb. (box or pail);1.0;39.0;39.0;4392556.93;American Spice;Keila Alfaro-Visvikis;RETAIL SEDANOS;1388994;Jun
2025-06-05;Sedanos Supermarkets #18;Invoice;008-05691;;Discount;;;-0.78;4392556.15;;Keila Alfaro-Visvikis;RETAIL SEDANOS;1388995;Jun
2025-06-05;Sedanos Supermarkets #32;Invoice;008-05692;Arroz a Granel:Largo Fino 50 LB -Bolsa Dos Hermanos.;;4.0;27.85;111.4;4392667.55;Bulk Rice;Keila Alfaro-Visvikis;RETAIL SEDANOS;1388996;Jun
2025-06-05;Sedanos Supermarkets #32;Invoice;008-05692;Arroz a Granel:Parboiled 50 LB -Bolsa Dos Hermanos.;;6.0;28.25;169.5;4392837.05;Bulk Rice;Keila Alfaro-Visvikis;RETAIL SEDANOS;1388997;Jun
2025-06-05;Sedanos Supermarkets #32;Invoice;008-05692;;Discount;;;-5.62;4392831.43;;Keila Alfaro-Visvikis;RETAIL SEDANOS;1388998;Jun
2025-06-05;El Palacio de los jugos / Lita Foods Inc.;Invoice;008-05693;Dry Beans:Dry Beans - Black Beans 50;Dry Black Beans 50 lb;1.0;34.0;34.0;4392865.43;Dry Beans;Lisset Limpio -020;Cafeteria;1388999;Jun
2025-06-05;El Palacio de los jugos / Lita Foods Inc.;Invoice;008-05693;Arroz a Granel:Parboiled 50 LB -Bolsa Dos Hermanos.;;12.0;26.75;321.0;4393186.43;Bulk Rice;Lisset Limpio -020;Cafeteria;1389000;Jun
2025-06-05;El Palacio de los jugos / Caribe Tropical;Invoice;008-05694;Arroz a Granel:Parboiled 50 LB -Bolsa Dos Hermanos.;;8.0;26.75;214.0;4393400.43;Bulk Rice;Lisset Limpio -020;Cafeteria;1389001;Jun
2025-06-05;El Palacio de los jugos / Caribe Tropical;Invoice;008-05694;Dry Beans:Dry Beans - Black Beans 50;Dry Black Beans 50 lb;2.0;34.0;68.0;4393468.43;Dry Beans;Lisset Limpio -020;Cafeteria;1389002;Jun
2025-06-05;El Palacio de los jugos / Divan and Denise Food;Invoice;008-05695;Arroz a Granel:Largo Fino 50 LB -Bolsa Dos Hermanos.;;5.0;27.85;139.25;4393607.68;Bulk Rice;Lisset Limpio -020;Cafeteria;1389003;Jun
2025-06-05;El Palacio de los jugos / Divan and Denise Food;Invoice;008-05695;Arroz a Granel:Parboiled 50 LB -Bolsa Dos Hermanos.;;9.0;26.75;240.75;4393848.43;Bulk Rice;Lisset Limpio -020;Cafeteria;1389004;Jun
2025-06-05;El Palacio de los jugos / Divan and Denise Food;Invoice;008-05695;;Discount;;;-3.8;4393844.63;;Lisset Limpio -020;Cafeteria;1389005;Jun
2025-06-05;Mei Chang;Invoice;008-05696;Arroz a Granel:Parboiled 50 LB -Bolsa Dos Hermanos.;;6.0;28.25;169.5;4394014.13;Bulk Rice;Lisset Limpio -020;CAFETERIA y RESTAURANTS;1389006;Jun
2025-06-05;Sedanos Supermarkets #33;Invoice;008-05697;Arroz a Granel:Parboiled 50 LB -Bolsa Dos Hermanos.;;4.0;28.25;113.0;4394127.13;Bulk Rice;Keila Alfaro-Visvikis;RETAIL SEDANOS;1389007;Jun
2025-06-05;Sedanos Supermarkets #33;Invoice;008-05697;;Discount;;;-2.26;4394124.87;;Keila Alfaro-Visvikis;RETAIL SEDANOS;1389008;Jun
2025-06-05;El Palacio de Los Jugos / Casa mía Food Restaurant inc;Invoice;008-05698;Dry Beans:Dry Beans - Black Beans 50;Dry Black Beans 50 lb;1.0;34.0;34.0;4394158.87;Dry Beans;Lisset Limpio -020;Cafeteria;1389009;Jun
2025-06-05;El Palacio de Los Jugos / Casa mía Food Restaurant inc;Invoice;008-05698;Spices:AS Chicken Base;1 / 30 lb. (box or pail);1.0;39.0;39.0;4394197.87;American Spice;Lisset Limpio -020;Cafeteria;1389010;Jun
2025-06-05;El Palacio de Los Jugos / Casa mía Food Restaurant inc;Invoice;008-05698;Spices:AS Sazon (for all);1 / 30 lb (box or pail);1.0;59.0;59.0;4394256.87;American Spice;Lisset Limpio -020;Cafeteria;1389011;Jun
2025-06-05;El Palacio de Los Jugos / Casa mía Food Restaurant inc;Invoice;008-05698;Arroz a Granel:Parboiled 50 LB -Bolsa Dos Hermanos.;;12.0;26.75;321.0;4394577.87;Bulk Rice;Lisset Limpio -020;Cafeteria;1389012;Jun
2025-06-05;El Palacio de Los Jugos / Casa mía Food Restaurant inc;Invoice;008-05698;Liquids:AS Marinating Sauce (Mojo);;1.0;17.0;17.0;4394594.87;American Spice;Lisset Limpio -020;Cafeteria;1389013;Jun
2025-06-05;El Palacio de Los Jugos / Casa mía Food Restaurant inc;Invoice;008-05698;Liquids:AS Lemon Juice 4/1 Gl;;1.0;14.95;14.95;4394609.82;American Spice;Lisset Limpio -020;Cafeteria;1389014;Jun
2025-06-06;Sedanos Supermarkets #38;Credit Memo;008-05699;Varios:Producto vencido/deteriorado (no impacta en inventario);10 salami;-10.0;0.99;-9.9;4394599.92;Puffed Products;Keila Alfaro-Visvikis;RETAIL SEDANOS;1389015;Jun
2025-06-06;Sedanos Supermarkets #42;Invoice;008-05700;Arroz a Granel:Parboiled 50 LB -Bolsa Dos Hermanos.;;5.0;28.25;141.25;4394741.17;Bulk Rice;Keila Alfaro-Visvikis;RETAIL SEDANOS;1389016;Jun
2025-06-06;Sedanos Supermarkets #42;Invoice;008-05700;;Discount;;;-2.83;4394738.34;;Keila Alfaro-Visvikis;RETAIL SEDANOS;1389017;Jun
2025-06-08;El Palacio de los jugos /  Nanos Latin Foods;Invoice;008-05701;Arroz a Granel:Largo Fino 50 LB -Bolsa Dos Hermanos.;;7.0;27.85;194.95;4394933.29;Bulk Rice;Lisset Limpio -020;Cafeteria;1389018;Jun
2025-06-08;El Palacio de los jugos /  Nanos Latin Foods;Invoice;008-05701;Arroz a Granel:Parboiled 50 LB -Bolsa Dos Hermanos.;;8.0;26.75;214.0;4395147.29;Bulk Rice;Lisset Limpio -020;Cafeteria;1389019;Jun
2025-06-08;El Palacio de Los Jugos / Casa mía Food Restaurant inc;Invoice;008-05702;Spices:AS Chicken Base;1 / 30 lb. (box or pail);1.0;39.0;39.0;4395186.29;American Spice;Lisset Limpio -020;Cafeteria;1389020;Jun
2025-06-08;El Palacio de Los Jugos / Casa mía Food Restaurant inc;Invoice;008-05702;Arroz a Granel:Parboiled 50 LB -Bolsa Dos Hermanos.;;8.0;26.75;214.0;4395400.29;Bulk Rice;Lisset Limpio -020;Cafeteria;1389021;Jun
2025-06-08;El Palacio de los Jugos / Bird Road Restaurant;Invoice;008-05703;Arroz a Granel:Parboiled 50 LB -Bolsa Dos Hermanos.;;11.0;27.75;305.25;4395705.54;Bulk Rice;;Cafeteria;1389022;Jun
2025-06-08;El Palacio de los Jugos / Bird Road Restaurant;Invoice;008-05703;Dry Beans:Dry Beans - Black Beans 50;Dry Black Beans 50 lb;1.0;34.0;34.0;4395739.54;Dry Beans;;Cafeteria;1389023;Jun
2025-06-08;El Palacio de los Jugos / Bird Road Restaurant;Invoice;008-05703;Arroz a Granel:Largo Fino 50 LB -Bolsa Dos Hermanos.;;1.0;27.75;27.75;4395767.29;Bulk Rice;;Cafeteria;1389024;Jun
2025-06-08;Be Your Will LLC;Invoice;008-05704;Liquids:AS Cooking Wine;4 1 Gl.;2.0;17.5;35.0;4395802.29;American Spice;Lisset Limpio -020;CAFETERIA y RESTAURANTS;1389025;Jun
2025-06-08;Be Your Will LLC;Invoice;008-05704;Arroz a Granel:Largo Fino 50 LB -Bolsa Dos Hermanos.;;7.0;27.85;194.95;4395997.24;Bulk Rice;Lisset Limpio -020;CAFETERIA y RESTAURANTS;1389026;Jun
2025-06-08;Be Your Will LLC;Invoice;008-05704;Arroz a Granel:Parboiled 50 LB -Bolsa Dos Hermanos.;;14.0;26.75;374.5;4396371.74;Bulk Rice;Lisset Limpio -020;CAFETERIA y RESTAURANTS;1389027;Jun
2025-06-08;El Palacio de los jugos / Divan and Denise Food;Invoice;008-05705;Arroz a Granel:Parboiled 50 LB -Bolsa Dos Hermanos.;;5.0;26.75;133.75;4396505.49;Bulk Rice;Lisset Limpio -020;Cafeteria;1389028;Jun
2025-06-08;El Palacio de los jugos / Rodriguez Foods;Invoice;008-05706;Arroz a Granel:Parboiled 50 LB -Bolsa Dos Hermanos.;;6.0;26.75;160.5;4396665.99;Bulk Rice;Lisset Limpio -020;Cafeteria;1389029;Jun
2025-06-08;El Palacio de los jugos / Delicias Criollas (DIAGO FOOD_MILLER);Invoice;008-05707;Arroz a Granel:Largo Fino 50 LB -Bolsa Dos Hermanos.;;6.0;27.85;167.1;4396833.09;Bulk Rice;Lisset Limpio -020;Cafeteria;1389030;Jun
2025-06-08;El Palacio de los jugos / Delicias Criollas (DIAGO FOOD_MILLER);Invoice;008-05707;Arroz a Granel:Parboiled 50 LB -Bolsa Dos Hermanos.;;11.0;26.75;294.25;4397127.34;Bulk Rice;Lisset Limpio -020;Cafeteria;1389031;Jun
2025-06-08;El Palacio de los jugos / Caribe Tropical;Invoice;008-05708;Dry Beans:Dry Beans - Black Beans 50;Dry Black Beans 50 lb;3.0;34.0;102.0;4397229.34;Dry Beans;Lisset Limpio -020;Cafeteria;1389032;Jun
2025-06-08;El Palacio de los jugos / Caribe Tropical;Invoice;008-05708;Arroz a Granel:Parboiled 50 LB -Bolsa Dos Hermanos.;;8.0;26.75;214.0;4397443.34;Bulk Rice;Lisset Limpio -020;Cafeteria;1389033;Jun
2025-06-08;JMN Dely Corp;Invoice;008-05709;Dry Beans:Dry Beans - Black Beans 50;Dry Black Beans 50 lb;1.0;45.7;45.7;4397489.04;Dry Beans;Keila Alfaro-Visvikis;CAFETERIA y RESTAURANTS;1389034;Jun
2025-06-08;JMN Dely Corp;Invoice;008-05709;Arroz a Granel:Largo Fino 50 LB -Bolsa Dos Hermanos.;;2.0;27.85;55.7;4397544.74;Bulk Rice;Keila Alfaro-Visvikis;CAFETERIA y RESTAURANTS;1389035;Jun
2025-06-08;JMN Dely Corp;Invoice;008-05709;Arroz a Granel:Parboiled 50 LB -Bolsa Dos Hermanos.;;2.0;28.25;56.5;4397601.24;Bulk Rice;Keila Alfaro-Visvikis;CAFETERIA y RESTAURANTS;1389036;Jun
2025-06-08;Sedanos Supermarkets #17;Invoice;008-05710;Spanish Style Yellow Rice:AS Spanish Style Yellow Rice;AS Spanish Style Yellow Rice 6 / 3.25 oz;1.0;34.5;34.5;4397635.74;American Spice;Keila Alfaro-Visvikis;RETAIL SEDANOS;1389037;Jun
2025-06-08;Sedanos Supermarkets #17;Invoice;008-05710;;Discount;;;-0.69;4397635.05;;Keila Alfaro-Visvikis;RETAIL SEDANOS;1389038;Jun
2025-06-08;Sedanos Supermarkets #42;Invoice;008-05711;Arroz Envasado:Parboiled 5KG Dos Hermanos.;6  11lbs;5.0;40.5;202.5;4397837.55;Branded Rice;Keila Alfaro-Visvikis;RETAIL SEDANOS;1389039;Jun
2025-06-08;Sedanos Supermarkets #42;Invoice;008-05711;Arroz Envasado:Parboiled 5KG Dos Hermanos.;6  11lbs;1.0;40.5;40.5;4397878.05;Branded Rice;Keila Alfaro-Visvikis;RETAIL SEDANOS;1389040;Jun
2025-06-08;Sedanos Supermarkets #42;Invoice;008-05711;;Discount;;;-4.05;4397874.0;;Keila Alfaro-Visvikis;RETAIL SEDANOS;1389041;Jun
2025-06-09;El Palacio de los jugos /  EMMA FOOD CORP;Invoice;008-05712;Arroz a Granel:Parboiled 50 LB -Bolsa Dos Hermanos.;;8.0;26.75;214.0;4398088.0;Bulk Rice;Lisset Limpio -020;Cafeteria;1389042;Jun
2025-06-09;Bravo   Francisco Diaz;Invoice;008-05713;Liquids:AS Cooking Wine;4 1 Gl.;4.0;17.5;70.0;4398158.0;American Spice;Lisset Limpio -020;RETAIL  DSD;1389043;Jun
2025-06-09;Bravo   Francisco Diaz;Invoice;008-05713;Liquids:AS Marinating Sauce (Mojo);;3.0;18.5;55.5;4398213.5;American Spice;Lisset Limpio -020;RETAIL  DSD;1389044;Jun
2025-06-09;Bravo   Francisco Diaz;Invoice;008-05713;Arroz a Granel:Largo Fino 50 LB -Bolsa Dos Hermanos.;;5.0;27.85;139.25;4398352.75;Bulk Rice;Lisset Limpio -020;RETAIL  DSD;1389045;Jun
2025-06-09;El Palacio de los jugos /  Mires Restaurants;Credit Memo;008-05714;Varios:Promotional Allowance;Arroz a Granel:Parboiled 50 LB -Bolsa Dos Hermanos.;-1.0;27.75;-27.75;4398325.0;Bulk Rice;Lisset Limpio -020;Cafeteria;1389046;Jun
2025-06-09;Diaz Grocers, Inc;Credit Memo;008-05715;Varios:Promotional Allowance;Arroz Envasado:Parboiled 5KG Dos Hermanos.;-2.0;46.5;-93.0;4398232.0;Branded Rice;Lisset Limpio -020;RETAIL  DSD;1389047;Jun
2025-06-09;Sedanos Supermarkets  #11;Credit Memo;008-05824;Varios:Promotional Allowance;Arroz Envasado:Parboiled 5KG Dos Hermanos.;-2.0;40.5;-81.0;4398151.0;Branded Rice;Keila Alfaro-Visvikis;RETAIL SEDANOS;1389048;Jun
2025-06-09;El Palacio de los Jugos / Bird Road Restaurant;Credit Memo;008-05825;Varios:Promotional Allowance;Arroz a Granel:Largo Fino 50 LB -Bolsa Dos Hermanos.;-1.0;27.75;-27.75;4398123.25;Bulk Rice;Lisset Limpio -020;Cafeteria;1389049;Jun
2025-06-09;Sedanos Supermarkets #42;Credit Memo;008-05826;Varios:Promotional Allowance;Arroz Envasado:Parboiled 5KG Dos Hermanos.;-1.0;40.5;-40.5;4398082.75;Branded Rice;Keila Alfaro-Visvikis;RETAIL SEDANOS;1389050;Jun
2025-06-11;Ideal Food Basket Davie Cafeteria;Invoice;008-05716;Arroz a Granel:Largo Fino 50 LB -Bolsa Dos Hermanos.;;8.0;27.85;222.8;4398305.55;Bulk Rice;Keila Alfaro-Visvikis;CAFETERIA y RESTAURANTS;1389051;Jun
2025-06-11;Sedanos Supermarkets #20;Invoice;008-05717;Arroz Envasado:Parboiled 5KG Dos Hermanos.;6  11lbs;5.0;40.5;202.5;4398508.05;Branded Rice;Keila Alfaro-Visvikis;RETAIL SEDANOS;1389052;Jun
2025-06-11;Sedanos Supermarkets #20;Invoice;008-05717;Arroz Envasado:Parboiled 5KG Dos Hermanos.;6  11lbs;1.0;40.5;40.5;4398548.55;Branded Rice;Keila Alfaro-Visvikis;RETAIL SEDANOS;1389053;Jun
2025-06-11;Sedanos Supermarkets #20;Invoice;008-05717;;Discount;;;-4.05;4398544.5;;Keila Alfaro-Visvikis;RETAIL SEDANOS;1389054;Jun
2025-06-11;Sedanos Supermarkets #34;Invoice;008-05718;Arroz Envasado:Parboiled 5KG Dos Hermanos.;6  11lbs;15.0;40.5;607.5;4399152.0;Branded Rice;Keila Alfaro-Visvikis;RETAIL SEDANOS;1389055;Jun
2025-06-11;Sedanos Supermarkets #34;Invoice;008-05718;Arroz Envasado:Parboiled 5KG Dos Hermanos.;6  11lbs;3.0;40.5;121.5;4399273.5;Branded Rice;Keila Alfaro-Visvikis;RETAIL SEDANOS;1389056;Jun
2025-06-11;Sedanos Supermarkets #34;Invoice;008-05718;;Discount;;;-12.15;4399261.35;;Keila Alfaro-Visvikis;RETAIL SEDANOS;1389057;Jun
2025-06-11;Pacifico Chinese Restaurant;Invoice;008-05719;Arroz a Granel:Parboiled 50 LB -Bolsa Dos Hermanos.;;10.0;28.25;282.5;4399543.85;Bulk Rice;Lisset Limpio -020;CAFETERIA y RESTAURANTS;1389058;Jun
2025-06-11;Sedanos Supermarkets #43;Invoice;008-05720;Arroz a Granel:Parboiled 50 LB -Bolsa Dos Hermanos.;;5.0;28.25;141.25;4399685.1;Bulk Rice;Keila Alfaro-Visvikis;RETAIL SEDANOS;1389059;Jun
2025-06-11;Sedanos Supermarkets #43;Invoice;008-05720;;Discount;;;-2.83;4399682.27;;Keila Alfaro-Visvikis;RETAIL SEDANOS;1389060;Jun
2025-06-11;Sedanos Supermarkets #26;Invoice;008-05721;Arroz a Granel:Parboiled 50 LB -Bolsa Dos Hermanos.;;5.0;28.25;141.25;4399823.52;Bulk Rice;Keila Alfaro-Visvikis;RETAIL SEDANOS;1389061;Jun
2025-06-11;Sedanos Supermarkets #26;Invoice;008-05722;Spanish Style Yellow Rice:AS Spanish Style Yellow Rice;AS Spanish Style Yellow Rice 6 / 3.25 oz;1.0;34.5;34.5;4399858.02;American Spice;Keila Alfaro-Visvikis;RETAIL SEDANOS;1389062;Jun
2025-06-11;Sedanos Supermarkets #26;Invoice;008-05722;Arroz Envasado:Parboiled 5KG Dos Hermanos.;6  11lbs;5.0;40.5;202.5;4400060.52;Branded Rice;Keila Alfaro-Visvikis;RETAIL SEDANOS;1389063;Jun
2025-06-11;Sedanos Supermarkets #26;Invoice;008-05722;Arroz Envasado:Parboiled 5KG Dos Hermanos.;6  11lbs;1.0;40.5;40.5;4400101.02;Branded Rice;Keila Alfaro-Visvikis;RETAIL SEDANOS;1389064;Jun
2025-06-11;Sedanos Supermarkets #16;Invoice;008-05723;Arroz a Granel:Parboiled 50 LB -Bolsa Dos Hermanos.;;5.0;28.25;141.25;4400242.27;Bulk Rice;Keila Alfaro-Visvikis;RETAIL SEDANOS;1389065;Jun
2025-06-11;Sedanos Supermarkets #16;Invoice;008-05723;;Discount;;;-2.83;4400239.44;;Keila Alfaro-Visvikis;RETAIL SEDANOS;1389066;Jun
2025-06-11;Aries Supermarket & Cafeteria;Invoice;008-05724;Arroz a Granel:Parboiled 50 LB -Bolsa Dos Hermanos.;;5.0;28.25;141.25;4400380.69;Bulk Rice;Keila Alfaro-Visvikis;CAFETERIA y RESTAURANTS;1389067;Jun
2025-06-11;Aries Supermarket & Cafeteria;Invoice;008-05724;Spices:AS Chicken Base;1 / 30 lb. (box or pail);3.0;39.0;117.0;4400497.69;American Spice;Keila Alfaro-Visvikis;CAFETERIA y RESTAURANTS;1389068;Jun
2025-06-11;Aries Supermarket & Cafeteria;Invoice;008-05724;Liquids:AS Bitter Orange;;1.0;14.0;14.0;4400511.69;American Spice;Keila Alfaro-Visvikis;CAFETERIA y RESTAURANTS;1389069;Jun
2025-06-11;Sedanos Supermarkets #28;Invoice;008-05725;Spanish Style Yellow Rice:AS Spanish Style Yellow Rice;AS Spanish Style Yellow Rice 6 / 3.25 oz;1.0;34.5;34.5;4400546.19;American Spice;Keila Alfaro-Visvikis;RETAIL SEDANOS;1389070;Jun
2025-06-11;Sedanos Supermarkets #28;Invoice;008-05725;Arroz Envasado:Parboiled 5KG Dos Hermanos.;6  11lbs;15.0;40.5;607.5;4401153.69;Branded Rice;Keila Alfaro-Visvikis;RETAIL SEDANOS;1389071;Jun
2025-06-11;Sedanos Supermarkets #28;Invoice;008-05725;Arroz Envasado:Parboiled 5KG Dos Hermanos.;6  11lbs;3.0;40.5;121.5;4401275.19;Branded Rice;Keila Alfaro-Visvikis;RETAIL SEDANOS;1389072;Jun
2025-06-11;Sedanos Supermarkets #28;Invoice;008-05725;;Discount;;;-12.84;4401262.35;;Keila Alfaro-Visvikis;RETAIL SEDANOS;1389073;Jun
2025-06-11;Sabor Tropical #1 - Supermarket;Invoice;008-05726;Arroz Envasado:Largo Fino 1kg (Long grain rice) Dos Hermanos;;10.0;18.0;180.0;4401442.35;Branded Rice;Keila Alfaro-Visvikis;RETAIL  DSD;1389074;Jun
2025-06-11;Sabor Tropical #1 - Supermarket;Invoice;008-05726;Arroz Envasado:Largo Fino 1kg (Long grain rice) Dos Hermanos;;2.0;18.0;36.0;4401478.35;Branded Rice;Keila Alfaro-Visvikis;RETAIL  DSD;1389075;Jun
2025-06-12;Sedanos Supermarkets #31;Invoice;008-05727;Arroz a Granel:Parboiled 50 LB -Bolsa Dos Hermanos.;;5.0;28.25;141.25;4401619.6;Bulk Rice;Keila Alfaro-Visvikis;RETAIL SEDANOS;1389076;Jun
2025-06-12;Sedanos Supermarkets #31;Invoice;008-05727;;Discount;;;-2.83;4401616.77;;Keila Alfaro-Visvikis;RETAIL SEDANOS;1389077;Jun
2025-06-12;Sedanos Supermarkets #34;Credit Memo;008-05827;Varios:Promotional Allowance;Arroz Envasado:Parboiled 5KG Dos Hermanos.;-3.0;40.5;-121.5;4401495.27;Branded Rice;Keila Alfaro-Visvikis;RETAIL SEDANOS;1389078;Jun
2025-06-12;Sedanos Supermarkets #28;Credit Memo;008-05828;Varios:Promotional Allowance;Arroz Envasado:Parboiled 5KG Dos Hermanos.;-3.0;40.5;-121.5;4401373.77;Branded Rice;Keila Alfaro-Visvikis;RETAIL SEDANOS;1389079;Jun
2025-06-12;Sedanos Supermarkets #20;Credit Memo;008-05829;Varios:Promotional Allowance;Arroz Envasado:Parboiled 5KG Dos Hermanos.;-1.0;40.5;-40.5;4401333.27;Branded Rice;Keila Alfaro-Visvikis;RETAIL SEDANOS;1389080;Jun
2025-06-12;Sedanos Supermarkets #26;Credit Memo;008-05830;Varios:Promotional Allowance;Arroz Envasado:Parboiled 5KG Dos Hermanos.;-1.0;40.5;-40.5;4401292.77;Branded Rice;Keila Alfaro-Visvikis;RETAIL SEDANOS;1389081;Jun
2025-06-12;Sabor Tropical #1 - Supermarket;Credit Memo;008-05831;Varios:Promotional Allowance;Arroz Envasado:Largo Fino 1kg (Long grain rice) Dos Hermanos;-2.0;18.0;-36.0;4401256.77;Branded Rice;Keila Alfaro-Visvikis;RETAIL  DSD;1389082;Jun
2025-06-12;Sedanos Supermarkets #38;Credit Memo;008-05832;Varios:Promotional Allowance;Arroz Envasado:Parboiled 5KG Dos Hermanos.;-20.0;40.5;-810.0;4400446.77;Branded Rice;Keila Alfaro-Visvikis;RETAIL SEDANOS;1389083;Jun
2025-06-13;Soriano Brothers PB;Invoice;008-05728;Spices:AS Sazon (for all);1 / 30 lb (box or pail);2.0;51.0;102.0;4400548.77;American Spice;Lisset Limpio -020;CAFETERIA y RESTAURANTS;1389084;Jun
2025-06-13;Soriano Brothers PB;Invoice;008-05728;Arroz a Granel:Largo Fino 50 LB -Bolsa Dos Hermanos.;;18.0;27.85;501.3;4401050.07;Bulk Rice;Lisset Limpio -020;CAFETERIA y RESTAURANTS;1389085;Jun
2025-06-13;Soriano Brothers PB;Invoice;008-05728;Dry Beans:Dry Beans - Black Beans 50;Dry Black Beans 50 lb;1.0;34.0;34.0;4401084.07;Dry Beans;Lisset Limpio -020;CAFETERIA y RESTAURANTS;1389086;Jun
2025-06-13;Soriano Brothers PB;Invoice;008-05728;Arroz a Granel:Parboiled 50 LB -Bolsa Dos Hermanos.;;20.0;26.75;535.0;4401619.07;Bulk Rice;Lisset Limpio -020;CAFETERIA y RESTAURANTS;1389087;Jun
2025-06-13;HONG KONG;Invoice;008-05729;Arroz a Granel:Parboiled 50 LB -Bolsa Dos Hermanos.;;5.0;27.75;138.75;4401757.82;Bulk Rice;Lisset Limpio -020;CAFETERIA y RESTAURANTS;1389088;Jun
2025-06-13;El Palacio de los jugos / Caribe Tropical;Invoice;008-05730;Arroz a Granel:Parboiled 50 LB -Bolsa Dos Hermanos.;;10.0;26.75;267.5;4402025.32;Bulk Rice;Lisset Limpio -020;Cafeteria;1389089;Jun
2025-06-13;El Palacio de los jugos / Leti Corp.;Invoice;008-05731;Arroz a Granel:Largo Fino 50 LB -Bolsa Dos Hermanos.;;5.0;27.85;139.25;4402164.57;Bulk Rice;Lisset Limpio -020;Cafeteria;1389090;Jun
2025-06-13;El Palacio de los jugos / Leti Corp.;Invoice;008-05731;Arroz a Granel:Parboiled 50 LB -Bolsa Dos Hermanos.;;6.0;26.75;160.5;4402325.07;Bulk Rice;Lisset Limpio -020;Cafeteria;1389091;Jun
2025-06-13;China Tokyo;Invoice;008-05732;Arroz a Granel:Parboiled 50 LB -Bolsa Dos Hermanos.;;9.0;28.25;254.25;4402579.32;Bulk Rice;Lisset Limpio -020;CAFETERIA y RESTAURANTS;1389092;Jun
2025-06-13;El Palacio de Los Jugos / Casa mía Food Restaurant inc;Invoice;008-05733;Spices:AS Chicken Base;1 / 30 lb. (box or pail);1.0;39.0;39.0;4402618.32;American Spice;Lisset Limpio -020;Cafeteria;1389093;Jun
2025-06-13;El Palacio de Los Jugos / Casa mía Food Restaurant inc;Invoice;008-05733;Liquids:AS Lemon Juice 4/1 Gl;;1.0;14.95;14.95;4402633.27;American Spice;Lisset Limpio -020;Cafeteria;1389094;Jun
2025-06-13;El Palacio de Los Jugos / Casa mía Food Restaurant inc;Invoice;008-05733;Liquids:AS Marinating Sauce (Mojo);;1.0;17.0;17.0;4402650.27;American Spice;Lisset Limpio -020;Cafeteria;1389095;Jun
2025-06-13;El Palacio de Los Jugos / Casa mía Food Restaurant inc;Invoice;008-05733;Arroz a Granel:Parboiled 50 LB -Bolsa Dos Hermanos.;;6.0;26.75;160.5;4402810.77;Bulk Rice;Lisset Limpio -020;Cafeteria;1389096;Jun
2025-06-13;El Palacio de Los Jugos / Casa mía Food Restaurant inc;Invoice;008-05733;Spices:AS Sazon (for all);1 / 30 lb (box or pail);1.0;51.0;51.0;4402861.77;American Spice;Lisset Limpio -020;Cafeteria;1389097;Jun
2025-06-13;Sedanos Supermarkets #33;Invoice;008-05734;Arroz a Granel:Parboiled 50 LB -Bolsa Dos Hermanos.;;3.0;28.25;84.75;4402946.52;Bulk Rice;Keila Alfaro-Visvikis;RETAIL SEDANOS;1389098;Jun
2025-06-13;Sedanos Supermarkets #33;Invoice;008-05734;;Discount;;;-1.7;4402944.82;;Keila Alfaro-Visvikis;RETAIL SEDANOS;1389099;Jun
2025-06-13;Sedanos Supermarkets #18;Invoice;008-05735;Spices:AS Chicken Base;1 / 30 lb. (box or pail);1.0;39.0;39.0;4402983.82;American Spice;Keila Alfaro-Visvikis;RETAIL SEDANOS;1389100;Jun
2025-06-13;Sedanos Supermarkets #18;Invoice;008-05735;Arroz a Granel:Parboiled 50 LB -Bolsa Dos Hermanos.;;10.0;28.25;282.5;4403266.32;Bulk Rice;Keila Alfaro-Visvikis;RETAIL SEDANOS;1389101;Jun
2025-06-13;Sedanos Supermarkets #18;Invoice;008-05735;;Discount;;;-6.43;4403259.89;;Keila Alfaro-Visvikis;RETAIL SEDANOS;1389102;Jun
2025-06-13;Sedanos Supermarkets #32;Invoice;008-05736;Arroz a Granel:Largo Fino 50 LB -Bolsa Dos Hermanos.;;1.0;27.85;27.85;4403287.74;Bulk Rice;Keila Alfaro-Visvikis;RETAIL SEDANOS;1389103;Jun
2025-06-13;Sedanos Supermarkets #32;Invoice;008-05736;Arroz a Granel:Parboiled 50 LB -Bolsa Dos Hermanos.;;2.0;28.25;56.5;4403344.24;Bulk Rice;Keila Alfaro-Visvikis;RETAIL SEDANOS;1389104;Jun
2025-06-13;Sedanos Supermarkets #32;Invoice;008-05736;;Discount;;;-1.69;4403342.55;;Keila Alfaro-Visvikis;RETAIL SEDANOS;1389105;Jun
2025-06-13;Sedanos Supermarkets #38;Invoice;008-05737;Arroz Envasado:Parboiled 5KG Dos Hermanos.;6  11lbs;20.0;40.5;810.0;4404152.55;Branded Rice;Keila Alfaro-Visvikis;RETAIL SEDANOS;1389106;Jun
2025-06-13;Sedanos Supermarkets #38;Invoice;008-05737;Arroz Envasado:Parboiled 5KG Dos Hermanos.;6  11lbs;20.0;40.5;810.0;4404962.55;Branded Rice;Keila Alfaro-Visvikis;RETAIL SEDANOS;1389107;Jun
2025-06-13;Sedanos Supermarkets #38;Invoice;008-05737;;Discount;;;-16.2;4404946.35;;Keila Alfaro-Visvikis;RETAIL SEDANOS;1389108;Jun
2025-06-13;ALS Foods;Invoice;008-05738;Liquids:AS Cooking Wine;4 1 Gl.;2.0;17.5;35.0;4404981.35;American Spice;Lisset Limpio -020;CAFETERIA y RESTAURANTS;1389109;Jun
2025-06-13;ALS Foods;Invoice;008-05738;Arroz a Granel:Largo Fino 50 LB -Bolsa Dos Hermanos.;;8.0;27.85;222.8;4405204.15;Bulk Rice;Lisset Limpio -020;CAFETERIA y RESTAURANTS;1389110;Jun
2025-06-13;ALS Foods;Invoice;008-05738;Arroz a Granel:Parboiled 50 LB -Bolsa Dos Hermanos.;;6.0;26.75;160.5;4405364.65;Bulk Rice;Lisset Limpio -020;CAFETERIA y RESTAURANTS;1389111;Jun
2025-06-13;El Palacio de los jugos /  Nanos Latin Foods;Invoice;008-05739;Arroz a Granel:Largo Fino 50 LB -Bolsa Dos Hermanos.;;5.0;27.85;139.25;4405503.9;Bulk Rice;Lisset Limpio -020;Cafeteria;1389112;Jun
2025-06-13;El Palacio de los jugos /  Nanos Latin Foods;Invoice;008-05739;Arroz a Granel:Parboiled 50 LB -Bolsa Dos Hermanos.;;5.0;26.75;133.75;4405637.65;Bulk Rice;Lisset Limpio -020;Cafeteria;1389113;Jun
2025-06-13;El Palacio de los jugos /  EMMA FOOD CORP;Invoice;008-05740;Arroz a Granel:Largo Fino 50 LB -Bolsa Dos Hermanos.;;8.0;27.85;222.8;4405860.45;Bulk Rice;Lisset Limpio -020;Cafeteria;1389114;Jun
2025-06-13;El Palacio de los jugos /  EMMA FOOD CORP;Invoice;008-05740;Arroz a Granel:Parboiled 50 LB -Bolsa Dos Hermanos.;;12.0;26.75;321.0;4406181.45;Bulk Rice;Lisset Limpio -020;Cafeteria;1389115;Jun
2025-06-13;El Palacio de los jugos / J Mena Corp.;Invoice;008-05741;Arroz a Granel:Parboiled 50 LB -Bolsa Dos Hermanos.;;10.0;26.75;267.5;4406448.95;American Spice;Lisset Limpio -020;Cafeteria;1389116;Jun
2025-06-13;El Palacio de los jugos / Rodriguez Foods;Invoice;008-05742;Arroz a Granel:Parboiled 50 LB -Bolsa Dos Hermanos.;;10.0;26.75;267.5;4406716.45;Bulk Rice;Lisset Limpio -020;Cafeteria;1389117;Jun
2025-06-13;El Gallego Supermarket;Invoice;008-05743;Arroz a Granel:Parboiled 50 LB -Bolsa Dos Hermanos.;;5.0;27.75;138.75;4406855.2;Bulk Rice;Lisset Limpio -020;RETAIL  DSD;1389118;Jun
2025-06-13;El Gallego Supermarket;Invoice;008-05743;Liquids:AS Bitter Orange;;2.0;14.0;28.0;4406883.2;American Spice;Lisset Limpio -020;RETAIL  DSD;1389119;Jun
2025-06-13;El Gallego Supermarket;Invoice;008-05743;Liquids:AS Cooking Wine;4 1 Gl.;1.0;17.5;17.5;4406900.7;American Spice;Lisset Limpio -020;RETAIL  DSD;1389120;Jun
2025-06-13;El Gallego Supermarket;Invoice;008-05743;Dry Beans:Dry Beans - Black Beans 50;Dry Black Beans 50 lb;2.0;34.0;68.0;4406968.7;Dry Beans;Lisset Limpio -020;RETAIL  DSD;1389121;Jun
2025-06-13;El Gallego Supermarket;Invoice;008-05743;Liquids:AS White Vinegar;4/1 Gl.;1.0;9.5;9.5;4406978.2;American Spice;Lisset Limpio -020;RETAIL  DSD;1389122;Jun
2025-06-13;El Palacio de los jugos / Lita Foods Inc.;Invoice;008-05744;Dry Beans:Dry Beans - Black Beans 50;Dry Black Beans 50 lb;1.0;34.0;34.0;4407012.2;Dry Beans;Lisset Limpio -020;Cafeteria;1389123;Jun
2025-06-13;El Palacio de los jugos / Lita Foods Inc.;Invoice;008-05744;Arroz a Granel:Parboiled 50 LB -Bolsa Dos Hermanos.;;15.0;26.75;401.25;4407413.45;Bulk Rice;Lisset Limpio -020;Cafeteria;1389124;Jun
2025-06-13;Sedanos Supermarkets #38;Credit Memo;008-05745;Varios:Producto vencido/deteriorado (no impacta en inventario);10 salami 10 ham;-20.0;0.99;-19.8;4407393.65;Puffed Products;Keila Alfaro-Visvikis;RETAIL SEDANOS;1389125;Jun
2025-06-13;Sedanos Supermarkets #38;Credit Memo;008-05745;Varios:Producto vencido/deteriorado (no impacta en inventario);parbo 5k;-4.0;3.37;-13.48;4407380.17;Branded Rice;Keila Alfaro-Visvikis;RETAIL SEDANOS;1389126;Jun
2025-06-15;El Palacio de los jugos / Rodriguez Foods;Invoice;008-05746;Arroz a Granel:Parboiled 50 LB -Bolsa Dos Hermanos.;;8.0;26.75;214.0;4407594.17;Bulk Rice;Lisset Limpio -020;Cafeteria;1389127;Jun
2025-06-15;Bravo   Francisco Diaz;Invoice;008-05747;Liquids:AS Cooking Wine;4 1 Gl.;3.0;17.5;52.5;4407646.67;American Spice;Lisset Limpio -020;RETAIL  DSD;1389128;Jun
2025-06-15;Bravo   Francisco Diaz;Invoice;008-05747;Arroz a Granel:Largo Fino 50 LB -Bolsa Dos Hermanos.;;3.0;27.85;83.55;4407730.22;Bulk Rice;Lisset Limpio -020;RETAIL  DSD;1389129;Jun
2025-06-15;El Palacio de los jugos / J Mena Corp.;Invoice;008-05748;Arroz a Granel:Parboiled 50 LB -Bolsa Dos Hermanos.;;10.0;26.75;267.5;4407997.72;Bulk Rice;Lisset Limpio -020;Cafeteria;1389130;Jun
2025-06-15;El Palacio de los jugos / J Mena Corp.;Invoice;008-05748;Liquids:AS Marinating Sauce (Mojo);;2.0;17.0;34.0;4408031.72;American Spice;Lisset Limpio -020;Cafeteria;1389131;Jun
2025-06-15;El Palacio de los Jugos / Bird Road Restaurant;Invoice;008-05749;Arroz a Granel:Parboiled 50 LB -Bolsa Dos Hermanos.;;10.0;26.75;267.5;4408299.22;Bulk Rice;Lisset Limpio -020;Cafeteria;1389132;Jun
2025-06-15;El Palacio de los jugos /  Nanos Latin Foods;Invoice;008-05750;Arroz a Granel:Parboiled 50 LB -Bolsa Dos Hermanos.;;10.0;26.75;267.5;4408566.72;Bulk Rice;Lisset Limpio -020;Cafeteria;1389133;Jun
2025-06-15;El Palacio de los jugos /  EMMA FOOD CORP;Invoice;008-05751;Arroz a Granel:Largo Fino 50 LB -Bolsa Dos Hermanos.;;3.0;27.85;83.55;4408650.27;Bulk Rice;Lisset Limpio -020;Cafeteria;1389134;Jun
2025-06-15;El Palacio de los jugos /  EMMA FOOD CORP;Invoice;008-05751;Arroz a Granel:Parboiled 50 LB -Bolsa Dos Hermanos.;;3.0;26.75;80.25;4408730.52;Bulk Rice;Lisset Limpio -020;Cafeteria;1389135;Jun
2025-06-15;El Palacio de los jugos / Caribe Tropical;Invoice;008-05752;Arroz a Granel:Parboiled 50 LB -Bolsa Dos Hermanos.;;8.0;26.75;214.0;4408944.52;Bulk Rice;Lisset Limpio -020;Cafeteria;1389136;Jun
2025-06-15;El Palacio de Los Jugos / Casa mía Food Restaurant inc;Invoice;008-05753;Spices:AS Chicken Base;1 / 30 lb. (box or pail);1.0;39.0;39.0;4408983.52;American Spice;Lisset Limpio -020;Cafeteria;1389137;Jun
2025-06-15;El Palacio de Los Jugos / Casa mía Food Restaurant inc;Invoice;008-05753;Spices:AS Sazon (for all);1 / 30 lb (box or pail);1.0;51.0;51.0;4409034.52;American Spice;Lisset Limpio -020;Cafeteria;1389138;Jun
2025-06-15;El Palacio de Los Jugos / Casa mía Food Restaurant inc;Invoice;008-05753;Arroz a Granel:Parboiled 50 LB -Bolsa Dos Hermanos.;;6.0;26.75;160.5;4409195.02;Bulk Rice;Lisset Limpio -020;Cafeteria;1389139;Jun
2025-06-15;El Palacio de los jugos / Delicias Criollas (DIAGO FOOD_MILLER);Invoice;008-05754;Arroz a Granel:Largo Fino 50 LB -Bolsa Dos Hermanos.;;4.0;27.85;111.4;4409306.42;Bulk Rice;Lisset Limpio -020;Cafeteria;1389140;Jun
2025-06-15;El Palacio de los jugos / Delicias Criollas (DIAGO FOOD_MILLER);Invoice;008-05754;Arroz a Granel:Parboiled 50 LB -Bolsa Dos Hermanos.;;12.0;26.75;321.0;4409627.42;Bulk Rice;Lisset Limpio -020;Cafeteria;1389141;Jun
2025-06-15;Los Mejores Tamales de Miami;Invoice;008-05755;Arroz a Granel:Parboiled 50 LB -Bolsa Dos Hermanos.;;6.0;28.25;169.5;4409796.92;Bulk Rice;Lisset Limpio -020;CAFETERIA y RESTAURANTS;1389142;Jun
2025-06-15;Sedanos Supermarkets  #37;Invoice;008-05756;Arroz a Granel:Largo Fino 50 LB -Bolsa Dos Hermanos.;;6.0;27.85;167.1;4409964.02;Bulk Rice;Keila Alfaro-Visvikis;RETAIL SEDANOS;1389143;Jun
2025-06-15;Sedanos Supermarkets  #37;Invoice;008-05756;;Discount;;;-3.07;4409960.95;;Keila Alfaro-Visvikis;RETAIL SEDANOS;1389144;Jun
2025-06-15;Meat Club Market, LLC.;Invoice;008-05757;Arroz Envasado:Largo Fino 1kg (Long grain rice) Dos Hermanos;;2.0;18.0;36.0;4409996.95;Branded Rice;Lisset Limpio -020;RETAIL  DSD;1389145;Jun
2025-06-15;Meat Club Market, LLC.;Invoice;008-05757;Arroz Envasado:Parboiled 1kg Bolsa Dos Hermanos.;.;1.0;19.9;19.9;4410016.85;Branded Rice;Lisset Limpio -020;RETAIL  DSD;1389146;Jun
2025-06-15;Meat Club Market, LLC.;Invoice;008-05757;Arroz Envasado:Sushi Rice Dos Hermanos.;.;2.0;25.5;51.0;4410067.85;Branded Rice;Lisset Limpio -020;RETAIL  DSD;1389147;Jun
2025-06-15;Meat Club Market, LLC.;Invoice;008-05757;;Discount;;;-0.81;4410067.04;;Lisset Limpio -020;RETAIL  DSD;1389148;Jun
2025-06-16;Fritanga Momotombo;Invoice;008-05758;Spices:AS Chicken Base;1 / 30 lb. (box or pail);1.0;39.0;39.0;4410106.04;American Spice;Lisset Limpio -020;CAFETERIA y RESTAURANTS;1389149;Jun
2025-06-16;Fritanga Momotombo;Invoice;008-05758;Arroz a Granel:Largo Fino 50 LB -Bolsa Dos Hermanos.;;6.0;27.85;167.1;4410273.14;Bulk Rice;Lisset Limpio -020;CAFETERIA y RESTAURANTS;1389150;Jun
2025-06-16;Sedanos Supermarkets #31;Invoice;008-05759;Arroz Envasado:Long Rice 10 LB Dos Hermanos;;2.0;35.5;71.0;4410344.14;Branded Rice;Keila Alfaro-Visvikis;RETAIL SEDANOS;1389151;Jun
2025-06-16;Sedanos Supermarkets #31;Invoice;008-05759;;Discount;;;-1.42;4410342.72;;Keila Alfaro-Visvikis;RETAIL SEDANOS;1389152;Jun
2025-06-16;Bay supermarket;Invoice;008-05760;Arroz Envasado:Largo Fino 1kg (Long grain rice) Dos Hermanos;;5.0;18.0;90.0;4410432.72;Branded Rice;Keila Alfaro-Visvikis;RETAIL  DSD;1389153;Jun
2025-06-16;Bay supermarket;Invoice;008-05760;Arroz Envasado:Largo Fino 1kg (Long grain rice) Dos Hermanos;;1.0;18.0;18.0;4410450.72;Branded Rice;Keila Alfaro-Visvikis;RETAIL  DSD;1389154;Jun
2025-06-16;Sedanos Supermarkets #7;Invoice;008-05761;Spanish Style Yellow Rice:AS Spanish Style Yellow Rice;AS Spanish Style Yellow Rice 6 / 3.25 oz;1.0;34.5;34.5;4410485.22;American Spice;Keila Alfaro-Visvikis;RETAIL SEDANOS;1389155;Jun
2025-06-16;Sedanos Supermarkets #7;Invoice;008-05761;Arroz Envasado:Largo Fino 1kg (Long grain rice) Dos Hermanos;;1.0;17.5;17.5;4410502.72;Branded Rice;Keila Alfaro-Visvikis;RETAIL SEDANOS;1389156;Jun
2025-06-16;Sedanos Supermarkets #7;Invoice;008-05761;;Discount;;;-1.04;4410501.68;;Keila Alfaro-Visvikis;RETAIL SEDANOS;1389157;Jun
2025-06-16;Sedanos Supermarkets #8;Invoice;008-05762;Arroz Envasado:Largo Fino 1kg (Long grain rice) Dos Hermanos;;1.0;17.5;17.5;4410519.18;Branded Rice;Keila Alfaro-Visvikis;RETAIL SEDANOS;1389158;Jun
2025-06-16;Sedanos Supermarkets #8;Invoice;008-05762;Arroz Envasado:Parboiled 1kg Bolsa Dos Hermanos.;.;1.0;19.9;19.9;4410539.08;Branded Rice;Keila Alfaro-Visvikis;RETAIL SEDANOS;1389159;Jun
2025-06-16;Sedanos Supermarkets #8;Invoice;008-05762;Arroz Envasado:Long Rice 10 LB Dos Hermanos;;1.0;35.5;35.5;4410574.58;Branded Rice;Keila Alfaro-Visvikis;RETAIL SEDANOS;1389160;Jun
2025-06-16;Sedanos Supermarkets #8;Invoice;008-05762;;Discount;;;-1.46;4410573.12;;Keila Alfaro-Visvikis;RETAIL SEDANOS;1389161;Jun
2025-06-16;Sedanos Supermarkets #9;Invoice;008-05763;Arroz Envasado:Largo Fino 1kg (Long grain rice) Dos Hermanos;;1.0;17.8;17.8;4410590.92;Branded Rice;Keila Alfaro-Visvikis;RETAIL SEDANOS;1389162;Jun
2025-06-16;Sedanos Supermarkets #9;Invoice;008-05763;Arroz Envasado:Parboiled 1kg Bolsa Dos Hermanos.;.;1.0;19.9;19.9;4410610.82;Branded Rice;Keila Alfaro-Visvikis;RETAIL SEDANOS;1389163;Jun
2025-06-16;Sedanos Supermarkets #9;Invoice;008-05763;Spanish Style Yellow Rice:AS Spanish Style Yellow Rice;AS Spanish Style Yellow Rice 6 / 3.25 oz;1.0;34.5;34.5;4410645.32;American Spice;Keila Alfaro-Visvikis;RETAIL SEDANOS;1389164;Jun
2025-06-16;Sedanos Supermarkets #9;Invoice;008-05763;Arroz Envasado:Long Rice 10 LB Dos Hermanos;;1.0;35.5;35.5;4410680.82;Branded Rice;Keila Alfaro-Visvikis;RETAIL SEDANOS;1389165;Jun
2025-06-16;Sedanos Supermarkets #9;Invoice;008-05763;;Discount;;;-1.4;4410679.42;;Keila Alfaro-Visvikis;RETAIL SEDANOS;1389166;Jun
2025-06-16;Sedanos Supermarkets #10;Invoice;008-05764;Arroz Envasado:Largo Fino 1kg (Long grain rice) Dos Hermanos;;1.0;17.5;17.5;4410696.92;Branded Rice;Keila Alfaro-Visvikis;RETAIL SEDANOS;1389167;Jun
2025-06-16;Sedanos Supermarkets #10;Invoice;008-05764;Arroz Envasado:Long Rice 10 LB Dos Hermanos;;1.0;35.5;35.5;4410732.42;Branded Rice;Keila Alfaro-Visvikis;RETAIL SEDANOS;1389168;Jun
2025-06-16;Sedanos Supermarkets #43;Invoice;008-05765;Spanish Style Yellow Rice:AS Spanish Style Yellow Rice;AS Spanish Style Yellow Rice 6 / 3.25 oz;1.0;34.5;34.5;4410766.92;American Spice;Keila Alfaro-Visvikis;RETAIL SEDANOS;1389169;Jun
2025-06-16;Sedanos Supermarkets #43;Invoice;008-05765;Arroz Envasado:Long Rice 10 LB Dos Hermanos;;1.0;35.5;35.5;4410802.42;Branded Rice;Keila Alfaro-Visvikis;RETAIL SEDANOS;1389170;Jun
2025-06-16;Sedanos Supermarkets #43;Invoice;008-05765;;Discount;;;-1.4;4410801.02;;Keila Alfaro-Visvikis;RETAIL SEDANOS;1389171;Jun
2025-06-16;Sedanos Supermarkets #22;Invoice;008-05766;Spanish Style Yellow Rice:AS Spanish Style Yellow Rice;AS Spanish Style Yellow Rice 6 / 3.25 oz;1.0;34.5;34.5;4410835.52;American Spice;Keila Alfaro-Visvikis;RETAIL SEDANOS;1389172;Jun
2025-06-16;Sedanos Supermarkets #22;Invoice;008-05766;Arroz Envasado:Long Rice 10 LB Dos Hermanos;;1.0;35.5;35.5;4410871.02;Branded Rice;Keila Alfaro-Visvikis;RETAIL SEDANOS;1389173;Jun
2025-06-16;Sedanos Supermarkets #22;Invoice;008-05766;;Discount;;;-1.23;4410869.79;;Keila Alfaro-Visvikis;RETAIL SEDANOS;1389174;Jun
2025-06-16;Sedanos Supermarkets #42;Invoice;008-05767;Arroz Envasado:Long Rice 10 LB Dos Hermanos;;2.0;35.5;71.0;4410940.79;Branded Rice;Keila Alfaro-Visvikis;RETAIL SEDANOS;1389175;Jun
2025-06-16;Sedanos Supermarkets #42;Invoice;008-05767;;Discount;;;-1.42;4410939.37;;Keila Alfaro-Visvikis;RETAIL SEDANOS;1389176;Jun
2025-06-16;Sedanos Supermarkets #42;Invoice;008-05768;Arroz a Granel:Parboiled 50 LB -Bolsa Dos Hermanos.;;6.0;28.25;169.5;4411108.87;Bulk Rice;Keila Alfaro-Visvikis;RETAIL SEDANOS;1389177;Jun
2025-06-16;Sedanos Supermarkets #42;Invoice;008-05768;;Discount;;;-3.39;4411105.48;;Keila Alfaro-Visvikis;RETAIL SEDANOS;1389178;Jun
2025-06-17;Armando Carpio;Invoice;008-05769;Arroz Envasado:Long Rice 10 LB Dos Hermanos;*****SAMPLES*****;1.0;35.5;35.5;4411140.98;Branded Rice;Armando Carpio - 017;OTHER;1389179;Jun
2025-06-18;Sedanos Supermarkets #16;Invoice;008-05770;Arroz a Granel:Parboiled 50 LB -Bolsa Dos Hermanos.;;4.0;28.25;113.0;4411253.98;Bulk Rice;Keila Alfaro-Visvikis;RETAIL SEDANOS;1389180;Jun
2025-06-18;Sedanos Supermarkets #16;Invoice;008-05770;;Discount;;;-2.26;4411251.72;;Keila Alfaro-Visvikis;RETAIL SEDANOS;1389181;Jun
2025-06-18;Ideal Food Basket Davie Cafeteria;Invoice;008-05771;Arroz a Granel:Largo Fino 50 LB -Bolsa Dos Hermanos.;;9.0;27.85;250.65;4411502.37;Bulk Rice;Keila Alfaro-Visvikis;CAFETERIA y RESTAURANTS;1389182;Jun
2025-06-18;Rey Chavez Distributor #2;Invoice;008-05772;Arroz a Granel:Parboiled 50 LB -Bolsa Dos Hermanos.;;25.0;27.75;693.75;4412196.12;Bulk Rice;Lisset Limpio -020;WHOLESALER;1389183;Jun
2025-06-18;Sedanos Supermarkets #27;Invoice;008-05773;Arroz Envasado:Long Rice 10 LB Dos Hermanos;;1.0;35.5;35.5;4412231.62;American Spice;Keila Alfaro-Visvikis;RETAIL SEDANOS;1389184;Jun
2025-06-18;Sedanos Supermarkets #27;Invoice;008-05773;;Discount;;;-0.71;4412230.91;;Keila Alfaro-Visvikis;RETAIL SEDANOS;1389185;Jun
2025-06-18;Sedanos Supermarkets #27;Invoice;008-05774;Arroz a Granel:Parboiled 50 LB -Bolsa Dos Hermanos.;;4.0;28.25;113.0;4412343.91;Bulk Rice;Keila Alfaro-Visvikis;RETAIL SEDANOS;1389186;Jun
2025-06-18;Sedanos Supermarkets #27;Invoice;008-05774;;Discount;;;-2.26;4412341.65;;Keila Alfaro-Visvikis;RETAIL SEDANOS;1389187;Jun
2025-06-18;Sedanos Supermarkets #24;Invoice;008-05775;Arroz Envasado:Long Rice 10 LB Dos Hermanos;;1.0;35.5;35.5;4412377.15;Branded Rice;Keila Alfaro-Visvikis;RETAIL SEDANOS;1389188;Jun
2025-06-18;Sedanos Supermarkets #24;Invoice;008-05775;Rice Snack:Rice Snack Ham Flavored DOS HERMANOS;;1.0;19.9;19.9;4412397.05;Puffed Products;Keila Alfaro-Visvikis;RETAIL SEDANOS;1389189;Jun
2025-06-18;Sedanos Supermarkets #24;Invoice;008-05775;;Discount;;;-0.71;4412396.34;;Keila Alfaro-Visvikis;RETAIL SEDANOS;1389190;Jun
2025-06-18;Los Caringas Latin America  Foods;Invoice;008-05776;Arroz a Granel:Largo Fino 50 LB -Bolsa Dos Hermanos.;;2.0;27.85;55.7;4412452.04;Bulk Rice;Lisset Limpio -020;CAFETERIA y RESTAURANTS;1389191;Jun
2025-06-18;Los Caringas Latin America  Foods;Invoice;008-05776;Arroz a Granel:Parboiled 50 LB -Bolsa Dos Hermanos.;;2.0;28.25;56.5;4412508.54;Bulk Rice;Lisset Limpio -020;CAFETERIA y RESTAURANTS;1389192;Jun
2025-06-18;Key Foods - 10301 Royal Palm Food Corp.;Invoice;008-05777;Arroz Envasado:Parboiled 1kg Bolsa Dos Hermanos.;.;50.0;19.9;995.0;4413503.54;Branded Rice;Keila Alfaro-Visvikis;RETAIL KEY FOOD;1389193;Jun
2025-06-18;Key Foods - 10301 Royal Palm Food Corp.;Invoice;008-05777;Arroz Envasado:Parboiled 1kg Bolsa Dos Hermanos.;.;10.0;19.9;199.0;4413702.54;Branded Rice;Keila Alfaro-Visvikis;RETAIL KEY FOOD;1389194;Jun
2025-06-18;Sabor Tropical Supermarket #7;Invoice;008-05778;Arroz Envasado:Largo Fino 1kg (Long grain rice) Dos Hermanos;;2.0;18.0;36.0;4413738.54;Branded Rice;Keila Alfaro-Visvikis;RETAIL  DSD;1389195;Jun
2025-06-18;Sabor Tropical Supermarket #7;Invoice;008-05778;Arroz Envasado:Parboiled 5KG Dos Hermanos.;6  11lbs;9.0;46.5;418.5;4414157.04;Branded Rice;Keila Alfaro-Visvikis;RETAIL  DSD;1389196;Jun
2025-06-18;Sabor Tropical Supermarket #7;Invoice;008-05778;Arroz Envasado:Long Rice 10 LB Dos Hermanos;;6.0;35.5;213.0;4414370.04;Branded Rice;Keila Alfaro-Visvikis;RETAIL  DSD;1389197;Jun
2025-06-18;Sabor Tropical Supermarket #7;Invoice;008-05778;Rice Snack:Rice Snack Salami Flavored DOS HERMANOS;;3.0;13.2;39.6;4414409.64;Puffed Products;Keila Alfaro-Visvikis;RETAIL  DSD;1389198;Jun
2025-06-18;Sabor Tropical Supermarket #7;Invoice;008-05778;Rice Snack:Rice Snack Ham Flavored DOS HERMANOS;;2.0;13.2;26.4;4414436.04;Puffed Products;Keila Alfaro-Visvikis;RETAIL  DSD;1389199;Jun
2025-06-18;Sabor Tropical Supermarket #7;Invoice;008-05778;Arroz Envasado:Parboiled 5KG Dos Hermanos.;6  11lbs;1.0;46.5;46.5;4414482.54;Branded Rice;Keila Alfaro-Visvikis;RETAIL  DSD;1389200;Jun
2025-06-18;Sabor Tropical Supermarket #7;Invoice;008-05778;Arroz Envasado:Long Rice 10 LB Dos Hermanos;;3.0;35.5;106.5;4414589.04;Branded Rice;Keila Alfaro-Visvikis;RETAIL  DSD;1389201;Jun
2025-06-18;Sabor Tropical Supermarket #7;Invoice;008-05778;Rice Snack:Rice Snack Salami Flavored DOS HERMANOS;;1.0;13.2;13.2;4414602.24;Puffed Products;Keila Alfaro-Visvikis;RETAIL  DSD;1389202;Jun
2025-06-18;Sabor Tropical Supermarket #7;Invoice;008-05778;Varios:Exhibidor de pie DOS HERMANOS PVC -;;1.0;0.01;0.01;4414602.25;Branded Rice;Keila Alfaro-Visvikis;RETAIL  DSD;1389203;Jun
2025-06-18;Sabor Tropical Supermarket #7;Invoice;008-05778;;Discount;;;-0.01;4414602.24;;Keila Alfaro-Visvikis;RETAIL  DSD;1389204;Jun
2025-06-18;Sedanos Supermarkets #16;Invoice;008-05779;Spanish Style Yellow Rice:AS Spanish Style Yellow Rice;AS Spanish Style Yellow Rice 6 / 3.25 oz;1.0;34.5;34.5;4414636.74;American Spice;Keila Alfaro-Visvikis;RETAIL SEDANOS;1389205;Jun
2025-06-18;Sedanos Supermarkets #16;Invoice;008-05779;Arroz Envasado:Largo Fino 1kg (Long grain rice) Dos Hermanos;;1.0;17.5;17.5;4414654.24;Branded Rice;Keila Alfaro-Visvikis;RETAIL SEDANOS;1389206;Jun
2025-06-18;Sedanos Supermarkets #16;Invoice;008-05779;Arroz Envasado:Long Rice 10 LB Dos Hermanos;;5.0;35.5;177.5;4414831.74;Branded Rice;Keila Alfaro-Visvikis;RETAIL SEDANOS;1389207;Jun
2025-06-18;Sedanos Supermarkets #16;Invoice;008-05779;Arroz Envasado:Parboiled 1kg Bolsa Dos Hermanos.;.;1.0;19.9;19.9;4414851.64;Branded Rice;Keila Alfaro-Visvikis;RETAIL SEDANOS;1389208;Jun
2025-06-18;Sedanos Supermarkets #16;Invoice;008-05779;Arroz Envasado:Long Rice 10 LB Dos Hermanos;;1.0;35.5;35.5;4414887.14;Branded Rice;Keila Alfaro-Visvikis;RETAIL SEDANOS;1389209;Jun
2025-06-18;Sedanos Supermarkets #16;Invoice;008-05779;;Discount;;;-4.99;4414882.15;;Keila Alfaro-Visvikis;RETAIL SEDANOS;1389210;Jun
2025-06-18;Sedanos Supermarkets #1;Invoice;008-05780;Arroz Envasado:Largo Fino 1kg (Long grain rice) Dos Hermanos;;1.0;17.5;17.5;4414899.65;Branded Rice;Keila Alfaro-Visvikis;RETAIL SEDANOS;1389211;Jun
2025-06-18;Sedanos Supermarkets #1;Invoice;008-05780;Arroz Envasado:Long Rice 10 LB Dos Hermanos;;1.0;35.5;35.5;4414935.15;Branded Rice;Keila Alfaro-Visvikis;RETAIL SEDANOS;1389212;Jun
2025-06-18;Sedanos Supermarkets #1;Invoice;008-05780;Arroz Envasado:Parboiled 1kg Bolsa Dos Hermanos.;.;1.0;19.9;19.9;4414955.05;Branded Rice;Keila Alfaro-Visvikis;RETAIL SEDANOS;1389213;Jun
2025-06-18;Sedanos Supermarkets #1;Invoice;008-05780;Arroz Envasado:Parboiled 5KG Dos Hermanos.;6  11lbs;1.0;40.5;40.5;4414995.55;Branded Rice;Keila Alfaro-Visvikis;RETAIL SEDANOS;1389214;Jun
2025-06-18;Sedanos Supermarkets #36;Invoice;008-05781;Spanish Style Yellow Rice:AS Spanish Style Yellow Rice;AS Spanish Style Yellow Rice 6 / 3.25 oz;1.0;34.5;34.5;4415030.05;American Spice;Keila Alfaro-Visvikis;RETAIL SEDANOS;1389215;Jun
2025-06-18;Sedanos Supermarkets #36;Invoice;008-05781;Arroz Envasado:Long Rice 10 LB Dos Hermanos;;1.0;35.5;35.5;4415065.55;Branded Rice;Keila Alfaro-Visvikis;RETAIL SEDANOS;1389216;Jun
2025-06-18;Sedanos Supermarkets #36;Invoice;008-05781;;Discount;;;-1.4;4415064.15;;Keila Alfaro-Visvikis;RETAIL SEDANOS;1389217;Jun
2025-06-18;Sedanos Supermarkets #27;Credit Memo;008-05782;Varios:Producto vencido/deteriorado (no impacta en inventario);15  jamon, 14 salami 1 pizza;-30.0;0.99;-29.7;4415034.45;Puffed Products;Keila Alfaro-Visvikis;RETAIL SEDANOS;1389218;Jun
2025-06-18;Sedanos Supermarkets #24;Credit Memo;008-05783;Varios:Producto vencido/deteriorado (no impacta en inventario);7 jamon 3 salami;-10.0;0.99;-9.9;4415024.55;Puffed Products;Keila Alfaro-Visvikis;RETAIL SEDANOS;1389219;Jun
2025-06-18;Key Foods - 10301 Royal Palm Food Corp.;Credit Memo;008-05833;Varios:Promotional Allowance;Arroz Envasado:Parboiled 1kg Bolsa Dos Hermanos.;-10.0;19.9;-199.0;4414825.55;Branded Rice;Keila Alfaro-Visvikis;RETAIL KEY FOOD;1389220;Jun
2025-06-18;Sabor Tropical Supermarket #7;Credit Memo;008-05834;Varios:Promotional Allowance;Arroz Envasado:Parboiled 5KG Dos Hermanos.;-1.0;46.5;-46.5;4414779.05;Branded Rice;Keila Alfaro-Visvikis;RETAIL  DSD;1389221;Jun
2025-06-18;Sabor Tropical Supermarket #7;Credit Memo;008-05834;Varios:Promotional Allowance;Arroz Envasado:Long Rice 10 LB Dos Hermanos;-3.0;35.5;-106.5;4414672.55;Branded Rice;Keila Alfaro-Visvikis;RETAIL  DSD;1389222;Jun
2025-06-18;Sabor Tropical Supermarket #7;Credit Memo;008-05834;Varios:Promotional Allowance;Rice Snack:Rice Snack Salami Flavored DOS HERMANOS;-1.0;13.2;-13.2;4414659.35;Puffed Products;Keila Alfaro-Visvikis;RETAIL  DSD;1389223;Jun
2025-06-18;Sedanos Supermarkets #16;Credit Memo;008-05835;Varios:Promotional Allowance;Arroz Envasado:Long Rice 10 LB Dos Hermanos;-1.0;35.5;-35.5;4414623.85;Branded Rice;Keila Alfaro-Visvikis;RETAIL SEDANOS;1389224;Jun
2025-06-19;Sedanos Supermarkets #14;Invoice;008-05784;Arroz Envasado:Parboiled 1kg Bolsa Dos Hermanos.;.;3.0;19.9;59.7;4414683.55;Branded Rice;Keila Alfaro-Visvikis;RETAIL SEDANOS;1389225;Jun
2025-06-19;Sedanos Supermarkets #14;Invoice;008-05784;Arroz Envasado:Largo Fino 1kg (Long grain rice) Dos Hermanos;;2.0;17.5;35.0;4414718.55;Branded Rice;Keila Alfaro-Visvikis;RETAIL SEDANOS;1389226;Jun
2025-06-19;Sedanos Supermarkets #14;Invoice;008-05784;Arroz Envasado:Largo Fino 1kg (Long grain rice) Dos Hermanos;;1.0;17.5;17.5;4414736.05;Branded Rice;Keila Alfaro-Visvikis;RETAIL SEDANOS;1389227;Jun
2025-06-19;Sedanos Supermarkets #14;Invoice;008-05784;;Discount;;;-1.89;4414734.16;;Keila Alfaro-Visvikis;RETAIL SEDANOS;1389228;Jun
2025-06-19;Sedanos Supermarkets #14;Invoice;008-05785;Arroz a Granel:Parboiled 50 LB -Bolsa Dos Hermanos.;;2.0;28.25;56.5;4414790.66;Bulk Rice;Keila Alfaro-Visvikis;RETAIL SEDANOS;1389229;Jun
2025-06-19;Sedanos Supermarkets #14;Invoice;008-05785;;Discount;;;-1.13;4414789.53;;Keila Alfaro-Visvikis;RETAIL SEDANOS;1389230;Jun
2025-06-19;Sedanos Supermarkets #23;Invoice;008-05786;Spanish Style Yellow Rice:AS Spanish Style Yellow Rice;AS Spanish Style Yellow Rice 6 / 3.25 oz;1.0;34.5;34.5;4414824.03;American Spice;Keila Alfaro-Visvikis;RETAIL SEDANOS;1389231;Jun
2025-06-19;Sedanos Supermarkets #23;Invoice;008-05786;Arroz Envasado:Largo Fino 1kg (Long grain rice) Dos Hermanos;;1.0;17.5;17.5;4414841.53;Branded Rice;Keila Alfaro-Visvikis;RETAIL SEDANOS;1389232;Jun
2025-06-19;Sedanos Supermarkets #23;Invoice;008-05786;Arroz Envasado:Long Rice 10 LB Dos Hermanos;;5.0;35.5;177.5;4415019.03;Branded Rice;Keila Alfaro-Visvikis;RETAIL SEDANOS;1389233;Jun
2025-06-19;Sedanos Supermarkets #23;Invoice;008-05786;Arroz Envasado:Long Rice 10 LB Dos Hermanos;;1.0;17.5;17.5;4415036.53;Branded Rice;Keila Alfaro-Visvikis;RETAIL SEDANOS;1389234;Jun
2025-06-19;Sedanos Supermarkets #23;Invoice;008-05786;;Discount;;;-4.59;4415031.94;;Keila Alfaro-Visvikis;RETAIL SEDANOS;1389235;Jun
2025-06-19;El Gallego Supermarket;Invoice;008-05787;Arroz a Granel:Parboiled 50 LB -Bolsa Dos Hermanos.;;3.0;27.75;83.25;4415115.19;Bulk Rice;Lisset Limpio -020;RETAIL  DSD;1389236;Jun
2025-06-19;El Gallego Supermarket;Invoice;008-05787;Liquids:AS Bitter Orange;;2.0;14.0;28.0;4415143.19;American Spice;Lisset Limpio -020;RETAIL  DSD;1389237;Jun
2025-06-19;El Gallego Supermarket;Invoice;008-05787;Liquids:AS White Vinegar;4/1 Gl.;2.0;9.5;19.0;4415162.19;American Spice;Lisset Limpio -020;RETAIL  DSD;1389238;Jun
2025-06-19;El Gallego Supermarket;Invoice;008-05787;Dry Beans:Dry Beans - Black Beans 50;Dry Black Beans 50 lb;1.0;34.0;34.0;4415196.19;Dry Beans;Lisset Limpio -020;RETAIL  DSD;1389239;Jun
2025-06-19;El Palacio de los jugos / Delicias Criollas (DIAGO FOOD_MILLER);Invoice;008-05788;Arroz a Granel:Parboiled 50 LB -Bolsa Dos Hermanos.;;10.0;26.75;267.5;4415463.69;Bulk Rice;Lisset Limpio -020;Cafeteria;1389240;Jun
2025-06-19;El Palacio de los jugos / Rodriguez Foods;Invoice;008-05789;Arroz a Granel:Parboiled 50 LB -Bolsa Dos Hermanos.;;6.0;26.75;160.5;4415624.19;Bulk Rice;Lisset Limpio -020;Cafeteria;1389241;Jun
2025-06-19;Panda Depot;Invoice;008-05790;Arroz a Granel:Parboiled 50 LB -Bolsa Dos Hermanos.;;110.0;25.0;2750.0;4418374.19;Bulk Rice;Lisset Limpio -020;WHOLESALER;1389242;Jun
2025-06-19;El Palacio de los jugos /  EMMA FOOD CORP;Invoice;008-05791;Arroz a Granel:Largo Fino 50 LB -Bolsa Dos Hermanos.;;4.0;27.85;111.4;4418485.59;Bulk Rice;Lisset Limpio -020;Cafeteria;1389243;Jun
2025-06-19;El Palacio de los jugos /  EMMA FOOD CORP;Invoice;008-05791;Arroz a Granel:Parboiled 50 LB -Bolsa Dos Hermanos.;;5.0;26.75;133.75;4418619.34;Bulk Rice;Lisset Limpio -020;Cafeteria;1389244;Jun
2025-06-19;Sedanos Supermarkets  #37;Invoice;008-05792;Arroz Envasado:Long Rice 10 LB Dos Hermanos;;5.0;35.5;177.5;4418796.84;Branded Rice;Keila Alfaro-Visvikis;RETAIL SEDANOS;1389245;Jun
2025-06-19;Sedanos Supermarkets  #37;Invoice;008-05792;Arroz Envasado:Long Rice 10 LB Dos Hermanos;;1.0;35.5;35.5;4418832.34;Branded Rice;Keila Alfaro-Visvikis;RETAIL SEDANOS;1389246;Jun
2025-06-19;Sedanos Supermarkets #18;Invoice;008-05793;Arroz a Granel:Parboiled 50 LB -Bolsa Dos Hermanos.;;10.0;28.25;282.5;4419114.84;Bulk Rice;Keila Alfaro-Visvikis;RETAIL SEDANOS;1389247;Jun
2025-06-19;Sedanos Supermarkets #18;Invoice;008-05793;;Discount;;;-5.65;4419109.19;;Keila Alfaro-Visvikis;RETAIL SEDANOS;1389248;Jun
2025-06-19;Sedanos Supermarkets #32;Invoice;008-05794;Arroz Envasado:Long Rice 10 LB Dos Hermanos;;5.0;35.5;177.5;4419286.69;Branded Rice;Keila Alfaro-Visvikis;RETAIL SEDANOS;1389249;Jun
2025-06-19;Sedanos Supermarkets #32;Invoice;008-05794;Rice Snack:Rice Snack Ham Flavored DOS HERMANOS;;3.0;13.2;39.6;4419326.29;Puffed Products;Keila Alfaro-Visvikis;RETAIL SEDANOS;1389250;Jun
2025-06-19;Sedanos Supermarkets #32;Invoice;008-05794;Arroz Envasado:Long Rice 10 LB Dos Hermanos;;1.0;35.5;35.5;4419361.79;Branded Rice;Keila Alfaro-Visvikis;RETAIL SEDANOS;1389251;Jun
2025-06-19;Sedanos Supermarkets #32;Invoice;008-05794;Rice Snack:Rice Snack Salami Flavored DOS HERMANOS;;1.0;19.9;19.9;4419381.69;Puffed Products;Keila Alfaro-Visvikis;RETAIL SEDANOS;1389252;Jun
2025-06-19;Sedanos Supermarkets #32;Invoice;008-05794;Varios:Exhibidor de pie DOS HERMANOS PVC -;;1.0;0.01;0.01;4419381.7;Branded Rice;Keila Alfaro-Visvikis;RETAIL SEDANOS;1389253;Jun
2025-06-19;Sedanos Supermarkets #32;Invoice;008-05794;;Discount;;;-4.75;4419376.95;;Keila Alfaro-Visvikis;RETAIL SEDANOS;1389254;Jun
2025-06-19;Sedanos Supermarkets #32;Invoice;008-05795;Spices:AS Chicken Base;1 / 30 lb. (box or pail);1.0;39.0;39.0;4419415.95;American Spice;Keila Alfaro-Visvikis;RETAIL SEDANOS;1389255;Jun
2025-06-19;Sedanos Supermarkets #32;Invoice;008-05795;Arroz a Granel:Largo Fino 50 LB -Bolsa Dos Hermanos.;;4.0;27.85;111.4;4419527.35;Bulk Rice;Keila Alfaro-Visvikis;RETAIL SEDANOS;1389256;Jun
2025-06-19;Sedanos Supermarkets #32;Invoice;008-05795;Arroz a Granel:Parboiled 50 LB -Bolsa Dos Hermanos.;;4.0;28.25;113.0;4419640.35;Bulk Rice;Keila Alfaro-Visvikis;RETAIL SEDANOS;1389257;Jun
2025-06-19;Sedanos Supermarkets #32;Invoice;008-05795;;Discount;;;-5.27;4419635.08;;Keila Alfaro-Visvikis;RETAIL SEDANOS;1389258;Jun
2025-06-19;El Palacio de los jugos / Lita Foods Inc.;Invoice;008-05796;Dry Beans:Dry Beans - Black Beans 50;Dry Black Beans 50 lb;1.0;34.0;34.0;4419669.08;Dry Beans;Lisset Limpio -020;Cafeteria;1389259;Jun
2025-06-19;El Palacio de los jugos / Lita Foods Inc.;Invoice;008-05796;Arroz a Granel:Parboiled 50 LB -Bolsa Dos Hermanos.;;12.0;26.75;321.0;4419990.08;Bulk Rice;Lisset Limpio -020;Cafeteria;1389260;Jun
2025-06-19;El Palacio de Los Jugos / Casa mía Food Restaurant inc;Invoice;008-05797;Arroz a Granel:Parboiled 50 LB -Bolsa Dos Hermanos.;;6.0;26.75;160.5;4420150.58;Bulk Rice;Lisset Limpio -020;Cafeteria;1389261;Jun
2025-06-19;Futuro Supermarket;Invoice;008-05798;Arroz Envasado:Largo Fino 1kg (Long grain rice) Dos Hermanos;;1.0;18.0;18.0;4420168.58;Branded Rice;Lisset Limpio -020;RETAIL  DSD;1389262;Jun
2025-06-19;Futuro Supermarket;Invoice;008-05798;Arroz Envasado:Long Rice 10 LB Dos Hermanos;;15.0;35.5;532.5;4420701.08;Branded Rice;Lisset Limpio -020;RETAIL  DSD;1389263;Jun
2025-06-19;Futuro Supermarket;Invoice;008-05798;Arroz Envasado:Long Rice 10 LB Dos Hermanos;;3.0;35.5;106.5;4420807.58;Branded Rice;Lisset Limpio -020;RETAIL  DSD;1389264;Jun
2025-06-19;Sedanos Supermarkets #38;Invoice;008-05799;Arroz Envasado:Long Rice 10 LB Dos Hermanos;;15.0;35.5;532.5;4421340.08;Branded Rice;Keila Alfaro-Visvikis;RETAIL SEDANOS;1389265;Jun
2025-06-19;Sedanos Supermarkets #38;Invoice;008-05799;Arroz Envasado:Long Rice 10 LB Dos Hermanos;;3.0;35.5;106.5;4421446.58;Branded Rice;Keila Alfaro-Visvikis;RETAIL SEDANOS;1389266;Jun
2025-06-19;Sedanos Supermarkets #38;Invoice;008-05799;Rice Snack:Rice Snack Ham Flavored DOS HERMANOS;;1.0;13.2;13.2;4421459.78;Puffed Products;Keila Alfaro-Visvikis;RETAIL SEDANOS;1389267;Jun
2025-06-19;Sedanos Supermarkets #38;Invoice;008-05799;Rice Snack:Rice Snack Salami Flavored DOS HERMANOS;;1.0;13.2;13.2;4421472.98;Puffed Products;Keila Alfaro-Visvikis;RETAIL SEDANOS;1389268;Jun
2025-06-19;Sedanos Supermarkets #38;Invoice;008-05799;;Discount;;;-11.18;4421461.8;;Keila Alfaro-Visvikis;RETAIL SEDANOS;1389269;Jun
2025-06-19;Be Your Will LLC;Invoice;008-05800;Arroz a Granel:Largo Fino 50 LB -Bolsa Dos Hermanos.;;7.0;27.85;194.95;4421656.75;Bulk Rice;Lisset Limpio -020;CAFETERIA y RESTAURANTS;1389270;Jun
2025-06-19;Be Your Will LLC;Invoice;008-05800;Arroz a Granel:Parboiled 50 LB -Bolsa Dos Hermanos.;;11.0;26.75;294.25;4421951.0;Bulk Rice;Lisset Limpio -020;CAFETERIA y RESTAURANTS;1389271;Jun
2025-06-19;Be Your Will LLC;Invoice;008-05800;Liquids:AS Cooking Wine;4 1 Gl.;1.0;17.5;17.5;4421968.5;American Spice;Lisset Limpio -020;CAFETERIA y RESTAURANTS;1389272;Jun
2025-06-19;Sedanos Supermarkets  #4;Invoice;008-05801;Arroz Envasado:Parboiled 5KG Dos Hermanos.;6  11lbs;5.0;40.5;202.5;4422171.0;Branded Rice;Keila Alfaro-Visvikis;RETAIL SEDANOS;1389273;Jun
2025-06-19;Sedanos Supermarkets  #4;Invoice;008-05801;Arroz Envasado:Long Rice 10 LB Dos Hermanos;;5.0;35.5;177.5;4422348.5;Branded Rice;Keila Alfaro-Visvikis;RETAIL SEDANOS;1389274;Jun
2025-06-19;Sedanos Supermarkets  #4;Invoice;008-05801;Arroz Envasado:Long Rice 10 LB Dos Hermanos;;1.0;35.5;35.5;4422384.0;Branded Rice;Keila Alfaro-Visvikis;RETAIL SEDANOS;1389275;Jun
2025-06-19;Sedanos Supermarkets  #4;Invoice;008-05801;Arroz Envasado:Parboiled 5KG Dos Hermanos.;6  11lbs;1.0;40.5;40.5;4422424.5;Branded Rice;Keila Alfaro-Visvikis;RETAIL SEDANOS;1389276;Jun
2025-06-19;Sedanos Supermarkets  #4;Invoice;008-05801;;Discount;;;-7.6;4422416.9;;Keila Alfaro-Visvikis;RETAIL SEDANOS;1389277;Jun
2025-06-19;El Palacio de los jugos /  Nanos Latin Foods;Invoice;008-05802;Arroz a Granel:Largo Fino 50 LB -Bolsa Dos Hermanos.;;5.0;27.85;139.25;4422556.15;Bulk Rice;Lisset Limpio -020;Cafeteria;1389278;Jun
2025-06-19;El Palacio de los jugos /  Nanos Latin Foods;Invoice;008-05802;Arroz a Granel:Parboiled 50 LB -Bolsa Dos Hermanos.;;10.0;26.75;267.5;4422823.65;Bulk Rice;Lisset Limpio -020;Cafeteria;1389279;Jun
2025-06-19;Sedanos Supermarkets #33;Invoice;008-05803;Arroz a Granel:Parboiled 50 LB -Bolsa Dos Hermanos.;;4.0;28.25;113.0;4422936.65;Bulk Rice;Keila Alfaro-Visvikis;RETAIL SEDANOS;1389280;Jun
2025-06-19;Sedanos Supermarkets #33;Invoice;008-05803;;Discount;;;-2.26;4422934.39;;Keila Alfaro-Visvikis;RETAIL SEDANOS;1389281;Jun
2025-06-19;El Palacio de los jugos / Caribe Tropical;Invoice;008-05804;Dry Beans:Dry Beans - Black Beans 50;Dry Black Beans 50 lb;3.0;34.0;102.0;4423036.39;Dry Beans;Lisset Limpio -020;Cafeteria;1389282;Jun
2025-06-19;El Palacio de los jugos / Caribe Tropical;Invoice;008-05804;Arroz a Granel:Parboiled 50 LB -Bolsa Dos Hermanos.;;8.0;26.75;214.0;4423250.39;Bulk Rice;Lisset Limpio -020;Cafeteria;1389283;Jun
2025-06-19;El Palacio de los jugos / J Mena Corp.;Invoice;008-05805;Liquids:AS Marinating Sauce (Mojo);;2.0;18.5;37.0;4423287.39;American Spice;Lisset Limpio -020;Cafeteria;1389284;Jun
2025-06-19;El Palacio de los jugos / J Mena Corp.;Invoice;008-05805;Arroz a Granel:Parboiled 50 LB -Bolsa Dos Hermanos.;;10.0;26.75;267.5;4423554.89;Bulk Rice;Lisset Limpio -020;Cafeteria;1389285;Jun
2025-06-19;Sedanos Supermarkets #32;Credit Memo;008-05807;Varios:Producto vencido/deteriorado (no impacta en inventario);21 jamon;-21.0;0.99;-20.79;4423494.5;Puffed Products;Keila Alfaro-Visvikis;RETAIL SEDANOS;1389287;Jun
2025-06-19;Sabor Tropical Supermarket #7;Credit Memo;008-05808;Varios:Producto vencido/deteriorado (no impacta en inventario);22 crédito jamón, salame  y 1 tostadas arroz;-23.0;0.99;-22.77;4423471.73;Puffed Products;Keila Alfaro-Visvikis;RETAIL  DSD;1389288;Jun
2025-06-19;Futuro Supermarket;Credit Memo;008-05836;Varios:Promotional Allowance;Arroz Envasado:Long Rice 10 LB Dos Hermanos;-3.0;35.5;-106.5;4423365.23;Branded Rice;Lisset Limpio -020;RETAIL  DSD;1389289;Jun
2025-06-19;Sedanos Supermarkets  #37;Credit Memo;008-05837;Varios:Promotional Allowance;Arroz Envasado:Long Rice 10 LB Dos Hermanos;-1.0;35.5;-35.5;4423329.73;Branded Rice;Keila Alfaro-Visvikis;RETAIL SEDANOS;1389290;Jun
2025-06-19;Sedanos Supermarkets  #4;Credit Memo;008-05838;Varios:Promotional Allowance;Arroz Envasado:Long Rice 10 LB Dos Hermanos;-1.0;35.5;-35.5;4423294.23;Branded Rice;Keila Alfaro-Visvikis;RETAIL SEDANOS;1389291;Jun
2025-06-19;Sedanos Supermarkets  #4;Credit Memo;008-05838;Varios:Promotional Allowance;Arroz Envasado:Parboiled 5KG Dos Hermanos.;-1.0;40.5;-40.5;4423253.73;Branded Rice;Keila Alfaro-Visvikis;RETAIL SEDANOS;1389292;Jun
2025-06-19;Sedanos Supermarkets #32;Credit Memo;008-05839;Varios:Promotional Allowance;Arroz Envasado:Long Rice 10 LB Dos Hermanos;-1.0;35.5;-35.5;4423218.23;Branded Rice;Keila Alfaro-Visvikis;RETAIL SEDANOS;1389293;Jun
2025-06-20;Bravo   Francisco Diaz;Invoice;008-05809;Arroz a Granel:Largo Fino 50 LB -Bolsa Dos Hermanos.;;5.0;27.85;139.25;4423357.48;Bulk Rice;Lisset Limpio -020;RETAIL  DSD;1389294;Jun
2025-06-20;Bravo   Francisco Diaz;Invoice;008-05809;Liquids:AS Cooking Wine;4 1 Gl.;5.0;17.5;87.5;4423444.98;American Spice;Lisset Limpio -020;RETAIL  DSD;1389295;Jun
2025-06-20;Bravo   Francisco Diaz;Invoice;008-05809;Liquids:AS Marinating Sauce (Mojo);;3.0;18.5;55.5;4423500.48;American Spice;Lisset Limpio -020;RETAIL  DSD;1389296;Jun
2025-06-20;Bravo   Francisco Diaz;Invoice;008-05809;Liquids:AS White Vinegar;4/1 Gl.;2.0;10.0;20.0;4423520.48;American Spice;Lisset Limpio -020;RETAIL  DSD;1389297;Jun
2025-06-20;Sedanos Supermarkets #38;Credit Memo;008-05840;Varios:Promotional Allowance;Arroz Envasado:Long Rice 10 LB Dos Hermanos;-3.0;35.5;-106.5;4423413.98;Branded Rice;Keila Alfaro-Visvikis;RETAIL SEDANOS;1389298;Jun
2025-06-23;El Palacio de los jugos /  Mires Restaurants;Invoice;008-05810;Arroz a Granel:Parboiled 50 LB -Bolsa Dos Hermanos.;;11.0;27.75;305.25;4423719.23;Bulk Rice;Lisset Limpio -020;Cafeteria;1389299;Jun
2025-06-23;El Palacio de los jugos /  Mires Restaurants;Invoice;008-05810;Arroz a Granel:Parboiled 50 LB -Bolsa Dos Hermanos.;;1.0;27.75;27.75;4423746.98;Bulk Rice;Lisset Limpio -020;Cafeteria;1389300;Jun
2025-06-23;El Palacio de los jugos / J Mena Corp.;Invoice;008-05811;Arroz a Granel:Parboiled 50 LB -Bolsa Dos Hermanos.;;10.0;26.75;267.5;4424014.48;Bulk Rice;Lisset Limpio -020;Cafeteria;1389301;Jun
2025-06-23;El Palacio de los jugos /  EMMA FOOD CORP;Invoice;008-05812;Arroz a Granel:Largo Fino 50 LB -Bolsa Dos Hermanos.;;5.0;27.85;139.25;4424153.73;Bulk Rice;Lisset Limpio -020;Cafeteria;1389302;Jun
2025-06-23;El Palacio de los jugos /  EMMA FOOD CORP;Invoice;008-05812;Arroz a Granel:Parboiled 50 LB -Bolsa Dos Hermanos.;;8.0;26.75;214.0;4424367.73;Bulk Rice;Lisset Limpio -020;Cafeteria;1389303;Jun
2025-06-23;El Palacio de los Jugos / Bird Road Restaurant;Invoice;008-05813;Arroz a Granel:Parboiled 50 LB -Bolsa Dos Hermanos.;;10.0;26.75;267.5;4424635.23;Bulk Rice;Lisset Limpio -020;Cafeteria;1389304;Jun
2025-06-23;El Palacio de los Jugos / Bird Road Restaurant;Invoice;008-05813;Dry Beans:Dry Beans - Black Beans 50;Dry Black Beans 50 lb;1.0;34.0;34.0;4424669.23;Dry Beans;Lisset Limpio -020;Cafeteria;1389305;Jun
2025-06-23;El Palacio de Los Jugos / Casa mía Food Restaurant inc;Invoice;008-05814;Arroz a Granel:Parboiled 50 LB -Bolsa Dos Hermanos.;;6.0;26.75;160.5;4424829.73;Bulk Rice;Lisset Limpio -020;Cafeteria;1389306;Jun
2025-06-23;El Palacio de Los Jugos / Casa mía Food Restaurant inc;Invoice;008-05814;Liquids:AS Lemon Juice 4/1 Gl;;1.0;14.95;14.95;4424844.68;American Spice;Lisset Limpio -020;Cafeteria;1389307;Jun
2025-06-23;El Palacio de los jugos /  Nanos Latin Foods;Invoice;008-05815;Arroz a Granel:Largo Fino 50 LB -Bolsa Dos Hermanos.;;5.0;27.85;139.25;4424983.93;Bulk Rice;Lisset Limpio -020;Cafeteria;1389308;Jun
2025-06-23;El Palacio de los jugos /  Nanos Latin Foods;Invoice;008-05815;Arroz a Granel:Parboiled 50 LB -Bolsa Dos Hermanos.;;7.0;26.75;187.25;4425171.18;Bulk Rice;Lisset Limpio -020;Cafeteria;1389309;Jun
2025-06-23;El Palacio de los jugos / Rodriguez Foods;Invoice;008-05816;Arroz a Granel:Parboiled 50 LB -Bolsa Dos Hermanos.;;6.0;26.75;160.5;4425331.68;Bulk Rice;Lisset Limpio -020;Cafeteria;1389310;Jun
2025-06-23;El Palacio de los jugos / Divan and Denise Food;Invoice;008-05817;Dry Beans:Dry Beans - Black Beans 50;Dry Black Beans 50 lb;1.0;34.0;34.0;4425365.68;Dry Beans;Lisset Limpio -020;Cafeteria;1389311;Jun
2025-06-23;El Palacio de los jugos / Divan and Denise Food;Invoice;008-05817;Arroz a Granel:Parboiled 50 LB -Bolsa Dos Hermanos.;;10.0;26.75;267.5;4425633.18;Bulk Rice;Lisset Limpio -020;Cafeteria;1389312;Jun
2025-06-23;El Palacio de los jugos / Caribe Tropical;Invoice;008-05818;Dry Beans:Dry Beans - Black Beans 50;Dry Black Beans 50 lb;2.0;34.0;68.0;4425701.18;Dry Beans;Lisset Limpio -020;Cafeteria;1389313;Jun
2025-06-23;El Palacio de los jugos / Caribe Tropical;Invoice;008-05818;Arroz a Granel:Parboiled 50 LB -Bolsa Dos Hermanos.;;6.0;26.75;160.5;4425861.68;Bulk Rice;Lisset Limpio -020;Cafeteria;1389314;Jun
2025-06-23;JMN Dely Corp;Invoice;008-05819;Dry Beans:Dry Beans - Black Beans 50;Dry Black Beans 50 lb;1.0;45.7;45.7;4425907.38;Dry Beans;Keila Alfaro-Visvikis;CAFETERIA y RESTAURANTS;1389315;Jun
2025-06-23;JMN Dely Corp;Invoice;008-05819;Arroz a Granel:Largo Fino 50 LB -Bolsa Dos Hermanos.;;2.0;27.85;55.7;4425963.08;Bulk Rice;Keila Alfaro-Visvikis;CAFETERIA y RESTAURANTS;1389316;Jun
2025-06-23;JMN Dely Corp;Invoice;008-05819;Arroz a Granel:Parboiled 50 LB -Bolsa Dos Hermanos.;;2.0;28.25;56.5;4426019.58;Bulk Rice;Keila Alfaro-Visvikis;CAFETERIA y RESTAURANTS;1389317;Jun
2025-06-23;Sedanos Supermarkets #31;Invoice;008-05820;Arroz a Granel:Parboiled 50 LB -Bolsa Dos Hermanos.;;4.0;28.25;113.0;4426132.58;Bulk Rice;Keila Alfaro-Visvikis;RETAIL SEDANOS;1389318;Jun
2025-06-23;Sedanos Supermarkets #31;Invoice;008-05820;;Discount;;;-2.26;4426130.32;;Keila Alfaro-Visvikis;RETAIL SEDANOS;1389319;Jun
2025-06-24;Bravo   Francisco Diaz;Invoice;008-05821;Spices:AS Chicken Base;1 / 30 lb. (box or pail);1.0;39.0;39.0;4426169.32;American Spice;Lisset Limpio -020;RETAIL  DSD;1389320;Jun
2025-06-24;Bravo   Francisco Diaz;Invoice;008-05821;Liquids:AS Cooking Wine;4 1 Gl.;2.0;17.5;35.0;4426204.32;American Spice;Lisset Limpio -020;RETAIL  DSD;1389321;Jun
2025-06-24;Bravo   Francisco Diaz;Invoice;008-05821;Arroz a Granel:Largo Fino 50 LB -Bolsa Dos Hermanos.;;5.0;27.85;139.25;4426343.57;Bulk Rice;Lisset Limpio -020;RETAIL  DSD;1389322;Jun
2025-06-24;Bravo   Francisco Diaz;Invoice;008-05821;Dry Beans:Dry Beans - Black Beans 50;Dry Black Beans 50 lb;1.0;35.0;35.0;4426378.57;Dry Beans;Lisset Limpio -020;RETAIL  DSD;1389323;Jun
2025-06-24;El Palacio de Los Jugos / Casa mía Food Restaurant inc;Invoice;008-05822;Liquids:AS Marinating Sauce (Mojo);4 / 1 Gl;1.0;17.5;17.5;4426396.07;American Spice;Lisset Limpio -020;Cafeteria;1389324;Jun
2025-06-24;Soriano Brothers PB;Invoice;008-05823;Arroz a Granel:Largo Fino 50 LB -Bolsa Dos Hermanos.;;10.0;27.85;278.5;4426674.57;Bulk Rice;Lisset Limpio -020;CAFETERIA y RESTAURANTS;1389325;Jun
2025-06-24;Soriano Brothers PB;Invoice;008-05823;Arroz a Granel:Parboiled 50 LB -Bolsa Dos Hermanos.;;12.0;25.44;305.28;4426979.85;Bulk Rice;Lisset Limpio -020;CAFETERIA y RESTAURANTS;1389326;Jun
2025-06-24;Soriano Brothers PB;Invoice;008-05823;Spices:AS Sazon (for all);1 / 30 lb (box or pail);2.0;51.0;102.0;4427081.85;American Spice;Lisset Limpio -020;CAFETERIA y RESTAURANTS;1389327;Jun
2025-06-24;Soriano Brothers PB;Invoice;008-05823;Dry Beans:Dry Beans - Black Beans 50;Dry Black Beans 50 lb;3.0;34.0;102.0;4427183.85;Dry Beans;Lisset Limpio -020;CAFETERIA y RESTAURANTS;1389328;Jun
2025-06-25;Sedanos Supermarkets #26;Credit Memo;008-05841;Varios:Producto vencido/deteriorado (no impacta en inventario);11/6/2025 19 salame, 12 jamon 1 pizza;-32.0;0.99;-31.68;4427152.17;Puffed Products;Keila Alfaro-Visvikis;RETAIL SEDANOS;1389329;Jun
2025-06-25;Aries Supermarket & Cafeteria;Invoice;008-05842;Dry Beans:Dry Beans - Black Beans 50;Dry Black Beans 50 lb;5.0;35.7;178.5;4427330.67;Dry Beans;Keila Alfaro-Visvikis;CAFETERIA y RESTAURANTS;1389330;Jun
2025-06-25;Aries Supermarket & Cafeteria;Invoice;008-05842;Arroz a Granel:Parboiled 50 LB -Bolsa Dos Hermanos.;;10.0;28.25;282.5;4427613.17;Bulk Rice;Keila Alfaro-Visvikis;CAFETERIA y RESTAURANTS;1389331;Jun
2025-06-25;Sedanos Supermarkets #43;Invoice;008-05843;Arroz a Granel:Parboiled 50 LB -Bolsa Dos Hermanos.;;5.0;28.25;141.25;4427754.42;Bulk Rice;Keila Alfaro-Visvikis;RETAIL SEDANOS;1389332;Jun
2025-06-25;Sedanos Supermarkets #43;Invoice;008-05843;;Discount;;;-2.83;4427751.59;;Keila Alfaro-Visvikis;RETAIL SEDANOS;1389333;Jun
2025-06-25;Sedanos Supermarkets #16;Invoice;008-05844;Arroz a Granel:Parboiled 50 LB -Bolsa Dos Hermanos.;;4.0;28.25;113.0;4427864.59;Bulk Rice;Keila Alfaro-Visvikis;RETAIL SEDANOS;1389334;Jun
2025-06-25;Sedanos Supermarkets #16;Invoice;008-05844;;Discount;;;-2.26;4427862.33;;Keila Alfaro-Visvikis;RETAIL SEDANOS;1389335;Jun
2025-06-25;Sedanos Supermarkets #26;Invoice;008-05845;Rice Snack:Rice Snack Ham Flavored DOS HERMANOS;;2.0;19.9;39.8;4427902.13;Puffed Products;Keila Alfaro-Visvikis;RETAIL SEDANOS;1389336;Jun
2025-06-25;Sedanos Supermarkets #26;Invoice;008-05845;Rice Snack:Rice Snack Salami Flavored DOS HERMANOS;;1.0;19.9;19.9;4427922.03;Puffed Products;Keila Alfaro-Visvikis;RETAIL SEDANOS;1389337;Jun
2025-06-25;Sedanos Supermarkets #26;Invoice;008-05845;Arroz Envasado:Long Rice 10 LB Dos Hermanos;;1.0;35.5;35.5;4427957.53;American Spice;Keila Alfaro-Visvikis;RETAIL SEDANOS;1389338;Jun
2025-06-25;Sedanos Supermarkets #26;Invoice;008-05845;Rice Snack:Rice Snack Salami Flavored DOS HERMANOS;;1.0;19.9;19.9;4427977.43;Puffed Products;Keila Alfaro-Visvikis;RETAIL SEDANOS;1389339;Jun
2025-06-25;Sedanos Supermarkets #26;Invoice;008-05846;Arroz a Granel:Parboiled 50 LB -Bolsa Dos Hermanos.;;5.0;28.25;141.25;4428118.68;Bulk Rice;Keila Alfaro-Visvikis;RETAIL SEDANOS;1389340;Jun
2025-06-25;Ideal Food Basket Davie Cafeteria;Invoice;008-05847;Arroz a Granel:Largo Fino 50 LB -Bolsa Dos Hermanos.;;6.0;27.85;167.1;4428285.78;Bulk Rice;Keila Alfaro-Visvikis;CAFETERIA y RESTAURANTS;1389341;Jun
2025-06-25;Sedanos Supermarkets #34;Invoice;008-05848;Arroz Envasado:Largo Fino 1kg (Long grain rice) Dos Hermanos;;2.0;17.5;35.0;4428320.78;Branded Rice;Keila Alfaro-Visvikis;RETAIL SEDANOS;1389342;Jun
2025-06-25;Sedanos Supermarkets #34;Invoice;008-05848;Arroz Envasado:Parboiled 1kg Bolsa Dos Hermanos.;.;3.0;19.9;59.7;4428380.48;Branded Rice;Keila Alfaro-Visvikis;RETAIL SEDANOS;1389343;Jun
2025-06-25;Sedanos Supermarkets #34;Invoice;008-05848;Arroz Envasado:Largo Fino 1kg (Long grain rice) Dos Hermanos;;1.0;35.5;35.5;4428415.98;Branded Rice;Keila Alfaro-Visvikis;RETAIL SEDANOS;1389344;Jun
2025-06-25;Sedanos Supermarkets #34;Invoice;008-05848;;Discount;;;-1.89;4428414.09;;Keila Alfaro-Visvikis;RETAIL SEDANOS;1389345;Jun
2025-06-25;Sedanos Supermarkets #27;Invoice;008-05849;Arroz Envasado:Parboiled 5KG Dos Hermanos.;6  11lbs;15.0;40.5;607.5;4429021.59;Branded Rice;Keila Alfaro-Visvikis;RETAIL SEDANOS;1389346;Jun
2025-06-25;Sedanos Supermarkets #27;Invoice;008-05849;Rice Snack:Rice Snack Ham Flavored DOS HERMANOS;;2.0;13.2;26.4;4429047.99;Puffed Products;Keila Alfaro-Visvikis;RETAIL SEDANOS;1389347;Jun
2025-06-25;Sedanos Supermarkets #27;Invoice;008-05849;Rice Snack:Rice Snack Salami Flavored DOS HERMANOS;;1.0;13.2;13.2;4429061.19;Puffed Products;Keila Alfaro-Visvikis;RETAIL SEDANOS;1389348;Jun
2025-06-25;Sedanos Supermarkets #27;Invoice;008-05849;Spanish Style Yellow Rice:AS Spanish Style Yellow Rice;AS Spanish Style Yellow Rice 6 / 3.25 oz;1.0;34.5;34.5;4429095.69;American Spice;Keila Alfaro-Visvikis;RETAIL SEDANOS;1389349;Jun
2025-06-25;Sedanos Supermarkets #27;Invoice;008-05849;Arroz Envasado:Parboiled 5KG Dos Hermanos.;6  11lbs;3.0;40.5;121.5;4429217.19;Branded Rice;Keila Alfaro-Visvikis;RETAIL SEDANOS;1389350;Jun
2025-06-25;Sedanos Supermarkets #27;Invoice;008-05849;Rice Snack:Rice Snack Salami Flavored DOS HERMANOS;;1.0;13.2;13.2;4429230.39;Puffed Products;Keila Alfaro-Visvikis;RETAIL SEDANOS;1389351;Jun
2025-06-25;Sedanos Supermarkets #27;Invoice;008-05849;Varios:Exhibidor de pie DOS HERMANOS PVC -;;1.0;0.01;0.01;4429230.4;Branded Rice;Keila Alfaro-Visvikis;RETAIL SEDANOS;1389352;Jun
2025-06-25;Sedanos Supermarkets #27;Invoice;008-05849;;Discount;;;-13.05;4429217.35;;Keila Alfaro-Visvikis;RETAIL SEDANOS;1389353;Jun
2025-06-25;ALS Foods;Invoice;008-05850;Liquids:AS Cooking Wine;4 1 Gl.;1.0;17.5;17.5;4429234.85;American Spice;Lisset Limpio -020;CAFETERIA y RESTAURANTS;1389354;Jun
2025-06-25;ALS Foods;Invoice;008-05850;Arroz a Granel:Largo Fino 50 LB -Bolsa Dos Hermanos.;;7.0;27.85;194.95;4429429.8;Bulk Rice;Lisset Limpio -020;CAFETERIA y RESTAURANTS;1389355;Jun
2025-06-25;ALS Foods;Invoice;008-05850;Arroz a Granel:Parboiled 50 LB -Bolsa Dos Hermanos.;;11.0;27.75;305.25;4429735.05;Bulk Rice;Lisset Limpio -020;CAFETERIA y RESTAURANTS;1389356;Jun
2025-06-25;ALS Foods;Invoice;008-05850;Dry Beans:Dry Beans - Black Beans 50;Dry Black Beans 50 lb;1.0;34.0;34.0;4429769.05;Dry Beans;Lisset Limpio -020;CAFETERIA y RESTAURANTS;1389357;Jun
2025-06-25;ALS Foods;Invoice;008-05850;Arroz a Granel:Parboiled 50 LB -Bolsa Dos Hermanos.;;1.0;27.75;27.75;4429796.8;Bulk Rice;Lisset Limpio -020;CAFETERIA y RESTAURANTS;1389358;Jun
2025-06-25;Sedanos Supermarkets #24;Invoice;008-05851;Arroz a Granel:Parboiled 50 LB -Bolsa Dos Hermanos.;;10.0;28.25;282.5;4430079.3;Bulk Rice;Keila Alfaro-Visvikis;RETAIL SEDANOS;1389359;Jun
2025-06-25;Sedanos Supermarkets #24;Invoice;008-05851;;Discount;;;-5.45;4430073.85;;Keila Alfaro-Visvikis;RETAIL SEDANOS;1389360;Jun
2025-06-25;Mei Chang;Invoice;008-05852;Arroz a Granel:Parboiled 50 LB -Bolsa Dos Hermanos.;;7.0;28.25;197.75;4430271.6;Bulk Rice;Lisset Limpio -020;CAFETERIA y RESTAURANTS;1389361;Jun
2025-06-25;Festival Supermarket Margate;Invoice;008-05853;Arroz Envasado:Long Rice 10 LB Dos Hermanos;;5.0;35.5;177.5;4430449.1;Branded Rice;Keila Alfaro-Visvikis;RETAIL  DSD;1389362;Jun
2025-06-25;Festival Supermarket Margate;Invoice;008-05853;Arroz Envasado:Long Rice 10 LB Dos Hermanos;;1.0;35.5;35.5;4430484.6;Branded Rice;Keila Alfaro-Visvikis;RETAIL  DSD;1389363;Jun
2025-06-25;Festival Supermarket #35- Southgate;Invoice;008-05854;Arroz Envasado:Parboiled 5KG Dos Hermanos.;6  11lbs;15.0;46.5;697.5;4431182.1;Branded Rice;Keila Alfaro-Visvikis;RETAIL  DSD;1389364;Jun
2025-06-25;Festival Supermarket #35- Southgate;Invoice;008-05854;Arroz Envasado:Parboiled 5KG Dos Hermanos.;6  11lbs;8.0;46.5;372.0;4431554.1;Branded Rice;Keila Alfaro-Visvikis;RETAIL  DSD;1389365;Jun
2025-06-26;Sedanos Supermarkets #10;Invoice;008-05855;Rice Snack:Rice Snack Ham Flavored DOS HERMANOS;;2.0;19.9;39.8;4431593.9;Puffed Products;Keila Alfaro-Visvikis;RETAIL SEDANOS;1389366;Jun
2025-06-26;Sedanos Supermarkets #10;Invoice;008-05855;Rice Snack:Rice Snack Salami Flavored DOS HERMANOS;;1.0;19.9;19.9;4431613.8;Puffed Products;Keila Alfaro-Visvikis;RETAIL SEDANOS;1389367;Jun
2025-06-26;Sedanos Supermarkets #10;Invoice;008-05855;Spanish Style Yellow Rice:AS Spanish Style Yellow Rice;AS Spanish Style Yellow Rice 6 / 3.25 oz;1.0;34.5;34.5;4431648.3;American Spice;Keila Alfaro-Visvikis;RETAIL SEDANOS;1389368;Jun
2025-06-26;Sedanos Supermarkets #10;Invoice;008-05855;Rice Snack:Rice Snack Salami Flavored DOS HERMANOS;;1.0;19.9;19.9;4431668.2;Puffed Products;Keila Alfaro-Visvikis;RETAIL SEDANOS;1389369;Jun
2025-06-26;Sedanos Supermarkets #10;Invoice;008-05855;Varios:Exhibidor de pie DOS HERMANOS PVC -;;1.0;0.01;0.01;4431668.21;Branded Rice;Keila Alfaro-Visvikis;RETAIL SEDANOS;1389370;Jun
2025-06-26;Sedanos Supermarkets #10;Invoice;008-05855;;Discount;;;-1.09;4431667.12;;Keila Alfaro-Visvikis;RETAIL SEDANOS;1389371;Jun
2025-06-26;El Palacio de los jugos / Delicias Criollas (DIAGO FOOD_MILLER);Invoice;008-05856;Arroz a Granel:Largo Fino 50 LB -Bolsa Dos Hermanos.;;3.0;27.85;83.55;4431750.67;Bulk Rice;Lisset Limpio -020;Cafeteria;1389372;Jun
2025-06-26;El Palacio de los jugos / Delicias Criollas (DIAGO FOOD_MILLER);Invoice;008-05856;Arroz a Granel:Parboiled 50 LB -Bolsa Dos Hermanos.;;12.0;26.75;321.0;4432071.67;Bulk Rice;Lisset Limpio -020;Cafeteria;1389373;Jun
2025-06-26;Sabor Tropical #1 - Cafeteria;Invoice;008-05857;Arroz Envasado:Parboiled 5KG Dos Hermanos.;6  11lbs;15.0;46.5;697.5;4432769.17;Branded Rice;Keila Alfaro-Visvikis;CAFETERIA y RESTAURANTS;1389374;Jun
2025-06-26;Sabor Tropical #1 - Cafeteria;Invoice;008-05857;Arroz Envasado:Parboiled 5KG Dos Hermanos.;6  11lbs;7.0;46.5;325.5;4433094.67;Branded Rice;Keila Alfaro-Visvikis;CAFETERIA y RESTAURANTS;1389375;Jun
2025-06-26;Sedanos Supermarkets #33;Invoice;008-05858;Arroz a Granel:Parboiled 50 LB -Bolsa Dos Hermanos.;;3.0;28.25;84.75;4433179.42;Bulk Rice;Keila Alfaro-Visvikis;RETAIL SEDANOS;1389376;Jun
2025-06-26;Sedanos Supermarkets #33;Invoice;008-05858;;Discount;;;-1.71;4433177.71;;Keila Alfaro-Visvikis;RETAIL SEDANOS;1389377;Jun
2025-06-26;Sedanos Supermarkets #42;Invoice;008-05859;Spanish Style Yellow Rice:AS Spanish Style Yellow Rice;AS Spanish Style Yellow Rice 6 / 3.25 oz;1.0;34.5;34.5;4433212.21;American Spice;Keila Alfaro-Visvikis;RETAIL SEDANOS;1389378;Jun
2025-06-26;Sedanos Supermarkets #42;Invoice;008-05859;Arroz Envasado:Largo Fino 1kg (Long grain rice) Dos Hermanos;;1.0;17.5;17.5;4433229.71;Branded Rice;Keila Alfaro-Visvikis;RETAIL SEDANOS;1389379;Jun
2025-06-26;Sedanos Supermarkets #42;Invoice;008-05859;Arroz Envasado:Long Rice 10 LB Dos Hermanos;;1.0;35.5;35.5;4433265.21;Branded Rice;Keila Alfaro-Visvikis;RETAIL SEDANOS;1389380;Jun
2025-06-26;Sedanos Supermarkets #42;Invoice;008-05859;Rice Snack:Rice Snack Ham Flavored DOS HERMANOS;;2.0;19.9;39.8;4433305.01;Puffed Products;Keila Alfaro-Visvikis;RETAIL SEDANOS;1389381;Jun
2025-06-26;Sedanos Supermarkets #42;Invoice;008-05859;Rice Snack:Rice Snack Salami Flavored DOS HERMANOS;;1.0;19.9;19.9;4433324.91;Puffed Products;Keila Alfaro-Visvikis;RETAIL SEDANOS;1389382;Jun
2025-06-26;Sedanos Supermarkets #42;Invoice;008-05859;Rice Snack:Rice Snack Salami Flavored DOS HERMANOS;;1.0;19.9;19.9;4433344.81000001;Puffed Products;Keila Alfaro-Visvikis;RETAIL SEDANOS;1389383;Jun
2025-06-26;Sedanos Supermarkets #42;Invoice;008-05859;;Discount;;;-2.23;4433342.58;;Keila Alfaro-Visvikis;RETAIL SEDANOS;1389384;Jun
2025-06-26;Sedanos Supermarkets #42;Invoice;008-05860;Arroz a Granel:Parboiled 50 LB -Bolsa Dos Hermanos.;;5.0;28.25;141.25;4433483.83;Bulk Rice;Keila Alfaro-Visvikis;RETAIL SEDANOS;1389385;Jun
2025-06-26;Sedanos Supermarkets #42;Invoice;008-05860;;Discount;;;-2.83;4433481.0;;Keila Alfaro-Visvikis;RETAIL SEDANOS;1389386;Jun
2025-06-26;Sedanos Supermarkets #32;Invoice;008-05861;Arroz a Granel:Largo Fino 50 LB -Bolsa Dos Hermanos.;;3.0;27.85;83.55;4433564.55;Bulk Rice;Keila Alfaro-Visvikis;RETAIL SEDANOS;1389387;Jun
2025-06-26;Sedanos Supermarkets #32;Invoice;008-05861;Arroz a Granel:Parboiled 50 LB -Bolsa Dos Hermanos.;;3.0;28.25;84.75;4433649.3;Bulk Rice;Keila Alfaro-Visvikis;RETAIL SEDANOS;1389388;Jun
2025-06-26;Sedanos Supermarkets #32;Invoice;008-05861;;Discount;;;-2.95;4433646.35;;Keila Alfaro-Visvikis;RETAIL SEDANOS;1389389;Jun
2025-06-26;El Palacio de los jugos /  Nanos Latin Foods;Invoice;008-05862;Arroz a Granel:Largo Fino 50 LB -Bolsa Dos Hermanos.;;5.0;27.85;139.25;4433785.6;Bulk Rice;Lisset Limpio -020;Cafeteria;1389390;Jun
2025-06-26;El Palacio de los jugos /  Nanos Latin Foods;Invoice;008-05862;Arroz a Granel:Parboiled 50 LB -Bolsa Dos Hermanos.;;10.0;26.75;267.5;4434053.1;Bulk Rice;Lisset Limpio -020;Cafeteria;1389391;Jun
2025-06-26;El Palacio de los jugos / Lita Foods Inc.;Invoice;008-05863;Dry Beans:Dry Beans - Black Beans 50;Dry Black Beans 50 lb;1.0;34.0;34.0;4434087.1;Dry Beans;Lisset Limpio -020;Cafeteria;1389392;Jun
2025-06-26;El Palacio de los jugos / Lita Foods Inc.;Invoice;008-05863;Arroz a Granel:Parboiled 50 LB -Bolsa Dos Hermanos.;;11.0;26.75;294.25;4434381.35;Bulk Rice;Lisset Limpio -020;Cafeteria;1389393;Jun
2025-06-26;El Palacio de los jugos / Caribe Tropical;Invoice;008-05864;Arroz a Granel:Parboiled 50 LB -Bolsa Dos Hermanos.;;6.0;26.75;160.5;4434541.85;Bulk Rice;Lisset Limpio -020;Cafeteria;1389394;Jun
2025-06-26;El Palacio de los jugos / Caribe Tropical;Invoice;008-05864;Dry Beans:Dry Beans - Black Beans 50;Dry Black Beans 50 lb;1.0;34.0;34.0;4434575.85;Dry Beans;Lisset Limpio -020;Cafeteria;1389395;Jun
2025-06-26;El Palacio de Los Jugos / Casa mía Food Restaurant inc;Invoice;008-05865;Arroz a Granel:Parboiled 50 LB -Bolsa Dos Hermanos.;;8.0;26.75;214.0;4434789.85;Bulk Rice;Lisset Limpio -020;Cafeteria;1389396;Jun
2025-06-26;El Palacio de los jugos / Divan and Denise Food;Invoice;008-05866;Arroz a Granel:Parboiled 50 LB -Bolsa Dos Hermanos.;;10.0;26.75;267.5;4435057.35;Bulk Rice;Lisset Limpio -020;Cafeteria;1389397;Jun
2025-06-26;El Palacio de los jugos / Rodriguez Foods;Invoice;008-05867;Arroz a Granel:Parboiled 50 LB -Bolsa Dos Hermanos.;;6.0;26.75;160.5;4435217.85;Bulk Rice;Lisset Limpio -020;Cafeteria;1389398;Jun
2025-06-26;El Palacio de los jugos / Leti Corp.;Invoice;008-05868;Arroz a Granel:Largo Fino 50 LB -Bolsa Dos Hermanos.;;5.0;27.85;139.25;4435357.1;Bulk Rice;Lisset Limpio -020;Cafeteria;1389399;Jun
2025-06-26;El Palacio de los jugos / Leti Corp.;Invoice;008-05868;Arroz a Granel:Parboiled 50 LB -Bolsa Dos Hermanos.;;8.0;26.75;214.0;4435571.1;Bulk Rice;Lisset Limpio -020;Cafeteria;1389400;Jun
2025-06-26;Sedanos Supermarkets #21;Invoice;008-05869;Arroz Envasado:Parboiled 5KG Dos Hermanos.;6  11lbs;5.0;40.5;202.5;4435773.6;Branded Rice;Keila Alfaro-Visvikis;RETAIL SEDANOS;1389401;Jun
2025-06-26;Sedanos Supermarkets #21;Invoice;008-05869;Arroz Envasado:Long Rice 10 LB Dos Hermanos;;5.0;35.5;177.5;4435951.1;Branded Rice;Keila Alfaro-Visvikis;RETAIL SEDANOS;1389402;Jun
2025-06-26;Sedanos Supermarkets #21;Invoice;008-05869;Arroz Envasado:Parboiled 5KG Dos Hermanos.;6  11lbs;1.0;40.5;40.5;4435991.6;Branded Rice;Keila Alfaro-Visvikis;RETAIL SEDANOS;1389403;Jun
2025-06-26;Sedanos Supermarkets #21;Invoice;008-05869;Arroz Envasado:Long Rice 10 LB Dos Hermanos;6  / 10lbs;1.0;35.5;35.5;4436027.1;Branded Rice;Keila Alfaro-Visvikis;RETAIL SEDANOS;1389404;Jun
2025-06-26;Sedanos Supermarkets #21;Invoice;008-05869;;Discount;;;-7.6;4436019.5;;Keila Alfaro-Visvikis;RETAIL SEDANOS;1389405;Jun
2025-06-27;Festival Supermarket Margate;Credit Memo;008-05870;Varios:Promotional Allowance;Arroz Envasado:Long Rice 10 LB Dos Hermanos;-1.0;35.5;-35.5;4435984.0;Branded Rice;Keila Alfaro-Visvikis;RETAIL  DSD;1389406;Jun
2025-06-27;Sedanos Supermarkets #34;Credit Memo;008-05871;Varios:Promotional Allowance;Arroz Envasado:Largo Fino 1kg (Long grain rice) Dos Hermanos;-1.0;35.5;-35.5;4435948.5;Branded Rice;Keila Alfaro-Visvikis;RETAIL SEDANOS;1389407;Jun
2025-06-27;Festival Supermarket #35- Southgate;Credit Memo;008-05872;Varios:Promotional Allowance;Arroz Envasado:Parboiled 5KG Dos Hermanos.;-8.0;46.5;-372.0;4435576.5;Branded Rice;Keila Alfaro-Visvikis;RETAIL  DSD;1389408;Jun
2025-06-27;Sedanos Supermarkets #27;Credit Memo;008-05873;Varios:Promotional Allowance;Arroz Envasado:Parboiled 5KG Dos Hermanos.;-3.0;40.5;-121.5;4435455.0;Branded Rice;Keila Alfaro-Visvikis;RETAIL SEDANOS;1389409;Jun
2025-06-27;Sedanos Supermarkets #27;Credit Memo;008-05873;Varios:Promotional Allowance;Rice Snack: Rice Snack Salami Flavored DOS HERMANOS;-1.0;13.2;-13.2;4435441.8;Puffed Products;Keila Alfaro-Visvikis;RETAIL SEDANOS;1389410;Jun
2025-06-27;ALS Foods;Credit Memo;008-05874;Varios:Promotional Allowance;Arroz a Granel:Parboiled 50 LB -Bolsa Dos Hermanos.;-1.0;27.75;-27.75;4435414.05;Bulk Rice;Lisset Limpio -020;CAFETERIA y RESTAURANTS;1389411;Jun
2025-06-27;Sedanos Supermarkets #26;Credit Memo;008-05875;Varios:Promotional Allowance;Rice Snack:Rice Snack Salami Flavored DOS HERMANOS;-1.0;19.9;-19.9;4435394.15;Puffed Products;Keila Alfaro-Visvikis;RETAIL SEDANOS;1389412;Jun
2025-06-27;Bay supermarket;Credit Memo;008-05876;Varios:Promotional Allowance;Arroz Envasado:Largo Fino 1kg (Long grain rice) Dos Hermanos;-1.0;18.0;-18.0;4435376.15;Branded Rice;Keila Alfaro-Visvikis;RETAIL  DSD;1389413;Jun
2025-06-27;Sedanos Supermarkets #23;Credit Memo;008-05877;Varios:Promotional Allowance;Arroz Envasado:Long Rice 10 LB Dos Hermanos;-1.0;17.5;-17.5;4435358.65;Branded Rice;Keila Alfaro-Visvikis;RETAIL SEDANOS;1389414;Jun
2025-06-27;Sedanos Supermarkets #14;Credit Memo;008-05878;Varios:Promotional Allowance;Arroz Envasado:Long Rice 10 LB Dos Hermanos;-1.0;17.5;-17.5;4435341.15;Branded Rice;Keila Alfaro-Visvikis;RETAIL SEDANOS;1389415;Jun
2025-06-29;Bravo   Francisco Diaz;Invoice;008-05879;Liquids:AS Cooking Wine;4 1 Gl.;4.0;17.5;70.0;4435411.15;American Spice;Lisset Limpio -020;RETAIL  DSD;1389416;Jun
2025-06-29;Bravo   Francisco Diaz;Invoice;008-05879;Liquids:AS Marinating Sauce (Mojo);4 / 1 Gl;3.0;18.5;55.5;4435466.65;American Spice;Lisset Limpio -020;RETAIL  DSD;1389417;Jun
2025-06-29;Bravo   Francisco Diaz;Invoice;008-05879;Liquids:AS White Vinegar;4/1 Gl.;3.0;10.0;30.0;4435496.65;American Spice;Lisset Limpio -020;RETAIL  DSD;1389418;Jun
2025-06-29;Bravo   Francisco Diaz;Invoice;008-05879;Arroz a Granel:Largo Fino 50 LB -Bolsa Dos Hermanos.;;5.0;27.85;139.25;4435635.9;Bulk Rice;Lisset Limpio -020;RETAIL  DSD;1389419;Jun
2025-06-29;Bravo   Francisco Diaz;Invoice;008-05879;;Discount;;;-0.25;4435635.65;;Lisset Limpio -020;RETAIL  DSD;1389420;Jun
2025-06-29;Be Your Will LLC;Invoice;008-05880;Liquids:AS Cooking Wine;4 1 Gl.;1.0;17.5;17.5;4435653.15;American Spice;Lisset Limpio -020;CAFETERIA y RESTAURANTS;1389421;Jun
2025-06-29;Be Your Will LLC;Invoice;008-05880;Arroz a Granel:Largo Fino 50 LB -Bolsa Dos Hermanos.;;7.0;27.85;194.95;4435848.1;Bulk Rice;Lisset Limpio -020;CAFETERIA y RESTAURANTS;1389422;Jun
2025-06-29;Be Your Will LLC;Invoice;008-05880;Arroz a Granel:Parboiled 50 LB -Bolsa Dos Hermanos.;;11.0;27.75;305.25;4436153.35;Bulk Rice;Lisset Limpio -020;CAFETERIA y RESTAURANTS;1389423;Jun
2025-06-29;Be Your Will LLC;Invoice;008-05880;Arroz a Granel:Parboiled 50 LB -Bolsa Dos Hermanos.;;1.0;27.75;27.75;4436181.1;Bulk Rice;Lisset Limpio -020;CAFETERIA y RESTAURANTS;1389424;Jun
2025-06-29;El Palacio de los jugos / Caribe Tropical;Invoice;008-05881;Dry Beans:Dry Beans - Black Beans 50;Dry Black Beans 50 lb;2.0;34.0;68.0;4436249.1;Dry Beans;Lisset Limpio -020;Cafeteria;1389425;Jun
2025-06-29;El Palacio de los jugos / Caribe Tropical;Invoice;008-05881;Arroz a Granel:Parboiled 50 LB -Bolsa Dos Hermanos.;;8.0;26.75;214.0;4436463.1;Bulk Rice;Lisset Limpio -020;Cafeteria;1389426;Jun
2025-06-29;El Palacio de los jugos / J Mena Corp.;Invoice;008-05882;Dry Beans:Dry Beans - Black Beans 50;Dry Black Beans 50 lb;2.0;34.0;68.0;4436531.1;Dry Beans;Lisset Limpio -020;Cafeteria;1389427;Jun
2025-06-29;El Palacio de los jugos / J Mena Corp.;Invoice;008-05882;Arroz a Granel:Parboiled 50 LB -Bolsa Dos Hermanos.;;10.0;26.75;267.5;4436798.6;Bulk Rice;Lisset Limpio -020;Cafeteria;1389428;Jun
2025-06-29;El Palacio de los jugos / J Mena Corp.;Invoice;008-05882;Liquids:AS Marinating Sauce (Mojo);4 / 1 Gl;4.0;17.5;70.0;4436868.6;American Spice;Lisset Limpio -020;Cafeteria;1389429;Jun
2025-06-29;El Palacio de los jugos / J Mena Corp.;Invoice;008-05882;Spices:AS Cumin Ground;4 / 4 lb;1.0;50.25;50.25;4436918.85;American Spice;Lisset Limpio -020;Cafeteria;1389430;Jun
2025-06-29;El Palacio de los Jugos / Bird Road Restaurant;Invoice;008-05883;Arroz a Granel:Parboiled 50 LB -Bolsa Dos Hermanos.;;10.0;27.75;277.5;4437196.35;Bulk Rice;Lisset Limpio -020;Cafeteria;1389431;Jun
2025-06-29;El Palacio de los Jugos / Bird Road Restaurant;Invoice;008-05883;Dry Beans:Dry Beans - Black Beans 50;Dry Black Beans 50 lb;1.0;34.0;34.0;4437230.35;American Spice;Lisset Limpio -020;Cafeteria;1389432;Jun
2025-06-29;El Palacio de Los Jugos / Casa mía Food Restaurant inc;Invoice;008-05884;Liquids:AS Lemon Juice 4/1 Gl;;1.0;14.95;14.95;4437245.3;American Spice;Lisset Limpio -020;Cafeteria;1389433;Jun
2025-06-29;El Palacio de Los Jugos / Casa mía Food Restaurant inc;Invoice;008-05884;Liquids:AS Marinating Sauce (Mojo);4 / 1 Gl;1.0;17.5;17.5;4437262.8;American Spice;Lisset Limpio -020;Cafeteria;1389434;Jun
2025-06-29;El Palacio de Los Jugos / Casa mía Food Restaurant inc;Invoice;008-05884;Arroz a Granel:Parboiled 50 LB -Bolsa Dos Hermanos.;;8.0;26.75;214.0;4437476.8;Bulk Rice;Lisset Limpio -020;Cafeteria;1389435;Jun
2025-06-29;El Gallego Supermarket;Invoice;008-05885;Liquids:AS Bitter Orange;4 / 1 gl.;1.0;14.0;14.0;4437490.8;American Spice;Lisset Limpio -020;RETAIL  DSD;1389436;Jun
2025-06-29;El Gallego Supermarket;Invoice;008-05885;Liquids:AS White Vinegar;4/1 Gl.;2.0;9.5;19.0;4437509.8;American Spice;Lisset Limpio -020;RETAIL  DSD;1389437;Jun
2025-06-29;El Gallego Supermarket;Invoice;008-05885;Arroz a Granel:Parboiled 50 LB -Bolsa Dos Hermanos.;;4.0;27.75;111.0;4437620.8;Bulk Rice;Lisset Limpio -020;RETAIL  DSD;1389438;Jun
2025-06-29;El Gallego Supermarket;Invoice;008-05885;Dry Beans:Dry Beans - Black Beans 50;Dry Black Beans 50 lb;2.0;35.0;70.0;4437690.8;Dry Beans;Lisset Limpio -020;RETAIL  DSD;1389439;Jun
2025-06-29;El Palacio de los jugos / Divan and Denise Food;Invoice;008-05886;Arroz a Granel:Parboiled 50 LB -Bolsa Dos Hermanos.;;5.0;27.75;138.75;4437829.55;Bulk Rice;Lisset Limpio -020;Cafeteria;1389440;Jun
2025-06-29;Fritanga Momotombo;Invoice;008-05887;Spices:AS Chicken Base;1 / 30 lb. (box or pail);2.0;39.0;78.0;4437907.55;American Spice;Lisset Limpio -020;CAFETERIA y RESTAURANTS;1389441;Jun
2025-06-29;Fritanga Momotombo;Invoice;008-05887;Arroz a Granel:Largo Fino 50 LB -Bolsa Dos Hermanos.;;6.0;27.85;167.1;4438074.65;Bulk Rice;Lisset Limpio -020;CAFETERIA y RESTAURANTS;1389442;Jun
2025-06-29;El Palacio de los jugos / Rodriguez Foods;Invoice;008-05888;Arroz a Granel:Parboiled 50 LB -Bolsa Dos Hermanos.;;8.0;26.75;214.0;4438288.65;Bulk Rice;Lisset Limpio -020;Cafeteria;1389443;Jun
2025-06-29;Rey Chavez Distributor Corp;Invoice;008-05889;Arroz a Granel:Parboiled 50 LB -Bolsa Dos Hermanos.;;55.0;27.5;1512.5;4439801.15;Bulk Rice;Lisset Limpio -020;WHOLESALER;1389444;Jun
2025-06-30;Sedanos Supermarkets #20;Credit Memo;008-05890;Varios:Promotional Allowance;salami 4 units + ham 8;-12.0;1.49;-17.88;4439783.27;Puffed Products;Keila Alfaro-Visvikis;RETAIL SEDANOS;1389445;Jun
2025-06-30;Sedanos Supermarkets #20;Invoice;008-05891;Arroz Envasado:Long Rice 10 LB Dos Hermanos;;5.0;35.5;177.5;4439960.77;Branded Rice;Keila Alfaro-Visvikis;RETAIL SEDANOS;1389446;Jun
2025-06-30;Sedanos Supermarkets #20;Invoice;008-05891;Rice Snack:Rice Snack Ham Flavored DOS HERMANOS;;2.0;13.2;26.4;4439987.17;Puffed Products;Keila Alfaro-Visvikis;RETAIL SEDANOS;1389447;Jun
2025-06-30;Sedanos Supermarkets #20;Invoice;008-05891;Rice Snack:Rice Snack Salami Flavored DOS HERMANOS;;1.0;13.2;13.2;4440000.37;Puffed Products;Keila Alfaro-Visvikis;RETAIL SEDANOS;1389448;Jun
2025-06-30;Sedanos Supermarkets #20;Invoice;008-05891;Arroz Envasado:Long Rice 10 LB Dos Hermanos;;1.0;35.5;35.5;4440035.87;Branded Rice;Keila Alfaro-Visvikis;RETAIL SEDANOS;1389449;Jun
2025-06-30;Sedanos Supermarkets #20;Invoice;008-05891;;Discount;;;-3.98;4440031.89;;Keila Alfaro-Visvikis;RETAIL SEDANOS;1389450;Jun
2025-06-30;Sedanos Supermarkets #21;Credit Memo;008-05892;Varios:Promotional Allowance;Arroz Envasado:Parboiled 5KG Dos Hermanos.;-1.0;40.5;-40.5;4439991.39;Branded Rice;Keila Alfaro-Visvikis;RETAIL SEDANOS;1389451;Jun
2025-06-30;Sedanos Supermarkets #21;Credit Memo;008-05892;Varios:Promotional Allowance;Arroz Envasado:Long Rice 10 LB Dos Hermanos;-1.0;35.5;-35.5;4439955.89;Branded Rice;Keila Alfaro-Visvikis;RETAIL SEDANOS;1389452;Jun
2025-06-30;Sedanos Supermarkets #42;Credit Memo;008-05893;Arroz Envasado:Long Rice 10 LB Dos Hermanos;10 lb retorna;-1.0;35.5;-35.5;4439920.39;Branded Rice;Keila Alfaro-Visvikis;RETAIL SEDANOS;1389453;Jun
2025-06-30;Sedanos Supermarkets #42;Credit Memo;008-05893;Varios:Promotional Allowance;Rice Snack:Rice Snack Salami Flavored DOS HERMANOS;-1.0;19.9;-19.9;4439900.49;Puffed Products;Keila Alfaro-Visvikis;RETAIL SEDANOS;1389454;Jun
2025-06-30;Bake Mark USA LLC;Invoice;008-05894;Arroz a Granel:Parboiled 50 LB -Bolsa Dos Hermanos.;PO 207901-37;1100.0;22.9;25190.0;4465090.49;Bulk Rice;Armando Carpio - 017;WHOLESALER MANUFACTURY;1389455;Jun
2025-06-30;Sabor Tropical #1 - Cafeteria;Credit Memo;008-05895;Varios:Promotional Allowance;Arroz Envasado:Parboiled 5KG Dos Hermanos.;-7.0;46.5;-325.5;4464764.99;Branded Rice;Keila Alfaro-Visvikis;CAFETERIA y RESTAURANTS;1389456;Jun
2025-06-30;Bravo   Francisco Diaz;Credit Memo;008-05896;Arroz a Granel:Largo Fino 50 LB -Bolsa Dos Hermanos.;;-3.0;27.85;-83.55;4464681.44;Bulk Rice;Lisset Limpio -020;RETAIL  DSD;1389457;Jun
2025-06-30;Bravo   Francisco Diaz;Credit Memo;008-05896;Liquids:AS Marinating Sauce (Mojo);4 / 1 Gl;-1.0;17.0;-17.0;4464664.44;American Spice;Lisset Limpio -020;RETAIL  DSD;1389458;Jun
2025-06-30;China Tokyo;Credit Memo;008-05897;Arroz a Granel:Parboiled 50 LB -Bolsa Dos Hermanos.;;-7.0;28.25;-197.75;4464466.69;Bulk Rice;Lisset Limpio -020;CAFETERIA y RESTAURANTS;1389459;Jun
2025-06-30;El Palacio de los jugos /  Mires Restaurants;Credit Memo;008-05898;Varios:Promotional Allowance;Arroz a Granel:Parboiled 50 LB -Bolsa Dos Hermanos.;-1.0;27.75;-27.75;4464438.94;Bulk Rice;Lisset Limpio -020;Cafeteria;1389460;Jun
2025-06-30;Sabor Tropical Supermarket #4;Invoice;008-05899;Arroz Envasado:Parboiled 5KG Dos Hermanos.;6  11lbs;15.0;46.5;697.5;4465136.44;Branded Rice;Keila Alfaro-Visvikis;RETAIL  DSD;1389461;Jun
2025-06-30;Sabor Tropical Supermarket #4;Invoice;008-05899;Arroz Envasado:Long Rice 10 LB Dos Hermanos;;1.0;35.5;35.5;4465171.94;Branded Rice;Keila Alfaro-Visvikis;RETAIL  DSD;1389462;Jun
2025-06-30;Sabor Tropical Supermarket #4;Invoice;008-05899;Arroz Envasado:Parboiled 5KG Dos Hermanos.;6  11lbs;7.0;46.5;325.5;4465497.44;Branded Rice;Keila Alfaro-Visvikis;RETAIL  DSD;1389463;Jun
2025-06-30;Be Your Will LLC;Credit Memo;008-05900;Varios:Promotional Allowance;Arroz a Granel:Parboiled 50 LB -Bolsa Dos Hermanos.;-1.0;27.75;-27.75;4465469.69;Bulk Rice;Lisset Limpio -020;CAFETERIA y RESTAURANTS;1389464;Jun
2025-06-30;Sabor Tropical Supermarket #4;Credit Memo;008-05901;Varios:Promotional Allowance;Arroz Envasado:Parboiled 5KG Dos Hermanos.;-7.0;46.5;-325.5;4465144.19;Branded Rice;Keila Alfaro-Visvikis;RETAIL  DSD;1389465;Jun
2025-06-30;Sedanos Supermarkets #10;Credit Memo;008-05902;Varios:Promotional Allowance;Rice Snack:Rice Snack Salami Flavored DOS HERMANOS;-1.0;19.9;-19.9;4465124.29;Puffed Products;Keila Alfaro-Visvikis;RETAIL SEDANOS;1389466;Jun
2025-06-30;Sedanos Supermarkets #20;Credit Memo;008-05903;Varios:Promotional Allowance;Arroz Envasado:Long Rice 10 LB Dos Hermanos;-1.0;35.5;-35.5;4465088.79;Puffed Products;Keila Alfaro-Visvikis;RETAIL SEDANOS;1389467;Jun
2025-07-01;El Toro Loco Meat Distribution, LLC;Invoice;008-05904;Dry Beans:Dry Beans - Black Beans 50;Dry Black Beans 50 lb;55.0;36.0;1980.0;4467068.79;Dry Beans;Lisset Limpio -020;CAFETERIA y RESTAURANTS;1389468;Jul
2025-07-01;El Toro Loco Meat Distribution, LLC;Invoice;008-05904;Arroz a Granel:Largo Fino 50 LB -Bolsa Dos Hermanos.;;55.0;27.85;1531.75;4468600.54;Bulk Rice;Lisset Limpio -020;CAFETERIA y RESTAURANTS;1389469;Jul
2025-07-01;BRAVO - Flamingo #3;Invoice;008-05905;Arroz Envasado:Largo Fino 1kg (Long grain rice) Dos Hermanos;;10.0;18.0;180.0;4468780.54;Branded Rice;Keila Alfaro-Visvikis;RETAIL  DSD;1389470;Jul
2025-07-01;BRAVO - Flamingo #3;Invoice;008-05905;Arroz Envasado:Long Rice 10 LB Dos Hermanos;;5.0;35.5;177.5;4468958.04;Branded Rice;Keila Alfaro-Visvikis;RETAIL  DSD;1389471;Jul
2025-07-01;BRAVO - Flamingo #3;Invoice;008-05905;Arroz Envasado:Long Rice 10 LB Dos Hermanos;;1.0;18.0;18.0;4468976.04;Branded Rice;Keila Alfaro-Visvikis;RETAIL  DSD;1389472;Jul
2025-07-01;BRAVO - Flamingo #3;Invoice;008-05905;Arroz Envasado:Largo Fino 1kg (Long grain rice) Dos Hermanos;;2.0;35.5;71.0;4469047.04;Branded Rice;Keila Alfaro-Visvikis;RETAIL  DSD;1389473;Jul
2025-07-01;Ideal Food Basket Davie Cafeteria;Invoice;008-05906;Arroz a Granel:Largo Fino 50 LB -Bolsa Dos Hermanos.;;6.0;27.85;167.1;4469214.14;Bulk Rice;Keila Alfaro-Visvikis;CAFETERIA y RESTAURANTS;1389474;Jul
2025-07-01;Sedanos Supermarkets #43;Invoice;008-05907;Arroz a Granel:Parboiled 50 LB -Bolsa Dos Hermanos.;;5.0;28.25;141.25;4469355.39;Bulk Rice;Keila Alfaro-Visvikis;RETAIL SEDANOS;1389475;Jul
2025-07-01;Aries Supermarket & Cafeteria;Invoice;008-05908;Arroz a Granel:Parboiled 50 LB -Bolsa Dos Hermanos.;;5.0;28.25;141.25;4469496.64;Bulk Rice;Keila Alfaro-Visvikis;CAFETERIA y RESTAURANTS;1389476;Jul
2025-07-01;Aries Supermarket & Cafeteria;Invoice;008-05908;Dry Beans:Dry Beans - Black Beans 50;Dry Black Beans 50 lb;5.0;37.5;187.5;4469684.14;Dry Beans;Keila Alfaro-Visvikis;CAFETERIA y RESTAURANTS;1389477;Jul
2025-07-01;Sedanos Supermarkets #16;Invoice;008-05909;Arroz a Granel:Parboiled 50 LB -Bolsa Dos Hermanos.;;5.0;28.25;141.25;4469825.39;Bulk Rice;Keila Alfaro-Visvikis;RETAIL SEDANOS;1389478;Jul
2025-07-01;Sedanos Supermarkets #16;Invoice;008-05909;;Discount;;;-2.83;4469822.56;;Keila Alfaro-Visvikis;RETAIL SEDANOS;1389479;Jul
2025-07-01;El Palacio de los jugos /  Nanos Latin Foods;Invoice;008-05910;Arroz a Granel:Largo Fino 50 LB -Bolsa Dos Hermanos.;;6.0;27.85;167.1;4469989.66;Bulk Rice;Lisset Limpio -020;Cafeteria;1389480;Jul
2025-07-01;El Palacio de los jugos /  Nanos Latin Foods;Invoice;008-05910;Arroz a Granel:Parboiled 50 LB -Bolsa Dos Hermanos.;;10.0;26.75;267.5;4470257.16;Bulk Rice;Lisset Limpio -020;Cafeteria;1389481;Jul
2025-07-01;JMN Dely Corp;Invoice;008-05911;Dry Beans:Dry Beans - Black Beans 50;Dry Black Beans 50 lb;1.0;45.7;45.7;4470302.86;Dry Beans;Keila Alfaro-Visvikis;CAFETERIA y RESTAURANTS;1389482;Jul
2025-07-01;JMN Dely Corp;Invoice;008-05911;Arroz a Granel:Largo Fino 50 LB -Bolsa Dos Hermanos.;;2.0;27.85;55.7;4470358.56;Bulk Rice;Keila Alfaro-Visvikis;CAFETERIA y RESTAURANTS;1389483;Jul
2025-07-01;JMN Dely Corp;Invoice;008-05911;Arroz a Granel:Parboiled 50 LB -Bolsa Dos Hermanos.;;2.0;27.75;55.5;4470414.06;Bulk Rice;Keila Alfaro-Visvikis;CAFETERIA y RESTAURANTS;1389484;Jul
2025-07-01;BRAVO - Flamingo #3;Credit Memo;008-05912;Varios:Promotional Allowance;Arroz Envasado:Long Rice 10 LB Dos Hermanos;-1.0;18.0;-18.0;4470396.06;Branded Rice;Keila Alfaro-Visvikis;RETAIL  DSD;1389485;Jul
2025-07-01;BRAVO - Flamingo #3;Credit Memo;008-05912;Varios:Promotional Allowance;Arroz Envasado:Largo Fino 1kg (Long grain rice) Dos Hermanos;-2.0;35.5;-71.0;4470325.06;Branded Rice;Keila Alfaro-Visvikis;RETAIL  DSD;1389486;Jul
2025-07-01;Armando Carpio;Credit Memo;008-05913;Varios:Promotional Allowance;Arroz Envasado:Long Rice 10 LB Dos Hermanos;-1.0;35.5;-35.5;4470289.56;Branded Rice;Armando Carpio - 017;OTHER;1389487;Jul
2025-07-02;El Palacio de los jugos / Caribe Tropical;Invoice;008-05914;Dry Beans:Dry Beans - Black Beans 50;Dry Black Beans 50 lb;1.0;34.0;34.0;4470323.56;Dry Beans;Lisset Limpio -020;Cafeteria;1389488;Jul
2025-07-02;El Palacio de los jugos / Caribe Tropical;Invoice;008-05914;Arroz a Granel:Parboiled 50 LB -Bolsa Dos Hermanos.;;10.0;26.75;267.5;4470591.06;Bulk Rice;Lisset Limpio -020;Cafeteria;1389489;Jul
2025-07-02;El Palacio de los jugos / Divan and Denise Food;Invoice;008-05915;Arroz a Granel:Parboiled 50 LB -Bolsa Dos Hermanos.;;5.0;26.75;133.75;4470724.81;Bulk Rice;Lisset Limpio -020;Cafeteria;1389490;Jul
2025-07-02;El Palacio de los jugos / Delicias Criollas (DIAGO FOOD_MILLER);Invoice;008-05916;Arroz a Granel:Parboiled 50 LB -Bolsa Dos Hermanos.;;15.0;26.75;401.25;4471126.06;Bulk Rice;Lisset Limpio -020;Cafeteria;1389491;Jul
2025-07-02;El Palacio de los jugos / Delicias Criollas (DIAGO FOOD_MILLER);Invoice;008-05916;Arroz a Granel:Largo Fino 50 LB -Bolsa Dos Hermanos.;;5.0;27.85;139.25;4471265.31;Bulk Rice;Lisset Limpio -020;Cafeteria;1389492;Jul
2025-07-02;Los Caringas Latin America  Foods;Invoice;008-05917;Arroz a Granel:Parboiled 50 LB -Bolsa Dos Hermanos.;;3.0;28.25;84.75;4471350.06;Bulk Rice;Lisset Limpio -020;CAFETERIA y RESTAURANTS;1389493;Jul
2025-07-02;Los Caringas Latin America  Foods;Invoice;008-05917;Arroz a Granel:Largo Fino 50 LB -Bolsa Dos Hermanos.;;3.0;27.85;83.55;4471433.61;Bulk Rice;Lisset Limpio -020;CAFETERIA y RESTAURANTS;1389494;Jul
2025-07-02;Sedanos Supermarkets #33;Invoice;008-05918;Arroz a Granel:Parboiled 50 LB -Bolsa Dos Hermanos.;;3.0;28.25;84.75;4471518.36;Bulk Rice;Keila Alfaro-Visvikis;RETAIL SEDANOS;1389495;Jul
2025-07-02;Sedanos Supermarkets #33;Invoice;008-05918;;Discount;;;-1.7;4471516.66;;Keila Alfaro-Visvikis;RETAIL SEDANOS;1389496;Jul
2025-07-02;Sedanos Supermarkets #33;Invoice;008-05919;Arroz Envasado:Long Rice 10 LB Dos Hermanos;;5.0;35.5;177.5;4471694.16;Branded Rice;Keila Alfaro-Visvikis;RETAIL SEDANOS;1389497;Jul
2025-07-02;Sedanos Supermarkets #33;Invoice;008-05919;Arroz Envasado:Long Rice 10 LB Dos Hermanos;;1.0;35.5;35.5;4471729.66;Branded Rice;Keila Alfaro-Visvikis;RETAIL SEDANOS;1389498;Jul
2025-07-02;Sedanos Supermarkets #33;Invoice;008-05919;;Discount;;;-3.55;4471726.11;;Keila Alfaro-Visvikis;RETAIL SEDANOS;1389499;Jul
2025-07-02;El Palacio de los jugos / Lita Foods Inc.;Invoice;008-05920;Dry Beans:Dry Beans - Black Beans 50;Dry Black Beans 50 lb;1.0;34.0;34.0;4471760.11;Dry Beans;Lisset Limpio -020;Cafeteria;1389500;Jul
2025-07-02;El Palacio de los jugos / Lita Foods Inc.;Invoice;008-05920;Arroz a Granel:Parboiled 50 LB -Bolsa Dos Hermanos.;;12.0;26.75;321.0;4472081.11;Bulk Rice;Lisset Limpio -020;Cafeteria;1389501;Jul
2025-07-02;Sedanos Supermarkets #5;Invoice;008-05921;Arroz Envasado:Parboiled 5KG Dos Hermanos.;6  11lbs;5.0;40.5;202.5;4472283.61;Branded Rice;Keila Alfaro-Visvikis;RETAIL SEDANOS;1389502;Jul
2025-07-02;Sedanos Supermarkets #5;Invoice;008-05921;Arroz Envasado:Long Rice 10 LB Dos Hermanos;;5.0;35.5;177.5;4472461.11;Branded Rice;Keila Alfaro-Visvikis;RETAIL SEDANOS;1389503;Jul
2025-07-02;Sedanos Supermarkets #5;Invoice;008-05921;Rice Snack:Rice Snack Ham Flavored DOS HERMANOS;;2.0;19.9;39.8;4472500.91;Puffed Products;Keila Alfaro-Visvikis;RETAIL SEDANOS;1389504;Jul
2025-07-02;Sedanos Supermarkets #5;Invoice;008-05921;Rice Snack:Rice Snack Salami Flavored DOS HERMANOS;;1.0;19.9;19.9;4472520.81;Puffed Products;Keila Alfaro-Visvikis;RETAIL SEDANOS;1389505;Jul
2025-07-02;Sedanos Supermarkets #5;Invoice;008-05921;Arroz Envasado:Long Rice 10 LB Dos Hermanos;;1.0;35.5;35.5;4472556.31;Branded Rice;Keila Alfaro-Visvikis;RETAIL SEDANOS;1389506;Jul
2025-07-02;Sedanos Supermarkets #5;Invoice;008-05921;Arroz Envasado:Parboiled 5KG Dos Hermanos.;6  11lbs;2.0;40.5;81.0;4472637.31;Branded Rice;Keila Alfaro-Visvikis;RETAIL SEDANOS;1389507;Jul
2025-07-02;Sedanos Supermarkets #5;Invoice;008-05921;Rice Snack:Rice Snack Ham Flavored DOS HERMANOS;;1.0;19.9;19.9;4472657.21;Puffed Products;Keila Alfaro-Visvikis;RETAIL SEDANOS;1389508;Jul
2025-07-02;Sedanos Supermarkets #5;Invoice;008-05921;;Discount;;;-8.79;4472648.42;;Keila Alfaro-Visvikis;RETAIL SEDANOS;1389509;Jul
2025-07-02;El Palacio de los jugos / Leti Corp.;Invoice;008-05922;Arroz a Granel:Largo Fino 50 LB -Bolsa Dos Hermanos.;;5.0;27.85;139.25;4472787.67;Bulk Rice;Lisset Limpio -020;Cafeteria;1389510;Jul
2025-07-02;El Palacio de los jugos / Leti Corp.;Invoice;008-05922;Arroz a Granel:Parboiled 50 LB -Bolsa Dos Hermanos.;;6.0;26.75;160.5;4472948.17;Bulk Rice;Lisset Limpio -020;Cafeteria;1389511;Jul
2025-07-02;Sabor Tropical Supermarket #3;Invoice;008-05923;Arroz Envasado:Largo Fino 1kg (Long grain rice) Dos Hermanos;;5.0;18.0;90.0;4473038.17;Branded Rice;Keila Alfaro-Visvikis;RETAIL KEY FOOD;1389512;Jul
2025-07-02;Sabor Tropical Supermarket #3;Invoice;008-05923;Arroz Envasado:Long Rice 10 LB Dos Hermanos;;5.0;35.5;177.5;4473215.67;Branded Rice;Keila Alfaro-Visvikis;RETAIL KEY FOOD;1389513;Jul
2025-07-02;Sabor Tropical Supermarket #3;Invoice;008-05923;Arroz Envasado:Largo Fino 1kg (Long grain rice) Dos Hermanos;;1.0;18.0;18.0;4473233.67;Branded Rice;Keila Alfaro-Visvikis;RETAIL KEY FOOD;1389514;Jul
2025-07-02;Sabor Tropical Supermarket #3;Invoice;008-05923;Arroz Envasado:Long Rice 10 LB Dos Hermanos;;1.0;35.5;35.5;4473269.17;Branded Rice;Keila Alfaro-Visvikis;RETAIL KEY FOOD;1389515;Jul
2025-07-02;Sedanos Supermarkets #18;Invoice;008-05924;Arroz a Granel:Parboiled 50 LB -Bolsa Dos Hermanos.;;10.0;28.25;282.5;4473551.67;Bulk Rice;Keila Alfaro-Visvikis;RETAIL SEDANOS;1389516;Jul
2025-07-02;Sedanos Supermarkets #18;Invoice;008-05924;;Discount;;;-5.65;4473546.02;;Keila Alfaro-Visvikis;RETAIL SEDANOS;1389517;Jul
2025-07-02;Soriano Brothers PB;Invoice;008-05925;Arroz a Granel:Parboiled 50 LB -Bolsa Dos Hermanos.;;22.0;27.75;610.5;4474156.52;Bulk Rice;Lisset Limpio -020;CAFETERIA y RESTAURANTS;1389518;Jul
2025-07-02;Soriano Brothers PB;Invoice;008-05925;Arroz a Granel:Largo Fino 50 LB -Bolsa Dos Hermanos.;;11.0;27.85;306.35;4474462.87;Bulk Rice;Lisset Limpio -020;CAFETERIA y RESTAURANTS;1389519;Jul
2025-07-02;Soriano Brothers PB;Invoice;008-05925;Spices:AS Sazon (for all);1 / 30 lb (box or pail);2.0;51.0;102.0;4474564.87;American Spice;Lisset Limpio -020;CAFETERIA y RESTAURANTS;1389520;Jul
2025-07-02;Soriano Brothers PB;Invoice;008-05925;Liquids:AS Cooking Wine;4 1 Gl.;4.0;16.0;64.0;4474628.87;American Spice;Lisset Limpio -020;CAFETERIA y RESTAURANTS;1389521;Jul
2025-07-02;Soriano Brothers PB;Invoice;008-05925;Liquids:AS Lemon Juice 4/1 Gl;;2.0;14.0;28.0;4474656.87;American Spice;Lisset Limpio -020;CAFETERIA y RESTAURANTS;1389522;Jul
2025-07-02;Soriano Brothers PB;Invoice;008-05925;Liquids:AS Bitter Orange;4 / 1 gl.;2.0;14.0;28.0;4474684.87;American Spice;Lisset Limpio -020;CAFETERIA y RESTAURANTS;1389523;Jul
2025-07-02;Soriano Brothers PB;Invoice;008-05925;Spices:AS Chicken Base;1 / 30 lb. (box or pail);1.0;39.0;39.0;4474723.87;American Spice;Lisset Limpio -020;CAFETERIA y RESTAURANTS;1389524;Jul
2025-07-02;Soriano Brothers PB;Invoice;008-05925;Arroz a Granel:Parboiled 50 LB -Bolsa Dos Hermanos.;;2.0;27.75;55.5;4474779.37;Bulk Rice;Lisset Limpio -020;CAFETERIA y RESTAURANTS;1389525;Jul
2025-07-02;Sedanos Supermarkets #31;Invoice;008-05926;Spices:AS Chicken Base;1 / 30 lb. (box or pail);1.0;39.0;39.0;4474818.37;American Spice;Keila Alfaro-Visvikis;RETAIL SEDANOS;1389526;Jul
2025-07-02;Sedanos Supermarkets #31;Invoice;008-05926;Arroz a Granel:Parboiled 50 LB -Bolsa Dos Hermanos.;;6.0;28.25;169.5;4474987.87;Bulk Rice;Keila Alfaro-Visvikis;RETAIL SEDANOS;1389527;Jul
2025-07-02;Sedanos Supermarkets #31;Invoice;008-05926;;Discount;;;-4.17;4474983.7;;Keila Alfaro-Visvikis;RETAIL SEDANOS;1389528;Jul
2025-07-02;El Palacio de los jugos / J Mena Corp.;Invoice;008-05927;Arroz a Granel:Parboiled 50 LB -Bolsa Dos Hermanos.;;9.0;26.75;240.75;4475224.45;Bulk Rice;Lisset Limpio -020;Cafeteria;1389529;Jul
2025-07-02;El Palacio de los jugos / Rodriguez Foods;Invoice;008-05928;Arroz a Granel:Parboiled 50 LB -Bolsa Dos Hermanos.;;8.0;26.75;214.0;4475438.45;Bulk Rice;Lisset Limpio -020;Cafeteria;1389530;Jul
2025-07-02;El Palacio de Los Jugos / Casa mía Food Restaurant inc;Invoice;008-05929;Liquids:AS Marinating Sauce (Mojo);4 / 1 Gl;1.0;17.5;17.5;4475455.95;American Spice;Lisset Limpio -020;Cafeteria;1389531;Jul
2025-07-02;El Palacio de Los Jugos / Casa mía Food Restaurant inc;Invoice;008-05929;Liquids:AS Lemon Juice 4/1 Gl;;1.0;14.95;14.95;4475470.9;American Spice;Lisset Limpio -020;Cafeteria;1389532;Jul
2025-07-02;El Palacio de Los Jugos / Casa mía Food Restaurant inc;Invoice;008-05929;Arroz a Granel:Parboiled 50 LB -Bolsa Dos Hermanos.;;8.0;26.75;214.0;4475684.9;Bulk Rice;Lisset Limpio -020;Cafeteria;1389533;Jul
2025-07-02;Panda Depot;Invoice;008-05930;Arroz a Granel:Parboiled 50 LB -Bolsa Dos Hermanos.;;110.0;24.0;2640.0;4478324.9;Bulk Rice;Lisset Limpio -020;WHOLESALER;1389534;Jul
2025-07-02;Sedanos Supermarkets #33;Credit Memo;008-05946;Varios:Promotional Allowance;Arroz Envasado:Long Rice 10 LB Dos Hermanos;-1.0;35.5;-35.5;4478289.4;Branded Rice;Keila Alfaro-Visvikis;RETAIL SEDANOS;1389535;Jul
2025-07-02;Sedanos Supermarkets #5;Credit Memo;008-05947;Varios:Promotional Allowance;Arroz Envasado:Long Rice 10 LB Dos Hermanos;-1.0;35.5;-35.5;4478253.9;Branded Rice;Keila Alfaro-Visvikis;RETAIL SEDANOS;1389536;Jul
2025-07-02;Sedanos Supermarkets #5;Credit Memo;008-05947;Varios:Promotional Allowance;Arroz Envasado:Parboiled 5KG Dos Hermanos.;-2.0;40.5;-81.0;4478172.9;Branded Rice;Keila Alfaro-Visvikis;RETAIL SEDANOS;1389537;Jul
2025-07-02;Sedanos Supermarkets #5;Credit Memo;008-05947;Varios:Promotional Allowance;Rice Snack:Rice Snack Ham Flavored DOS HERMANOS;-1.0;19.9;-19.9;4478153.0;Puffed Products;Keila Alfaro-Visvikis;RETAIL SEDANOS;1389538;Jul
2025-07-02;Sabor Tropical Supermarket #3;Credit Memo;008-05948;Varios:Promotional Allowance;Arroz Envasado:Largo Fino 1kg (Long grain rice) Dos Hermanos;-1.0;18.0;-18.0;4478135.0;Branded Rice;Keila Alfaro-Visvikis;RETAIL KEY FOOD;1389539;Jul
2025-07-02;Sabor Tropical Supermarket #3;Credit Memo;008-05948;Varios:Promotional Allowance;Arroz Envasado:Long Rice 10 LB Dos Hermanos;-1.0;35.5;-35.5;4478099.5;Branded Rice;Keila Alfaro-Visvikis;RETAIL KEY FOOD;1389540;Jul
2025-07-02;Soriano Brothers PB;Credit Memo;008-05949;Varios:Promotional Allowance;Arroz a Granel:Parboiled 50 LB -Bolsa Dos Hermanos.;-2.0;27.75;-55.5;4478044.0;Bulk Rice;Lisset Limpio -020;CAFETERIA y RESTAURANTS;1389541;Jul
2025-07-03;Los Mejores Tamales de Miami;Invoice;008-05931;Arroz a Granel:Parboiled 50 LB -Bolsa Dos Hermanos.;;6.0;28.25;169.5;4478213.5;Bulk Rice;Lisset Limpio -020;CAFETERIA y RESTAURANTS;1389542;Jul
2025-07-03;El Palacio de los jugos / J Mena Corp.;Invoice;008-05932;Arroz a Granel:Parboiled 50 LB -Bolsa Dos Hermanos.;;6.0;26.75;160.5;4478374.0;Bulk Rice;Lisset Limpio -020;Cafeteria;1389543;Jul
2025-07-06;El Palacio de Los Jugos / Casa mía Food Restaurant inc;Invoice;008-05933;Arroz a Granel:Parboiled 50 LB -Bolsa Dos Hermanos.;;8.0;26.75;214.0;4478588.0;Bulk Rice;Lisset Limpio -020;Cafeteria;1389544;Jul
2025-07-06;Bravo   Francisco Diaz;Invoice;008-05934;Liquids:AS Cooking Wine;4 1 Gl.;3.0;17.5;52.5;4478640.5;American Spice;Lisset Limpio -020;RETAIL  DSD;1389545;Jul
2025-07-06;Bravo   Francisco Diaz;Invoice;008-05934;Liquids:AS Marinating Sauce (Mojo);4 / 1 Gl;1.0;18.5;18.5;4478659.0;American Spice;Lisset Limpio -020;RETAIL  DSD;1389546;Jul
2025-07-06;Bravo   Francisco Diaz;Invoice;008-05934;Liquids:AS White Vinegar;4/1 Gl.;2.0;10.0;20.0;4478679.0;American Spice;Lisset Limpio -020;RETAIL  DSD;1389547;Jul
2025-07-06;Bravo   Francisco Diaz;Invoice;008-05934;Spices:AS Chicken Base;1 / 30 lb. (box or pail);1.0;39.0;39.0;4478718.0;American Spice;Lisset Limpio -020;RETAIL  DSD;1389548;Jul
2025-07-06;Bravo   Francisco Diaz;Invoice;008-05934;Arroz a Granel:Largo Fino 50 LB -Bolsa Dos Hermanos.;;5.0;27.85;139.25;4478857.25;Bulk Rice;Lisset Limpio -020;RETAIL  DSD;1389549;Jul
2025-07-06;Bravo   Francisco Diaz;Invoice;008-05934;Dry Beans:Dry Beans - Black Beans 50;Dry Black Beans 50 lb;1.0;35.5;35.5;4478892.75;Dry Beans;Lisset Limpio -020;RETAIL  DSD;1389550;Jul
2025-07-06;El Palacio de los jugos / Caribe Tropical;Invoice;008-05935;Arroz a Granel:Parboiled 50 LB -Bolsa Dos Hermanos.;;6.0;26.75;160.5;4479053.25;Bulk Rice;Lisset Limpio -020;Cafeteria;1389551;Jul
2025-07-06;ALS Foods;Invoice;008-05936;Liquids:AS Cooking Wine;4 1 Gl.;2.0;17.5;35.0;4479088.25;American Spice;Lisset Limpio -020;CAFETERIA y RESTAURANTS;1389552;Jul
2025-07-06;ALS Foods;Invoice;008-05936;Arroz a Granel:Largo Fino 50 LB -Bolsa Dos Hermanos.;;8.0;27.85;222.8;4479311.05;Bulk Rice;Lisset Limpio -020;CAFETERIA y RESTAURANTS;1389553;Jul
2025-07-06;ALS Foods;Invoice;008-05936;Arroz a Granel:Parboiled 50 LB -Bolsa Dos Hermanos.;;11.0;27.75;305.25;4479616.3;Bulk Rice;Lisset Limpio -020;CAFETERIA y RESTAURANTS;1389554;Jul
2025-07-06;ALS Foods;Invoice;008-05936;Arroz a Granel:Parboiled 50 LB -Bolsa Dos Hermanos.;;1.0;27.75;27.75;4479644.05;Bulk Rice;Lisset Limpio -020;CAFETERIA y RESTAURANTS;1389555;Jul
2025-07-06;El Palacio de los jugos / Divan and Denise Food;Invoice;008-05937;Arroz a Granel:Parboiled 50 LB -Bolsa Dos Hermanos.;;8.0;26.75;214.0;4479858.05;Bulk Rice;Lisset Limpio -020;Cafeteria;1389556;Jul
2025-07-06;Sedanos Supermarkets #14;Invoice;008-05938;Arroz Envasado:Parboiled 5KG Dos Hermanos.;6  11lbs;5.0;40.5;202.5;4480060.55;Branded Rice;Keila Alfaro-Visvikis;RETAIL SEDANOS;1389557;Jul
2025-07-06;Sedanos Supermarkets #14;Invoice;008-05938;Arroz Envasado:Long Rice 10 LB Dos Hermanos;;1.0;35.5;35.5;4480096.05;Branded Rice;Keila Alfaro-Visvikis;RETAIL SEDANOS;1389558;Jul
2025-07-06;Sedanos Supermarkets #14;Invoice;008-05938;Arroz Envasado:Parboiled 5KG Dos Hermanos.;6  11lbs;1.0;40.5;40.5;4480136.55;Branded Rice;Keila Alfaro-Visvikis;RETAIL SEDANOS;1389559;Jul
2025-07-06;Sedanos Supermarkets #14;Invoice;008-05938;;Discount;;;-4.76;4480131.79;;Keila Alfaro-Visvikis;RETAIL SEDANOS;1389560;Jul
2025-07-06;Sedanos Supermarkets #14;Invoice;008-05939;Arroz a Granel:Parboiled 50 LB -Bolsa Dos Hermanos.;;2.0;28.25;56.5;4480188.29;Bulk Rice;Keila Alfaro-Visvikis;RETAIL SEDANOS;1389561;Jul
2025-07-06;Sedanos Supermarkets #14;Invoice;008-05939;;Discount;;;-1.13;4480187.16;;Keila Alfaro-Visvikis;RETAIL SEDANOS;1389562;Jul
2025-07-06;Sedanos Supermarkets #29;Invoice;008-05940;Arroz Envasado:Parboiled 5KG Dos Hermanos.;6  11lbs;15.0;40.5;607.5;4480794.66;Branded Rice;Keila Alfaro-Visvikis;RETAIL SEDANOS;1389563;Jul
2025-07-06;Sedanos Supermarkets #29;Invoice;008-05940;Arroz Envasado:Long Rice 10 LB Dos Hermanos;;5.0;35.5;177.5;4480972.16;Branded Rice;Keila Alfaro-Visvikis;RETAIL SEDANOS;1389564;Jul
2025-07-06;Sedanos Supermarkets #29;Invoice;008-05940;Arroz Envasado:Parboiled 5KG Dos Hermanos.;6  11lbs;3.0;40.5;121.5;4481093.66;Branded Rice;Keila Alfaro-Visvikis;RETAIL SEDANOS;1389565;Jul
2025-07-06;Sedanos Supermarkets #29;Invoice;008-05940;Arroz Envasado:Long Rice 10 LB Dos Hermanos;;1.0;35.5;35.5;4481129.16;Branded Rice;Keila Alfaro-Visvikis;RETAIL SEDANOS;1389566;Jul
2025-07-06;Sedanos Supermarkets #29;Invoice;008-05940;;Discount;;;-15.7;4481113.46;;Keila Alfaro-Visvikis;RETAIL SEDANOS;1389567;Jul
2025-07-06;El Palacio de los jugos /  Mires Restaurants;Invoice;008-05941;Liquids:AS Marinating Sauce (Mojo);4 / 1 Gl;1.0;18.5;18.5;4481131.96;American Spice;Lisset Limpio -020;Cafeteria;1389568;Jul
2025-07-06;El Palacio de los jugos /  Mires Restaurants;Invoice;008-05941;Arroz a Granel:Parboiled 50 LB -Bolsa Dos Hermanos.;;11.0;27.75;305.25;4481437.21;Bulk Rice;Lisset Limpio -020;Cafeteria;1389569;Jul
2025-07-06;El Palacio de los jugos /  Mires Restaurants;Invoice;008-05941;Arroz a Granel:Parboiled 50 LB -Bolsa Dos Hermanos.;;1.0;27.75;27.75;4481464.96;Bulk Rice;Lisset Limpio -020;Cafeteria;1389570;Jul
2025-07-06;ALS Foods;Credit Memo;008-05950;Varios:Promotional Allowance;Arroz a Granel:Parboiled 50 LB -Bolsa Dos Hermanos.;-1.0;27.75;-27.75;4481437.21;Bulk Rice;Lisset Limpio -020;CAFETERIA y RESTAURANTS;1389571;Jul
2025-07-06;El Palacio de los jugos /  Mires Restaurants;Credit Memo;008-05951;Varios:Promotional Allowance;Arroz a Granel:Parboiled 50 LB -Bolsa Dos Hermanos.;-1.0;27.75;-27.75;4481409.46;Bulk Rice;Lisset Limpio -020;Cafeteria;1389572;Jul
2025-07-06;Sedanos Supermarkets #14;Credit Memo;008-05952;Varios:Promotional Allowance;Arroz Envasado:Parboiled 5KG Dos Hermanos.;-1.0;40.5;-40.5;4481368.96;Branded Rice;Keila Alfaro-Visvikis;RETAIL SEDANOS;1389573;Jul
2025-07-06;Sedanos Supermarkets #29;Credit Memo;008-05953;Varios:Promotional Allowance;Arroz Envasado:Parboiled 5KG Dos Hermanos.;-3.0;40.5;-121.5;4481247.46;Branded Rice;Keila Alfaro-Visvikis;RETAIL SEDANOS;1389574;Jul
2025-07-06;Sedanos Supermarkets #29;Credit Memo;008-05953;Varios:Promotional Allowance;Arroz Envasado:Long Rice 10 LB Dos Hermanos;-1.0;35.5;-35.5;4481211.96;Branded Rice;Keila Alfaro-Visvikis;RETAIL SEDANOS;1389575;Jul
2025-07-07;El Palacio de los Jugos / Bird Road Restaurant;Invoice;008-05942;Arroz a Granel:Parboiled 50 LB -Bolsa Dos Hermanos.;;10.0;26.75;267.5;4481479.46;Bulk Rice;Lisset Limpio -020;Cafeteria;1389576;Jul
2025-07-07;El Palacio de los jugos /  Nanos Latin Foods;Invoice;008-05943;Arroz a Granel:Largo Fino 50 LB -Bolsa Dos Hermanos.;;5.0;27.85;139.25;4481618.71;Bulk Rice;Lisset Limpio -020;Cafeteria;1389577;Jul
2025-07-07;El Palacio de los jugos /  Nanos Latin Foods;Invoice;008-05943;Arroz a Granel:Parboiled 50 LB -Bolsa Dos Hermanos.;;12.0;26.75;321.0;4481939.71;Bulk Rice;Lisset Limpio -020;Cafeteria;1389578;Jul
2025-07-07;El Palacio de los jugos / Rodriguez Foods;Invoice;008-05944;Arroz a Granel:Parboiled 50 LB -Bolsa Dos Hermanos.;;6.0;26.75;160.5;4482100.21;Bulk Rice;Lisset Limpio -020;Cafeteria;1389579;Jul
2025-07-07;El Palacio de los jugos / La sabrosa salsa cubana Corp;Invoice;008-05945;Arroz a Granel:Largo Fino 50 LB -Bolsa Dos Hermanos.;;5.0;27.85;139.25;4482239.46;Bulk Rice;Lisset Limpio -020;Cafeteria;1389580;Jul
2025-07-07;Soriano Brothers Diaz Food Service,Inc;Invoice;008-05954;Arroz a Granel:Parboiled 50 LB -Bolsa Dos Hermanos.;;40.0;26.75;1070.0;4483309.46;Bulk Rice;Lisset Limpio -020;CAFETERIA y RESTAURANTS;1389581;Jul
2025-07-07;Soriano Brothers Diaz Food Service,Inc;Invoice;008-05954;Dry Beans:Dry Beans - Black Beans 50;Dry Black Beans 50 lb;3.0;34.0;102.0;4483411.46;Dry Beans;Lisset Limpio -020;CAFETERIA y RESTAURANTS;1389582;Jul
2025-07-07;Sedanos Supermarkets  #37;Invoice;008-05955;Arroz a Granel:Largo Fino 50 LB -Bolsa Dos Hermanos.;;6.0;27.85;167.1;4483578.56;Bulk Rice;Keila Alfaro-Visvikis;RETAIL SEDANOS;1389583;Jul
2025-07-07;Sedanos Supermarkets  #37;Invoice;008-05955;Arroz a Granel:Parboiled 50 LB -Bolsa Dos Hermanos.;;6.0;28.25;169.5;4483748.06;Bulk Rice;Keila Alfaro-Visvikis;RETAIL SEDANOS;1389584;Jul
2025-07-07;Sedanos Supermarkets  #37;Invoice;008-05956;Rice Snack:Rice Snack Ham Flavored DOS HERMANOS;;2.0;19.9;39.8;4483787.86;Puffed Products;Keila Alfaro-Visvikis;RETAIL SEDANOS;1389585;Jul
2025-07-07;Sedanos Supermarkets  #37;Invoice;008-05956;Rice Snack:Rice Snack Salami Flavored DOS HERMANOS;;1.0;19.9;19.9;4483807.76;Puffed Products;Keila Alfaro-Visvikis;RETAIL SEDANOS;1389586;Jul
2025-07-07;Sedanos Supermarkets  #37;Invoice;008-05956;Rice Snack:Rice Snack Salami Flavored DOS HERMANOS;;1.0;19.9;19.9;4483827.66;Puffed Products;Keila Alfaro-Visvikis;RETAIL SEDANOS;1389587;Jul
2025-07-10;Sedanos Supermarkets  #37;Credit Memo;008-05957;Varios:Producto vencido/deteriorado (no impacta en inventario);;-9.0;1.49;-13.41;4483814.25;Puffed Products;Keila Alfaro-Visvikis;RETAIL SEDANOS;1389588;Jul
2025-07-10;Aries Supermarket & Cafeteria;Invoice;008-05958;Arroz Envasado:Largo Fino 1kg (Long grain rice) Dos Hermanos;;2.0;18.0;36.0;4483850.25;Branded Rice;Keila Alfaro-Visvikis;CAFETERIA y RESTAURANTS;1389589;Jul
2025-07-10;Aries Supermarket & Cafeteria;Invoice;008-05958;Arroz Envasado:Long Rice 10 LB Dos Hermanos;;1.0;29.58;29.58;4483879.83;Branded Rice;Keila Alfaro-Visvikis;CAFETERIA y RESTAURANTS;1389590;Jul
2025-07-10;Aries Supermarket & Cafeteria;Invoice;008-05958;Arroz Envasado:Parboiled 5KG Dos Hermanos.;6  11lbs;2.0;46.5;93.0;4483972.83;Branded Rice;Keila Alfaro-Visvikis;CAFETERIA y RESTAURANTS;1389591;Jul
2025-07-10;Aries Supermarket & Cafeteria;Invoice;008-05958;Arroz Envasado:Parboiled 5KG Dos Hermanos.;6  11lbs;1.0;46.5;46.5;4484019.33;Branded Rice;Keila Alfaro-Visvikis;CAFETERIA y RESTAURANTS;1389592;Jul
2025-07-10;Price Choice Food Market # 6;Invoice;008-05959;Arroz Envasado:Parboiled 5KG Dos Hermanos.;6  11lbs;15.0;46.5;697.5;4484716.83;Branded Rice;Lisset Limpio -020;RETAIL  DSD;1389593;Jul
2025-07-10;Price Choice Food Market # 6;Invoice;008-05959;Arroz Envasado:Parboiled 5KG Dos Hermanos.;6  11lbs;7.0;46.5;325.5;4485042.33;Branded Rice;Lisset Limpio -020;RETAIL  DSD;1389594;Jul
2025-07-10;Sedanos Supermarkets #26;Invoice;008-05960;Arroz a Granel:Parboiled 50 LB -Bolsa Dos Hermanos.;;5.0;28.25;141.25;4485183.58;Bulk Rice;Keila Alfaro-Visvikis;RETAIL SEDANOS;1389595;Jul
2025-07-10;Sedanos Supermarkets #16;Invoice;008-05961;Arroz a Granel:Parboiled 50 LB -Bolsa Dos Hermanos.;;5.0;28.25;141.25;4485324.83;Bulk Rice;Keila Alfaro-Visvikis;RETAIL SEDANOS;1389596;Jul
2025-07-10;Sedanos Supermarkets #16;Invoice;008-05961;;Discount;;;-2.83;4485322.0;;Keila Alfaro-Visvikis;RETAIL SEDANOS;1389597;Jul
2025-07-10;Sedanos Supermarkets #43;Invoice;008-05962;Arroz a Granel:Parboiled 50 LB -Bolsa Dos Hermanos.;;5.0;28.25;141.25;4485463.25;Bulk Rice;Keila Alfaro-Visvikis;RETAIL SEDANOS;1389598;Jul
2025-07-10;Ideal Food Basket Davie Cafeteria;Invoice;008-05963;Arroz a Granel:Largo Fino 50 LB -Bolsa Dos Hermanos.;;7.0;27.85;194.95;4485658.2;Bulk Rice;Keila Alfaro-Visvikis;CAFETERIA y RESTAURANTS;1389599;Jul
2025-07-10;Ideal Food Basket Davie Grocery;Invoice;008-05964;Arroz Envasado:Largo Fino 1kg (Long grain rice) Dos Hermanos;;5.0;18.0;90.0;4485748.2;Branded Rice;Keila Alfaro-Visvikis;RETAIL  DSD;1389600;Jul
2025-07-10;Ideal Food Basket Davie Grocery;Invoice;008-05964;Arroz Envasado:Largo Fino 1kg (Long grain rice) Dos Hermanos;;1.0;18.0;18.0;4485766.2;Branded Rice;Keila Alfaro-Visvikis;RETAIL  DSD;1389601;Jul
2025-07-10;Key Food / Holywood;Invoice;008-05965;Arroz Envasado:Long Rice 10 LB Dos Hermanos;;4.0;29.58;118.32;4485884.52;Branded Rice;Keila Alfaro-Visvikis;RETAIL  DSD;1389602;Jul
2025-07-10;Aries Supermarket & Cafeteria;Credit Memo;008-05966;Varios:Promotional Allowance;Arroz Envasado:Parboiled 5KG Dos Hermanos.;-1.0;46.5;-46.5;4485838.02;Branded Rice;Keila Alfaro-Visvikis;CAFETERIA y RESTAURANTS;1389603;Jul
2025-07-10;Price Choice Food Market # 6;Credit Memo;008-05967;Varios:Promotional Allowance;Arroz Envasado:Parboiled 5KG Dos Hermanos.;-7.0;46.5;-325.5;4485512.52;Branded Rice;Lisset Limpio -020;RETAIL  DSD;1389604;Jul
2025-07-10;Ideal Food Basket Davie Grocery;Credit Memo;008-05968;Varios:Promotional Allowance;Arroz Envasado:Largo Fino 1kg (Long grain rice) Dos Hermanos;-1.0;18.0;-18.0;4485494.52;Branded Rice;Keila Alfaro-Visvikis;RETAIL  DSD;1389605;Jul
2025-07-10;Sedanos Supermarkets #5;Credit Memo;008-05969;Varios:Producto vencido/deteriorado (no impacta en inventario);10 salami;-1.0;14.92;-14.92;4485479.6;Puffed Products;Keila Alfaro-Visvikis;RETAIL SEDANOS;1389606;Jul
2025-07-10;El Palacio de los jugos /  Nanos Latin Foods;Invoice;008-05970;Arroz a Granel:Largo Fino 50 LB -Bolsa Dos Hermanos.;;5.0;27.85;139.25;4485618.85;Bulk Rice;Lisset Limpio -020;Cafeteria;1389607;Jul
2025-07-10;El Palacio de los jugos /  Nanos Latin Foods;Invoice;008-05970;Arroz a Granel:Parboiled 50 LB -Bolsa Dos Hermanos.;;10.0;26.75;267.5;4485886.35;Bulk Rice;Lisset Limpio -020;Cafeteria;1389608;Jul
2025-07-10;Bravo   Francisco Diaz;Invoice;008-05971;Arroz a Granel:Largo Fino 50 LB -Bolsa Dos Hermanos.;;5.0;27.85;139.25;4486025.6;Bulk Rice;Lisset Limpio -020;RETAIL  DSD;1389609;Jul
2025-07-10;El Palacio de Los Jugos / Casa mía Food Restaurant inc;Invoice;008-05972;Liquids:AS Marinating Sauce (Mojo);4 / 1 Gl;1.0;17.0;17.0;4486042.6;American Spice;Lisset Limpio -020;Cafeteria;1389610;Jul
2025-07-10;El Palacio de Los Jugos / Casa mía Food Restaurant inc;Invoice;008-05972;Liquids:AS Lemon Juice 4/1 Gl;;1.0;14.0;14.0;4486056.6;American Spice;Lisset Limpio -020;Cafeteria;1389611;Jul
2025-07-10;El Palacio de Los Jugos / Casa mía Food Restaurant inc;Invoice;008-05972;Arroz a Granel:Parboiled 50 LB -Bolsa Dos Hermanos.;;6.0;26.75;160.5;4486217.1;Bulk Rice;Lisset Limpio -020;Cafeteria;1389612;Jul
2025-07-10;Sedanos Supermarkets #33;Invoice;008-05973;Arroz a Granel:Parboiled 50 LB -Bolsa Dos Hermanos.;;5.0;28.25;141.25;4486358.35;Bulk Rice;Keila Alfaro-Visvikis;RETAIL SEDANOS;1389613;Jul
2025-07-10;Sedanos Supermarkets #33;Invoice;008-05973;;Discount;;;-2.83;4486355.52;;Keila Alfaro-Visvikis;RETAIL SEDANOS;1389614;Jul
2025-07-10;Sedanos Supermarkets #17;Invoice;008-05974;Rice Snack:Rice Snack Ham Flavored DOS HERMANOS;;3.0;19.9;59.7;4486415.22;Puffed Products;Keila Alfaro-Visvikis;RETAIL SEDANOS;1389615;Jul
2025-07-10;Sedanos Supermarkets #17;Invoice;008-05974;Rice Snack:Rice Snack Salami Flavored DOS HERMANOS;;2.0;19.9;39.8;4486455.02;Puffed Products;Keila Alfaro-Visvikis;RETAIL SEDANOS;1389616;Jul
2025-07-10;Sedanos Supermarkets #17;Invoice;008-05974;Arroz Envasado:Largo Fino 1kg (Long grain rice) Dos Hermanos;;1.0;18.0;18.0;4486473.02;Branded Rice;Keila Alfaro-Visvikis;RETAIL SEDANOS;1389617;Jul
2025-07-10;Sedanos Supermarkets #17;Invoice;008-05974;Rice Snack:Rice Snack Salami Flavored DOS HERMANOS;;1.0;19.9;19.9;4486492.92;Puffed Products;Keila Alfaro-Visvikis;RETAIL SEDANOS;1389618;Jul
2025-07-10;Sedanos Supermarkets #17;Invoice;008-05974;;Discount;;;-1.98;4486490.94;;Keila Alfaro-Visvikis;RETAIL SEDANOS;1389619;Jul
2025-07-10;Sedanos Supermarkets #18;Invoice;008-05975;Rice Snack:Rice Snack Ham Flavored DOS HERMANOS;;2.0;19.9;39.8;4486530.74;Puffed Products;Keila Alfaro-Visvikis;RETAIL SEDANOS;1389620;Jul
2025-07-10;Sedanos Supermarkets #18;Invoice;008-05975;Rice Snack:Rice Snack Salami Flavored DOS HERMANOS;;1.0;19.9;19.9;4486550.64;Puffed Products;Keila Alfaro-Visvikis;RETAIL SEDANOS;1389621;Jul
2025-07-10;Sedanos Supermarkets #18;Invoice;008-05975;Arroz Envasado:Long Rice 10 LB Dos Hermanos;;1.0;35.5;35.5;4486586.14;Branded Rice;Keila Alfaro-Visvikis;RETAIL SEDANOS;1389622;Jul
2025-07-10;Sedanos Supermarkets #18;Invoice;008-05975;Rice Snack:Rice Snack Salami Flavored DOS HERMANOS;;1.0;19.9;19.9;4486606.04;Puffed Products;Keila Alfaro-Visvikis;RETAIL SEDANOS;1389623;Jul
2025-07-10;Sedanos Supermarkets #18;Invoice;008-05976;Arroz a Granel:Parboiled 50 LB -Bolsa Dos Hermanos.;;10.0;28.25;282.5;4486888.54;Bulk Rice;Keila Alfaro-Visvikis;RETAIL SEDANOS;1389624;Jul
2025-07-10;Sedanos Supermarkets #18;Invoice;008-05976;Spices:AS Chicken Base;1 / 30 lb. (box or pail);1.0;39.0;39.0;4486927.54;American Spice;Keila Alfaro-Visvikis;RETAIL SEDANOS;1389625;Jul
2025-07-10;Sedanos Supermarkets #32;Invoice;008-05977;Arroz a Granel:Largo Fino 50 LB -Bolsa Dos Hermanos.;;6.0;27.85;167.1;4487094.64;Bulk Rice;Keila Alfaro-Visvikis;RETAIL SEDANOS;1389626;Jul
2025-07-10;Sedanos Supermarkets #32;Invoice;008-05977;Arroz a Granel:Parboiled 50 LB -Bolsa Dos Hermanos.;;6.0;28.25;169.5;4487264.14;Bulk Rice;Keila Alfaro-Visvikis;RETAIL SEDANOS;1389627;Jul
2025-07-10;Sedanos Supermarkets #32;Invoice;008-05977;;Discount;;;-6.73;4487257.41;;Keila Alfaro-Visvikis;RETAIL SEDANOS;1389628;Jul
2025-07-10;El Palacio de los jugos / Lita Foods Inc.;Invoice;008-05978;Dry Beans:Dry Beans - Black Beans 50;Dry Black Beans 50 lb;1.0;34.0;34.0;4487291.41;Dry Beans;Lisset Limpio -020;Cafeteria;1389629;Jul
2025-07-10;El Palacio de los jugos / Lita Foods Inc.;Invoice;008-05978;Arroz a Granel:Parboiled 50 LB -Bolsa Dos Hermanos.;;12.0;26.75;321.0;4487612.41;Bulk Rice;Lisset Limpio -020;Cafeteria;1389630;Jul
2025-07-10;El Palacio de los jugos / Divan and Denise Food;Invoice;008-05979;Arroz a Granel:Parboiled 50 LB -Bolsa Dos Hermanos.;;6.0;26.75;160.5;4487772.91;Bulk Rice;Lisset Limpio -020;Cafeteria;1389631;Jul
2025-07-10;El Palacio de los jugos / Caribe Tropical;Invoice;008-05980;Arroz a Granel:Parboiled 50 LB -Bolsa Dos Hermanos.;;5.0;26.75;133.75;4487906.66;Bulk Rice;Lisset Limpio -020;Cafeteria;1389632;Jul
2025-07-10;El Palacio de los jugos / Caribe Tropical;Invoice;008-05980;Dry Beans:Dry Beans - Black Beans 50;Dry Black Beans 50 lb;2.0;34.0;68.0;4487974.66;Dry Beans;Lisset Limpio -020;Cafeteria;1389633;Jul
2025-07-10;El Palacio de los jugos / Rodriguez Foods;Invoice;008-05981;Arroz a Granel:Parboiled 50 LB -Bolsa Dos Hermanos.;;6.0;26.75;160.5;4488135.16;Bulk Rice;Lisset Limpio -020;Cafeteria;1389634;Jul
2025-07-10;El Palacio de los jugos / Delicias Criollas (DIAGO FOOD_MILLER);Invoice;008-05982;Arroz a Granel:Parboiled 50 LB -Bolsa Dos Hermanos.;;12.0;26.75;321.0;4488456.16;Bulk Rice;Lisset Limpio -020;Cafeteria;1389635;Jul
2025-07-10;Soriano Brothers PB;Invoice;008-05983;Liquids:AS Bitter Orange;4 / 1 gl.;1.0;14.0;14.0;4488470.16;American Spice;Lisset Limpio -020;CAFETERIA y RESTAURANTS;1389636;Jul
2025-07-10;Soriano Brothers PB;Invoice;008-05983;Liquids:AS Cooking Wine;4 1 Gl.;7.0;16.0;112.0;4488582.16;American Spice;Lisset Limpio -020;CAFETERIA y RESTAURANTS;1389637;Jul
2025-07-10;Soriano Brothers PB;Invoice;008-05983;Spices:AS Sazon (for all);1 / 30 lb (box or pail);3.0;51.0;153.0;4488735.16;American Spice;Lisset Limpio -020;CAFETERIA y RESTAURANTS;1389638;Jul
2025-07-10;Soriano Brothers PB;Invoice;008-05983;Arroz a Granel:Largo Fino 50 LB -Bolsa Dos Hermanos.;;10.0;27.85;278.5;4489013.66;Bulk Rice;Lisset Limpio -020;CAFETERIA y RESTAURANTS;1389639;Jul
2025-07-10;Soriano Brothers PB;Invoice;008-05983;Arroz a Granel:Parboiled 50 LB -Bolsa Dos Hermanos.;;11.0;27.75;305.25;4489318.91;Bulk Rice;Lisset Limpio -020;CAFETERIA y RESTAURANTS;1389640;Jul
2025-07-10;Soriano Brothers PB;Invoice;008-05983;Arroz a Granel:Parboiled 50 LB -Bolsa Dos Hermanos.;;1.0;27.75;27.75;4489346.66;Bulk Rice;Lisset Limpio -020;CAFETERIA y RESTAURANTS;1389641;Jul
2025-07-10;El Palacio de los jugos / Leti Corp.;Invoice;008-05984;Arroz a Granel:Parboiled 50 LB -Bolsa Dos Hermanos.;;6.0;26.75;160.5;4489507.16;Bulk Rice;Lisset Limpio -020;Cafeteria;1389642;Jul
2025-07-10;Soriano Brothers PB;Credit Memo;008-05985;Varios:Promotional Allowance;Arroz a Granel:Parboiled 50 LB -Bolsa Dos Hermanos.;-1.0;27.75;-27.75;4489479.41;Bulk Rice;Lisset Limpio -020;CAFETERIA y RESTAURANTS;1389643;Jul
2025-07-10;Sedanos Supermarkets #17;Credit Memo;008-05986;Varios:Producto vencido/deteriorado (no impacta en inventario);;-1.0;1.49;-1.49;4489461.06;Puffed Products;Keila Alfaro-Visvikis;RETAIL SEDANOS;1389645;Jul
2025-07-10;Sedanos Supermarkets #17;Credit Memo;008-06008;Varios:Promotional Allowance;Rice Snack:Rice Snack Salami Flavored DOS HERMANOS;-1.0;19.9;-19.9;4489441.16;Puffed Products;Keila Alfaro-Visvikis;RETAIL SEDANOS;1389646;Jul
2025-07-11;Sedanos Supermarkets #21;Invoice;008-05987;Rice Snack:Rice Snack Ham Flavored DOS HERMANOS;;2.0;19.9;39.8;4489480.96;Puffed Products;Keila Alfaro-Visvikis;RETAIL SEDANOS;1389647;Jul
2025-07-11;Sedanos Supermarkets #21;Invoice;008-05987;Rice Snack:Rice Snack Salami Flavored DOS HERMANOS;;1.0;19.9;19.9;4489500.86;Puffed Products;Keila Alfaro-Visvikis;RETAIL SEDANOS;1389648;Jul
2025-07-11;Sedanos Supermarkets #21;Invoice;008-05987;Rice Snack:Rice Snack Salami Flavored DOS HERMANOS;;1.0;19.9;19.9;4489520.76;Puffed Products;Keila Alfaro-Visvikis;RETAIL SEDANOS;1389649;Jul
2025-07-11;Sedanos Supermarkets #21;Invoice;008-05987;;Discount;;;-1.19;4489519.57;;Keila Alfaro-Visvikis;RETAIL SEDANOS;1389650;Jul
2025-07-11;Sedanos Supermarkets #21;Credit Memo;008-05988;Varios:Producto vencido/deteriorado (no impacta en inventario);3 units jamón salame y pizza  / a $1.49;-13.0;1.49;-19.37;4489500.2;Puffed Products;Keila Alfaro-Visvikis;RETAIL SEDANOS;1389651;Jul
2025-07-11;Sedanos Supermarkets #21;Credit Memo;008-05989;Varios:Promotional Allowance;Rice Snack:Rice Snack Salami Flavored DOS HERMANOS;-1.0;19.9;-19.9;4489480.3;Puffed Products;Keila Alfaro-Visvikis;RETAIL SEDANOS;1389652;Jul
2025-07-13;Fritanga Momotombo;Invoice;008-05990;Spices:AS Chicken Base;1 / 30 lb. (box or pail);1.0;39.0;39.0;4489519.3;American Spice;Lisset Limpio -020;CAFETERIA y RESTAURANTS;1389653;Jul
2025-07-13;Fritanga Momotombo;Invoice;008-05990;Arroz a Granel:Largo Fino 50 LB -Bolsa Dos Hermanos.;;6.0;27.85;167.1;4489686.4;Bulk Rice;Lisset Limpio -020;CAFETERIA y RESTAURANTS;1389654;Jul
2025-07-13;Los Mejores Tamales de Miami;Invoice;008-05991;Arroz a Granel:Parboiled 50 LB -Bolsa Dos Hermanos.;;5.0;28.25;141.25;4489827.65;Bulk Rice;Lisset Limpio -020;CAFETERIA y RESTAURANTS;1389655;Jul
2025-07-13;El Palacio de los jugos / J Mena Corp.;Invoice;008-05992;Liquids:AS Marinating Sauce (Mojo);4 / 1 Gl;2.0;17.0;34.0;4489861.65;American Spice;Lisset Limpio -020;Cafeteria;1389656;Jul
2025-07-13;El Palacio de los jugos / J Mena Corp.;Invoice;008-05992;Arroz a Granel:Parboiled 50 LB -Bolsa Dos Hermanos.;;11.0;27.75;305.25;4490166.9;Bulk Rice;Lisset Limpio -020;Cafeteria;1389657;Jul
2025-07-13;El Palacio de los jugos / J Mena Corp.;Invoice;008-05992;Arroz a Granel:Parboiled 50 LB -Bolsa Dos Hermanos.;;1.0;27.75;27.75;4490194.65;Bulk Rice;Lisset Limpio -020;Cafeteria;1389658;Jul
2025-07-13;El Palacio de los jugos / Caribe Tropical;Invoice;008-05993;Arroz a Granel:Parboiled 50 LB -Bolsa Dos Hermanos.;;6.0;26.75;160.5;4490355.15;Bulk Rice;Lisset Limpio -020;Cafeteria;1389659;Jul
2025-07-13;El Palacio de Los Jugos / Casa mía Food Restaurant inc;Invoice;008-05994;Spices:AS Chicken Base;1 / 30 lb. (box or pail);1.0;39.0;39.0;4490394.15;American Spice;Lisset Limpio -020;Cafeteria;1389660;Jul
2025-07-13;El Palacio de Los Jugos / Casa mía Food Restaurant inc;Invoice;008-05994;Spices:AS Sazon (for all);1 / 30 lb (box or pail);1.0;51.0;51.0;4490445.15;American Spice;Lisset Limpio -020;Cafeteria;1389661;Jul
2025-07-13;El Palacio de Los Jugos / Casa mía Food Restaurant inc;Invoice;008-05994;Arroz a Granel:Parboiled 50 LB -Bolsa Dos Hermanos.;;6.0;26.75;160.5;4490605.65;Bulk Rice;Lisset Limpio -020;Cafeteria;1389662;Jul
2025-07-13;Be Your Will LLC;Invoice;008-05995;Liquids:AS Cooking Wine;4 1 Gl.;2.0;17.5;35.0;4490640.65;American Spice;Lisset Limpio -020;CAFETERIA y RESTAURANTS;1389663;Jul
2025-07-13;Be Your Will LLC;Invoice;008-05995;Arroz a Granel:Largo Fino 50 LB -Bolsa Dos Hermanos.;;8.0;27.85;222.8;4490863.45;Bulk Rice;Lisset Limpio -020;CAFETERIA y RESTAURANTS;1389664;Jul
2025-07-13;Be Your Will LLC;Invoice;008-05995;Arroz a Granel:Parboiled 50 LB -Bolsa Dos Hermanos.;;11.0;27.75;305.25;4491168.7;Bulk Rice;Lisset Limpio -020;CAFETERIA y RESTAURANTS;1389665;Jul
2025-07-13;Be Your Will LLC;Invoice;008-05995;Arroz a Granel:Largo Fino 50 LB -Bolsa Dos Hermanos.;;1.0;27.85;27.85;4491196.55;Bulk Rice;Lisset Limpio -020;CAFETERIA y RESTAURANTS;1389666;Jul
2025-07-13;El Palacio de los jugos / Rodriguez Foods;Invoice;008-05996;Arroz a Granel:Parboiled 50 LB -Bolsa Dos Hermanos.;;8.0;26.75;214.0;4491410.55;Bulk Rice;Lisset Limpio -020;Cafeteria;1389667;Jul
2025-07-13;El Palacio de los jugos / Divan and Denise Food;Invoice;008-05997;Arroz a Granel:Parboiled 50 LB -Bolsa Dos Hermanos.;;6.0;26.75;160.5;4491571.05;Bulk Rice;Lisset Limpio -020;Cafeteria;1389668;Jul
2025-07-13;El Palacio de los jugos / Delicias Criollas (DIAGO FOOD_MILLER);Invoice;008-05998;Arroz a Granel:Largo Fino 50 LB -Bolsa Dos Hermanos.;;6.0;27.85;167.1;4491738.15;Bulk Rice;Lisset Limpio -020;Cafeteria;1389669;Jul
2025-07-13;El Palacio de los jugos / Delicias Criollas (DIAGO FOOD_MILLER);Invoice;008-05998;Arroz a Granel:Parboiled 50 LB -Bolsa Dos Hermanos.;;6.0;26.75;160.5;4491898.65;Bulk Rice;Lisset Limpio -020;Cafeteria;1389670;Jul
2025-07-13;JMN Dely Corp;Invoice;008-05999;Arroz a Granel:Largo Fino 50 LB -Bolsa Dos Hermanos.;;2.0;27.85;55.7;4491954.35;Bulk Rice;Keila Alfaro-Visvikis;CAFETERIA y RESTAURANTS;1389671;Jul
2025-07-13;JMN Dely Corp;Invoice;008-05999;Arroz a Granel:Parboiled 50 LB -Bolsa Dos Hermanos.;;2.0;27.75;55.5;4492009.85;Bulk Rice;Keila Alfaro-Visvikis;CAFETERIA y RESTAURANTS;1389672;Jul
2025-07-13;JMN Dely Corp;Invoice;008-05999;Dry Beans:Dry Beans - Black Beans 50;Dry Black Beans 50 lb;1.0;45.7;45.7;4492055.55;Dry Beans;Keila Alfaro-Visvikis;CAFETERIA y RESTAURANTS;1389673;Jul
2025-07-13;Sedanos Supermarkets #7;Invoice;008-06000;Arroz Envasado:Parboiled 5KG Dos Hermanos.;6  11lbs;5.0;40.5;202.5;4492258.05;Branded Rice;Keila Alfaro-Visvikis;RETAIL SEDANOS;1389674;Jul
2025-07-13;Sedanos Supermarkets #7;Invoice;008-06000;Arroz Envasado:Parboiled 5KG Dos Hermanos.;6  11lbs;1.0;40.5;40.5;4492298.55;Branded Rice;Keila Alfaro-Visvikis;RETAIL SEDANOS;1389675;Jul
2025-07-13;Sedanos Supermarkets #7;Invoice;008-06000;;Discount;;;-4.05;4492294.5;;Keila Alfaro-Visvikis;RETAIL SEDANOS;1389676;Jul
2025-07-13;Sedanos Supermarkets #42;Invoice;008-06001;Arroz a Granel:Parboiled 50 LB -Bolsa Dos Hermanos.;;0.0;;0.0;4492294.5;Bulk Rice;Keila Alfaro-Visvikis;RETAIL SEDANOS;1389677;Jul
2025-07-13;Aries Supermarket & Cafeteria;Invoice;008-06002;Spices:AS Chicken Base;1 / 30 lb. (box or pail);3.0;39.0;117.0;4492411.5;American Spice;Keila Alfaro-Visvikis;CAFETERIA y RESTAURANTS;1389678;Jul
2025-07-13;Aries Supermarket & Cafeteria;Invoice;008-06002;Arroz a Granel:Parboiled 50 LB -Bolsa Dos Hermanos.;;10.0;28.25;282.5;4492694.0;Bulk Rice;Keila Alfaro-Visvikis;CAFETERIA y RESTAURANTS;1389679;Jul
2025-07-13;Aries Supermarket & Cafeteria;Invoice;008-06002;Dry Beans:Dry Beans - Black Beans 50;Dry Black Beans 50 lb;5.0;36.75;183.75;4492877.75;Dry Beans;Keila Alfaro-Visvikis;CAFETERIA y RESTAURANTS;1389680;Jul
2025-07-14;Sedanos Supermarkets  #37;Credit Memo;008-06003;Varios:Promotional Allowance;Rice Snack:Rice Snack Salami Flavored DOS HERMANOS;-1.0;19.9;-19.9;4492857.85;Puffed Products;Keila Alfaro-Visvikis;RETAIL SEDANOS;1389681;Jul
2025-07-14;Sedanos Supermarkets #18;Credit Memo;008-06004;Varios:Promotional Allowance;Rice Snack:Rice Snack Salami Flavored DOS HERMANOS;-1.0;19.9;-19.9;4492837.95;Puffed Products;Keila Alfaro-Visvikis;RETAIL SEDANOS;1389682;Jul
2025-07-14;El Palacio de los jugos / J Mena Corp.;Credit Memo;008-06005;Varios:Promotional Allowance;Arroz a Granel:Parboiled 50 LB -Bolsa Dos Hermanos.;-1.0;27.75;-27.75;4492810.2;Bulk Rice;Lisset Limpio -020;Cafeteria;1389683;Jul
2025-07-14;Be Your Will LLC;Credit Memo;008-06006;Varios:Promotional Allowance;Arroz a Granel:Largo Fino 50 LB -Bolsa Dos Hermanos.;-1.0;27.85;-27.85;4492782.35;Bulk Rice;Lisset Limpio -020;CAFETERIA y RESTAURANTS;1389684;Jul
2025-07-14;Sedanos Supermarkets #7;Credit Memo;008-06007;Varios:Sales;Arroz Envasado:Parboiled 5KG Dos Hermanos.;-1.0;40.5;-40.5;4492741.85;Bulk Rice;Keila Alfaro-Visvikis;RETAIL SEDANOS;1389685;Jul
2025-07-16;Sedanos Supermarkets #10;Invoice;008-06009;Arroz Envasado:Largo Fino 1kg (Long grain rice) Dos Hermanos;;15.0;17.0;255.0;4492996.85;Branded Rice;Keila Alfaro-Visvikis;RETAIL SEDANOS;1389686;Jul
2025-07-16;Sedanos Supermarkets #10;Invoice;008-06009;Arroz Envasado:Parboiled 5KG Dos Hermanos.;6  11lbs;21.0;40.5;850.5;4493847.35;Branded Rice;Keila Alfaro-Visvikis;RETAIL SEDANOS;1389687;Jul
2025-07-16;Sedanos Supermarkets #10;Invoice;008-06009;Arroz Envasado:Long Rice 10 LB Dos Hermanos;;21.0;35.5;745.5;4494592.85;Branded Rice;Keila Alfaro-Visvikis;RETAIL SEDANOS;1389688;Jul
2025-07-16;Sedanos Supermarkets #10;Invoice;008-06009;Arroz Envasado:Largo Fino 1kg (Long grain rice) Dos Hermanos;;5.0;17.0;85.0;4494677.85;Branded Rice;Keila Alfaro-Visvikis;RETAIL SEDANOS;1389689;Jul
2025-07-16;Sedanos Supermarkets #10;Invoice;008-06009;Arroz Envasado:Long Rice 10 LB Dos Hermanos;;21.0;35.5;745.5;4495423.35;Branded Rice;Keila Alfaro-Visvikis;RETAIL SEDANOS;1389690;Jul
2025-07-16;Sedanos Supermarkets #10;Invoice;008-06009;Arroz Envasado:Parboiled 5KG Dos Hermanos.;6  11lbs;21.0;40.5;850.5;4496273.85;Branded Rice;Keila Alfaro-Visvikis;RETAIL SEDANOS;1389691;Jul
2025-07-16;Sedanos Supermarkets #10;Invoice;008-06009;Rice Snack:Rice Snack Ham Flavored DOS HERMANOS;;2.0;19.9;39.8;4496313.65;Puffed Products;Keila Alfaro-Visvikis;RETAIL SEDANOS;1389692;Jul
2025-07-16;Sedanos Supermarkets #10;Invoice;008-06009;Rice Snack:Rice Snack Salami Flavored DOS HERMANOS;;3.0;19.9;59.7;4496373.35;Puffed Products;Keila Alfaro-Visvikis;RETAIL SEDANOS;1389693;Jul
2025-07-16;Sedanos Supermarkets #10;Invoice;008-06009;Varios:Exhibidor de pie DOS HERMANOS PVC -;;1.0;0.1;0.1;4496373.45;Branded Rice;Keila Alfaro-Visvikis;RETAIL SEDANOS;1389694;Jul
2025-07-16;Sedanos Supermarkets #9;Invoice;008-06010;Rice Snack:Rice Snack Ham Flavored DOS HERMANOS;;2.0;19.9;39.8;4496413.25;Puffed Products;Keila Alfaro-Visvikis;RETAIL SEDANOS;1389695;Jul
2025-07-16;Sedanos Supermarkets #9;Invoice;008-06010;Rice Snack:Rice Snack Salami Flavored DOS HERMANOS;;3.0;19.9;59.7;4496472.95;Puffed Products;Keila Alfaro-Visvikis;RETAIL SEDANOS;1389696;Jul
2025-07-16;Sedanos Supermarkets #9;Invoice;008-06010;Arroz Envasado:Largo Fino 1kg (Long grain rice) Dos Hermanos;;15.0;17.0;255.0;4496727.95;Branded Rice;Keila Alfaro-Visvikis;RETAIL SEDANOS;1389697;Jul
2025-07-16;Sedanos Supermarkets #9;Invoice;008-06010;Arroz Envasado:Parboiled 5KG Dos Hermanos.;6  11lbs;21.0;40.5;850.5;4497578.45;Branded Rice;Keila Alfaro-Visvikis;RETAIL SEDANOS;1389698;Jul
2025-07-16;Sedanos Supermarkets #9;Invoice;008-06010;Arroz Envasado:Long Rice 10 LB Dos Hermanos;;21.0;35.5;745.5;4498323.95;Branded Rice;Keila Alfaro-Visvikis;RETAIL SEDANOS;1389699;Jul
2025-07-16;Sedanos Supermarkets #9;Invoice;008-06010;Arroz Envasado:Largo Fino 1kg (Long grain rice) Dos Hermanos;;5.0;17.0;85.0;4498408.95;Branded Rice;Keila Alfaro-Visvikis;RETAIL SEDANOS;1389700;Jul
2025-07-16;Sedanos Supermarkets #9;Invoice;008-06010;Arroz Envasado:Long Rice 10 LB Dos Hermanos;;21.0;35.5;745.5;4499154.45;Branded Rice;Keila Alfaro-Visvikis;RETAIL SEDANOS;1389701;Jul
2025-07-16;Sedanos Supermarkets #9;Invoice;008-06010;Arroz Envasado:Parboiled 5KG Dos Hermanos.;6  11lbs;21.0;40.5;850.5;4500004.95;Branded Rice;Keila Alfaro-Visvikis;RETAIL SEDANOS;1389702;Jul
2025-07-16;Sedanos Supermarkets #9;Invoice;008-06010;Varios:Exhibidor de pie DOS HERMANOS PVC -;;1.0;0.1;0.1;4500005.05;Branded Rice;Keila Alfaro-Visvikis;RETAIL SEDANOS;1389703;Jul
2025-07-16;Sedanos Supermarkets #42;Invoice;008-06011;Arroz a Granel:Parboiled 50 LB -Bolsa Dos Hermanos.;;5.0;28.25;141.25;4500146.3;Bulk Rice;Keila Alfaro-Visvikis;RETAIL SEDANOS;1389704;Jul
2025-07-16;Sedanos Supermarkets #16;Invoice;008-06012;Arroz a Granel:Parboiled 50 LB -Bolsa Dos Hermanos.;;4.0;28.25;113.0;4500259.3;Bulk Rice;Keila Alfaro-Visvikis;RETAIL SEDANOS;1389705;Jul
2025-07-16;Sedanos Supermarkets #16;Invoice;008-06012;;Discount;;;-2.26;4500257.04;;Keila Alfaro-Visvikis;RETAIL SEDANOS;1389706;Jul
2025-07-16;Sedanos Supermarkets #34;Invoice;008-06013;Arroz Envasado:Long Rice 10 LB Dos Hermanos;;5.0;35.5;177.5;4500434.54;Branded Rice;Keila Alfaro-Visvikis;RETAIL SEDANOS;1389707;Jul
2025-07-16;Sedanos Supermarkets #34;Invoice;008-06013;Arroz Envasado:Long Rice 10 LB Dos Hermanos;;1.0;35.5;35.5;4500470.04;Branded Rice;Keila Alfaro-Visvikis;RETAIL SEDANOS;1389708;Jul
2025-07-16;Ideal Food Basket Davie Cafeteria;Invoice;008-06014;Arroz a Granel:Largo Fino 50 LB -Bolsa Dos Hermanos.;;6.0;27.85;167.1;4500637.14;Bulk Rice;Keila Alfaro-Visvikis;CAFETERIA y RESTAURANTS;1389709;Jul
2025-07-16;Rey Chavez Distributor #2;Invoice;008-06015;Arroz a Granel:Parboiled 50 LB -Bolsa Dos Hermanos.;;25.0;27.5;687.5;4501324.64;Bulk Rice;Lisset Limpio -020;WHOLESALER;1389710;Jul
2025-07-16;Los Caringas Latin America  Foods;Invoice;008-06016;Arroz a Granel:Parboiled 50 LB -Bolsa Dos Hermanos.;;3.0;28.25;84.75;4501409.39;Bulk Rice;Lisset Limpio -020;CAFETERIA y RESTAURANTS;1389711;Jul
2025-07-16;Los Caringas Latin America  Foods;Invoice;008-06016;Arroz a Granel:Largo Fino 50 LB -Bolsa Dos Hermanos.;;3.0;27.85;83.55;4501492.94;Bulk Rice;Lisset Limpio -020;CAFETERIA y RESTAURANTS;1389712;Jul
2025-07-16;Key Food / Holywood;Invoice;008-06017;Arroz Envasado:Long Rice 10 LB Dos Hermanos;;15.0;35.5;532.5;4502025.44;Branded Rice;Keila Alfaro-Visvikis;RETAIL  DSD;1389713;Jul
2025-07-16;Key Food / Holywood;Invoice;008-06017;Arroz Envasado:Long Rice 10 LB Dos Hermanos;;5.0;35.5;177.5;4502202.94;Branded Rice;Keila Alfaro-Visvikis;RETAIL  DSD;1389714;Jul
2025-07-16;Key Food / Holywood;Invoice;008-06018;Arroz Envasado:Long Rice 10 LB Dos Hermanos;;5.0;35.5;177.5;4502380.44;Branded Rice;Keila Alfaro-Visvikis;RETAIL  DSD;1389715;Jul
2025-07-16;Key Food / Holywood;Invoice;008-06018;Arroz Envasado:Long Rice 10 LB Dos Hermanos;;1.0;35.5;35.5;4502415.94;Branded Rice;Keila Alfaro-Visvikis;RETAIL  DSD;1389716;Jul
2025-07-16;Sedanos Supermarkets #28;Invoice;008-06019;Rice Snack:Rice Snack Ham Flavored DOS HERMANOS;;0.0;;0.0;4502415.94;Puffed Products;Keila Alfaro-Visvikis;RETAIL SEDANOS;1389717;Jul
2025-07-16;Sedanos Supermarkets #28;Invoice;008-06019;Rice Snack:Rice Snack Salami Flavored DOS HERMANOS;;0.0;;0.0;4502415.94;Puffed Products;Keila Alfaro-Visvikis;RETAIL SEDANOS;1389718;Jul
2025-07-16;Sedanos Supermarkets #28;Invoice;008-06019;Rice Snack:Rice Snack Salami Flavored DOS HERMANOS;;0.0;;0.0;4502415.94;Puffed Products;Keila Alfaro-Visvikis;RETAIL SEDANOS;1389719;Jul
2025-07-16;Sedanos Supermarkets #28;Credit Memo;008-06020;Varios:Producto vencido/deteriorado (no impacta en inventario);21 HAM Y SALAMI;-21.0;1.49;-31.29;4502384.65;Puffed Products;Keila Alfaro-Visvikis;RETAIL SEDANOS;1389720;Jul
2025-07-16;Sedanos Supermarkets #10;Credit Memo;008-06021;Varios:Promotional Allowance;Arroz Envasado:Largo Fino 1kg (Long grain rice) Dos Hermanos;-5.0;17.0;-85.0;4502299.65;Branded Rice;Keila Alfaro-Visvikis;RETAIL SEDANOS;1389721;Jul
2025-07-16;Sedanos Supermarkets #10;Credit Memo;008-06021;Varios:Promotional Allowance;Arroz Envasado:Parboiled 5KG Dos Hermanos.;-21.0;40.5;-850.5;4501449.15;Branded Rice;Keila Alfaro-Visvikis;RETAIL SEDANOS;1389722;Jul
2025-07-16;Sedanos Supermarkets #10;Credit Memo;008-06021;Varios:Promotional Allowance;Rice Snack:Rice Snack Salami Flavored DOS HERMANOS;-5.0;19.9;-99.5;4501349.65;Puffed Products;Keila Alfaro-Visvikis;RETAIL SEDANOS;1389723;Jul
2025-07-16;Sedanos Supermarkets #10;Credit Memo;008-06021;Varios:Promotional Allowance;Arroz Envasado:Long Rice 10 LB Dos Hermanos;-21.0;35.5;-745.5;4500604.15;Branded Rice;Keila Alfaro-Visvikis;RETAIL SEDANOS;1389724;Jul
2025-07-16;Key Food / Holywood;Credit Memo;008-06022;Varios:Promotional Allowance;Arroz Envasado:Long Rice 10 LB Dos Hermanos;-1.0;35.5;-35.5;4500568.65;Branded Rice;Keila Alfaro-Visvikis;RETAIL  DSD;1389725;Jul
2025-07-16;Key Food / Holywood;Credit Memo;008-06023;Varios:Promotional Allowance;Arroz Envasado:Long Rice 10 LB Dos Hermanos;-5.0;35.5;-177.5;4500391.15;Branded Rice;Keila Alfaro-Visvikis;RETAIL  DSD;1389726;Jul
2025-07-16;Sedanos Supermarkets #28;Credit Memo;008-06024;Varios:Promotional Allowance;Rice Snack:Rice Snack Salami Flavored DOS HERMANOS;-1.0;19.9;-19.9;4500371.25;Puffed Products;Keila Alfaro-Visvikis;RETAIL SEDANOS;1389727;Jul
2025-07-16;Sedanos Supermarkets #34;Credit Memo;008-06025;Varios:Promotional Allowance;Arroz Envasado:Long Rice 10 LB Dos Hermanos;-1.0;35.5;-35.5;4500335.75;Branded Rice;Keila Alfaro-Visvikis;RETAIL SEDANOS;1389728;Jul
2025-07-16;Sedanos Supermarkets #9;Credit Memo;008-06026;Varios:Promotional Allowance;Rice Snack:Rice Snack Salami Flavored DOS HERMANOS;-3.0;19.9;-59.7;4500276.05;Puffed Products;Keila Alfaro-Visvikis;RETAIL SEDANOS;1389729;Jul
2025-07-16;Sedanos Supermarkets #9;Credit Memo;008-06026;Varios:Promotional Allowance;Arroz Envasado:Largo Fino 1kg (Long grain rice) Dos Hermanos;-5.0;17.0;-85.0;4500191.05;Branded Rice;Keila Alfaro-Visvikis;RETAIL SEDANOS;1389730;Jul
2025-07-16;Sedanos Supermarkets #9;Credit Memo;008-06026;Varios:Promotional Allowance;Arroz Envasado:Parboiled 5KG Dos Hermanos.;-21.0;40.5;-850.5;4499340.55;Branded Rice;Keila Alfaro-Visvikis;RETAIL SEDANOS;1389731;Jul
2025-07-16;Sedanos Supermarkets #9;Credit Memo;008-06026;Varios:Promotional Allowance;Arroz Envasado:Long Rice 10 LB Dos Hermanos;-21.0;35.5;-745.5;4498595.05;Branded Rice;Keila Alfaro-Visvikis;RETAIL SEDANOS;1389732;Jul
2025-07-17;El Palacio de Los Jugos / Casa mía Food Restaurant inc;Invoice;008-06027;Arroz a Granel:Parboiled 50 LB -Bolsa Dos Hermanos.;;8.0;26.75;214.0;4498809.05;Bulk Rice;Lisset Limpio -020;Cafeteria;1389733;Jul
2025-07-17;El Palacio de Los Jugos / Casa mía Food Restaurant inc;Invoice;008-06027;Spices:AS Chicken Base;1 / 30 lb. (box or pail);1.0;39.0;39.0;4498848.05;American Spice;Lisset Limpio -020;Cafeteria;1389734;Jul
2025-07-17;El Palacio de Los Jugos / Casa mía Food Restaurant inc;Invoice;008-06027;Liquids:AS Marinating Sauce (Mojo);4 / 1 Gl;1.0;17.0;17.0;4498865.05;American Spice;Lisset Limpio -020;Cafeteria;1389735;Jul
2025-07-17;El Palacio de Los Jugos / Casa mía Food Restaurant inc;Invoice;008-06027;Liquids:AS Lemon Juice 4/1 Gl;;1.0;14.95;14.95;4498880.0;American Spice;Lisset Limpio -020;Cafeteria;1389736;Jul
2025-07-17;El Palacio de Los Jugos / Casa mía Food Restaurant inc;Invoice;008-06027;Spices:AS Sazon (for all);1 / 30 lb (box or pail);1.0;51.0;51.0;4498931.0;American Spice;Lisset Limpio -020;Cafeteria;1389737;Jul
2025-07-17;El Palacio de los jugos / Lita Foods Inc.;Invoice;008-06028;Dry Beans:Dry Beans - Black Beans 50;Dry Black Beans 50 lb;1.0;34.0;34.0;4498965.0;Dry Beans;Lisset Limpio -020;Cafeteria;1389738;Jul
2025-07-17;El Palacio de los jugos / Lita Foods Inc.;Invoice;008-06028;Arroz a Granel:Parboiled 50 LB -Bolsa Dos Hermanos.;;12.0;26.75;321.0;4499286.0;Bulk Rice;Lisset Limpio -020;Cafeteria;1389739;Jul
2025-07-17;El Palacio de los jugos / Divan and Denise Food;Invoice;008-06029;Arroz a Granel:Parboiled 50 LB -Bolsa Dos Hermanos.;;10.0;26.75;267.5;4499553.5;Bulk Rice;Lisset Limpio -020;Cafeteria;1389740;Jul
2025-07-17;El Palacio de los jugos / Caribe Tropical;Invoice;008-06030;Dry Beans:Dry Beans - Black Beans 50;Dry Black Beans 50 lb;2.0;34.0;68.0;4499621.5;Dry Beans;Lisset Limpio -020;Cafeteria;1389741;Jul
2025-07-17;El Palacio de los jugos / Caribe Tropical;Invoice;008-06030;Arroz a Granel:Parboiled 50 LB -Bolsa Dos Hermanos.;;8.0;26.75;214.0;4499835.5;Bulk Rice;Lisset Limpio -020;Cafeteria;1389742;Jul
2025-07-17;El Palacio de los jugos / Rodriguez Foods;Invoice;008-06031;Arroz a Granel:Parboiled 50 LB -Bolsa Dos Hermanos.;;6.0;26.75;160.5;4499996.0;Bulk Rice;Lisset Limpio -020;Cafeteria;1389743;Jul
2025-07-17;El Gallego Supermarket;Invoice;008-06032;Liquids:AS Bitter Orange;4 / 1 gl.;1.0;14.0;14.0;4500010.0;American Spice;Lisset Limpio -020;RETAIL  DSD;1389744;Jul
2025-07-17;El Gallego Supermarket;Invoice;008-06032;Liquids:AS Cooking Wine;4 1 Gl.;1.0;17.5;17.5;4500027.5;American Spice;Lisset Limpio -020;RETAIL  DSD;1389745;Jul
2025-07-17;El Gallego Supermarket;Invoice;008-06032;Dry Beans:Dry Beans - Black Beans 50;Dry Black Beans 50 lb;2.0;35.0;70.0;4500097.5;Dry Beans;Lisset Limpio -020;RETAIL  DSD;1389746;Jul
2025-07-17;El Gallego Supermarket;Invoice;008-06032;Arroz a Granel:Parboiled 50 LB -Bolsa Dos Hermanos.;;5.0;26.75;133.75;4500231.25;Bulk Rice;Lisset Limpio -020;RETAIL  DSD;1389747;Jul
2025-07-17;Bravo   Francisco Diaz;Invoice;008-06033;Liquids:AS Cooking Wine;4 1 Gl.;4.0;17.5;70.0;4500301.25;American Spice;Lisset Limpio -020;RETAIL  DSD;1389748;Jul
2025-07-17;Bravo   Francisco Diaz;Invoice;008-06033;Liquids:AS Marinating Sauce (Mojo);4 / 1 Gl;3.0;18.5;55.5;4500356.75;American Spice;Lisset Limpio -020;RETAIL  DSD;1389749;Jul
2025-07-17;Bravo   Francisco Diaz;Invoice;008-06033;Liquids:AS Lemon Juice 4/1 Gl;;2.0;14.95;29.9;4500386.65;American Spice;Lisset Limpio -020;RETAIL  DSD;1389750;Jul
2025-07-17;Bravo   Francisco Diaz;Invoice;008-06033;Liquids:AS White Vinegar;4/1 Gl.;3.0;10.0;30.0;4500416.65;American Spice;Lisset Limpio -020;RETAIL  DSD;1389751;Jul
2025-07-17;Bravo   Francisco Diaz;Invoice;008-06033;Spices:AS Chicken Base;1 / 30 lb. (box or pail);1.0;39.0;39.0;4500455.65;American Spice;Lisset Limpio -020;RETAIL  DSD;1389752;Jul
2025-07-17;Bravo   Francisco Diaz;Invoice;008-06033;Arroz a Granel:Largo Fino 50 LB -Bolsa Dos Hermanos.;;5.0;27.85;139.25;4500594.9;Bulk Rice;Lisset Limpio -020;RETAIL  DSD;1389753;Jul
2025-07-17;Bravo   Francisco Diaz;Invoice;008-06034;Arroz Envasado:Long Rice 10 LB Dos Hermanos;;15.0;35.5;532.5;4501127.4;Branded Rice;Lisset Limpio -020;RETAIL  DSD;1389754;Jul
2025-07-17;Bravo   Francisco Diaz;Invoice;008-06034;Arroz Envasado:Long Rice 10 LB Dos Hermanos;;3.0;35.5;106.5;4501233.9;Branded Rice;Lisset Limpio -020;RETAIL  DSD;1389755;Jul
2025-07-17;Extra Supermarket;Invoice;008-06035;Arroz Envasado:Largo Fino 1kg (Long grain rice) Dos Hermanos;;5.0;18.0;90.0;4501323.9;Branded Rice;Keila Alfaro-Visvikis;RETAIL  DSD;1389756;Jul
2025-07-17;Extra Supermarket;Invoice;008-06035;Arroz Envasado:Largo Fino 1kg (Long grain rice) Dos Hermanos;;1.0;18.0;18.0;4501341.9;Branded Rice;Keila Alfaro-Visvikis;RETAIL  DSD;1389757;Jul
2025-07-17;Sedanos Supermarkets #31;Invoice;008-06036;Arroz Envasado:Parboiled 5KG Dos Hermanos.;6  11lbs;15.0;40.5;607.5;4501949.4;Branded Rice;Keila Alfaro-Visvikis;RETAIL SEDANOS;1389758;Jul
2025-07-17;Sedanos Supermarkets #31;Invoice;008-06036;Arroz Envasado:Parboiled 5KG Dos Hermanos.;6  11lbs;4.0;40.5;162.0;4502111.4;Branded Rice;Keila Alfaro-Visvikis;RETAIL SEDANOS;1389759;Jul
2025-07-17;Sedanos Supermarkets #31;Invoice;008-06037;Arroz a Granel:Parboiled 50 LB -Bolsa Dos Hermanos.;;5.0;28.25;141.25;4502252.65;Bulk Rice;Keila Alfaro-Visvikis;RETAIL SEDANOS;1389760;Jul
2025-07-17;El Palacio de los jugos /  Nanos Latin Foods;Invoice;008-06038;Arroz a Granel:Parboiled 50 LB -Bolsa Dos Hermanos.;;12.0;26.75;321.0;4502573.65;Bulk Rice;Lisset Limpio -020;Cafeteria;1389761;Jul
2025-07-17;El Palacio de los jugos /  Nanos Latin Foods;Invoice;008-06038;Arroz a Granel:Largo Fino 50 LB -Bolsa Dos Hermanos.;;5.0;27.85;139.25;4502712.9;Bulk Rice;Lisset Limpio -020;Cafeteria;1389762;Jul
2025-07-17;Soriano Brothers Diaz Food Service,Inc;Invoice;008-06039;Dry Beans:Dry Beans - Black Beans 50;Dry Black Beans 50 lb;10.0;34.0;340.0;4503052.9;Dry Beans;Lisset Limpio -020;CAFETERIA y RESTAURANTS;1389763;Jul
2025-07-17;El Palacio de los jugos / Leti Corp.;Invoice;008-06040;Arroz a Granel:Parboiled 50 LB -Bolsa Dos Hermanos.;;8.0;26.75;214.0;4503266.9;Bulk Rice;Lisset Limpio -020;Cafeteria;1389764;Jul
2025-07-17;El Palacio de los jugos / Leti Corp.;Invoice;008-06040;Arroz a Granel:Largo Fino 50 LB -Bolsa Dos Hermanos.;;4.0;27.85;111.4;4503378.3;Bulk Rice;Lisset Limpio -020;Cafeteria;1389765;Jul
2025-07-17;Sedanos Supermarkets #33;Invoice;008-06041;Arroz a Granel:Parboiled 50 LB -Bolsa Dos Hermanos.;;3.0;28.25;84.75;4503463.05;Bulk Rice;Keila Alfaro-Visvikis;RETAIL SEDANOS;1389766;Jul
2025-07-17;Bravo   Francisco Diaz;Credit Memo;008-06042;Varios:Promotional Allowance;Arroz Envasado:Long Rice 10 LB Dos Hermanos;-3.0;35.5;-106.5;4503356.55;Branded Rice;Lisset Limpio -020;RETAIL  DSD;1389767;Jul
2025-07-17;Sedanos Supermarkets #31;Credit Memo;008-06043;Varios:Promotional Allowance;Arroz Envasado:Parboiled 5KG Dos Hermanos.;-4.0;40.5;-162.0;4503194.55;Branded Rice;Keila Alfaro-Visvikis;RETAIL SEDANOS;1389768;Jul
2025-07-17;Extra Supermarket;Credit Memo;008-06044;Varios:Promotional Allowance;Arroz Envasado:Largo Fino 1kg (Long grain rice) Dos Hermanos;-1.0;18.0;-18.0;4503176.55;Branded Rice;Keila Alfaro-Visvikis;RETAIL  DSD;1389769;Jul
2025-07-18;Sedanos Supermarkets #31;Credit Memo;008-06045;Varios:Producto vencido/deteriorado (no impacta en inventario);Parboiled 5k @ $3.37;-1.0;3.37;-3.37;4503173.18;Branded Rice;Keila Alfaro-Visvikis;RETAIL SEDANOS;1389770;Jul
2025-07-18;Sedanos Supermarkets #38;Invoice;008-06046;Arroz Envasado:Parboiled 5KG Dos Hermanos.;6  11lbs;21.0;40.5;850.5;4504023.68;Branded Rice;Keila Alfaro-Visvikis;RETAIL SEDANOS;1389771;Jul
2025-07-18;Sedanos Supermarkets #38;Invoice;008-06046;Arroz Envasado:Parboiled 5KG Dos Hermanos.;6  11lbs;21.0;40.5;850.5;4504874.18;Branded Rice;Keila Alfaro-Visvikis;RETAIL SEDANOS;1389772;Jul
2025-07-18;Sedanos Supermarkets #28;Invoice;008-06047;Arroz Envasado:Parboiled 5KG Dos Hermanos.;6  11lbs;15.0;40.5;607.5;4505481.68;American Spice;Keila Alfaro-Visvikis;RETAIL SEDANOS;1389773;Jul
2025-07-18;Sedanos Supermarkets #28;Invoice;008-06047;Arroz Envasado:Parboiled 5KG Dos Hermanos.;6  11lbs;3.0;40.5;121.5;4505603.18;Branded Rice;Keila Alfaro-Visvikis;RETAIL SEDANOS;1389774;Jul
2025-07-18;Sedanos Supermarkets #28;Invoice;008-06047;Rice Snack:Rice Snack Ham Flavored DOS HERMANOS;;2.0;19.9;39.8;4505642.98;Puffed Products;Keila Alfaro-Visvikis;RETAIL SEDANOS;1389775;Jul
2025-07-18;Sedanos Supermarkets #28;Invoice;008-06047;Rice Snack:Rice Snack Salami Flavored DOS HERMANOS;;1.0;19.9;19.9;4505662.88;Puffed Products;Keila Alfaro-Visvikis;RETAIL SEDANOS;1389776;Jul
2025-07-18;Sedanos Supermarkets #28;Invoice;008-06047;Rice Snack:Rice Snack Salami Flavored DOS HERMANOS;;1.0;19.9;19.9;4505682.78;Puffed Products;Keila Alfaro-Visvikis;RETAIL SEDANOS;1389777;Jul
2025-07-18;Sedanos Supermarkets #38;Credit Memo;008-06060;Varios:Promotional Allowance;Arroz Envasado:Parboiled 5KG Dos Hermanos.;-21.0;40.5;-850.5;4504832.28;Branded Rice;Keila Alfaro-Visvikis;RETAIL SEDANOS;1389778;Jul
2025-07-18;ALS Foods;Credit Memo;008-06061;Varios:Promotional Allowance;Arroz a Granel:Parboiled 50 LB -Bolsa Dos Hermanos.;-1.0;27.75;-27.75;4504804.53;Branded Rice;Lisset Limpio -020;CAFETERIA y RESTAURANTS;1389779;Jul
2025-07-18;Sedanos Supermarkets #28;Credit Memo;008-06063;Varios:Promotional Allowance;Rice Snack:Rice Snack Salami Flavored DOS HERMANOS;-1.0;19.9;-19.9;4504784.63;Puffed Products;Keila Alfaro-Visvikis;RETAIL SEDANOS;1389780;Jul
2025-07-18;Sedanos Supermarkets #28;Credit Memo;008-06063;Varios:Promotional Allowance;Arroz Envasado:Parboiled 5KG Dos Hermanos.;-3.0;40.5;-121.5;4504663.13;Branded Rice;Keila Alfaro-Visvikis;RETAIL SEDANOS;1389781;Jul
2025-07-20;El Palacio de Los Jugos / Casa mía Food Restaurant inc;Invoice;008-06048;Arroz a Granel:Parboiled 50 LB -Bolsa Dos Hermanos.;;8.0;26.75;214.0;4504877.13;Bulk Rice;Lisset Limpio -020;Cafeteria;1389782;Jul
2025-07-20;El Palacio de los jugos / Caribe Tropical;Invoice;008-06049;Arroz a Granel:Parboiled 50 LB -Bolsa Dos Hermanos.;;6.0;26.75;160.5;4505037.63;Bulk Rice;Lisset Limpio -020;Cafeteria;1389783;Jul
2025-07-20;El Palacio de los jugos /  Nanos Latin Foods;Invoice;008-06050;Arroz a Granel:Parboiled 50 LB -Bolsa Dos Hermanos.;;10.0;26.75;267.5;4505305.13;Bulk Rice;Lisset Limpio -020;Cafeteria;1389784;Jul
2025-07-20;El Palacio de los jugos /  Nanos Latin Foods;Invoice;008-06050;Arroz a Granel:Largo Fino 50 LB -Bolsa Dos Hermanos.;;5.0;27.85;139.25;4505444.38;Bulk Rice;Lisset Limpio -020;Cafeteria;1389785;Jul
2025-07-20;El Palacio de los jugos / Divan and Denise Food;Invoice;008-06051;Arroz a Granel:Parboiled 50 LB -Bolsa Dos Hermanos.;;8.0;26.75;214.0;4505658.38;Bulk Rice;Lisset Limpio -020;Cafeteria;1389786;Jul
2025-07-20;El Palacio de los jugos / Delicias Criollas (DIAGO FOOD_MILLER);Invoice;008-06052;Arroz a Granel:Largo Fino 50 LB -Bolsa Dos Hermanos.;;5.0;27.85;139.25;4505797.63;Bulk Rice;Lisset Limpio -020;Cafeteria;1389787;Jul
2025-07-20;El Palacio de los jugos / Delicias Criollas (DIAGO FOOD_MILLER);Invoice;008-06052;Arroz a Granel:Parboiled 50 LB -Bolsa Dos Hermanos.;;12.0;26.75;321.0;4506118.63;Bulk Rice;Lisset Limpio -020;Cafeteria;1389788;Jul
2025-07-20;Aries Supermarket & Cafeteria;Invoice;008-06053;Arroz a Granel:Parboiled 50 LB -Bolsa Dos Hermanos.;;10.0;28.25;282.5;4506401.13;Bulk Rice;Keila Alfaro-Visvikis;CAFETERIA y RESTAURANTS;1389789;Jul
2025-07-20;Aries Supermarket & Cafeteria;Invoice;008-06053;Dry Beans:Dry Beans - Black Beans 50;Dry Black Beans 50 lb;5.0;36.75;183.75;4506584.88;Dry Beans;Keila Alfaro-Visvikis;CAFETERIA y RESTAURANTS;1389790;Jul
2025-07-20;Aries Supermarket & Cafeteria;Invoice;008-06053;Spices:AS Oregano Ground;4 / 3.5 Lbs.;1.0;37.5;37.5;4506622.38;American Spice;Keila Alfaro-Visvikis;CAFETERIA y RESTAURANTS;1389791;Jul
2025-07-20;Sedanos Supermarkets #8;Invoice;008-06054;Rice Snack:Rice Snack Ham Flavored DOS HERMANOS;;1.0;19.9;19.9;4506642.28;Puffed Products;Keila Alfaro-Visvikis;RETAIL SEDANOS;1389792;Jul
2025-07-20;Sedanos Supermarkets #8;Invoice;008-06054;Rice Snack:Rice Snack Salami Flavored DOS HERMANOS;;1.0;19.9;19.9;4506662.18;Puffed Products;Keila Alfaro-Visvikis;RETAIL SEDANOS;1389793;Jul
2025-07-20;Sedanos Supermarkets #8;Invoice;008-06054;Arroz Envasado:Largo Fino 1kg (Long grain rice) Dos Hermanos;;15.0;17.5;262.5;4506924.68;Branded Rice;Keila Alfaro-Visvikis;RETAIL SEDANOS;1389794;Jul
2025-07-20;Sedanos Supermarkets #8;Invoice;008-06054;Arroz Envasado:Parboiled 5KG Dos Hermanos.;6  11lbs;21.0;40.5;850.5;4507775.18;Branded Rice;Keila Alfaro-Visvikis;RETAIL SEDANOS;1389795;Jul
2025-07-20;Sedanos Supermarkets #8;Invoice;008-06054;Arroz Envasado:Long Rice 10 LB Dos Hermanos;;21.0;35.5;745.5;4508520.68;Branded Rice;Keila Alfaro-Visvikis;RETAIL SEDANOS;1389796;Jul
2025-07-20;Sedanos Supermarkets #8;Invoice;008-06054;Rice Snack:Rice Snack Salami Flavored DOS HERMANOS;;1.0;19.9;19.9;4508540.58;Puffed Products;Keila Alfaro-Visvikis;RETAIL SEDANOS;1389797;Jul
2025-07-20;Sedanos Supermarkets #8;Invoice;008-06054;Rice Snack:Rice Snack Ham Flavored DOS HERMANOS;;2.0;19.9;39.8;4508580.38;Puffed Products;Keila Alfaro-Visvikis;RETAIL SEDANOS;1389798;Jul
2025-07-20;Sedanos Supermarkets #8;Invoice;008-06054;Arroz Envasado:Largo Fino 1kg (Long grain rice) Dos Hermanos;;5.0;17.5;87.5;4508667.88;Branded Rice;Keila Alfaro-Visvikis;RETAIL SEDANOS;1389799;Jul
2025-07-20;Sedanos Supermarkets #8;Invoice;008-06054;Arroz Envasado:Long Rice 10 LB Dos Hermanos;;21.0;35.5;745.5;4509413.38;Branded Rice;Keila Alfaro-Visvikis;RETAIL SEDANOS;1389800;Jul
2025-07-20;Sedanos Supermarkets #8;Invoice;008-06054;Arroz Envasado:Parboiled 5KG Dos Hermanos.;6  11lbs;21.0;40.5;850.5;4510263.88;Branded Rice;Keila Alfaro-Visvikis;RETAIL SEDANOS;1389801;Jul
2025-07-20;Sedanos Supermarkets #8;Invoice;008-06054;Varios:Exhibidor de pie DOS HERMANOS PVC -;;1.0;0.01;0.01;4510263.89;Branded Rice;Keila Alfaro-Visvikis;RETAIL SEDANOS;1389802;Jul
2025-07-20;El Palacio de los jugos /  Mires Restaurants;Invoice;008-06055;Liquids:AS Marinating Sauce (Mojo);4 / 1 Gl;1.0;18.5;18.5;4510282.39;American Spice;Lisset Limpio -020;Cafeteria;1389803;Jul
2025-07-20;El Palacio de los jugos /  Mires Restaurants;Invoice;008-06055;Arroz a Granel:Parboiled 50 LB -Bolsa Dos Hermanos.;;11.0;27.75;305.25;4510587.64;Bulk Rice;Lisset Limpio -020;Cafeteria;1389804;Jul
2025-07-20;El Palacio de los jugos /  Mires Restaurants;Invoice;008-06055;Arroz a Granel:Parboiled 50 LB -Bolsa Dos Hermanos.;;1.0;27.75;27.75;4510615.39;Bulk Rice;Lisset Limpio -020;Cafeteria;1389805;Jul
2025-07-20;Soriano Brothers PB;Invoice;008-06056;Liquids:AS Cooking Wine;4 1 Gl.;3.0;16.0;48.0;4510663.39;American Spice;Lisset Limpio -020;CAFETERIA y RESTAURANTS;1389806;Jul
2025-07-20;Soriano Brothers PB;Invoice;008-06056;Spices:AS Sazon (for all);1 / 30 lb (box or pail);1.0;51.0;51.0;4510714.39;American Spice;Lisset Limpio -020;CAFETERIA y RESTAURANTS;1389807;Jul
2025-07-20;Soriano Brothers PB;Invoice;008-06056;Arroz a Granel:Largo Fino 50 LB -Bolsa Dos Hermanos.;;10.0;27.85;278.5;4510992.89;Bulk Rice;Lisset Limpio -020;CAFETERIA y RESTAURANTS;1389808;Jul
2025-07-20;El Palacio de los jugos / Rodriguez Foods;Invoice;008-06057;Arroz a Granel:Parboiled 50 LB -Bolsa Dos Hermanos.;;6.0;26.75;160.5;4511153.39;Bulk Rice;Lisset Limpio -020;Cafeteria;1389809;Jul
2025-07-20;El Palacio de los Jugos / Bird Road Restaurant;Invoice;008-06058;Arroz a Granel:Parboiled 50 LB -Bolsa Dos Hermanos.;;10.0;26.75;267.5;4511420.89;Bulk Rice;Lisset Limpio -020;Cafeteria;1389810;Jul
2025-07-20;El Palacio de los jugos /  Mires Restaurants;Credit Memo;008-06062;Varios:Promotional Allowance;Arroz a Granel:Parboiled 50 LB -Bolsa Dos Hermanos.;-1.0;27.75;-27.75;4511393.14;Bulk Rice;Lisset Limpio -020;Cafeteria;1389811;Jul
2025-07-20;Sedanos Supermarkets #8;Credit Memo;008-06064;Varios:Promotional Allowance;Rice Snack:Rice Snack Salami Flavored DOS HERMANOS;-1.0;19.9;-19.9;4511373.24;Puffed Products;Keila Alfaro-Visvikis;RETAIL SEDANOS;1389812;Jul
2025-07-20;Sedanos Supermarkets #8;Credit Memo;008-06064;Varios:Promotional Allowance;Rice Snack:Rice Snack Ham Flavored DOS HERMANOS;-2.0;19.9;-39.8;4511333.44;Puffed Products;Keila Alfaro-Visvikis;RETAIL SEDANOS;1389813;Jul
2025-07-20;Sedanos Supermarkets #8;Credit Memo;008-06064;Varios:Promotional Allowance;Arroz Envasado:Largo Fino 1kg (Long grain rice) Dos Hermanos;-5.0;17.5;-87.5;4511245.94;Branded Rice;Keila Alfaro-Visvikis;RETAIL SEDANOS;1389814;Jul
2025-07-20;Sedanos Supermarkets #8;Credit Memo;008-06064;Varios:Promotional Allowance;Arroz Envasado:Long Rice 10 LB Dos Hermanos;-21.0;35.5;-745.5;4510500.44;Branded Rice;Keila Alfaro-Visvikis;RETAIL SEDANOS;1389815;Jul
2025-07-20;Sedanos Supermarkets #8;Credit Memo;008-06064;Varios:Promotional Allowance;Arroz Envasado:Parboiled 5KG Dos Hermanos.;-21.0;40.5;-850.5;4509649.94;Branded Rice;Keila Alfaro-Visvikis;RETAIL SEDANOS;1389816;Jul
2025-07-21;ALS Foods;Invoice;008-06059;Liquids:AS Cooking Wine;4 1 Gl.;2.0;17.5;35.0;4509684.94;American Spice;Lisset Limpio -020;CAFETERIA y RESTAURANTS;1389817;Jul
2025-07-21;ALS Foods;Invoice;008-06059;Arroz a Granel:Largo Fino 50 LB -Bolsa Dos Hermanos.;;7.0;27.85;194.95;4509879.89;Bulk Rice;Lisset Limpio -020;CAFETERIA y RESTAURANTS;1389818;Jul
2025-07-21;ALS Foods;Invoice;008-06059;Arroz a Granel:Parboiled 50 LB -Bolsa Dos Hermanos.;;11.0;27.75;305.25;4510185.14;Bulk Rice;Lisset Limpio -020;CAFETERIA y RESTAURANTS;1389819;Jul
2025-07-21;ALS Foods;Invoice;008-06059;Arroz a Granel:Parboiled 50 LB -Bolsa Dos Hermanos.;;1.0;27.75;27.75;4510212.89;Bulk Rice;Lisset Limpio -020;CAFETERIA y RESTAURANTS;1389820;Jul
2025-07-21;JMN Dely Corp;Invoice;008-06065;Dry Beans:Dry Beans - Black Beans 50;Dry Black Beans 50 lb;1.0;45.7;45.7;4510258.59;Dry Beans;Keila Alfaro-Visvikis;CAFETERIA y RESTAURANTS;1389821;Jul
2025-07-21;JMN Dely Corp;Invoice;008-06065;Arroz a Granel:Largo Fino 50 LB -Bolsa Dos Hermanos.;;2.0;27.85;55.7;4510314.29;Bulk Rice;Keila Alfaro-Visvikis;CAFETERIA y RESTAURANTS;1389822;Jul
2025-07-21;JMN Dely Corp;Invoice;008-06065;Arroz a Granel:Parboiled 50 LB -Bolsa Dos Hermanos.;;2.0;27.75;55.5;4510369.79;Bulk Rice;Keila Alfaro-Visvikis;CAFETERIA y RESTAURANTS;1389823;Jul
2025-07-21;JMN Dely Corp;Invoice;008-06065;;Discount;;;-0.9;4510368.89;;Keila Alfaro-Visvikis;CAFETERIA y RESTAURANTS;1389824;Jul
2025-07-21;Sedanos Supermarkets #43;Invoice;008-06066;Arroz Envasado:Largo Fino 1kg (Long grain rice) Dos Hermanos;;15.0;17.5;262.5;4510631.39;Branded Rice;Keila Alfaro-Visvikis;RETAIL SEDANOS;1389825;Jul
2025-07-21;Sedanos Supermarkets #43;Invoice;008-06066;Arroz Envasado:Parboiled 5KG Dos Hermanos.;6  11lbs;21.0;40.5;850.5;4511481.89;Branded Rice;Keila Alfaro-Visvikis;RETAIL SEDANOS;1389826;Jul
2025-07-21;Sedanos Supermarkets #43;Invoice;008-06066;Arroz Envasado:Long Rice 10 LB Dos Hermanos;;21.0;35.5;745.5;4512227.39;Branded Rice;Keila Alfaro-Visvikis;RETAIL SEDANOS;1389827;Jul
2025-07-21;Sedanos Supermarkets #43;Invoice;008-06066;Rice Snack:Rice Snack Ham Flavored DOS HERMANOS;;1.0;19.9;19.9;4512247.29;Puffed Products;Keila Alfaro-Visvikis;RETAIL SEDANOS;1389828;Jul
2025-07-21;Sedanos Supermarkets #43;Invoice;008-06066;Rice Snack:Rice Snack Salami Flavored DOS HERMANOS;;1.0;19.9;19.9;4512267.19;Puffed Products;Keila Alfaro-Visvikis;RETAIL SEDANOS;1389829;Jul
2025-07-21;Sedanos Supermarkets #43;Invoice;008-06066;Rice Snack:Rice Snack Ham Flavored DOS HERMANOS;;2.0;19.9;39.8;4512306.99;Puffed Products;Keila Alfaro-Visvikis;RETAIL SEDANOS;1389830;Jul
2025-07-21;Sedanos Supermarkets #43;Invoice;008-06066;Rice Snack:Rice Snack Salami Flavored DOS HERMANOS;;1.0;19.9;19.9;4512326.89;Puffed Products;Keila Alfaro-Visvikis;RETAIL SEDANOS;1389831;Jul
2025-07-21;Sedanos Supermarkets #43;Invoice;008-06066;Arroz Envasado:Largo Fino 1kg (Long grain rice) Dos Hermanos;;5.0;17.5;87.5;4512414.39;Branded Rice;Keila Alfaro-Visvikis;RETAIL SEDANOS;1389832;Jul
2025-07-21;Sedanos Supermarkets #43;Invoice;008-06066;Arroz Envasado:Parboiled 5KG Dos Hermanos.;6  11lbs;21.0;40.5;850.5;4513264.89;Branded Rice;Keila Alfaro-Visvikis;RETAIL SEDANOS;1389833;Jul
2025-07-21;Sedanos Supermarkets #43;Invoice;008-06066;Arroz Envasado:Long Rice 10 LB Dos Hermanos;;21.0;35.5;745.5;4514010.39;Branded Rice;Keila Alfaro-Visvikis;RETAIL SEDANOS;1389834;Jul
2025-07-21;Sedanos Supermarkets #43;Invoice;008-06066;Varios:Exhibidor de pie DOS HERMANOS PVC -;;1.0;0.01;0.01;4514010.4;Branded Rice;Keila Alfaro-Visvikis;RETAIL SEDANOS;1389835;Jul
2025-07-21;Sedanos Supermarkets #22;Invoice;008-06067;Arroz Envasado:Largo Fino 1kg (Long grain rice) Dos Hermanos;;15.0;17.5;262.5;4514272.9;Branded Rice;Keila Alfaro-Visvikis;RETAIL SEDANOS;1389836;Jul
2025-07-21;Sedanos Supermarkets #22;Invoice;008-06067;Rice Snack:Rice Snack Ham Flavored DOS HERMANOS;;1.0;19.9;19.9;4514292.8;Puffed Products;Keila Alfaro-Visvikis;RETAIL SEDANOS;1389837;Jul
2025-07-21;Sedanos Supermarkets #22;Invoice;008-06067;Rice Snack:Rice Snack Salami Flavored DOS HERMANOS;;1.0;19.9;19.9;4514312.7;Puffed Products;Keila Alfaro-Visvikis;RETAIL SEDANOS;1389838;Jul
2025-07-21;Sedanos Supermarkets #22;Invoice;008-06067;Arroz Envasado:Parboiled 5KG Dos Hermanos.;6  11lbs;21.0;40.5;850.5;4515163.2;Branded Rice;Keila Alfaro-Visvikis;RETAIL SEDANOS;1389839;Jul
2025-07-21;Sedanos Supermarkets #22;Invoice;008-06067;Arroz Envasado:Long Rice 10 LB Dos Hermanos;;21.0;35.5;745.5;4515908.7;Branded Rice;Keila Alfaro-Visvikis;RETAIL SEDANOS;1389840;Jul
2025-07-21;Sedanos Supermarkets #22;Invoice;008-06067;Rice Snack:Rice Snack Ham Flavored DOS HERMANOS;;2.0;19.9;39.8;4515948.5;Puffed Products;Keila Alfaro-Visvikis;RETAIL SEDANOS;1389841;Jul
2025-07-21;Sedanos Supermarkets #22;Invoice;008-06067;Rice Snack:Rice Snack Salami Flavored DOS HERMANOS;;1.0;19.9;19.9;4515968.4;Puffed Products;Keila Alfaro-Visvikis;RETAIL SEDANOS;1389842;Jul
2025-07-21;Sedanos Supermarkets #22;Invoice;008-06067;Arroz Envasado:Parboiled 5KG Dos Hermanos.;6  11lbs;21.0;40.5;850.5;4516818.9;Branded Rice;Keila Alfaro-Visvikis;RETAIL SEDANOS;1389843;Jul
2025-07-21;Sedanos Supermarkets #22;Invoice;008-06067;Arroz Envasado:Long Rice 10 LB Dos Hermanos;;21.0;35.5;745.5;4517564.4;Branded Rice;Keila Alfaro-Visvikis;RETAIL SEDANOS;1389844;Jul
2025-07-21;Sedanos Supermarkets #22;Invoice;008-06067;Varios:Exhibidor de pie DOS HERMANOS PVC -;;1.0;0.01;0.01;4517564.41;Branded Rice;Keila Alfaro-Visvikis;RETAIL SEDANOS;1389845;Jul
2025-07-21;Sedanos Supermarkets #22;Invoice;008-06067;Arroz Envasado:Largo Fino 1kg (Long grain rice) Dos Hermanos;;5.0;17.5;87.5;4517651.91;Branded Rice;Keila Alfaro-Visvikis;RETAIL SEDANOS;1389846;Jul
2025-07-21;Sedanos Supermarkets #26;Invoice;008-06068;Arroz Envasado:Largo Fino 1kg (Long grain rice) Dos Hermanos;;15.0;17.5;262.5;4517914.41;Branded Rice;Keila Alfaro-Visvikis;RETAIL SEDANOS;1389847;Jul
2025-07-21;Sedanos Supermarkets #26;Invoice;008-06068;Arroz Envasado:Parboiled 5KG Dos Hermanos.;6  11lbs;21.0;40.5;850.5;4518764.91;Branded Rice;Keila Alfaro-Visvikis;RETAIL SEDANOS;1389848;Jul
2025-07-21;Sedanos Supermarkets #26;Invoice;008-06068;Arroz Envasado:Long Rice 10 LB Dos Hermanos;;21.0;35.5;745.5;4519510.41;Branded Rice;Keila Alfaro-Visvikis;RETAIL SEDANOS;1389849;Jul
2025-07-21;Sedanos Supermarkets #26;Invoice;008-06068;Rice Snack:Rice Snack Ham Flavored DOS HERMANOS;;1.0;19.9;19.9;4519530.31;Puffed Products;Keila Alfaro-Visvikis;RETAIL SEDANOS;1389850;Jul
2025-07-21;Sedanos Supermarkets #26;Invoice;008-06068;Rice Snack:Rice Snack Salami Flavored DOS HERMANOS;;1.0;19.9;19.9;4519550.21;Puffed Products;Keila Alfaro-Visvikis;RETAIL SEDANOS;1389851;Jul
2025-07-21;Sedanos Supermarkets #26;Invoice;008-06068;Rice Snack:Rice Snack Ham Flavored DOS HERMANOS;;2.0;19.9;39.8;4519590.01;Puffed Products;Keila Alfaro-Visvikis;RETAIL SEDANOS;1389852;Jul
2025-07-21;Sedanos Supermarkets #26;Invoice;008-06068;Rice Snack:Rice Snack Salami Flavored DOS HERMANOS;;1.0;19.9;19.9;4519609.91;Puffed Products;Keila Alfaro-Visvikis;RETAIL SEDANOS;1389853;Jul
2025-07-21;Sedanos Supermarkets #26;Invoice;008-06068;Arroz Envasado:Largo Fino 1kg (Long grain rice) Dos Hermanos;;5.0;17.5;87.5;4519697.41;Branded Rice;Keila Alfaro-Visvikis;RETAIL SEDANOS;1389854;Jul
2025-07-21;Sedanos Supermarkets #26;Invoice;008-06068;Arroz Envasado:Parboiled 5KG Dos Hermanos.;6  11lbs;21.0;40.5;850.5;4520547.91;Branded Rice;Keila Alfaro-Visvikis;RETAIL SEDANOS;1389855;Jul
2025-07-21;Sedanos Supermarkets #26;Invoice;008-06068;Arroz Envasado:Long Rice 10 LB Dos Hermanos;;21.0;35.5;745.5;4521293.41;Branded Rice;Keila Alfaro-Visvikis;RETAIL SEDANOS;1389856;Jul
2025-07-21;Sedanos Supermarkets #26;Invoice;008-06068;Varios:Exhibidor de pie DOS HERMANOS PVC -;;1.0;0.01;0.01;4521293.42;Branded Rice;Keila Alfaro-Visvikis;RETAIL SEDANOS;1389857;Jul
2025-07-21;Sedanos Supermarkets #1;Invoice;008-06069;Rice Snack:Rice Snack Ham Flavored DOS HERMANOS;;1.0;19.9;19.9;4521313.32;Puffed Products;Keila Alfaro-Visvikis;RETAIL SEDANOS;1389858;Jul
2025-07-21;Sedanos Supermarkets #1;Invoice;008-06069;Rice Snack:Rice Snack Salami Flavored DOS HERMANOS;;1.0;19.9;19.9;4521333.22;Puffed Products;Keila Alfaro-Visvikis;RETAIL SEDANOS;1389859;Jul
2025-07-21;Sedanos Supermarkets #1;Invoice;008-06069;Arroz Envasado:Largo Fino 1kg (Long grain rice) Dos Hermanos;;5.0;17.5;87.5;4521420.72;Branded Rice;Keila Alfaro-Visvikis;RETAIL SEDANOS;1389860;Jul
2025-07-21;Sedanos Supermarkets #1;Invoice;008-06069;Arroz Envasado:Parboiled 5KG Dos Hermanos.;6  11lbs;10.0;40.5;405.0;4521825.72;Branded Rice;Keila Alfaro-Visvikis;RETAIL SEDANOS;1389861;Jul
2025-07-21;Sedanos Supermarkets #1;Invoice;008-06069;Arroz Envasado:Long Rice 10 LB Dos Hermanos;;10.0;35.5;355.0;4522180.72;Branded Rice;Keila Alfaro-Visvikis;RETAIL SEDANOS;1389862;Jul
2025-07-21;Sedanos Supermarkets #1;Invoice;008-06069;Arroz Envasado:Largo Fino 1kg (Long grain rice) Dos Hermanos;;2.0;17.5;35.0;4522215.72;Branded Rice;Keila Alfaro-Visvikis;RETAIL SEDANOS;1389863;Jul
2025-07-21;Sedanos Supermarkets #1;Invoice;008-06069;Arroz Envasado:Long Rice 10 LB Dos Hermanos;;10.0;35.5;355.0;4522570.72;Branded Rice;Keila Alfaro-Visvikis;RETAIL SEDANOS;1389864;Jul
2025-07-21;Sedanos Supermarkets #1;Invoice;008-06069;Arroz Envasado:Parboiled 5KG Dos Hermanos.;6  11lbs;10.0;40.5;405.0;4522975.72;Branded Rice;Keila Alfaro-Visvikis;RETAIL SEDANOS;1389865;Jul
2025-07-21;Sedanos Supermarkets #1;Invoice;008-06069;Rice Snack:Rice Snack Ham Flavored DOS HERMANOS;;2.0;19.9;39.8;4523015.52;Puffed Products;Keila Alfaro-Visvikis;RETAIL SEDANOS;1389866;Jul
2025-07-21;Sedanos Supermarkets #1;Invoice;008-06069;Rice Snack:Rice Snack Salami Flavored DOS HERMANOS;;1.0;19.9;19.9;4523035.42;Puffed Products;Keila Alfaro-Visvikis;RETAIL SEDANOS;1389867;Jul
2025-07-21;Bake Mark USA LLC;Invoice;008-06070;Arroz a Granel:Parboiled 50 LB -Bolsa Dos Hermanos.;;1100.0;22.9;25190.0;4548225.42;Bulk Rice;Armando Carpio - 017;WHOLESALER MANUFACTURY;1389868;Jul
2025-07-21;Sedanos Supermarkets #1;Credit Memo;008-06071;Varios:Promotional Allowance;Arroz Envasado:Largo Fino 1kg (Long grain rice) Dos Hermanos;-2.0;17.5;-35.0;4548190.42;Branded Rice;Keila Alfaro-Visvikis;RETAIL SEDANOS;1389869;Jul
2025-07-21;Sedanos Supermarkets #1;Credit Memo;008-06071;Varios:Promotional Allowance;Arroz Envasado:Long Rice 10 LB Dos Hermanos;-10.0;35.5;-355.0;4547835.42;Branded Rice;Keila Alfaro-Visvikis;RETAIL SEDANOS;1389870;Jul
2025-07-21;Sedanos Supermarkets #1;Credit Memo;008-06071;Varios:Promotional Allowance;Arroz Envasado:Parboiled 5KG Dos Hermanos.;-10.0;40.5;-405.0;4547430.42;Branded Rice;Keila Alfaro-Visvikis;RETAIL SEDANOS;1389871;Jul
2025-07-21;Sedanos Supermarkets #1;Credit Memo;008-06071;Varios:Promotional Allowance;Rice Snack:Rice Snack Ham Flavored DOS HERMANOS;-2.0;19.9;-39.8;4547390.62;Puffed Products;Keila Alfaro-Visvikis;RETAIL SEDANOS;1389872;Jul
2025-07-21;Sedanos Supermarkets #1;Credit Memo;008-06071;Varios:Promotional Allowance;Rice Snack:Rice Snack Salami Flavored DOS HERMANOS;-1.0;19.9;-19.9;4547370.72;Puffed Products;Keila Alfaro-Visvikis;RETAIL SEDANOS;1389873;Jul
2025-07-21;Sedanos Supermarkets #22;Credit Memo;008-06072;Varios:Promotional Allowance;Rice Snack:Rice Snack Ham Flavored DOS HERMANOS;-2.0;19.9;-39.8;4547330.92;Puffed Products;Keila Alfaro-Visvikis;RETAIL SEDANOS;1389874;Jul
2025-07-21;Sedanos Supermarkets #22;Credit Memo;008-06072;Varios:Promotional Allowance;Rice Snack:Rice Snack Salami Flavored DOS HERMANOS;-1.0;19.9;-19.9;4547311.02;Puffed Products;Keila Alfaro-Visvikis;RETAIL SEDANOS;1389875;Jul
2025-07-21;Sedanos Supermarkets #22;Credit Memo;008-06072;Varios:Promotional Allowance;Arroz Envasado:Parboiled 5KG Dos Hermanos.;-21.0;40.5;-850.5;4546460.52;Branded Rice;Keila Alfaro-Visvikis;RETAIL SEDANOS;1389876;Jul
2025-07-21;Sedanos Supermarkets #22;Credit Memo;008-06072;Varios:Promotional Allowance;Arroz Envasado:Long Rice 10 LB Dos Hermanos;-21.0;35.5;-745.5;4545715.02;Branded Rice;Keila Alfaro-Visvikis;RETAIL SEDANOS;1389877;Jul
2025-07-21;Sedanos Supermarkets #22;Credit Memo;008-06072;Varios:Promotional Allowance;Arroz Envasado:Largo Fino 1kg (Long grain rice) Dos Hermanos;-5.0;17.5;-87.5;4545627.52;Branded Rice;Keila Alfaro-Visvikis;RETAIL SEDANOS;1389878;Jul
2025-07-21;Sedanos Supermarkets #26;Credit Memo;008-06073;Varios:Promotional Allowance;Rice Snack:Rice Snack Ham Flavored DOS HERMANOS;-2.0;19.9;-39.8;4545587.72;Puffed Products;Keila Alfaro-Visvikis;RETAIL SEDANOS;1389879;Jul
2025-07-21;Sedanos Supermarkets #26;Credit Memo;008-06073;Varios:Promotional Allowance;Rice Snack:Rice Snack Salami Flavored DOS HERMANOS;-1.0;19.9;-19.9;4545567.82;Puffed Products;Keila Alfaro-Visvikis;RETAIL SEDANOS;1389880;Jul
2025-07-21;Sedanos Supermarkets #26;Credit Memo;008-06073;Varios:Promotional Allowance;Arroz Envasado:Largo Fino 1kg (Long grain rice) Dos Hermanos;-5.0;17.5;-87.5;4545480.32;Branded Rice;Keila Alfaro-Visvikis;RETAIL SEDANOS;1389881;Jul
2025-07-21;Sedanos Supermarkets #26;Credit Memo;008-06073;Varios:Promotional Allowance;Arroz Envasado:Parboiled 5KG Dos Hermanos.;-21.0;40.5;-850.5;4544629.82;Branded Rice;Keila Alfaro-Visvikis;RETAIL SEDANOS;1389882;Jul
2025-07-21;Sedanos Supermarkets #26;Credit Memo;008-06073;Varios:Promotional Allowance;Arroz Envasado:Long Rice 10 LB Dos Hermanos;-21.0;35.5;-745.5;4543884.32;Branded Rice;Keila Alfaro-Visvikis;RETAIL SEDANOS;1389883;Jul
2025-07-21;Sedanos Supermarkets #43;Credit Memo;008-06074;Varios:Promotional Allowance;Rice Snack:Rice Snack Ham Flavored DOS HERMANOS;-2.0;19.9;-39.8;4543844.52;Puffed Products;Keila Alfaro-Visvikis;RETAIL SEDANOS;1389884;Jul
2025-07-21;Sedanos Supermarkets #43;Credit Memo;008-06074;Varios:Promotional Allowance;Rice Snack:Rice Snack Salami Flavored DOS HERMANOS;-1.0;19.9;-19.9;4543824.62;Puffed Products;Keila Alfaro-Visvikis;RETAIL SEDANOS;1389885;Jul
2025-07-21;Sedanos Supermarkets #43;Credit Memo;008-06074;Varios:Promotional Allowance;Arroz Envasado:Largo Fino 1kg (Long grain rice) Dos Hermanos;-5.0;17.5;-87.5;4543737.12;Branded Rice;Keila Alfaro-Visvikis;RETAIL SEDANOS;1389886;Jul
2025-07-21;Sedanos Supermarkets #43;Credit Memo;008-06074;Varios:Promotional Allowance;Arroz Envasado:Parboiled 5KG Dos Hermanos.;-21.0;40.5;-850.5;4542886.62;Branded Rice;Keila Alfaro-Visvikis;RETAIL SEDANOS;1389887;Jul
2025-07-21;Sedanos Supermarkets #43;Credit Memo;008-06074;Varios:Promotional Allowance;Arroz Envasado:Long Rice 10 LB Dos Hermanos;-21.0;35.5;-745.5;4542141.12;Branded Rice;Keila Alfaro-Visvikis;RETAIL SEDANOS;1389888;Jul
2025-07-23;Chavez Distributors Inc.;Invoice;008-06075;Arroz Envasado:Parboiled 5KG Dos Hermanos.;6  11lbs;15.0;46.5;697.5;4542838.62;Branded Rice;Keila Alfaro-Visvikis;WHOLESALER;1389889;Jul
2025-07-23;Chavez Distributors Inc.;Invoice;008-06075;Arroz Envasado:Long Rice 10 LB Dos Hermanos;;15.0;35.5;532.5;4543371.12;Branded Rice;Keila Alfaro-Visvikis;WHOLESALER;1389890;Jul
2025-07-23;Chavez Distributors Inc.;Invoice;008-06075;Arroz Envasado:Parboiled 5KG Dos Hermanos.;6  11lbs;7.0;46.5;325.5;4543696.62;Branded Rice;Keila Alfaro-Visvikis;WHOLESALER;1389891;Jul
2025-07-23;Chavez Distributors Inc.;Invoice;008-06075;Arroz Envasado:Long Rice 10 LB Dos Hermanos;;3.0;35.5;106.5;4543803.12;Branded Rice;Keila Alfaro-Visvikis;WHOLESALER;1389892;Jul
2025-07-23;Key Food / Holywood;Invoice;008-06076;Arroz Envasado:Long Rice 10 LB Dos Hermanos;;5.0;35.5;177.5;4543980.62;Branded Rice;Keila Alfaro-Visvikis;RETAIL  DSD;1389893;Jul
2025-07-23;Key Food / Holywood;Invoice;008-06076;Arroz Envasado:Long Rice 10 LB Dos Hermanos;;1.0;35.5;35.5;4544016.12;Branded Rice;Keila Alfaro-Visvikis;RETAIL  DSD;1389894;Jul
2025-07-23;Key Foods  / Ivan;Invoice;008-06077;Arroz Envasado:Parboiled 5KG Dos Hermanos.;6  11lbs;15.0;46.5;697.5;4544713.62;Branded Rice;Keila Alfaro-Visvikis;RETAIL  DSD;1389895;Jul
2025-07-23;Key Foods  / Ivan;Invoice;008-06077;Arroz Envasado:Parboiled 5KG Dos Hermanos.;6  11lbs;7.0;46.5;325.5;4545039.12;Branded Rice;Keila Alfaro-Visvikis;RETAIL  DSD;1389896;Jul
2025-07-23;Key Foods - 10301 Royal Palm Food Corp.;Invoice;008-06078;Arroz Envasado:Parboiled 1kg Bolsa Dos Hermanos.;.;30.0;19.9;597.0;4545636.12;Branded Rice;Keila Alfaro-Visvikis;RETAIL KEY FOOD;1389897;Jul
2025-07-23;Key Foods - 10301 Royal Palm Food Corp.;Invoice;008-06078;Arroz Envasado:Parboiled 1kg Bolsa Dos Hermanos.;.;6.0;19.9;119.4;4545755.52;Branded Rice;Keila Alfaro-Visvikis;RETAIL KEY FOOD;1389898;Jul
2025-07-23;Ideal Food Basket Davie Cafeteria;Invoice;008-06079;Arroz a Granel:Largo Fino 50 LB -Bolsa Dos Hermanos.;;8.0;27.85;222.8;4545978.32;Bulk Rice;Keila Alfaro-Visvikis;CAFETERIA y RESTAURANTS;1389899;Jul
2025-07-23;Food Fair Plantation Corp;Invoice;008-06080;Arroz Envasado:Parboiled 5KG Dos Hermanos.;6  11lbs;15.0;46.5;697.5;4546675.82;Branded Rice;Keila Alfaro-Visvikis;RETAIL  DSD;1389900;Jul
2025-07-23;Food Fair Plantation Corp;Invoice;008-06080;Arroz Envasado:Long Rice 10 LB Dos Hermanos;;15.0;35.5;532.5;4547208.32;Branded Rice;Keila Alfaro-Visvikis;RETAIL  DSD;1389901;Jul
2025-07-23;Food Fair Plantation Corp;Invoice;008-06080;Arroz Envasado:Parboiled 5KG Dos Hermanos.;6  11lbs;7.0;46.5;325.5;4547533.82;Branded Rice;Keila Alfaro-Visvikis;RETAIL  DSD;1389902;Jul
2025-07-23;Food Fair Plantation Corp;Invoice;008-06080;Arroz Envasado:Long Rice 10 LB Dos Hermanos;;3.0;35.5;106.5;4547640.32;Branded Rice;Keila Alfaro-Visvikis;RETAIL  DSD;1389903;Jul
2025-07-23;Brito Family Corp.;Invoice;008-06081;Arroz a Granel:Parboiled 50 LB -Bolsa Dos Hermanos.;;55.0;24.5;1347.5;4548987.82;Bulk Rice;Lisset Limpio -020;CAFETERIA y RESTAURANTS;1389904;Jul
2025-07-23;Brito Family Corp.;Invoice;008-06081;Arroz a Granel:Largo Fino 50 LB -Bolsa Dos Hermanos.;;55.0;25.0;1375.0;4550362.82;Bulk Rice;Lisset Limpio -020;CAFETERIA y RESTAURANTS;1389905;Jul
2025-07-23;Chavez Distributors Inc.;Credit Memo;008-06082;Varios:Promotional Allowance;Arroz Envasado:Parboiled 5KG Dos Hermanos.;-7.0;46.5;-325.5;4550037.32;Branded Rice;Keila Alfaro-Visvikis;WHOLESALER;1389906;Jul
2025-07-23;Chavez Distributors Inc.;Credit Memo;008-06082;Varios:Promotional Allowance;Arroz Envasado:Long Rice 10 LB Dos Hermanos;-3.0;35.5;-106.5;4549930.82;Branded Rice;Keila Alfaro-Visvikis;WHOLESALER;1389907;Jul
2025-07-23;Food Fair Plantation Corp;Credit Memo;008-06083;Varios:Promotional Allowance;Arroz Envasado:Parboiled 5KG Dos Hermanos.;-7.0;46.5;-325.5;4549605.32;Branded Rice;Keila Alfaro-Visvikis;RETAIL  DSD;1389908;Jul
2025-07-23;Food Fair Plantation Corp;Credit Memo;008-06083;Varios:Promotional Allowance;Arroz Envasado:Long Rice 10 LB Dos Hermanos;-3.0;35.5;-106.5;4549498.82;Branded Rice;Keila Alfaro-Visvikis;RETAIL  DSD;1389909;Jul
2025-07-23;Key Food / Holywood;Credit Memo;008-06084;Varios:Promotional Allowance;Arroz Envasado:Long Rice 10 LB Dos Hermanos;-1.0;35.5;-35.5;4549463.32;Branded Rice;Keila Alfaro-Visvikis;RETAIL  DSD;1389910;Jul
2025-07-23;Key Foods - 10301 Royal Palm Food Corp.;Credit Memo;008-06085;Varios:Promotional Allowance;Arroz Envasado:Parboiled 1kg Bolsa Dos Hermanos.;-6.0;19.9;-119.4;4549343.92;Branded Rice;Keila Alfaro-Visvikis;RETAIL KEY FOOD;1389911;Jul
2025-07-23;Key Foods  / Ivan;Credit Memo;008-06086;Varios:Promotional Allowance;Arroz Envasado:Parboiled 5KG Dos Hermanos.;-7.0;46.5;-325.5;4549018.42;Branded Rice;Keila Alfaro-Visvikis;RETAIL  DSD;1389912;Jul
2025-07-23;Sedanos Supermarkets #16;Invoice;008-06087;Arroz a Granel:Parboiled 50 LB -Bolsa Dos Hermanos.;;3.0;28.25;84.75;4549103.17;Bulk Rice;Keila Alfaro-Visvikis;RETAIL SEDANOS;1389913;Jul
2025-07-24;El Palacio de Los Jugos / Casa mía Food Restaurant inc;Invoice;008-06088;Arroz a Granel:Parboiled 50 LB -Bolsa Dos Hermanos.;;8.0;26.75;214.0;4549317.17;Bulk Rice;Lisset Limpio -020;Cafeteria;1389914;Jul
2025-07-24;Soriano Brothers PB;Invoice;008-06089;Liquids:AS Bitter Orange;4 / 1 gl.;1.0;14.0;14.0;4549331.17;American Spice;Lisset Limpio -020;CAFETERIA y RESTAURANTS;1389915;Jul
2025-07-24;Soriano Brothers PB;Invoice;008-06089;Liquids:AS Cooking Wine;4 1 Gl.;4.0;16.0;64.0;4549395.17;American Spice;Lisset Limpio -020;CAFETERIA y RESTAURANTS;1389916;Jul
2025-07-24;Soriano Brothers PB;Invoice;008-06089;Dry Beans:Dry Beans - Black Beans 50;Dry Black Beans 50 lb;6.0;32.0;192.0;4549587.17;Dry Beans;Lisset Limpio -020;CAFETERIA y RESTAURANTS;1389917;Jul
2025-07-24;Soriano Brothers PB;Invoice;008-06089;Spices:AS Sazon (for all);1 / 30 lb (box or pail);2.0;51.0;102.0;4549689.17;American Spice;Lisset Limpio -020;CAFETERIA y RESTAURANTS;1389918;Jul
2025-07-24;Soriano Brothers PB;Invoice;008-06089;Arroz a Granel:Parboiled 50 LB -Bolsa Dos Hermanos.;;11.0;27.75;305.25;4549994.42;Bulk Rice;Lisset Limpio -020;CAFETERIA y RESTAURANTS;1389919;Jul
2025-07-24;Soriano Brothers PB;Invoice;008-06089;Arroz a Granel:Largo Fino 50 LB -Bolsa Dos Hermanos.;;7.0;27.85;194.95;4550189.37;Bulk Rice;Lisset Limpio -020;CAFETERIA y RESTAURANTS;1389920;Jul
2025-07-24;Soriano Brothers PB;Invoice;008-06089;Arroz a Granel:Parboiled 50 LB -Bolsa Dos Hermanos.;;1.0;27.75;27.75;4550217.12;Bulk Rice;Lisset Limpio -020;CAFETERIA y RESTAURANTS;1389921;Jul
2025-07-24;El Palacio de los jugos /  Nanos Latin Foods;Invoice;008-06090;Arroz a Granel:Largo Fino 50 LB -Bolsa Dos Hermanos.;;3.0;27.85;83.55;4550300.67;Bulk Rice;Lisset Limpio -020;Cafeteria;1389922;Jul
2025-07-24;El Palacio de los jugos /  Nanos Latin Foods;Invoice;008-06090;Arroz a Granel:Parboiled 50 LB -Bolsa Dos Hermanos.;;8.0;26.75;214.0;4550514.67;Bulk Rice;Lisset Limpio -020;Cafeteria;1389923;Jul
2025-07-24;Sedanos Supermarkets #33;Invoice;008-06091;Arroz a Granel:Parboiled 50 LB -Bolsa Dos Hermanos.;;3.0;28.25;84.75;4550599.42;Bulk Rice;Keila Alfaro-Visvikis;RETAIL SEDANOS;1389924;Jul
2025-07-24;Sedanos Supermarkets #42;Invoice;008-06092;Arroz Envasado:Parboiled 1kg Bolsa Dos Hermanos.;.;3.0;19.9;59.7;4550659.12;Branded Rice;Keila Alfaro-Visvikis;RETAIL SEDANOS;1389925;Jul
2025-07-24;Sedanos Supermarkets #42;Invoice;008-06092;Arroz Envasado:Long Rice 10 LB Dos Hermanos;;5.0;35.5;177.5;4550836.62;Branded Rice;Keila Alfaro-Visvikis;RETAIL SEDANOS;1389926;Jul
2025-07-24;Sedanos Supermarkets #42;Invoice;008-06092;Arroz Envasado:Largo Fino 1kg (Long grain rice) Dos Hermanos;;2.0;17.5;35.0;4550871.62;Branded Rice;Keila Alfaro-Visvikis;RETAIL SEDANOS;1389927;Jul
2025-07-24;Sedanos Supermarkets #42;Invoice;008-06092;Arroz Envasado:Largo Fino 1kg (Long grain rice) Dos Hermanos;;1.0;17.5;17.5;4550889.12;Branded Rice;Keila Alfaro-Visvikis;RETAIL SEDANOS;1389928;Jul
2025-07-24;Sedanos Supermarkets #42;Invoice;008-06092;Arroz Envasado:Long Rice 10 LB Dos Hermanos;;2.0;35.5;71.0;4550960.12;Branded Rice;Keila Alfaro-Visvikis;RETAIL SEDANOS;1389929;Jul
2025-07-24;El Palacio de los jugos / Caribe Tropical;Invoice;008-06093;Arroz a Granel:Parboiled 50 LB -Bolsa Dos Hermanos.;;8.0;26.75;214.0;4551174.12;Bulk Rice;Lisset Limpio -020;Cafeteria;1389930;Jul
2025-07-24;Sedanos Supermarkets  #37;Invoice;008-06094;Arroz a Granel:Largo Fino 50 LB -Bolsa Dos Hermanos.;;6.0;27.85;167.1;4551341.22;Bulk Rice;Keila Alfaro-Visvikis;RETAIL SEDANOS;1389931;Jul
2025-07-24;Sedanos Supermarkets  #37;Invoice;008-06094;Arroz a Granel:Parboiled 50 LB -Bolsa Dos Hermanos.;;6.0;28.25;169.5;4551510.72;Bulk Rice;Keila Alfaro-Visvikis;RETAIL SEDANOS;1389932;Jul
2025-07-24;El Palacio de los jugos / Lita Foods Inc.;Invoice;008-06095;Dry Beans:Dry Beans - Black Beans 50;Dry Black Beans 50 lb;1.0;34.0;34.0;4551544.72;Dry Beans;Lisset Limpio -020;Cafeteria;1389933;Jul
2025-07-24;El Palacio de los jugos / Lita Foods Inc.;Invoice;008-06095;Arroz a Granel:Parboiled 50 LB -Bolsa Dos Hermanos.;;12.0;26.75;321.0;4551865.72;Bulk Rice;Lisset Limpio -020;Cafeteria;1389934;Jul
2025-07-24;El Palacio de los jugos / Divan and Denise Food;Invoice;008-06096;Dry Beans:Dry Beans - Black Beans 50;Dry Black Beans 50 lb;2.0;34.0;68.0;4551933.72;Dry Beans;Lisset Limpio -020;Cafeteria;1389935;Jul
2025-07-24;El Palacio de los jugos / Divan and Denise Food;Invoice;008-06096;Arroz a Granel:Parboiled 50 LB -Bolsa Dos Hermanos.;;5.0;26.75;133.75;4552067.47;Bulk Rice;Lisset Limpio -020;Cafeteria;1389936;Jul
2025-07-24;El Palacio de los jugos / Rodriguez Foods;Invoice;008-06097;Arroz a Granel:Parboiled 50 LB -Bolsa Dos Hermanos.;;8.0;26.75;214.0;4552281.47;Bulk Rice;Lisset Limpio -020;Cafeteria;1389937;Jul
2025-07-24;El Palacio de los jugos / J Mena Corp.;Invoice;008-06098;Liquids:AS Marinating Sauce (Mojo);4 / 1 Gl;3.0;17.0;51.0;4552332.47;American Spice;Lisset Limpio -020;Cafeteria;1389938;Jul
2025-07-24;El Palacio de los jugos / J Mena Corp.;Invoice;008-06098;Arroz a Granel:Parboiled 50 LB -Bolsa Dos Hermanos.;;10.0;26.75;267.5;4552599.97;Bulk Rice;Lisset Limpio -020;Cafeteria;1389939;Jul
2025-07-24;Sedanos Supermarkets #32;Invoice;008-06099;Arroz a Granel:Largo Fino 50 LB -Bolsa Dos Hermanos.;;4.0;27.85;111.4;4552711.37;Bulk Rice;Keila Alfaro-Visvikis;RETAIL SEDANOS;1389940;Jul
2025-07-24;Sedanos Supermarkets #32;Invoice;008-06099;Arroz a Granel:Parboiled 50 LB -Bolsa Dos Hermanos.;;4.0;28.25;113.0;4552824.37;Bulk Rice;Keila Alfaro-Visvikis;RETAIL SEDANOS;1389941;Jul
2025-07-24;Meat Club Market, LLC.;Invoice;008-06100;Arroz Envasado:Sushi Rice Dos Hermanos.;.;6.0;25.5;153.0;4552977.37;Branded Rice;Lisset Limpio -020;RETAIL  DSD;1389942;Jul
2025-07-24;Key Foods 40 St;Invoice;008-06101;Arroz Envasado:Parboiled 5KG Dos Hermanos.;6  11lbs;15.0;46.5;697.5;4553674.87;Branded Rice;Keila Alfaro-Visvikis;RETAIL  DSD;1389943;Jul
2025-07-24;Key Foods 40 St;Invoice;008-06101;Arroz Envasado:Long Rice 10 LB Dos Hermanos;;15.0;35.5;532.5;4554207.37;Branded Rice;Keila Alfaro-Visvikis;RETAIL  DSD;1389944;Jul
2025-07-24;Key Foods 40 St;Invoice;008-06101;Arroz Envasado:Parboiled 5KG Dos Hermanos.;6  11lbs;7.0;46.5;325.5;4554532.87;Branded Rice;Keila Alfaro-Visvikis;RETAIL  DSD;1389945;Jul
2025-07-24;Key Foods 40 St;Invoice;008-06101;Arroz Envasado:Long Rice 10 LB Dos Hermanos;;3.0;35.5;106.5;4554639.37;Branded Rice;Keila Alfaro-Visvikis;RETAIL  DSD;1389946;Jul
2025-07-24;Soriano Brothers PB;Credit Memo;008-06102;Varios:Promotional Allowance;Arroz a Granel:Parboiled 50 LB -Bolsa Dos Hermanos.;-1.0;27.75;-27.75;4554611.62;Branded Rice;Lisset Limpio -020;CAFETERIA y RESTAURANTS;1389947;Jul
2025-07-24;Key Foods 40 St;Credit Memo;008-06103;Varios:Promotional Allowance;Arroz Envasado:Parboiled 5KG Dos Hermanos.;-7.0;46.5;-325.5;4554286.12;Branded Rice;Keila Alfaro-Visvikis;RETAIL  DSD;1389948;Jul
2025-07-24;Key Foods 40 St;Credit Memo;008-06103;Varios:Promotional Allowance;Arroz Envasado:Long Rice 10 LB Dos Hermanos;-3.0;35.5;-106.5;4554179.62;Branded Rice;Keila Alfaro-Visvikis;RETAIL  DSD;1389949;Jul
2025-07-24;Sedanos Supermarkets #42;Credit Memo;008-06104;Varios:Promotional Allowance;Arroz Envasado:Largo Fino 1kg (Long grain rice) Dos Hermanos;-1.0;19.9;-19.9;4554159.72;Branded Rice;Keila Alfaro-Visvikis;RETAIL SEDANOS;1389950;Jul
2025-07-24;Sedanos Supermarkets #42;Credit Memo;008-06104;Varios:Promotional Allowance;Arroz Envasado:Long Rice 10 LB Dos Hermanos;-2.0;35.5;-71.0;4554088.72;Branded Rice;Keila Alfaro-Visvikis;RETAIL SEDANOS;1389951;Jul
2025-07-24;Sedanos Supermarkets #42;Credit Memo;008-06168;Varios:Promotional Allowance;Arroz Envasado:Largo Fino 1kg (Long grain rice) Dos Hermanos;-1.0;17.5;-17.5;4554071.22;Branded Rice;Keila Alfaro-Visvikis;RETAIL SEDANOS;1389952;Jul
2025-07-24;Sedanos Supermarkets #42;Credit Memo;008-06168;Varios:Promotional Allowance;Arroz Envasado:Long Rice 10 LB Dos Hermanos;-2.0;35.5;-71.0;4554000.22;Branded Rice;Keila Alfaro-Visvikis;RETAIL SEDANOS;1389953;Jul
2025-07-24;Soriano Brothers PB;Credit Memo;008-06169;Varios:Promotional Allowance;Arroz a Granel:Parboiled 50 LB -Bolsa Dos Hermanos.;0.0;;0.0;4554000.22;Branded Rice;Lisset Limpio -020;CAFETERIA y RESTAURANTS;1389954;Jul
2025-07-25;Sedanos Supermarkets #24;Credit Memo;008-06105;Varios:Promotional Allowance;Rice Snack:Rice Snack Ham Flavored DOS HERMANOS;-1.0;19.9;-19.9;4553980.32;Puffed Products;Keila Alfaro-Visvikis;RETAIL SEDANOS;1389955;Jul
2025-07-27;El Palacio de los Jugos / Bird Road Restaurant;Invoice;008-06106;Arroz a Granel:Parboiled 50 LB -Bolsa Dos Hermanos.;;10.0;26.75;267.5;4554247.82;Bulk Rice;Lisset Limpio -020;Cafeteria;1389956;Jul
2025-07-27;El Palacio de los jugos / Rodriguez Foods;Invoice;008-06107;Arroz a Granel:Parboiled 50 LB -Bolsa Dos Hermanos.;;6.0;26.75;160.5;4554408.32;Bulk Rice;Lisset Limpio -020;Cafeteria;1389957;Jul
2025-07-27;Bravo   Francisco Diaz;Invoice;008-06108;Liquids:AS Cooking Wine;4 1 Gl.;1.0;17.5;17.5;4554425.82;American Spice;Lisset Limpio -020;RETAIL  DSD;1389958;Jul
2025-07-27;Bravo   Francisco Diaz;Invoice;008-06108;Liquids:AS Marinating Sauce (Mojo);4 / 1 Gl;2.0;18.5;37.0;4554462.82;American Spice;Lisset Limpio -020;RETAIL  DSD;1389959;Jul
2025-07-27;Bravo   Francisco Diaz;Invoice;008-06108;Arroz a Granel:Largo Fino 50 LB -Bolsa Dos Hermanos.;;5.0;27.85;139.25;4554602.07;Bulk Rice;Lisset Limpio -020;RETAIL  DSD;1389960;Jul
2025-07-27;El Palacio de los jugos /  Nanos Latin Foods;Invoice;008-06109;Arroz a Granel:Largo Fino 50 LB -Bolsa Dos Hermanos.;;4.0;27.85;111.4;4554713.47;Bulk Rice;Lisset Limpio -020;Cafeteria;1389961;Jul
2025-07-27;El Palacio de los jugos /  Nanos Latin Foods;Invoice;008-06109;Arroz a Granel:Parboiled 50 LB -Bolsa Dos Hermanos.;;6.0;26.75;160.5;4554873.97;Bulk Rice;Lisset Limpio -020;Cafeteria;1389962;Jul
2025-07-27;El Palacio de los jugos /  Nanos Latin Foods;Invoice;008-06109;Dry Beans:Dry Beans - Black Beans 50;Dry Black Beans 50 lb;1.0;34.0;34.0;4554907.97;Dry Beans;Lisset Limpio -020;Cafeteria;1389963;Jul
2025-07-27;El Palacio de los jugos / Delicias Criollas (DIAGO FOOD_MILLER);Invoice;008-06110;Arroz a Granel:Parboiled 50 LB -Bolsa Dos Hermanos.;;12.0;26.75;321.0;4555228.97;Bulk Rice;Lisset Limpio -020;Cafeteria;1389964;Jul
2025-07-27;Fritanga Momotombo;Invoice;008-06111;Spices:AS Chicken Base;1 / 30 lb. (box or pail);2.0;39.0;78.0;4555306.97;American Spice;Lisset Limpio -020;CAFETERIA y RESTAURANTS;1389965;Jul
2025-07-27;Fritanga Momotombo;Invoice;008-06111;Arroz a Granel:Largo Fino 50 LB -Bolsa Dos Hermanos.;;5.0;27.85;139.25;4555446.22;Bulk Rice;Lisset Limpio -020;CAFETERIA y RESTAURANTS;1389966;Jul
2025-07-27;Be Your Will LLC;Invoice;008-06112;Liquids:AS Cooking Wine;4 1 Gl.;2.0;17.5;35.0;4555481.22;American Spice;Lisset Limpio -020;CAFETERIA y RESTAURANTS;1389967;Jul
2025-07-27;Be Your Will LLC;Invoice;008-06112;Arroz a Granel:Largo Fino 50 LB -Bolsa Dos Hermanos.;;7.0;27.85;194.95;4555676.17;Bulk Rice;Lisset Limpio -020;CAFETERIA y RESTAURANTS;1389968;Jul
2025-07-27;Be Your Will LLC;Invoice;008-06112;Arroz a Granel:Parboiled 50 LB -Bolsa Dos Hermanos.;;11.0;27.75;305.25;4555981.42;Bulk Rice;Lisset Limpio -020;CAFETERIA y RESTAURANTS;1389969;Jul
2025-07-27;Be Your Will LLC;Invoice;008-06112;Arroz a Granel:Parboiled 50 LB -Bolsa Dos Hermanos.;;1.0;27.75;27.75;4556009.17;Bulk Rice;Lisset Limpio -020;CAFETERIA y RESTAURANTS;1389970;Jul
2025-07-27;El Palacio de los jugos / Caribe Tropical;Invoice;008-06113;Arroz a Granel:Parboiled 50 LB -Bolsa Dos Hermanos.;;8.0;26.75;214.0;4556223.17;Bulk Rice;Lisset Limpio -020;Cafeteria;1389971;Jul
2025-07-27;El Palacio de los jugos / Caribe Tropical;Invoice;008-06113;Dry Beans:Dry Beans - Black Beans 50;Dry Black Beans 50 lb;2.0;34.0;68.0;4556291.17;Dry Beans;Lisset Limpio -020;Cafeteria;1389972;Jul
2025-07-27;El Palacio de los jugos / Divan and Denise Food;Invoice;008-06114;Dry Beans:Dry Beans - Black Beans 50;Dry Black Beans 50 lb;2.0;34.0;68.0;4556359.17;Dry Beans;Lisset Limpio -020;Cafeteria;1389973;Jul
2025-07-27;El Palacio de los jugos / Divan and Denise Food;Invoice;008-06114;Arroz a Granel:Parboiled 50 LB -Bolsa Dos Hermanos.;;5.0;26.75;133.75;4556492.92;Bulk Rice;Lisset Limpio -020;Cafeteria;1389974;Jul
2025-07-27;JMN Dely Corp;Invoice;008-06115;Dry Beans:Dry Beans - Black Beans 50;Dry Black Beans 50 lb;1.0;45.7;45.7;4556538.62;Dry Beans;Keila Alfaro-Visvikis;CAFETERIA y RESTAURANTS;1389975;Jul
2025-07-27;JMN Dely Corp;Invoice;008-06115;Arroz a Granel:Parboiled 50 LB -Bolsa Dos Hermanos.;;2.0;28.75;57.5;4556596.12;Bulk Rice;Keila Alfaro-Visvikis;CAFETERIA y RESTAURANTS;1389976;Jul
2025-07-27;Aries Supermarket & Cafeteria;Invoice;008-06116;Liquids:AS Bitter Orange;4 / 1 gl.;2.0;14.0;28.0;4556624.12;American Spice;Keila Alfaro-Visvikis;CAFETERIA y RESTAURANTS;1389977;Jul
2025-07-27;Aries Supermarket & Cafeteria;Invoice;008-06116;Liquids:AS Cooking Wine;4 1 Gl.;2.0;17.5;35.0;4556659.12;American Spice;Keila Alfaro-Visvikis;CAFETERIA y RESTAURANTS;1389978;Jul
2025-07-27;Aries Supermarket & Cafeteria;Invoice;008-06116;Spices:AS Oregano Ground;4 / 3.5 Lbs.;1.0;38.5;38.5;4556697.62;American Spice;Keila Alfaro-Visvikis;CAFETERIA y RESTAURANTS;1389979;Jul
2025-07-27;Aries Supermarket & Cafeteria;Invoice;008-06116;Arroz a Granel:Parboiled 50 LB -Bolsa Dos Hermanos.;;10.0;28.25;282.5;4556980.12;Bulk Rice;Keila Alfaro-Visvikis;CAFETERIA y RESTAURANTS;1389980;Jul
2025-07-27;Sedanos Supermarkets #42;Invoice;008-06117;Arroz a Granel:Parboiled 50 LB -Bolsa Dos Hermanos.;;5.0;28.25;141.25;4557121.37;Bulk Rice;Keila Alfaro-Visvikis;RETAIL SEDANOS;1389981;Jul
2025-07-27;Be Your Will LLC;Credit Memo;008-06118;Varios:Promotional Allowance;Arroz a Granel:Parboiled 50 LB -Bolsa Dos Hermanos.;-1.0;27.75;-27.75;4557093.62;Bulk Rice;Lisset Limpio -020;CAFETERIA y RESTAURANTS;1389982;Jul
2025-07-28;Sedanos Supermarkets #9;Credit Memo;008-06119;Varios:Promotional Allowance;Arroz Envasado:Largo Fino 1kg (Long grain rice) Dos Hermanos;-1.0;17.8;-17.8;4557075.82;Branded Rice;Keila Alfaro-Visvikis;RETAIL SEDANOS;1389983;Jul
2025-07-28;Sedanos Supermarkets #9;Credit Memo;008-06119;Varios:Promotional Allowance;Arroz Envasado:Parboiled 1kg Bolsa Dos Hermanos.;-1.0;19.9;-19.9;4557055.92;Branded Rice;Keila Alfaro-Visvikis;RETAIL SEDANOS;1389984;Jul
2025-07-28;Los Mejores Tamales de Miami;Invoice;008-06120;Arroz a Granel:Parboiled 50 LB -Bolsa Dos Hermanos.;;5.0;28.25;141.25;4557197.17;Bulk Rice;Lisset Limpio -020;CAFETERIA y RESTAURANTS;1389985;Jul
2025-07-28;Chavez Distributors Inc.;Invoice;008-06121;Arroz a Granel:Parboiled 50 LB -Bolsa Dos Hermanos.;;55.0;27.75;1526.25;4558723.42;Bulk Rice;Keila Alfaro-Visvikis;WHOLESALER;1389986;Jul
2025-07-28;Soriano Brothers PB;Invoice;008-06122;Arroz a Granel:Largo Fino 50 LB -Bolsa Dos Hermanos.;;5.0;27.85;139.25;4558862.67;Bulk Rice;Lisset Limpio -020;CAFETERIA y RESTAURANTS;1389987;Jul
2025-07-29;Sedanos Supermarkets #24;Credit Memo;008-06123;Varios:Producto vencido/deteriorado (no impacta en inventario);6 unidades de Ham rice snacks a $1.90;-10.0;1.9;-19.0;4558843.67;Puffed Products;Keila Alfaro-Visvikis;RETAIL SEDANOS;1389988;Jul
2025-07-31;El Palacio de los jugos / Leti Corp.;Invoice;008-06124;Arroz a Granel:Largo Fino 50 LB -Bolsa Dos Hermanos.;;6.0;27.85;167.1;4559010.77;Bulk Rice;Lisset Limpio -020;Cafeteria;1389989;Jul
2025-07-31;Festival Supermarket #35- Southgate;Invoice;008-06125;Arroz Envasado:Parboiled 5KG Dos Hermanos.;6  11lbs;15.0;46.5;697.5;4559708.27;Branded Rice;Keila Alfaro-Visvikis;RETAIL  DSD;1389990;Jul
2025-07-31;Festival Supermarket #35- Southgate;Invoice;008-06125;Arroz Envasado:Parboiled 5KG Dos Hermanos.;6  11lbs;8.0;46.5;372.0;4560080.27;Branded Rice;Keila Alfaro-Visvikis;RETAIL  DSD;1389991;Jul
2025-07-31;El Palacio de los jugos /  Nanos Latin Foods;Invoice;008-06126;Arroz a Granel:Largo Fino 50 LB -Bolsa Dos Hermanos.;;5.0;27.85;139.25;4560219.52;Bulk Rice;Lisset Limpio -020;Cafeteria;1389992;Jul
2025-07-31;El Palacio de los jugos /  Nanos Latin Foods;Invoice;008-06126;Arroz a Granel:Parboiled 50 LB -Bolsa Dos Hermanos.;;10.0;26.75;267.5;4560487.02;Bulk Rice;Lisset Limpio -020;Cafeteria;1389993;Jul
2025-07-31;Sedanos Supermarkets #43;Invoice;008-06127;Arroz a Granel:Parboiled 50 LB -Bolsa Dos Hermanos.;;5.0;28.25;141.25;4560628.27;Bulk Rice;Keila Alfaro-Visvikis;RETAIL SEDANOS;1389994;Jul
2025-07-31;Sedanos Supermarkets #24;Invoice;008-06128;Arroz a Granel:Parboiled 50 LB -Bolsa Dos Hermanos.;;10.0;28.25;282.5;4560910.77;Bulk Rice;Keila Alfaro-Visvikis;RETAIL SEDANOS;1389995;Jul
2025-07-31;Sedanos Supermarkets #24;Invoice;008-06128;Arroz a Granel:Parboiled 50 LB -Bolsa Dos Hermanos.;;1.0;28.25;28.25;4560939.02;Bulk Rice;Keila Alfaro-Visvikis;RETAIL SEDANOS;1389996;Jul
2025-07-31;Key Food / Holywood;Invoice;008-06129;Arroz Envasado:Long Rice 10 LB Dos Hermanos;;5.0;35.5;177.5;4561116.52;Branded Rice;Keila Alfaro-Visvikis;RETAIL  DSD;1389997;Jul
2025-07-31;Key Food / Holywood;Invoice;008-06129;Arroz Envasado:Long Rice 10 LB Dos Hermanos;;1.0;35.5;35.5;4561152.02;Branded Rice;Keila Alfaro-Visvikis;RETAIL  DSD;1389998;Jul
2025-07-31;Los Caringas Latin America  Foods;Invoice;008-06130;Arroz a Granel:Largo Fino 50 LB -Bolsa Dos Hermanos.;;3.0;27.85;83.55;4561235.57;Bulk Rice;Lisset Limpio -020;CAFETERIA y RESTAURANTS;1389999;Jul
2025-07-31;Los Caringas Latin America  Foods;Invoice;008-06130;Arroz a Granel:Parboiled 50 LB -Bolsa Dos Hermanos.;;3.0;28.25;84.75;4561320.32;Bulk Rice;Lisset Limpio -020;CAFETERIA y RESTAURANTS;1390000;Jul
2025-07-31;Mei Chang;Invoice;008-06131;Arroz a Granel:Parboiled 50 LB -Bolsa Dos Hermanos.;;6.0;28.25;169.5;4561489.82;Bulk Rice;Lisset Limpio -020;CAFETERIA y RESTAURANTS;1390001;Jul
2025-07-31;Soriano Brothers PB;Invoice;008-06132;Arroz a Granel:Largo Fino 50 LB -Bolsa Dos Hermanos.;;2.0;27.85;55.7;4561545.52;Bulk Rice;Lisset Limpio -020;CAFETERIA y RESTAURANTS;1390002;Jul
2025-07-31;El Palacio de los jugos / Caribe Tropical;Invoice;008-06133;Arroz a Granel:Parboiled 50 LB -Bolsa Dos Hermanos.;;8.0;26.75;214.0;4561759.52;Bulk Rice;Lisset Limpio -020;Cafeteria;1390003;Jul
2025-07-31;El Palacio de los jugos / Divan and Denise Food;Invoice;008-06134;Arroz a Granel:Parboiled 50 LB -Bolsa Dos Hermanos.;;5.0;26.75;133.75;4561893.27;Bulk Rice;Lisset Limpio -020;Cafeteria;1390004;Jul
2025-07-31;ALS Foods;Invoice;008-06135;Liquids:AS Bitter Orange;4 / 1 gl.;1.0;14.0;14.0;4561907.27;American Spice;Lisset Limpio -020;CAFETERIA y RESTAURANTS;1390005;Jul
2025-07-31;ALS Foods;Invoice;008-06135;Arroz a Granel:Largo Fino 50 LB -Bolsa Dos Hermanos.;;6.0;27.85;167.1;4562074.37;Bulk Rice;Lisset Limpio -020;CAFETERIA y RESTAURANTS;1390006;Jul
2025-07-31;ALS Foods;Invoice;008-06135;Arroz a Granel:Parboiled 50 LB -Bolsa Dos Hermanos.;;8.0;26.75;214.0;4562288.37;Bulk Rice;Lisset Limpio -020;CAFETERIA y RESTAURANTS;1390007;Jul
2025-07-31;El Palacio de Los Jugos / Casa mía Food Restaurant inc;Invoice;008-06136;Arroz a Granel:Parboiled 50 LB -Bolsa Dos Hermanos.;;12.0;26.75;321.0;4562609.37;Bulk Rice;Lisset Limpio -020;Cafeteria;1390008;Jul
2025-07-31;El Palacio de Los Jugos / Casa mía Food Restaurant inc;Invoice;008-06136;Spices:AS Sazon (for all);1 / 30 lb (box or pail);1.0;51.0;51.0;4562660.37;American Spice;Lisset Limpio -020;Cafeteria;1390009;Jul
2025-07-31;El Palacio de los jugos / Lita Foods Inc.;Invoice;008-06137;Dry Beans:Dry Beans - Black Beans 50;Dry Black Beans 50 lb;1.0;34.0;34.0;4562694.37;Dry Beans;Lisset Limpio -020;Cafeteria;1390010;Jul
2025-07-31;El Palacio de los jugos / Lita Foods Inc.;Invoice;008-06137;Arroz a Granel:Parboiled 50 LB -Bolsa Dos Hermanos.;;12.0;26.75;321.0;4563015.37;Bulk Rice;Lisset Limpio -020;Cafeteria;1390011;Jul
2025-07-31;Sedanos Supermarkets #38;Invoice;008-06138;Arroz Envasado:Long Rice 10 LB Dos Hermanos;;15.0;35.5;532.5;4563547.87;Branded Rice;Keila Alfaro-Visvikis;RETAIL SEDANOS;1390012;Jul
2025-07-31;Sedanos Supermarkets #38;Invoice;008-06138;Arroz Envasado:Long Rice 10 LB Dos Hermanos;;3.0;35.5;106.5;4563654.37;Branded Rice;Keila Alfaro-Visvikis;RETAIL SEDANOS;1390013;Jul
2025-07-31;Sedanos Supermarkets #32;Invoice;008-06139;Arroz a Granel:Largo Fino 50 LB -Bolsa Dos Hermanos.;;4.0;27.85;111.4;4563765.77;Bulk Rice;Keila Alfaro-Visvikis;RETAIL SEDANOS;1390014;Jul
2025-07-31;Sedanos Supermarkets #32;Invoice;008-06139;Arroz a Granel:Parboiled 50 LB -Bolsa Dos Hermanos.;;5.0;28.25;141.25;4563907.02;Bulk Rice;Keila Alfaro-Visvikis;RETAIL SEDANOS;1390015;Jul
2025-07-31;Sedanos Supermarkets #18;Invoice;008-06140;Arroz a Granel:Parboiled 50 LB -Bolsa Dos Hermanos.;;12.0;28.25;339.0;4564246.02;Bulk Rice;Keila Alfaro-Visvikis;RETAIL SEDANOS;1390016;Jul
2025-07-31;El Gallego Supermarket;Invoice;008-06141;Arroz a Granel:Parboiled 50 LB -Bolsa Dos Hermanos.;;5.0;27.75;138.75;4564384.77;Bulk Rice;Lisset Limpio -020;RETAIL  DSD;1390017;Jul
2025-07-31;El Gallego Supermarket;Invoice;008-06141;Dry Beans:Dry Beans - Black Beans 50;Dry Black Beans 50 lb;2.0;35.0;70.0;4564454.77;Dry Beans;Lisset Limpio -020;RETAIL  DSD;1390018;Jul
2025-07-31;El Gallego Supermarket;Invoice;008-06141;Liquids:AS Bitter Orange;4 / 1 gl.;2.0;14.0;28.0;4564482.77;American Spice;Lisset Limpio -020;RETAIL  DSD;1390019;Jul
2025-07-31;El Gallego Supermarket;Invoice;008-06141;Liquids:AS Marinating Sauce (Mojo);4 / 1 Gl;2.0;18.5;37.0;4564519.77;American Spice;Lisset Limpio -020;RETAIL  DSD;1390020;Jul
2025-07-31;El Palacio de los jugos / J Mena Corp.;Invoice;008-06142;Liquids:AS Marinating Sauce (Mojo);4 / 1 Gl;3.0;17.5;52.5;4564572.27;American Spice;Lisset Limpio -020;Cafeteria;1390021;Jul
2025-07-31;El Palacio de los jugos / J Mena Corp.;Invoice;008-06142;Arroz a Granel:Parboiled 50 LB -Bolsa Dos Hermanos.;;10.0;26.75;267.5;4564839.77;Bulk Rice;Lisset Limpio -020;Cafeteria;1390022;Jul
2025-07-31;Sedanos Supermarkets #31;Invoice;008-06143;Arroz a Granel:Parboiled 50 LB -Bolsa Dos Hermanos.;;6.0;28.25;169.5;4565009.27;Bulk Rice;Keila Alfaro-Visvikis;RETAIL SEDANOS;1390023;Jul
2025-07-31;El Toro Loco Meat Distribution, LLC;Invoice;008-06144;Liquids:AS Lemon Juice 4/1 Gl;;1.0;14.95;14.95;4565024.22;American Spice;Lisset Limpio -020;CAFETERIA y RESTAURANTS;1390024;Jul
2025-07-31;El Toro Loco Meat Distribution, LLC;Invoice;008-06144;Dry Beans:Dry Beans - Black Beans 50;Dry Black Beans 50 lb;55.0;36.0;1980.0;4567004.22;American Spice;Lisset Limpio -020;CAFETERIA y RESTAURANTS;1390025;Jul
2025-07-31;El Toro Loco Meat Distribution, LLC;Invoice;008-06144;Liquids:AS Bitter Orange;4 / 1 gl.;1.0;14.0;14.0;4567018.22;American Spice;Lisset Limpio -020;CAFETERIA y RESTAURANTS;1390026;Jul
2025-07-31;Bravo   Francisco Diaz;Invoice;008-06145;Liquids:AS Marinating Sauce (Mojo);4 / 1 Gl;3.0;18.5;55.5;4567073.72;American Spice;Lisset Limpio -020;RETAIL  DSD;1390027;Jul
2025-07-31;Bravo   Francisco Diaz;Invoice;008-06145;Arroz a Granel:Largo Fino 50 LB -Bolsa Dos Hermanos.;;5.0;27.85;139.25;4567212.97;Bulk Rice;Lisset Limpio -020;RETAIL  DSD;1390028;Jul
2025-07-31;Soriano Brothers PB;Credit Memo;008-06146;Varios:Producto vencido/deteriorado (no impacta en inventario);Largo fino 50lb;-9.0;27.85;-250.65;4566962.32;Bulk Rice;Lisset Limpio -020;CAFETERIA y RESTAURANTS;1390029;Jul
2025-07-31;Soriano Brothers PB;Invoice;008-06147;Spices:AS Chicken Base;1 / 30 lb. (box or pail);2.0;39.0;78.0;4567040.32;American Spice;Lisset Limpio -020;CAFETERIA y RESTAURANTS;1390030;Jul
2025-07-31;Soriano Brothers PB;Invoice;008-06147;Spices:AS Sazon (for all);1 / 30 lb (box or pail);3.0;51.0;153.0;4567193.32;American Spice;Lisset Limpio -020;CAFETERIA y RESTAURANTS;1390031;Jul
2025-07-31;Soriano Brothers PB;Invoice;008-06147;Arroz a Granel:Largo Fino 50 LB -Bolsa Dos Hermanos.;;10.0;27.85;278.5;4567471.82;Bulk Rice;Lisset Limpio -020;CAFETERIA y RESTAURANTS;1390032;Jul
2025-07-31;Soriano Brothers PB;Invoice;008-06147;Arroz a Granel:Parboiled 50 LB -Bolsa Dos Hermanos.;;11.0;27.75;305.25;4567777.07;Bulk Rice;Lisset Limpio -020;CAFETERIA y RESTAURANTS;1390033;Jul
2025-07-31;Soriano Brothers PB;Invoice;008-06147;Dry Beans:Dry Beans - Black Beans 50;Dry Black Beans 50 lb;4.0;32.5;130.0;4567907.07;Dry Beans;Lisset Limpio -020;CAFETERIA y RESTAURANTS;1390034;Jul
2025-07-31;Soriano Brothers PB;Invoice;008-06147;Arroz a Granel:Parboiled 50 LB -Bolsa Dos Hermanos.;;1.0;27.85;27.85;4567934.92;Bulk Rice;Lisset Limpio -020;CAFETERIA y RESTAURANTS;1390035;Jul
2025-07-31;Sedanos Supermarkets #33;Invoice;008-06148;Arroz a Granel:Parboiled 50 LB -Bolsa Dos Hermanos.;;3.0;28.25;84.75;4568019.67;Bulk Rice;Keila Alfaro-Visvikis;RETAIL SEDANOS;1390036;Jul
2025-07-31;Festival Supermarket #35- Southgate;Credit Memo;008-06149;Varios:Promotional Allowance;Arroz Envasado:Parboiled 5KG Dos Hermanos.;-8.0;46.5;-372.0;4567647.67;Branded Rice;Keila Alfaro-Visvikis;RETAIL  DSD;1390037;Jul
2025-07-31;Key Food / Holywood;Credit Memo;008-06150;Varios:Promotional Allowance;Arroz Envasado:Long Rice 10 LB Dos Hermanos;-1.0;35.5;-35.5;4567612.17;Branded Rice;Keila Alfaro-Visvikis;RETAIL  DSD;1390038;Jul
2025-07-31;Sedanos Supermarkets #24;Credit Memo;008-06151;Varios:Promotional Allowance;Arroz a Granel:Parboiled 50 LB -Bolsa Dos Hermanos.;-1.0;28.25;-28.25;4567583.92;Bulk Rice;Keila Alfaro-Visvikis;RETAIL SEDANOS;1390039;Jul
2025-07-31;Sedanos Supermarkets #38;Credit Memo;008-06152;Varios:Promotional Allowance;Arroz Envasado:Long Rice 10 LB Dos Hermanos;-3.0;35.5;-106.5;4567477.42;Branded Rice;Keila Alfaro-Visvikis;RETAIL SEDANOS;1390040;Jul
2025-07-31;Soriano Brothers PB;Credit Memo;008-06153;Varios:Promotional Allowance;Arroz a Granel:Parboiled 50 LB -Bolsa Dos Hermanos.;-1.0;27.75;-27.75;4567449.67;Bulk Rice;Lisset Limpio -020;CAFETERIA y RESTAURANTS;1390041;Jul
2025-08-01;El Palacio de los jugos / Rodriguez Foods;Invoice;008-06154;Arroz a Granel:Parboiled 50 LB -Bolsa Dos Hermanos.;;6.0;26.75;160.5;4567610.17;Bulk Rice;Lisset Limpio -020;Cafeteria;1390042;Aug
2025-08-03;El Palacio de los jugos / Rodriguez Foods;Invoice;008-06155;Arroz a Granel:Parboiled 50 LB -Bolsa Dos Hermanos.;;7.0;26.75;187.25;4567797.42;Bulk Rice;Lisset Limpio -020;Cafeteria;1390043;Aug
2025-08-03;El Palacio de los jugos /  Nanos Latin Foods;Invoice;008-06156;Dry Beans:Dry Beans - Black Beans 50;Dry Black Beans 50 lb;1.0;34.0;34.0;4567831.42;Dry Beans;Lisset Limpio -020;Cafeteria;1390044;Aug
2025-08-03;El Palacio de los jugos /  Nanos Latin Foods;Invoice;008-06156;Arroz a Granel:Largo Fino 50 LB -Bolsa Dos Hermanos.;;3.0;27.85;83.55;4567914.97;Bulk Rice;Lisset Limpio -020;Cafeteria;1390045;Aug
2025-08-03;El Palacio de los jugos /  Nanos Latin Foods;Invoice;008-06156;Arroz a Granel:Parboiled 50 LB -Bolsa Dos Hermanos.;;8.0;26.75;214.0;4568128.97;Bulk Rice;Lisset Limpio -020;Cafeteria;1390046;Aug
2025-08-03;El Palacio de los jugos / Divan and Denise Food;Invoice;008-06157;Dry Beans:Dry Beans - Black Beans 50;Dry Black Beans 50 lb;1.0;34.0;34.0;4568162.97;Dry Beans;Lisset Limpio -020;Cafeteria;1390047;Aug
2025-08-03;El Palacio de los jugos / Divan and Denise Food;Invoice;008-06157;Arroz a Granel:Parboiled 50 LB -Bolsa Dos Hermanos.;;5.0;26.75;133.75;4568296.72;Bulk Rice;Lisset Limpio -020;Cafeteria;1390048;Aug
2025-08-03;El Palacio de los Jugos / Bird Road Restaurant;Invoice;008-06158;Arroz a Granel:Parboiled 50 LB -Bolsa Dos Hermanos.;;10.0;26.75;267.5;4568564.22;Bulk Rice;Lisset Limpio -020;Cafeteria;1390049;Aug
2025-08-03;El Palacio de los jugos / Caribe Tropical;Invoice;008-06159;Dry Beans:Dry Beans - Black Beans 50;Dry Black Beans 50 lb;2.0;34.0;68.0;4568632.22;Dry Beans;Lisset Limpio -020;Cafeteria;1390050;Aug
2025-08-03;El Palacio de los jugos / Caribe Tropical;Invoice;008-06159;Arroz a Granel:Parboiled 50 LB -Bolsa Dos Hermanos.;;6.0;26.75;160.5;4568792.72;Bulk Rice;Lisset Limpio -020;Cafeteria;1390051;Aug
2025-08-03;El Palacio de los jugos / Delicias Criollas (DIAGO FOOD_MILLER);Invoice;008-06160;Arroz a Granel:Largo Fino 50 LB -Bolsa Dos Hermanos.;;6.0;27.85;167.1;4568959.82;Bulk Rice;Lisset Limpio -020;Cafeteria;1390052;Aug
2025-08-03;El Palacio de los jugos / Delicias Criollas (DIAGO FOOD_MILLER);Invoice;008-06160;Arroz a Granel:Parboiled 50 LB -Bolsa Dos Hermanos.;;12.0;26.75;321.0;4569280.82;Bulk Rice;Lisset Limpio -020;Cafeteria;1390053;Aug
2025-08-03;El Palacio de Los Jugos / Casa mía Food Restaurant inc;Invoice;008-06161;Spices:AS Chicken Base;1 / 30 lb. (box or pail);2.0;39.0;78.0;4569358.82;American Spice;Lisset Limpio -020;Cafeteria;1390054;Aug
2025-08-03;El Palacio de Los Jugos / Casa mía Food Restaurant inc;Invoice;008-06161;Arroz a Granel:Parboiled 50 LB -Bolsa Dos Hermanos.;;8.0;26.75;214.0;4569572.82;Bulk Rice;Lisset Limpio -020;Cafeteria;1390055;Aug
2025-08-03;JMN Dely Corp;Invoice;008-06162;Arroz a Granel:Largo Fino 50 LB -Bolsa Dos Hermanos.;;2.0;27.85;55.7;4569628.52;Bulk Rice;Keila Alfaro-Visvikis;CAFETERIA y RESTAURANTS;1390056;Aug
2025-08-03;JMN Dely Corp;Invoice;008-06162;Arroz a Granel:Parboiled 50 LB -Bolsa Dos Hermanos.;;2.0;28.75;57.5;4569686.02;Bulk Rice;Keila Alfaro-Visvikis;CAFETERIA y RESTAURANTS;1390057;Aug
2025-08-03;JMN Dely Corp;Invoice;008-06162;Dry Beans:Dry Beans - Black Beans 50;Dry Black Beans 50 lb;1.0;45.7;45.7;4569731.72;Dry Beans;Keila Alfaro-Visvikis;CAFETERIA y RESTAURANTS;1390058;Aug
2025-08-03;Sedanos Supermarkets #14;Invoice;008-06163;Arroz Envasado:Largo Fino 1kg (Long grain rice) Dos Hermanos;;1.0;17.5;17.5;4569749.22;Branded Rice;Keila Alfaro-Visvikis;RETAIL SEDANOS;1390059;Aug
2025-08-03;Sedanos Supermarkets #14;Invoice;008-06163;Arroz Envasado:Parboiled 1kg Bolsa Dos Hermanos.;.;1.0;19.9;19.9;4569769.12;Bulk Rice;Keila Alfaro-Visvikis;RETAIL SEDANOS;1390060;Aug
2025-08-03;Sedanos Supermarkets #14;Invoice;008-06163;Arroz Envasado:Long Rice 10 LB Dos Hermanos;;5.0;35.5;177.5;4569946.62;Branded Rice;Keila Alfaro-Visvikis;RETAIL SEDANOS;1390061;Aug
2025-08-03;Sedanos Supermarkets #14;Invoice;008-06163;Arroz Envasado:Long Rice 10 LB Dos Hermanos;;1.0;35.5;35.5;4569982.12;Branded Rice;Keila Alfaro-Visvikis;RETAIL SEDANOS;1390062;Aug
2025-08-03;Sedanos Supermarkets #14;Invoice;008-06164;Arroz a Granel:Parboiled 50 LB -Bolsa Dos Hermanos.;;2.0;28.25;56.5;4570038.62;Bulk Rice;Keila Alfaro-Visvikis;RETAIL SEDANOS;1390063;Aug
2025-08-03;Sedanos Supermarkets #42;Invoice;008-06165;Arroz a Granel:Parboiled 50 LB -Bolsa Dos Hermanos.;;5.0;28.25;141.25;4570179.87;Bulk Rice;Keila Alfaro-Visvikis;RETAIL SEDANOS;1390064;Aug
2025-08-03;Sedanos Supermarkets #14;Credit Memo;008-06167;Varios:Promotional Allowance;Arroz Envasado:Long Rice 10 LB Dos Hermanos;-1.0;35.5;-35.5;4570144.37;Branded Rice;Keila Alfaro-Visvikis;RETAIL SEDANOS;1390065;Aug
2025-08-04;Hings Chinese;Invoice;008-06166;Arroz a Granel:Parboiled 50 LB -Bolsa Dos Hermanos.;;5.0;28.25;141.25;4570285.62;Bulk Rice;Lisset Limpio -020;CAFETERIA y RESTAURANTS;1390066;Aug
2025-08-04;Soriano Brothers PB;Invoice;008-06170;Arroz a Granel:Largo Fino 50 LB -Bolsa Dos Hermanos.;214114;5.0;27.85;139.25;4570424.87;Bulk Rice;Lisset Limpio -020;CAFETERIA y RESTAURANTS;1390067;Aug
2025-08-07;Rey Chavez Distributor Corp;Invoice;008-06171;Arroz a Granel:Parboiled 50 LB -Bolsa Dos Hermanos.;;55.0;27.5;1512.5;4571937.37;Bulk Rice;Lisset Limpio -020;WHOLESALER;1390068;Aug
2025-08-07;Sedanos Supermarkets #34;Invoice;008-06172;Arroz Envasado:Parboiled 5KG Dos Hermanos.;6  11lbs;15.0;40.5;607.5;4572544.87;Branded Rice;Keila Alfaro-Visvikis;RETAIL SEDANOS;1390069;Aug
2025-08-07;Sedanos Supermarkets #34;Invoice;008-06172;Spanish Style Yellow Rice:AS Spanish Style Yellow Rice;AS Spanish Style Yellow Rice 6 / 3.25 oz;1.0;34.5;34.5;4572579.37;American Spice;Keila Alfaro-Visvikis;RETAIL SEDANOS;1390070;Aug
2025-08-07;Sedanos Supermarkets #34;Invoice;008-06172;Arroz Envasado:Parboiled 5KG Dos Hermanos.;6  11lbs;3.0;40.5;121.5;4572700.87;Branded Rice;Keila Alfaro-Visvikis;RETAIL SEDANOS;1390071;Aug
2025-08-07;Food Fair Plantation Corp;Invoice;008-06173;Arroz a Granel:Parboiled 50 LB -Bolsa Dos Hermanos.;;55.0;28.25;1553.75;4574254.62;Bulk Rice;Keila Alfaro-Visvikis;RETAIL  DSD;1390072;Aug
2025-08-07;Food Fair Plantation Corp;Invoice;008-06173;Arroz Envasado:Parboiled 1kg Bolsa Dos Hermanos.;.;1.0;19.9;19.9;4574274.52;Branded Rice;Keila Alfaro-Visvikis;RETAIL  DSD;1390073;Aug
2025-08-07;Food Fair Plantation Corp;Invoice;008-06173;Arroz Envasado:Largo Fino 1kg (Long grain rice) Dos Hermanos;;1.0;18.0;18.0;4574292.52;Branded Rice;Keila Alfaro-Visvikis;RETAIL  DSD;1390074;Aug
2025-08-07;Sedanos Supermarkets #27;Invoice;008-06174;Arroz Envasado:Long Rice 10 LB Dos Hermanos;;5.0;35.5;177.5;4574470.02;Branded Rice;Keila Alfaro-Visvikis;RETAIL SEDANOS;1390075;Aug
2025-08-07;Sedanos Supermarkets #27;Invoice;008-06174;Arroz Envasado:Parboiled 5KG Dos Hermanos.;6  11lbs;10.0;40.5;405.0;4574875.02;Branded Rice;Keila Alfaro-Visvikis;RETAIL SEDANOS;1390076;Aug
2025-08-07;Sedanos Supermarkets #27;Invoice;008-06174;Arroz Envasado:Parboiled 5KG Dos Hermanos.;6  11lbs;2.0;40.5;81.0;4574956.02;Branded Rice;Keila Alfaro-Visvikis;RETAIL SEDANOS;1390077;Aug
2025-08-07;Sedanos Supermarkets #27;Invoice;008-06174;Arroz Envasado:Long Rice 10 LB Dos Hermanos;;1.0;35.5;35.5;4574991.52;Branded Rice;Keila Alfaro-Visvikis;RETAIL SEDANOS;1390078;Aug
2025-08-07;Key Food / Holywood;Invoice;008-06175;Arroz Envasado:Long Rice 10 LB Dos Hermanos;;5.0;35.5;177.5;4575169.02;Branded Rice;Keila Alfaro-Visvikis;RETAIL  DSD;1390079;Aug
2025-08-07;Key Food / Holywood;Invoice;008-06175;Arroz Envasado:Long Rice 10 LB Dos Hermanos;;1.0;35.5;35.5;4575204.52;Branded Rice;Keila Alfaro-Visvikis;RETAIL  DSD;1390080;Aug
2025-08-07;Food Fair Plantation Corp;Credit Memo;008-06176;Varios:Producto vencido/deteriorado (no impacta en inventario);1 unit Parboiled 5k @ $5.28;-1.0;5.28;-5.28;4575199.24;Branded Rice;Keila Alfaro-Visvikis;RETAIL  DSD;1390081;Aug
2025-08-07;Food Fair Plantation Corp;Credit Memo;008-06176;Varios:Producto vencido/deteriorado (no impacta en inventario);1 bolsa 50 lb. Parboiled @ $28.25;-1.0;28.25;-28.25;4575170.99;Bulk Rice;Keila Alfaro-Visvikis;RETAIL  DSD;1390082;Aug
2025-08-07;Sedanos Supermarkets #34;Credit Memo;008-06177;Varios:Promotional Allowance;Arroz Envasado:Parboiled 5KG Dos Hermanos.;-3.0;40.5;-121.5;4575049.49;Branded Rice;Keila Alfaro-Visvikis;RETAIL SEDANOS;1390083;Aug
2025-08-07;Key Food / Holywood;Credit Memo;008-06178;Varios:Promotional Allowance;Arroz Envasado:Long Rice 10 LB Dos Hermanos;-1.0;35.5;-35.5;4575013.99;Branded Rice;Keila Alfaro-Visvikis;RETAIL  DSD;1390084;Aug
2025-08-07;Sedanos Supermarkets #27;Credit Memo;008-06179;Varios:Promotional Allowance;Arroz Envasado:Long Rice 10 LB Dos Hermanos;-1.0;35.5;-35.5;4574978.49;Branded Rice;Keila Alfaro-Visvikis;RETAIL SEDANOS;1390085;Aug
2025-08-07;Sedanos Supermarkets #27;Credit Memo;008-06179;Varios:Promotional Allowance;Arroz Envasado:Parboiled 5KG Dos Hermanos.;-2.0;40.5;-81.0;4574897.49;Branded Rice;Keila Alfaro-Visvikis;RETAIL SEDANOS;1390086;Aug
2025-08-07;American Spice Trading Co, Inc.;Credit Memo;008-06180;Arroz a Granel:Parboiled 50 LB -Bolsa Dos Hermanos.;;-550.0;26.0;-14300.0;4560597.49;Bulk Rice;Armando Carpio - 017;WHOLESALER MANUFACTURY;1390087;Aug
2025-08-07;American Spice Trading Co, Inc.;Invoice;008-06181;Arroz a Granel:Parboiled 50 LB -Bolsa Dos Hermanos.;;550.0;26.0;14300.0;4574897.49;Bulk Rice;Armando Carpio - 017;WHOLESALER MANUFACTURY;1390088;Aug
2025-08-08;Soriano Brothers PB;Invoice;008-06182;Spices:AS Sazon (for all);1 / 30 lb (box or pail);1.0;51.0;51.0;4574948.49;American Spice;Lisset Limpio -020;CAFETERIA y RESTAURANTS;1390089;Aug
2025-08-08;Soriano Brothers PB;Invoice;008-06182;Arroz a Granel:Largo Fino 50 LB -Bolsa Dos Hermanos.;;10.0;27.85;278.5;4575226.99;Bulk Rice;Lisset Limpio -020;CAFETERIA y RESTAURANTS;1390090;Aug
2025-08-08;Soriano Brothers PB;Invoice;008-06182;Arroz a Granel:Parboiled 50 LB -Bolsa Dos Hermanos.;;11.0;27.75;305.25;4575532.24;Bulk Rice;Lisset Limpio -020;CAFETERIA y RESTAURANTS;1390091;Aug
2025-08-08;Soriano Brothers PB;Invoice;008-06182;Dry Beans:Dry Beans - Black Beans 50;Dry Black Beans 50 lb;2.0;32.0;64.0;4575596.24;Dry Beans;Lisset Limpio -020;CAFETERIA y RESTAURANTS;1390092;Aug
2025-08-08;Soriano Brothers PB;Invoice;008-06182;Arroz a Granel:Parboiled 50 LB -Bolsa Dos Hermanos.;;1.0;27.75;27.75;4575623.99;Bulk Rice;Lisset Limpio -020;CAFETERIA y RESTAURANTS;1390093;Aug
2025-08-08;Bravo   Francisco Diaz;Invoice;008-06183;Arroz a Granel:Largo Fino 50 LB -Bolsa Dos Hermanos.;;5.0;27.85;139.25;4575763.24;Bulk Rice;Lisset Limpio -020;RETAIL  DSD;1390094;Aug
2025-08-08;El Palacio de los jugos / Leti Corp.;Invoice;008-06184;Arroz a Granel:Largo Fino 50 LB -Bolsa Dos Hermanos.;;3.0;27.85;83.55;4575846.79;Bulk Rice;Lisset Limpio -020;Cafeteria;1390095;Aug
2025-08-08;El Palacio de los jugos / Leti Corp.;Invoice;008-06184;Arroz a Granel:Parboiled 50 LB -Bolsa Dos Hermanos.;;6.0;26.75;160.5;4576007.29;Bulk Rice;Lisset Limpio -020;Cafeteria;1390096;Aug
2025-08-08;El Palacio de los jugos /  Mires Restaurants;Invoice;008-06185;Liquids:AS Marinating Sauce (Mojo);4 / 1 Gl;1.0;18.5;18.5;4576025.79;American Spice;Lisset Limpio -020;Cafeteria;1390097;Aug
2025-08-08;El Palacio de los jugos /  Mires Restaurants;Invoice;008-06185;Arroz a Granel:Parboiled 50 LB -Bolsa Dos Hermanos.;;11.0;27.75;305.25;4576331.04;Bulk Rice;Lisset Limpio -020;Cafeteria;1390098;Aug
2025-08-08;El Palacio de los jugos /  Mires Restaurants;Invoice;008-06185;Arroz a Granel:Parboiled 50 LB -Bolsa Dos Hermanos.;;1.0;27.75;27.75;4576358.79;Bulk Rice;Lisset Limpio -020;Cafeteria;1390099;Aug
2025-08-08;El Palacio de los jugos /  EMMA FOOD CORP;Invoice;008-06186;Arroz a Granel:Parboiled 50 LB -Bolsa Dos Hermanos.;;8.0;26.75;214.0;4576572.79;Bulk Rice;Lisset Limpio -020;Cafeteria;1390100;Aug
2025-08-08;El Palacio de los jugos /  Nanos Latin Foods;Invoice;008-06187;Arroz a Granel:Largo Fino 50 LB -Bolsa Dos Hermanos.;;5.0;27.85;139.25;4576712.04;Bulk Rice;Lisset Limpio -020;Cafeteria;1390101;Aug
2025-08-08;El Palacio de los jugos /  Nanos Latin Foods;Invoice;008-06187;Arroz a Granel:Parboiled 50 LB -Bolsa Dos Hermanos.;;8.0;26.75;214.0;4576926.04;Bulk Rice;Lisset Limpio -020;Cafeteria;1390102;Aug
2025-08-08;El Palacio de los jugos /  Nanos Latin Foods;Invoice;008-06187;Dry Beans:Dry Beans - Black Beans 50;Dry Black Beans 50 lb;1.0;34.0;34.0;4576960.04;Dry Beans;Lisset Limpio -020;Cafeteria;1390103;Aug
2025-08-08;Sedanos Supermarkets #33;Invoice;008-06188;Arroz a Granel:Parboiled 50 LB -Bolsa Dos Hermanos.;;3.0;28.25;84.75;4577044.79;Bulk Rice;Keila Alfaro-Visvikis;RETAIL SEDANOS;1390104;Aug
2025-08-08;Be Your Will LLC;Invoice;008-06189;Arroz a Granel:Largo Fino 50 LB -Bolsa Dos Hermanos.;;6.0;27.85;167.1;4577211.89;Bulk Rice;Lisset Limpio -020;CAFETERIA y RESTAURANTS;1390105;Aug
2025-08-08;Be Your Will LLC;Invoice;008-06189;Arroz a Granel:Parboiled 50 LB -Bolsa Dos Hermanos.;;11.0;27.75;305.25;4577517.14;Bulk Rice;Lisset Limpio -020;CAFETERIA y RESTAURANTS;1390106;Aug
2025-08-08;Be Your Will LLC;Invoice;008-06189;Arroz a Granel:Largo Fino 50 LB -Bolsa Dos Hermanos.;;1.0;27.85;27.85;4577544.99;Bulk Rice;Lisset Limpio -020;CAFETERIA y RESTAURANTS;1390107;Aug
2025-08-08;El Palacio de Los Jugos / Casa mía Food Restaurant inc;Invoice;008-06190;Arroz a Granel:Parboiled 50 LB -Bolsa Dos Hermanos.;;8.0;26.75;214.0;4577758.99;Bulk Rice;Lisset Limpio -020;Cafeteria;1390108;Aug
2025-08-08;El Palacio de Los Jugos / Casa mía Food Restaurant inc;Invoice;008-06190;Spices:AS Sazon (for all);1 / 30 lb (box or pail);1.0;51.0;51.0;4577809.99;American Spice;Lisset Limpio -020;Cafeteria;1390109;Aug
2025-08-08;Sedanos Supermarkets #32;Invoice;008-06191;Arroz a Granel:Largo Fino 50 LB -Bolsa Dos Hermanos.;;2.0;27.85;55.7;4577865.69;Bulk Rice;Keila Alfaro-Visvikis;RETAIL SEDANOS;1390110;Aug
2025-08-08;Sedanos Supermarkets #32;Invoice;008-06191;Arroz a Granel:Parboiled 50 LB -Bolsa Dos Hermanos.;;3.0;28.25;84.75;4577950.44;Bulk Rice;Keila Alfaro-Visvikis;RETAIL SEDANOS;1390111;Aug
2025-08-08;El Palacio de los jugos / Lita Foods Inc.;Invoice;008-06192;Dry Beans:Dry Beans - Black Beans 50;Dry Black Beans 50 lb;1.0;34.0;34.0;4577984.44;Dry Beans;Lisset Limpio -020;Cafeteria;1390112;Aug
2025-08-08;El Palacio de los jugos / Lita Foods Inc.;Invoice;008-06192;Arroz a Granel:Parboiled 50 LB -Bolsa Dos Hermanos.;;11.0;27.75;305.25;4578289.69;Bulk Rice;Lisset Limpio -020;Cafeteria;1390113;Aug
2025-08-08;El Palacio de los jugos / Lita Foods Inc.;Invoice;008-06192;Arroz a Granel:Parboiled 50 LB -Bolsa Dos Hermanos.;;1.0;27.75;27.75;4578317.44;Bulk Rice;Lisset Limpio -020;Cafeteria;1390114;Aug
2025-08-08;El Palacio de los jugos / Divan and Denise Food;Invoice;008-06193;Dry Beans:Dry Beans - Black Beans 50;Dry Black Beans 50 lb;1.0;34.0;34.0;4578351.44;Dry Beans;Lisset Limpio -020;Cafeteria;1390115;Aug
2025-08-08;El Palacio de los jugos / Divan and Denise Food;Invoice;008-06193;Arroz a Granel:Parboiled 50 LB -Bolsa Dos Hermanos.;;10.0;26.75;267.5;4578618.94;Bulk Rice;Lisset Limpio -020;Cafeteria;1390116;Aug
2025-08-08;El Palacio de los jugos / Caribe Tropical;Invoice;008-06194;Dry Beans:Dry Beans - Black Beans 50;Dry Black Beans 50 lb;2.0;34.0;68.0;4578686.94;Dry Beans;Lisset Limpio -020;Cafeteria;1390117;Aug
2025-08-08;El Palacio de los jugos / Caribe Tropical;Invoice;008-06194;Arroz a Granel:Parboiled 50 LB -Bolsa Dos Hermanos.;;10.0;26.75;267.5;4578954.44;Bulk Rice;Lisset Limpio -020;Cafeteria;1390118;Aug
2025-08-08;El Palacio de los jugos / Rodriguez Foods;Invoice;008-06195;Arroz a Granel:Parboiled 50 LB -Bolsa Dos Hermanos.;;8.0;26.75;214.0;4579168.44;Bulk Rice;Lisset Limpio -020;Cafeteria;1390119;Aug
2025-08-08;Soriano Brothers Diaz Food Service,Inc;Invoice;008-06196;Dry Beans:Dry Beans - Black Beans 50;Dry Black Beans 50 lb;7.0;34.0;238.0;4579406.44;Bulk Rice;Lisset Limpio -020;CAFETERIA y RESTAURANTS;1390120;Aug
2025-08-08;Soriano Brothers Diaz Food Service,Inc;Invoice;008-06196;Arroz a Granel:Parboiled 50 LB -Bolsa Dos Hermanos.;;40.0;26.75;1070.0;4580476.44;Bulk Rice;Lisset Limpio -020;CAFETERIA y RESTAURANTS;1390121;Aug
2025-08-08;Soriano Brothers PB;Credit Memo;008-06265;Varios:Promotional Allowance;Arroz a Granel:Parboiled 50 LB -Bolsa Dos Hermanos.;-1.0;27.75;-27.75;4580448.69;Bulk Rice;Lisset Limpio -020;CAFETERIA y RESTAURANTS;1390122;Aug
2025-08-08;El Palacio de los jugos /  Mires Restaurants;Credit Memo;008-06266;Varios:Promotional Allowance;Arroz a Granel:Parboiled 50 LB -Bolsa Dos Hermanos.;-1.0;27.75;-27.75;4580420.94;Bulk Rice;Lisset Limpio -020;Cafeteria;1390123;Aug
2025-08-08;Be Your Will LLC;Credit Memo;008-06267;Varios:Promotional Allowance;Arroz a Granel:Largo Fino 50 LB -Bolsa Dos Hermanos.;-1.0;27.85;-27.85;4580393.09;Bulk Rice;Lisset Limpio -020;CAFETERIA y RESTAURANTS;1390124;Aug
2025-08-08;El Palacio de los jugos / Lita Foods Inc.;Credit Memo;008-06268;Varios:Promotional Allowance;Arroz a Granel:Parboiled 50 LB -Bolsa Dos Hermanos.;-1.0;27.75;-27.75;4580365.34;Bulk Rice;Lisset Limpio -020;Cafeteria;1390125;Aug
2025-08-10;Aries Supermarket & Cafeteria;Invoice;008-06197;Arroz a Granel:Parboiled 50 LB -Bolsa Dos Hermanos.;;10.0;28.25;282.5;4580647.84;Bulk Rice;Keila Alfaro-Visvikis;CAFETERIA y RESTAURANTS;1390126;Aug
2025-08-10;Aries Supermarket & Cafeteria;Invoice;008-06197;Dry Beans:Dry Beans - Black Beans 50;Dry Black Beans 50 lb;5.0;37.5;187.5;4580835.34;Dry Beans;Keila Alfaro-Visvikis;CAFETERIA y RESTAURANTS;1390127;Aug
2025-08-10;Aries Supermarket & Cafeteria;Invoice;008-06197;Liquids:AS Bitter Orange;4 / 1 gl.;2.0;14.5;29.0;4580864.34;American Spice;Keila Alfaro-Visvikis;CAFETERIA y RESTAURANTS;1390128;Aug
2025-08-10;Aries Supermarket & Cafeteria;Invoice;008-06197;Spices:AS Oregano Ground;4 / 3.5 Lbs.;1.0;37.5;37.5;4580901.84;American Spice;Keila Alfaro-Visvikis;CAFETERIA y RESTAURANTS;1390129;Aug
2025-08-10;Aries Supermarket & Cafeteria;Invoice;008-06197;Spices:AS Chicken Base;1 / 30 lb. (box or pail);5.0;43.5;217.5;4581119.34;American Spice;Keila Alfaro-Visvikis;CAFETERIA y RESTAURANTS;1390130;Aug
2025-08-10;Aries Supermarket & Cafeteria;Invoice;008-06197;Spices:AS Whole Bay Leaves;4/12 OZ;1.0;27.5;27.5;4581146.84;American Spice;Keila Alfaro-Visvikis;CAFETERIA y RESTAURANTS;1390131;Aug
2025-08-10;Aries Supermarket & Cafeteria;Invoice;008-06197;Spices:AS Cumin Ground;4 / 4 lb;1.0;50.25;50.25;4581197.09;American Spice;Keila Alfaro-Visvikis;CAFETERIA y RESTAURANTS;1390132;Aug
2025-08-10;El Palacio de los jugos / J Mena Corp.;Invoice;008-06198;Arroz a Granel:Parboiled 50 LB -Bolsa Dos Hermanos.;;15.0;26.75;401.25;4581598.34;Bulk Rice;Lisset Limpio -020;Cafeteria;1390133;Aug
2025-08-10;Sedanos Supermarkets #43;Invoice;008-06199;Arroz a Granel:Parboiled 50 LB -Bolsa Dos Hermanos.;;4.0;28.25;113.0;4581711.34;Bulk Rice;Keila Alfaro-Visvikis;RETAIL SEDANOS;1390134;Aug
2025-08-10;Sedanos Supermarkets #16;Invoice;008-06200;Arroz a Granel:Parboiled 50 LB -Bolsa Dos Hermanos.;;4.0;28.25;113.0;4581824.34;Bulk Rice;Keila Alfaro-Visvikis;RETAIL SEDANOS;1390135;Aug
2025-08-11;Fritanga Momotombo;Invoice;008-06201;Spices:AS Chicken Base;1 / 30 lb. (box or pail);1.0;39.0;39.0;4581863.34;American Spice;Lisset Limpio -020;CAFETERIA y RESTAURANTS;1390136;Aug
2025-08-11;Fritanga Momotombo;Invoice;008-06201;Arroz a Granel:Largo Fino 50 LB -Bolsa Dos Hermanos.;;5.0;27.85;139.25;4582002.59;Bulk Rice;Lisset Limpio -020;CAFETERIA y RESTAURANTS;1390137;Aug
2025-08-11;El Palacio de los Jugos / Bird Road Restaurant;Invoice;008-06202;Arroz a Granel:Parboiled 50 LB -Bolsa Dos Hermanos.;;12.0;26.75;321.0;4582323.59;Bulk Rice;Lisset Limpio -020;Cafeteria;1390138;Aug
2025-08-11;El Palacio de los jugos / Rodriguez Foods;Invoice;008-06203;Arroz a Granel:Parboiled 50 LB -Bolsa Dos Hermanos.;;6.0;26.75;160.5;4582484.09;Bulk Rice;Lisset Limpio -020;Cafeteria;1390139;Aug
2025-08-11;El Palacio de los jugos /  Nanos Latin Foods;Invoice;008-06204;Arroz a Granel:Largo Fino 50 LB -Bolsa Dos Hermanos.;;5.0;27.85;139.25;4582623.34;Bulk Rice;Lisset Limpio -020;Cafeteria;1390140;Aug
2025-08-11;El Palacio de los jugos /  Nanos Latin Foods;Invoice;008-06204;Arroz a Granel:Parboiled 50 LB -Bolsa Dos Hermanos.;;8.0;26.75;214.0;4582837.34;Bulk Rice;Lisset Limpio -020;Cafeteria;1390141;Aug
2025-08-11;El Palacio de los jugos /  Nanos Latin Foods;Invoice;008-06204;Dry Beans:Dry Beans - Black Beans 50;Dry Black Beans 50 lb;2.0;34.0;68.0;4582905.34;Dry Beans;Lisset Limpio -020;Cafeteria;1390142;Aug
2025-08-11;El Palacio de los jugos / Caribe Tropical;Invoice;008-06205;Arroz a Granel:Parboiled 50 LB -Bolsa Dos Hermanos.;;6.0;26.75;160.5;4583065.84;Bulk Rice;Lisset Limpio -020;Cafeteria;1390143;Aug
2025-08-11;El Palacio de los jugos / Divan and Denise Food;Invoice;008-06206;Arroz a Granel:Parboiled 50 LB -Bolsa Dos Hermanos.;;5.0;26.75;133.75;4583199.59;Bulk Rice;Lisset Limpio -020;Cafeteria;1390144;Aug
2025-08-11;El Palacio de los jugos / Divan and Denise Food;Invoice;008-06206;Dry Beans:Dry Beans - Black Beans 50;Dry Black Beans 50 lb;2.0;34.0;68.0;4583267.59;Dry Beans;Lisset Limpio -020;Cafeteria;1390145;Aug
2025-08-11;JMN Dely Corp;Invoice;008-06207;Dry Beans:Dry Beans - Black Beans 50;Dry Black Beans 50 lb;1.0;45.7;45.7;4583313.29;Dry Beans;Keila Alfaro-Visvikis;CAFETERIA y RESTAURANTS;1390146;Aug
2025-08-11;JMN Dely Corp;Invoice;008-06207;Arroz a Granel:Largo Fino 50 LB -Bolsa Dos Hermanos.;;2.0;27.85;55.7;4583368.99;Bulk Rice;Keila Alfaro-Visvikis;CAFETERIA y RESTAURANTS;1390147;Aug
2025-08-11;JMN Dely Corp;Invoice;008-06207;Arroz a Granel:Parboiled 50 LB -Bolsa Dos Hermanos.;;2.0;27.75;55.5;4583424.49;Bulk Rice;Keila Alfaro-Visvikis;CAFETERIA y RESTAURANTS;1390148;Aug
2025-08-11;El Palacio de Los Jugos / Casa mía Food Restaurant inc;Invoice;008-06208;Arroz a Granel:Parboiled 50 LB -Bolsa Dos Hermanos.;;4.0;26.75;107.0;4583531.49;Bulk Rice;Lisset Limpio -020;Cafeteria;1390149;Aug
2025-08-11;Sedanos Supermarkets  #4;Invoice;008-06209;Arroz Envasado:Long Rice 10 LB Dos Hermanos;;5.0;35.5;177.5;4583708.99;Branded Rice;Keila Alfaro-Visvikis;RETAIL SEDANOS;1390150;Aug
2025-08-11;Sedanos Supermarkets  #4;Invoice;008-06209;Varios:Promotional Allowance;Long Grain 10 lb;5.0;-3.2;-16.0;4583692.99;Branded Rice;Keila Alfaro-Visvikis;RETAIL SEDANOS;1390151;Aug
2025-08-11;Sedanos Supermarkets #7;Invoice;008-06210;Arroz Envasado:Long Rice 10 LB Dos Hermanos;;10.0;35.5;355.0;4584047.99;Branded Rice;Keila Alfaro-Visvikis;RETAIL SEDANOS;1390152;Aug
2025-08-11;Sedanos Supermarkets #7;Invoice;008-06210;Varios:Promotional Allowance;;10.0;-3.2;-32.0;4584015.99;Branded Rice;Keila Alfaro-Visvikis;RETAIL SEDANOS;1390153;Aug
2025-08-11;Sedanos Supermarkets #42;Invoice;008-06211;Arroz Envasado:Long Rice 10 LB Dos Hermanos;;10.0;35.5;355.0;4584370.99;Branded Rice;Keila Alfaro-Visvikis;RETAIL SEDANOS;1390154;Aug
2025-08-11;Sedanos Supermarkets #42;Invoice;008-06211;Varios:Promotional Allowance;;10.0;-3.2;-32.0;4584338.99;Branded Rice;Keila Alfaro-Visvikis;RETAIL SEDANOS;1390155;Aug
2025-08-11;Sedanos Supermarkets #23;Invoice;008-06212;Arroz Envasado:Long Rice 10 LB Dos Hermanos;;10.0;35.5;355.0;4584693.99;Branded Rice;Keila Alfaro-Visvikis;RETAIL SEDANOS;1390156;Aug
2025-08-11;Sedanos Supermarkets #23;Invoice;008-06212;Varios:Promotional Allowance;DH Long grain 10lb;10.0;-3.2;-32.0;4584661.99;Branded Rice;Keila Alfaro-Visvikis;RETAIL SEDANOS;1390157;Aug
2025-08-11;El Palacio de los jugos / Delicias Criollas (DIAGO FOOD_MILLER);Invoice;008-06213;Arroz a Granel:Largo Fino 50 LB -Bolsa Dos Hermanos.;;4.0;27.85;111.4;4584773.39;Bulk Rice;Lisset Limpio -020;Cafeteria;1390158;Aug
2025-08-11;El Palacio de los jugos / Delicias Criollas (DIAGO FOOD_MILLER);Invoice;008-06213;Arroz a Granel:Parboiled 50 LB -Bolsa Dos Hermanos.;;14.0;26.75;374.5;4585147.89;Bulk Rice;Lisset Limpio -020;Cafeteria;1390159;Aug
2025-08-13;Sabor Tropical Supermarket #4;Invoice;008-06214;Arroz Envasado:Parboiled 5KG Dos Hermanos.;6  11lbs;15.0;46.5;697.5;4585845.39;Branded Rice;Keila Alfaro-Visvikis;RETAIL  DSD;1390160;Aug
2025-08-13;Sabor Tropical Supermarket #4;Invoice;008-06214;Arroz Envasado:Parboiled 5KG Dos Hermanos.;6  11lbs;7.0;46.5;325.5;4586170.89;Branded Rice;Keila Alfaro-Visvikis;RETAIL  DSD;1390161;Aug
2025-08-13;Rey Chavez Distributor #2;Invoice;008-06215;Arroz a Granel:Parboiled 50 LB -Bolsa Dos Hermanos.;;25.0;27.5;687.5;4586858.39;Bulk Rice;Lisset Limpio -020;WHOLESALER;1390162;Aug
2025-08-13;Sedanos Supermarkets  #11;Invoice;008-06216;Arroz Envasado:Largo Fino 1kg (Long grain rice) Dos Hermanos;;1.0;17.5;17.5;4586875.89;Branded Rice;Keila Alfaro-Visvikis;RETAIL SEDANOS;1390163;Aug
2025-08-13;Sedanos Supermarkets  #11;Invoice;008-06216;Varios:Promotional Allowance;;1.0;-2.5;-2.5;4586873.39;Branded Rice;Keila Alfaro-Visvikis;RETAIL SEDANOS;1390164;Aug
2025-08-13;Sedanos Supermarkets  #11;Invoice;008-06216;Arroz Envasado:Parboiled 1kg Bolsa Dos Hermanos.;.;1.0;19.9;19.9;4586893.29;Branded Rice;Keila Alfaro-Visvikis;RETAIL SEDANOS;1390165;Aug
2025-08-13;Sedanos Supermarkets  #11;Invoice;008-06216;Varios:Promotional Allowance;;1.0;-5.0;-5.0;4586888.29;Branded Rice;Keila Alfaro-Visvikis;RETAIL SEDANOS;1390166;Aug
2025-08-13;Sedanos Supermarkets  #11;Invoice;008-06216;Spanish Style Yellow Rice:AS Spanish Style Yellow Rice;AS Spanish Style Yellow Rice 6 / 3.25 oz;1.0;34.5;34.5;4586922.79;American Spice;Keila Alfaro-Visvikis;RETAIL SEDANOS;1390167;Aug
2025-08-13;Sedanos Supermarkets  #11;Invoice;008-06216;Varios:Promotional Allowance;;1.0;-4.5;-4.5;4586918.29;American Spice;Keila Alfaro-Visvikis;RETAIL SEDANOS;1390168;Aug
2025-08-13;Sedanos Supermarkets  #11;Invoice;008-06216;Arroz Envasado:Long Rice 10 LB Dos Hermanos;;10.0;35.5;355.0;4587273.29;Branded Rice;Keila Alfaro-Visvikis;RETAIL SEDANOS;1390169;Aug
2025-08-13;Sedanos Supermarkets  #11;Invoice;008-06216;Varios:Promotional Allowance;;10.0;-3.2;-32.0;4587241.29;Branded Rice;Keila Alfaro-Visvikis;RETAIL SEDANOS;1390170;Aug
2025-08-13;ALS Foods;Invoice;008-06217;Liquids:AS Bitter Orange;4 / 1 gl.;1.0;15.9;15.9;4587257.19;American Spice;Lisset Limpio -020;CAFETERIA y RESTAURANTS;1390171;Aug
2025-08-13;ALS Foods;Invoice;008-06217;Arroz a Granel:Largo Fino 50 LB -Bolsa Dos Hermanos.;;6.0;27.85;167.1;4587424.29;Bulk Rice;Lisset Limpio -020;CAFETERIA y RESTAURANTS;1390172;Aug
2025-08-13;ALS Foods;Invoice;008-06217;Arroz a Granel:Parboiled 50 LB -Bolsa Dos Hermanos.;;11.0;27.75;305.25;4587729.54;Bulk Rice;Lisset Limpio -020;CAFETERIA y RESTAURANTS;1390173;Aug
2025-08-13;ALS Foods;Invoice;008-06217;Arroz a Granel:Parboiled 50 LB -Bolsa Dos Hermanos.;;1.0;27.75;27.75;4587757.29;Bulk Rice;Lisset Limpio -020;CAFETERIA y RESTAURANTS;1390174;Aug
2025-08-13;Sedanos Supermarkets #16;Invoice;008-06218;Arroz a Granel:Parboiled 50 LB -Bolsa Dos Hermanos.;;4.0;28.25;113.0;4587870.29;Bulk Rice;Keila Alfaro-Visvikis;RETAIL SEDANOS;1390175;Aug
2025-08-13;Sedanos Supermarkets #10;Invoice;008-06220;Arroz Envasado:Parboiled 1kg Bolsa Dos Hermanos.;.;2.0;19.9;39.8;4587910.09;Branded Rice;Keila Alfaro-Visvikis;RETAIL SEDANOS;1390176;Aug
2025-08-13;Sedanos Supermarkets #10;Invoice;008-06220;Varios:Promotional Allowance;;2.0;-5.0;-10.0;4587900.09;Branded Rice;Keila Alfaro-Visvikis;RETAIL SEDANOS;1390177;Aug
2025-08-13;Sedanos Supermarkets #10;Invoice;008-06220;Arroz Envasado:Long Rice 10 LB Dos Hermanos;;10.0;35.5;355.0;4588255.09;Branded Rice;Keila Alfaro-Visvikis;RETAIL SEDANOS;1390178;Aug
2025-08-13;Sedanos Supermarkets #10;Invoice;008-06220;Varios:Promotional Allowance;;10.0;-3.2;-32.0;4588223.09;Branded Rice;Keila Alfaro-Visvikis;RETAIL SEDANOS;1390179;Aug
2025-08-13;Sedanos Supermarkets #43;Invoice;008-06221;Arroz a Granel:Parboiled 50 LB -Bolsa Dos Hermanos.;;4.0;28.25;113.0;4588336.09;Bulk Rice;Keila Alfaro-Visvikis;RETAIL SEDANOS;1390180;Aug
2025-08-13;Gala Fresh Farms - Boca Ratón;Invoice;008-06222;Arroz Envasado:Long Rice 10 LB Dos Hermanos;;15.0;35.5;532.5;4588868.59;Branded Rice;Keila Alfaro-Visvikis;RETAIL  DSD;1390181;Aug
2025-08-13;Gala Fresh Farms - Boca Ratón;Invoice;008-06222;Arroz Envasado:Long Rice 10 LB Dos Hermanos;;3.0;35.5;106.5;4588975.09;Branded Rice;Keila Alfaro-Visvikis;RETAIL  DSD;1390182;Aug
2025-08-13;Sedanos Supermarkets #27;Invoice;008-06223;Arroz Envasado:Largo Fino 1kg (Long grain rice) Dos Hermanos;;1.0;18.0;18.0;4588993.09;Branded Rice;Keila Alfaro-Visvikis;RETAIL SEDANOS;1390183;Aug
2025-08-13;Sedanos Supermarkets #27;Invoice;008-06223;Varios:Promotional Allowance;;1.0;-2.5;-2.5;4588990.59;Branded Rice;Keila Alfaro-Visvikis;RETAIL SEDANOS;1390184;Aug
2025-08-13;Sedanos Supermarkets #27;Invoice;008-06223;Spanish Style Yellow Rice:AS Spanish Style Yellow Rice;AS Spanish Style Yellow Rice 6 / 3.25 oz;1.0;34.5;34.5;4589025.09;American Spice;Keila Alfaro-Visvikis;RETAIL SEDANOS;1390185;Aug
2025-08-13;Sedanos Supermarkets #27;Invoice;008-06223;Varios:Promotional Allowance;;1.0;-4.5;-4.5;4589020.59;American Spice;Keila Alfaro-Visvikis;RETAIL SEDANOS;1390186;Aug
2025-08-13;Sedanos Supermarkets #27;Invoice;008-06223;Arroz Envasado:Long Rice 10 LB Dos Hermanos;;10.0;35.5;355.0;4589375.59;Branded Rice;Keila Alfaro-Visvikis;RETAIL SEDANOS;1390187;Aug
2025-08-13;Sedanos Supermarkets #27;Invoice;008-06223;Varios:Promotional Allowance;;10.0;-3.2;-32.0;4589343.59;Branded Rice;Keila Alfaro-Visvikis;RETAIL SEDANOS;1390188;Aug
2025-08-13;Sedanos Supermarkets #24;Invoice;008-06224;Arroz Envasado:Largo Fino 1kg (Long grain rice) Dos Hermanos;;1.0;17.5;17.5;4589361.09;Branded Rice;Keila Alfaro-Visvikis;RETAIL SEDANOS;1390189;Aug
2025-08-13;Sedanos Supermarkets #24;Invoice;008-06224;Varios:Promotional Allowance;;1.0;-2.5;-2.5;4589358.59;Branded Rice;Keila Alfaro-Visvikis;RETAIL SEDANOS;1390190;Aug
2025-08-13;Sedanos Supermarkets #24;Invoice;008-06224;Arroz Envasado:Parboiled 1kg Bolsa Dos Hermanos.;.;1.0;19.9;19.9;4589378.49;Branded Rice;Keila Alfaro-Visvikis;RETAIL SEDANOS;1390191;Aug
2025-08-13;Sedanos Supermarkets #24;Invoice;008-06224;Varios:Promotional Allowance;;1.0;-5.0;-5.0;4589373.49;Branded Rice;Keila Alfaro-Visvikis;RETAIL SEDANOS;1390192;Aug
2025-08-13;Sedanos Supermarkets #24;Invoice;008-06224;Spanish Style Yellow Rice:AS Spanish Style Yellow Rice;AS Spanish Style Yellow Rice 6 / 3.25 oz;1.0;34.5;34.5;4589407.99;American Spice;Keila Alfaro-Visvikis;RETAIL SEDANOS;1390193;Aug
2025-08-13;Sedanos Supermarkets #24;Invoice;008-06224;Varios:Promotional Allowance;;1.0;-4.5;-4.5;4589403.49;American Spice;Keila Alfaro-Visvikis;RETAIL SEDANOS;1390194;Aug
2025-08-13;Sedanos Supermarkets #24;Invoice;008-06224;Arroz Envasado:Long Rice 10 LB Dos Hermanos;;10.0;35.5;355.0;4589758.49;Branded Rice;Keila Alfaro-Visvikis;RETAIL SEDANOS;1390195;Aug
2025-08-13;Sedanos Supermarkets #24;Invoice;008-06224;Varios:Promotional Allowance;;10.0;-3.2;-32.0;4589726.49;Branded Rice;Keila Alfaro-Visvikis;RETAIL SEDANOS;1390196;Aug
2025-08-13;Key Food / Holywood;Invoice;008-06225;Arroz Envasado:Long Rice 10 LB Dos Hermanos;;5.0;35.5;177.5;4589903.99;Branded Rice;Keila Alfaro-Visvikis;RETAIL  DSD;1390197;Aug
2025-08-13;Key Food / Holywood;Invoice;008-06225;Arroz Envasado:Long Rice 10 LB Dos Hermanos;;1.0;35.5;35.5;4589939.49;Branded Rice;Keila Alfaro-Visvikis;RETAIL  DSD;1390198;Aug
2025-08-13;Sabor Tropical Supermarket #4;Credit Memo;008-06269;Varios:Promotional Allowance;Arroz Envasado:Parboiled 5KG Dos Hermanos.;-7.0;46.5;-325.5;4589613.99;Bulk Rice;Keila Alfaro-Visvikis;RETAIL  DSD;1390199;Aug
2025-08-13;ALS Foods;Credit Memo;008-06270;Varios:Promotional Allowance;Arroz a Granel:Parboiled 50 LB -Bolsa Dos Hermanos.;-1.0;27.75;-27.75;4589586.24;Bulk Rice;Lisset Limpio -020;CAFETERIA y RESTAURANTS;1390200;Aug
2025-08-13;Gala Fresh Farms - Boca Ratón;Credit Memo;008-06271;Varios:Promotional Allowance;Arroz Envasado:Long Rice 10 LB Dos Hermanos;-3.0;35.5;-106.5;4589479.74;Bulk Rice;Keila Alfaro-Visvikis;RETAIL  DSD;1390201;Aug
2025-08-13;Key Food / Holywood;Credit Memo;008-06272;Varios:Promotional Allowance;Arroz Envasado:Long Rice 10 LB Dos Hermanos;-1.0;35.5;-35.5;4589444.24;Branded Rice;Keila Alfaro-Visvikis;RETAIL  DSD;1390202;Aug
2025-08-15;Mei Chang;Invoice;008-06226;Arroz a Granel:Parboiled 50 LB -Bolsa Dos Hermanos.;;7.0;28.25;197.75;4589641.99;Bulk Rice;Lisset Limpio -020;CAFETERIA y RESTAURANTS;1390203;Aug
2025-08-15;Soriano Brothers PB;Invoice;008-06227;Liquids:AS Lemon Juice 4/1 Gl;;3.0;14.95;44.85;4589686.84;American Spice;Lisset Limpio -020;CAFETERIA y RESTAURANTS;1390204;Aug
2025-08-15;Soriano Brothers PB;Invoice;008-06227;Liquids:AS White Vinegar;4/1 Gl.;2.0;9.5;19.0;4589705.84;American Spice;Lisset Limpio -020;CAFETERIA y RESTAURANTS;1390205;Aug
2025-08-15;Soriano Brothers PB;Invoice;008-06227;Spices:AS Sazon (for all);1 / 30 lb (box or pail);2.0;59.0;118.0;4589823.84;American Spice;Lisset Limpio -020;CAFETERIA y RESTAURANTS;1390206;Aug
2025-08-15;Soriano Brothers PB;Invoice;008-06227;Arroz a Granel:Parboiled 50 LB -Bolsa Dos Hermanos.;;11.0;27.75;305.25;4590129.09;Bulk Rice;Lisset Limpio -020;CAFETERIA y RESTAURANTS;1390207;Aug
2025-08-15;Soriano Brothers PB;Invoice;008-06227;Arroz a Granel:Largo Fino 50 LB -Bolsa Dos Hermanos.;;10.0;27.85;278.5;4590407.59;Bulk Rice;Lisset Limpio -020;CAFETERIA y RESTAURANTS;1390208;Aug
2025-08-15;Soriano Brothers PB;Invoice;008-06227;Arroz a Granel:Parboiled 50 LB -Bolsa Dos Hermanos.;;1.0;27.75;27.75;4590435.34;Bulk Rice;Lisset Limpio -020;CAFETERIA y RESTAURANTS;1390209;Aug
2025-08-15;Bravo   Francisco Diaz;Invoice;008-06228;Arroz a Granel:Largo Fino 50 LB -Bolsa Dos Hermanos.;;5.0;27.85;139.25;4590574.59;Bulk Rice;Lisset Limpio -020;RETAIL  DSD;1390210;Aug
2025-08-15;El Gallego Supermarket;Invoice;008-06229;Liquids:AS Bitter Orange;4 / 1 gl.;2.0;14.0;28.0;4590602.59;American Spice;Lisset Limpio -020;RETAIL  DSD;1390211;Aug
2025-08-15;El Gallego Supermarket;Invoice;008-06229;Arroz a Granel:Parboiled 50 LB -Bolsa Dos Hermanos.;;5.0;26.75;133.75;4590736.34;Bulk Rice;Lisset Limpio -020;RETAIL  DSD;1390212;Aug
2025-08-15;El Gallego Supermarket;Invoice;008-06229;Dry Beans:Dry Beans - Black Beans 50;Dry Black Beans 50 lb;2.0;35.0;70.0;4590806.34;Dry Beans;Lisset Limpio -020;RETAIL  DSD;1390213;Aug
2025-08-15;El Gallego Supermarket;Invoice;008-06229;Arroz Envasado:Long Rice 10 LB Dos Hermanos;;6.0;35.5;213.0;4591019.34;Branded Rice;Lisset Limpio -020;RETAIL  DSD;1390214;Aug
2025-08-15;El Gallego Supermarket;Invoice;008-06229;Arroz Envasado:Long Rice 10 LB Dos Hermanos;;1.0;35.5;35.5;4591054.84;Branded Rice;Lisset Limpio -020;RETAIL  DSD;1390215;Aug
2025-08-15;El Palacio de los jugos /  Nanos Latin Foods;Invoice;008-06230;Arroz a Granel:Largo Fino 50 LB -Bolsa Dos Hermanos.;;5.0;27.85;139.25;4591194.09;Bulk Rice;Lisset Limpio -020;Cafeteria;1390216;Aug
2025-08-15;El Palacio de los jugos /  Nanos Latin Foods;Invoice;008-06230;Arroz a Granel:Parboiled 50 LB -Bolsa Dos Hermanos.;;7.0;26.75;187.25;4591381.34;Bulk Rice;Lisset Limpio -020;Cafeteria;1390217;Aug
2025-08-15;El Palacio de los jugos / Caribe Tropical;Invoice;008-06231;Arroz a Granel:Parboiled 50 LB -Bolsa Dos Hermanos.;;6.0;26.75;160.5;4591541.84;Bulk Rice;Lisset Limpio -020;Cafeteria;1390218;Aug
2025-08-15;El Palacio de Los Jugos / Casa mía Food Restaurant inc;Invoice;008-06232;Arroz a Granel:Parboiled 50 LB -Bolsa Dos Hermanos.;;10.0;26.75;267.5;4591809.34;Bulk Rice;Lisset Limpio -020;Cafeteria;1390219;Aug
2025-08-15;El Palacio de los jugos / Divan and Denise Food;Invoice;008-06233;Arroz a Granel:Parboiled 50 LB -Bolsa Dos Hermanos.;;5.0;26.75;133.75;4591943.09;Bulk Rice;Lisset Limpio -020;Cafeteria;1390220;Aug
2025-08-15;El Palacio de los jugos / Lita Foods Inc.;Invoice;008-06234;Arroz a Granel:Parboiled 50 LB -Bolsa Dos Hermanos.;;11.0;27.75;305.25;4592248.34;Bulk Rice;Lisset Limpio -020;Cafeteria;1390221;Aug
2025-08-15;El Palacio de los jugos / Lita Foods Inc.;Invoice;008-06234;Dry Beans:Dry Beans - Black Beans 50;Dry Black Beans 50 lb;1.0;34.0;34.0;4592282.34;Dry Beans;Lisset Limpio -020;Cafeteria;1390222;Aug
2025-08-15;El Palacio de los jugos / Lita Foods Inc.;Invoice;008-06234;Arroz a Granel:Parboiled 50 LB -Bolsa Dos Hermanos.;;1.0;27.75;27.75;4592310.09;Bulk Rice;Lisset Limpio -020;Cafeteria;1390223;Aug
2025-08-15;El Palacio de los jugos / Leti Corp.;Invoice;008-06235;Arroz a Granel:Largo Fino 50 LB -Bolsa Dos Hermanos.;;3.0;27.85;83.55;4592393.64;Bulk Rice;Lisset Limpio -020;Cafeteria;1390224;Aug
2025-08-15;El Palacio de los jugos / Leti Corp.;Invoice;008-06235;Arroz a Granel:Parboiled 50 LB -Bolsa Dos Hermanos.;;8.0;26.75;214.0;4592607.64;Bulk Rice;Lisset Limpio -020;Cafeteria;1390225;Aug
2025-08-15;Sedanos Supermarkets #33;Invoice;008-06236;Arroz a Granel:Parboiled 50 LB -Bolsa Dos Hermanos.;;3.0;28.25;84.75;4592692.39;Bulk Rice;Keila Alfaro-Visvikis;RETAIL SEDANOS;1390226;Aug
2025-08-15;Sedanos Supermarkets #33;Invoice;008-06237;Arroz Envasado:Long Rice 10 LB Dos Hermanos;;15.0;35.5;532.5;4593224.89;Branded Rice;Keila Alfaro-Visvikis;RETAIL SEDANOS;1390227;Aug
2025-08-15;Sedanos Supermarkets #33;Invoice;008-06237;Varios:Promotional Allowance;;15.0;-3.2;-48.0;4593176.89;Branded Rice;Keila Alfaro-Visvikis;RETAIL SEDANOS;1390228;Aug
2025-08-15;Bravo supermarket Coral Way 26 th;Invoice;008-06238;Arroz Envasado:Long Rice 10 LB Dos Hermanos;;6.0;35.5;213.0;4593389.89;Branded Rice;Lisset Limpio -020;RETAIL  DSD;1390229;Aug
2025-08-15;Bravo supermarket Coral Way 26 th;Invoice;008-06238;Arroz Envasado:Long Rice 10 LB Dos Hermanos;;1.0;35.5;35.5;4593425.39;Branded Rice;Lisset Limpio -020;RETAIL  DSD;1390230;Aug
2025-08-15;Sedanos Supermarkets #31;Invoice;008-06239;Arroz Envasado:Largo Fino 1kg (Long grain rice) Dos Hermanos;;1.0;17.5;17.5;4593442.89;Branded Rice;Keila Alfaro-Visvikis;RETAIL SEDANOS;1390231;Aug
2025-08-15;Sedanos Supermarkets #31;Invoice;008-06239;Arroz Envasado:Parboiled 1kg Bolsa Dos Hermanos.;.;2.0;19.9;39.8;4593482.69;Branded Rice;Keila Alfaro-Visvikis;RETAIL SEDANOS;1390232;Aug
2025-08-15;Sedanos Supermarkets #31;Invoice;008-06239;Spanish Style Yellow Rice:AS Spanish Style Yellow Rice;AS Spanish Style Yellow Rice 6 / 3.25 oz;1.0;34.5;34.5;4593517.19;American Spice;Keila Alfaro-Visvikis;RETAIL SEDANOS;1390233;Aug
2025-08-15;Sedanos Supermarkets #31;Invoice;008-06239;Arroz Envasado:Long Rice 10 LB Dos Hermanos;;30.0;35.5;1065.0;4594582.19;Branded Rice;Keila Alfaro-Visvikis;RETAIL SEDANOS;1390234;Aug
2025-08-15;Sedanos Supermarkets #31;Invoice;008-06239;Varios:Promotional Allowance;DH Long Grain Rice 10lb.;30.0;-3.2;-96.0;4594486.19;Branded Rice;Keila Alfaro-Visvikis;RETAIL SEDANOS;1390235;Aug
2025-08-15;Sedanos Supermarkets #31;Invoice;008-06239;Varios:Promotional Allowance;Long Grain 1 K;1.0;-2.5;-2.5;4594483.69;Branded Rice;Keila Alfaro-Visvikis;RETAIL SEDANOS;1390236;Aug
2025-08-15;Sedanos Supermarkets #31;Invoice;008-06239;Varios:Promotional Allowance;Parboiled 1 K;2.0;-5.0;-10.0;4594473.69;Branded Rice;Keila Alfaro-Visvikis;RETAIL SEDANOS;1390237;Aug
2025-08-15;Sedanos Supermarkets #31;Invoice;008-06239;Varios:Promotional Allowance;AS SEASONED Yellow Rice;1.0;-4.5;-4.5;4594469.19;American Spice;Keila Alfaro-Visvikis;RETAIL SEDANOS;1390238;Aug
2025-08-15;Food-Star Supermarket;Invoice;008-06240;Arroz Envasado:Long Rice 10 LB Dos Hermanos;;6.0;35.5;213.0;4594682.19;Branded Rice;Lisset Limpio -020;RETAIL  DSD;1390239;Aug
2025-08-15;Food-Star Supermarket;Invoice;008-06240;Arroz Envasado:Long Rice 10 LB Dos Hermanos;;1.0;35.5;35.5;4594717.69;Branded Rice;Lisset Limpio -020;RETAIL  DSD;1390240;Aug
2025-08-15;Los Caringas Latin America  Foods;Invoice;008-06241;Arroz a Granel:Largo Fino 50 LB -Bolsa Dos Hermanos.;;3.0;27.85;83.55;4594801.24;Bulk Rice;Lisset Limpio -020;CAFETERIA y RESTAURANTS;1390241;Aug
2025-08-15;Los Caringas Latin America  Foods;Invoice;008-06241;Arroz a Granel:Parboiled 50 LB -Bolsa Dos Hermanos.;;3.0;28.25;84.75;4594885.99;Bulk Rice;Lisset Limpio -020;CAFETERIA y RESTAURANTS;1390242;Aug
2025-08-15;Sedanos Supermarkets #31;Invoice;008-06242;Arroz a Granel:Parboiled 50 LB -Bolsa Dos Hermanos.;;6.0;28.25;169.5;4595055.49;Bulk Rice;Keila Alfaro-Visvikis;RETAIL SEDANOS;1390243;Aug
2025-08-15;El Palacio de los jugos / Rodriguez Foods;Invoice;008-06243;Arroz a Granel:Parboiled 50 LB -Bolsa Dos Hermanos.;;8.0;26.75;214.0;4595269.49;Bulk Rice;Lisset Limpio -020;Cafeteria;1390244;Aug
2025-08-15;Soriano Brothers PB;Credit Memo;008-06273;Varios:Promotional Allowance;Arroz a Granel:Parboiled 50 LB -Bolsa Dos Hermanos.;-1.0;27.75;-27.75;4595241.74;Bulk Rice;Lisset Limpio -020;CAFETERIA y RESTAURANTS;1390245;Aug
2025-08-15;El Gallego Supermarket;Credit Memo;008-06274;Varios:Promotional Allowance;Arroz Envasado:Long Rice 10 LB Dos Hermanos;-1.0;35.5;-35.5;4595206.24;Branded Rice;Lisset Limpio -020;RETAIL  DSD;1390246;Aug
2025-08-15;El Palacio de los jugos / Lita Foods Inc.;Credit Memo;008-06275;Varios:Promotional Allowance;Arroz a Granel:Parboiled 50 LB -Bolsa Dos Hermanos.;-1.0;27.75;-27.75;4595178.49;Bulk Rice;Lisset Limpio -020;Cafeteria;1390247;Aug
2025-08-15;Bravo supermarket Coral Way 26 th;Credit Memo;008-06276;Varios:Promotional Allowance;Arroz Envasado:Long Rice 10 LB Dos Hermanos;-1.0;35.5;-35.5;4595142.99;Branded Rice;Lisset Limpio -020;RETAIL  DSD;1390248;Aug
2025-08-15;Food-Star Supermarket;Credit Memo;008-06277;Varios:Promotional Allowance;Arroz Envasado:Long Rice 10 LB Dos Hermanos;-1.0;35.5;-35.5;4595107.49;Branded Rice;Lisset Limpio -020;RETAIL  DSD;1390249;Aug
2025-08-15;Bravo Supermarkets Palm Bay;Credit Memo;008-06278;Varios:Promotional Allowance;Arroz a Granel:Largo Fino 50 LB -Bolsa Dos Hermanos.;-1.0;35.5;-35.5;4595071.99;Bulk Rice;# Orlando 0024;RETAIL  DSD;1390250;Aug
2025-08-15;Bravo Supermarkets Palm Bay;Credit Memo;008-06278;Varios:Promotional Allowance;Arroz Envasado:Parboiled 5KG Dos Hermanos.;-7.0;46.5;-325.5;4594746.49;Branded Rice;# Orlando 0024;RETAIL  DSD;1390251;Aug
2025-08-16;Bravo Supermarkets Palm Bay;Invoice;008-06244;Arroz Envasado:Parboiled 5KG Dos Hermanos.;6  11lbs;15.0;46.5;697.5;4595443.99;Branded Rice;# Orlando 0024;RETAIL  DSD;1390252;Aug
2025-08-16;Bravo Supermarkets Palm Bay;Invoice;008-06244;Arroz Envasado:Long Rice 10 LB Dos Hermanos;;1.0;35.5;35.5;4595479.49;Branded Rice;# Orlando 0024;RETAIL  DSD;1390253;Aug
2025-08-16;Bravo Supermarkets Palm Bay;Invoice;008-06244;Arroz a Granel:Largo Fino 50 LB -Bolsa Dos Hermanos.;;1.0;27.85;27.85;4595507.34;Bulk Rice;# Orlando 0024;RETAIL  DSD;1390254;Aug
2025-08-16;Bravo Supermarkets Palm Bay;Invoice;008-06244;Arroz Envasado:Parboiled 5KG Dos Hermanos.;6  11lbs;7.0;46.5;325.5;4595832.84;Branded Rice;# Orlando 0024;RETAIL  DSD;1390255;Aug
2025-08-16;BRAVO 5100 Lake Worth Road;Invoice;008-06245;Arroz Envasado:Parboiled 5KG Dos Hermanos.;6  11lbs;20.0;46.5;930.0;4596762.84;Branded Rice;Keila Alfaro-Visvikis;RETAIL BRAVO;1390256;Aug
2025-08-16;BRAVO 5100 Lake Worth Road;Invoice;008-06245;Arroz Envasado:Parboiled 5KG Dos Hermanos.;6  11lbs;20.0;46.5;930.0;4597692.84;Branded Rice;Keila Alfaro-Visvikis;RETAIL BRAVO;1390257;Aug
2025-08-16;BRAVO 5100 Lake Worth Road;Invoice;008-06245;Arroz Envasado:Long Rice 10 LB Dos Hermanos;;5.0;35.5;177.5;4597870.34;Branded Rice;Keila Alfaro-Visvikis;RETAIL BRAVO;1390258;Aug
2025-08-16;BRAVO 5100 Lake Worth Road;Invoice;008-06245;Arroz Envasado:Long Rice 10 LB Dos Hermanos;;1.0;35.5;35.5;4597905.84;Branded Rice;Keila Alfaro-Visvikis;RETAIL BRAVO;1390259;Aug
2025-08-16;Brother´s Meat Market;Invoice;008-06246;Arroz Envasado:Long Rice 10 LB Dos Hermanos;;1.0;35.5;35.5;4597941.34;Branded Rice;Armando Carpio - 017;RETAIL  DSD;1390260;Aug
2025-08-16;Brother´s Meat Market;Invoice;008-06246;Arroz Envasado:Parboiled 5KG Dos Hermanos.;6  11lbs;10.0;46.5;465.0;4598406.34;Branded Rice;Armando Carpio - 017;RETAIL  DSD;1390261;Aug
2025-08-16;Brother´s Meat Market;Invoice;008-06246;Arroz Envasado:Parboiled 5KG Dos Hermanos.;6  11lbs;5.0;46.5;232.5;4598638.84;Branded Rice;Armando Carpio - 017;RETAIL  DSD;1390262;Aug
2025-08-16;Sedanos Supermarkets #40;Invoice;008-06247;Arroz Envasado:Parboiled 5KG Dos Hermanos.;6  11lbs;21.0;40.5;850.5;4599489.34;Branded Rice;# Orlando 0024;RETAIL SEDANOS;1390263;Aug
2025-08-16;Sedanos Supermarkets #40;Invoice;008-06247;Arroz Envasado:Largo Fino 1kg (Long grain rice) Dos Hermanos;;3.0;17.5;52.5;4599541.84;Branded Rice;# Orlando 0024;RETAIL SEDANOS;1390264;Aug
2025-08-16;Sedanos Supermarkets #40;Invoice;008-06247;Varios:Promotional Allowance;;3.0;-2.5;-7.5;4599534.34;Branded Rice;# Orlando 0024;RETAIL SEDANOS;1390265;Aug
2025-08-16;Sedanos Supermarkets #40;Invoice;008-06247;Arroz Envasado:Parboiled 1kg Bolsa Dos Hermanos.;.;2.0;19.9;39.8;4599574.14;Branded Rice;# Orlando 0024;RETAIL SEDANOS;1390266;Aug
2025-08-16;Sedanos Supermarkets #40;Invoice;008-06247;Varios:Promotional Allowance;;2.0;-5.0;-10.0;4599564.14;Branded Rice;# Orlando 0024;RETAIL SEDANOS;1390267;Aug
2025-08-16;Sedanos Supermarkets #40;Invoice;008-06247;Arroz Envasado:Parboiled 5KG Dos Hermanos.;6  11lbs;20.0;40.5;810.0;4600374.14;Branded Rice;# Orlando 0024;RETAIL SEDANOS;1390268;Aug
2025-08-16;Sedanos Supermarkets #40;Invoice;008-06247;Arroz Envasado:Long Rice 10 LB Dos Hermanos;;35.0;35.5;1242.5;4601616.64;Branded Rice;# Orlando 0024;RETAIL SEDANOS;1390269;Aug
2025-08-16;Sedanos Supermarkets #40;Invoice;008-06247;Varios:Promotional Allowance;;35.0;-3.2;-112.0;4601504.64;Branded Rice;# Orlando 0024;RETAIL SEDANOS;1390270;Aug
2025-08-16;Sedanos Supermarkets #40;Invoice;008-06247;Spanish Style Yellow Rice:AS Spanish Style Yellow Rice;AS Spanish Style Yellow Rice 6 / 3.25 oz;2.0;34.5;69.0;4601573.64;American Spice;# Orlando 0024;RETAIL SEDANOS;1390271;Aug
2025-08-16;Sedanos Supermarkets #40;Invoice;008-06247;Varios:Promotional Allowance;;2.0;-4.5;-9.0;4601564.64;American Spice;# Orlando 0024;RETAIL SEDANOS;1390272;Aug
2025-08-16;Sedanos Supermarkets #41;Invoice;008-06248;Arroz Envasado:Parboiled 5KG Dos Hermanos.;6  11lbs;21.0;40.5;850.5;4602415.14;Branded Rice;# Orlando 0024;RETAIL SEDANOS;1390273;Aug
2025-08-16;Sedanos Supermarkets #41;Invoice;008-06248;Arroz Envasado:Parboiled 5KG Dos Hermanos.;6  11lbs;20.0;40.5;810.0;4603225.14;Branded Rice;# Orlando 0024;RETAIL SEDANOS;1390274;Aug
2025-08-16;Sedanos Supermarkets #41;Invoice;008-06248;Arroz Envasado:Long Rice 10 LB Dos Hermanos;;30.0;35.5;1065.0;4604290.14;Branded Rice;# Orlando 0024;RETAIL SEDANOS;1390275;Aug
2025-08-16;Sedanos Supermarkets #41;Invoice;008-06248;Varios:Promotional Allowance;;30.0;-3.2;-96.0;4604194.14;Branded Rice;# Orlando 0024;RETAIL SEDANOS;1390276;Aug
2025-08-16;Sedanos Supermarkets #41;Invoice;008-06248;Arroz Envasado:Largo Fino 1kg (Long grain rice) Dos Hermanos;;3.0;17.5;52.5;4604246.64;Branded Rice;# Orlando 0024;RETAIL SEDANOS;1390277;Aug
2025-08-16;Sedanos Supermarkets #41;Invoice;008-06248;Varios:Promotional Allowance;;3.0;-2.5;-7.5;4604239.14;Branded Rice;# Orlando 0024;RETAIL SEDANOS;1390278;Aug
2025-08-16;Sedanos Supermarkets #41;Invoice;008-06248;Arroz Envasado:Parboiled 1kg Bolsa Dos Hermanos.;.;2.0;19.9;39.8;4604278.94;Branded Rice;# Orlando 0024;RETAIL SEDANOS;1390279;Aug
2025-08-16;Sedanos Supermarkets #41;Invoice;008-06248;Varios:Promotional Allowance;;2.0;-5.0;-10.0;4604268.94;Branded Rice;# Orlando 0024;RETAIL SEDANOS;1390280;Aug
2025-08-16;Sedanos Supermarkets #41;Invoice;008-06248;Spanish Style Yellow Rice:AS Spanish Style Yellow Rice;AS Spanish Style Yellow Rice 6 / 3.25 oz;2.0;34.5;69.0;4604337.94;American Spice;# Orlando 0024;RETAIL SEDANOS;1390281;Aug
2025-08-16;Sedanos Supermarkets #41;Invoice;008-06248;Varios:Promotional Allowance;;2.0;-4.5;-9.0;4604328.94;American Spice;# Orlando 0024;RETAIL SEDANOS;1390282;Aug
2025-08-16;Festival Supermarket #35- Southgate;Invoice;008-06249;Arroz Envasado:Long Rice 10 LB Dos Hermanos;;1.0;35.5;35.5;4604364.44;Branded Rice;Keila Alfaro-Visvikis;RETAIL  DSD;1390283;Aug
2025-08-16;BRAVO 5100 Lake Worth Road;Credit Memo;008-06279;Varios:Promotional Allowance;Arroz Envasado:Long Rice 10 LB Dos Hermanos;-1.0;35.5;-35.5;4604328.94;Branded Rice;Keila Alfaro-Visvikis;RETAIL BRAVO;1390284;Aug
2025-08-16;Brother´s Meat Market;Credit Memo;008-06280;Varios:Promotional Allowance;Arroz Envasado:Parboiled 10 LB Dos Hermanos;-5.0;46.5;-232.5;4604096.44;Branded Rice;Armando Carpio - 017;RETAIL  DSD;1390285;Aug
2025-08-16;BRAVO 5100 Lake Worth Road;Credit Memo;008-06281;Varios:Promotional Allowance;Arroz Envasado:Parboiled 10 LB Dos Hermanos;-20.0;46.5;-930.0;4603166.44;Branded Rice;Keila Alfaro-Visvikis;RETAIL BRAVO;1390286;Aug
2025-08-16;Sedanos Supermarkets #40;Credit Memo;008-06282;Varios:Promotional Allowance;Arroz Envasado:Parboiled 5KG Dos Hermanos.;-20.0;40.5;-810.0;4602356.44;Branded Rice;# Orlando 0024;RETAIL SEDANOS;1390287;Aug
2025-08-16;Sedanos Supermarkets #41;Credit Memo;008-06283;Varios:Promotional Allowance;Arroz Envasado:Parboiled 5KG Dos Hermanos.;-20.0;40.5;-810.0;4601546.44;Branded Rice;# Orlando 0024;RETAIL SEDANOS;1390288;Aug
2025-08-17;El Palacio de los jugos /  Nanos Latin Foods;Invoice;008-06250;Arroz a Granel:Largo Fino 50 LB -Bolsa Dos Hermanos.;;5.0;27.85;139.25;4601685.69;Bulk Rice;Lisset Limpio -020;Cafeteria;1390289;Aug
2025-08-17;El Palacio de los jugos /  Nanos Latin Foods;Invoice;008-06250;Arroz a Granel:Parboiled 50 LB -Bolsa Dos Hermanos.;;8.0;26.75;214.0;4601899.69;Bulk Rice;Lisset Limpio -020;Cafeteria;1390290;Aug
2025-08-17;El Palacio de los jugos / Lita Foods Inc.;Invoice;008-06251;Arroz a Granel:Parboiled 50 LB -Bolsa Dos Hermanos.;;5.0;26.75;133.75;4602033.44;Bulk Rice;Lisset Limpio -020;Cafeteria;1390291;Aug
2025-08-17;Be Your Will LLC;Invoice;008-06252;Arroz a Granel:Largo Fino 50 LB -Bolsa Dos Hermanos.;;6.0;27.85;167.1;4602200.54;Bulk Rice;Lisset Limpio -020;CAFETERIA y RESTAURANTS;1390292;Aug
2025-08-17;Be Your Will LLC;Invoice;008-06252;Arroz a Granel:Parboiled 50 LB -Bolsa Dos Hermanos.;;11.0;27.75;305.25;4602505.79;Bulk Rice;Lisset Limpio -020;CAFETERIA y RESTAURANTS;1390293;Aug
2025-08-17;Be Your Will LLC;Invoice;008-06252;Arroz a Granel:Parboiled 50 LB -Bolsa Dos Hermanos.;;1.0;27.75;27.75;4602533.54;Bulk Rice;Lisset Limpio -020;CAFETERIA y RESTAURANTS;1390294;Aug
2025-08-17;El Palacio de los jugos / Caribe Tropical;Invoice;008-06253;Dry Beans:Dry Beans - Black Beans 50;Dry Black Beans 50 lb;1.0;34.0;34.0;4602567.54;Dry Beans;Lisset Limpio -020;Cafeteria;1390295;Aug
2025-08-17;El Palacio de los jugos / Caribe Tropical;Invoice;008-06253;Arroz a Granel:Parboiled 50 LB -Bolsa Dos Hermanos.;;10.0;26.75;267.5;4602835.04;Bulk Rice;Lisset Limpio -020;Cafeteria;1390296;Aug
2025-08-17;El Palacio de los jugos / Divan and Denise Food;Invoice;008-06254;Arroz a Granel:Parboiled 50 LB -Bolsa Dos Hermanos.;;7.0;26.75;187.25;4603022.29;Bulk Rice;Lisset Limpio -020;Cafeteria;1390297;Aug
2025-08-17;Los Mejores Tamales de Miami;Invoice;008-06255;Arroz a Granel:Parboiled 50 LB -Bolsa Dos Hermanos.;;5.0;28.25;141.25;4603163.54;Bulk Rice;Lisset Limpio -020;CAFETERIA y RESTAURANTS;1390298;Aug
2025-08-17;Sedanos Supermarkets #38;Invoice;008-06256;Spanish Style Yellow Rice:AS Spanish Style Yellow Rice;AS Spanish Style Yellow Rice 6 / 3.25 oz;1.0;34.5;34.5;4603198.04;American Spice;Keila Alfaro-Visvikis;RETAIL SEDANOS;1390299;Aug
2025-08-17;Sedanos Supermarkets #38;Invoice;008-06256;Varios:Promotional Allowance;;1.0;-4.5;-4.5;4603193.54;American Spice;Keila Alfaro-Visvikis;RETAIL SEDANOS;1390300;Aug
2025-08-17;Sedanos Supermarkets #38;Invoice;008-06256;Arroz Envasado:Largo Fino 1kg (Long grain rice) Dos Hermanos;;2.0;17.5;35.0;4603228.54;Branded Rice;Keila Alfaro-Visvikis;RETAIL SEDANOS;1390301;Aug
2025-08-17;Sedanos Supermarkets #38;Invoice;008-06256;Varios:Promotional Allowance;;2.0;-2.5;-5.0;4603223.54;Branded Rice;Keila Alfaro-Visvikis;RETAIL SEDANOS;1390302;Aug
2025-08-17;Sedanos Supermarkets #38;Invoice;008-06256;Arroz Envasado:Long Rice 10 LB Dos Hermanos;;50.0;35.5;1775.0;4604998.54;Branded Rice;Keila Alfaro-Visvikis;RETAIL SEDANOS;1390303;Aug
2025-08-17;Sedanos Supermarkets #38;Invoice;008-06256;Varios:Promotional Allowance;;50.0;-3.2;-160.0;4604838.54;Branded Rice;Keila Alfaro-Visvikis;RETAIL SEDANOS;1390304;Aug
2025-08-17;Sedanos Supermarkets #5;Invoice;008-06257;Arroz Envasado:Largo Fino 1kg (Long grain rice) Dos Hermanos;;1.0;17.5;17.5;4604856.04;Branded Rice;Keila Alfaro-Visvikis;RETAIL SEDANOS;1390305;Aug
2025-08-17;Sedanos Supermarkets #5;Invoice;008-06257;Varios:Promotional Allowance;;1.0;-2.5;-2.5;4604853.54;Branded Rice;Keila Alfaro-Visvikis;RETAIL SEDANOS;1390306;Aug
2025-08-17;Sedanos Supermarkets #5;Invoice;008-06257;Arroz Envasado:Parboiled 1kg Bolsa Dos Hermanos.;.;1.0;19.9;19.9;4604873.44;Branded Rice;Keila Alfaro-Visvikis;RETAIL SEDANOS;1390307;Aug
2025-08-17;Sedanos Supermarkets #5;Invoice;008-06257;Varios:Promotional Allowance;;1.0;-5.0;-5.0;4604868.44;Branded Rice;Keila Alfaro-Visvikis;RETAIL SEDANOS;1390308;Aug
2025-08-17;Sedanos Supermarkets #5;Invoice;008-06257;Arroz Envasado:Parboiled 5KG Dos Hermanos.;6  11lbs;5.0;40.5;202.5;4605070.94;Branded Rice;Keila Alfaro-Visvikis;RETAIL SEDANOS;1390309;Aug
2025-08-17;Sedanos Supermarkets #5;Invoice;008-06257;Arroz Envasado:Parboiled 5KG Dos Hermanos.;6  11lbs;1.0;40.5;40.5;4605111.44;Branded Rice;Keila Alfaro-Visvikis;RETAIL SEDANOS;1390310;Aug
2025-08-17;Sedanos Supermarkets #5;Invoice;008-06257;Arroz Envasado:Long Rice 10 LB Dos Hermanos;;10.0;35.5;355.0;4605466.44;Branded Rice;Keila Alfaro-Visvikis;RETAIL SEDANOS;1390311;Aug
2025-08-17;Sedanos Supermarkets #5;Invoice;008-06257;Varios:Promotional Allowance;;10.0;-3.2;-32.0;4605434.44;Branded Rice;Keila Alfaro-Visvikis;RETAIL SEDANOS;1390312;Aug
2025-08-17;Sedanos Supermarkets #32;Invoice;008-06258;Arroz a Granel:Parboiled 50 LB -Bolsa Dos Hermanos.;;5.0;28.25;141.25;4605575.69;Bulk Rice;Keila Alfaro-Visvikis;RETAIL SEDANOS;1390313;Aug
2025-08-17;Sedanos Supermarkets #32;Invoice;008-06258;Arroz a Granel:Largo Fino 50 LB -Bolsa Dos Hermanos.;;2.0;27.85;55.7;4605631.39;Bulk Rice;Keila Alfaro-Visvikis;RETAIL SEDANOS;1390314;Aug
2025-08-17;Sedanos Supermarkets #18;Invoice;008-06259;Arroz Envasado:Largo Fino 1kg (Long grain rice) Dos Hermanos;;2.0;17.5;35.0;4605666.39;Branded Rice;Keila Alfaro-Visvikis;RETAIL SEDANOS;1390315;Aug
2025-08-17;Sedanos Supermarkets #18;Invoice;008-06259;Varios:Promotional Allowance;;2.0;-2.5;-5.0;4605661.39;Branded Rice;Keila Alfaro-Visvikis;RETAIL SEDANOS;1390316;Aug
2025-08-17;Sedanos Supermarkets #18;Invoice;008-06259;Arroz Envasado:Parboiled 1kg Bolsa Dos Hermanos.;.;1.0;19.9;19.9;4605681.29;Branded Rice;Keila Alfaro-Visvikis;RETAIL SEDANOS;1390317;Aug
2025-08-17;Sedanos Supermarkets #18;Invoice;008-06259;Varios:Promotional Allowance;;1.0;-5.0;-5.0;4605676.29;Branded Rice;Keila Alfaro-Visvikis;RETAIL SEDANOS;1390318;Aug
2025-08-17;Sedanos Supermarkets #18;Invoice;008-06259;Arroz Envasado:Long Rice 10 LB Dos Hermanos;;10.0;35.5;355.0;4606031.29;Branded Rice;Keila Alfaro-Visvikis;RETAIL SEDANOS;1390319;Aug
2025-08-17;Sedanos Supermarkets #18;Invoice;008-06259;Varios:Promotional Allowance;;10.0;-3.2;-32.0;4605999.29;Branded Rice;Keila Alfaro-Visvikis;RETAIL SEDANOS;1390320;Aug
2025-08-17;Sedanos Supermarkets #18;Invoice;008-06260;Arroz a Granel:Parboiled 50 LB -Bolsa Dos Hermanos.;;12.0;28.25;339.0;4606338.29;Bulk Rice;Keila Alfaro-Visvikis;RETAIL SEDANOS;1390321;Aug
2025-08-17;Sedanos Supermarkets #18;Invoice;008-06260;Spices:AS Chicken Base;1 / 30 lb. (box or pail);1.0;39.0;39.0;4606377.29;American Spice;Keila Alfaro-Visvikis;RETAIL SEDANOS;1390322;Aug
2025-08-17;Sedanos Supermarkets #32;Invoice;008-06261;Arroz Envasado:Parboiled 5KG Dos Hermanos.;6  11lbs;1.0;40.5;40.5;4606417.79;Branded Rice;Keila Alfaro-Visvikis;RETAIL SEDANOS;1390323;Aug
2025-08-17;Sedanos Supermarkets #32;Invoice;008-06261;Arroz Envasado:Long Rice 10 LB Dos Hermanos;;10.0;35.5;355.0;4606772.79;Branded Rice;Keila Alfaro-Visvikis;RETAIL SEDANOS;1390324;Aug
2025-08-17;Sedanos Supermarkets #32;Invoice;008-06261;Varios:Promotional Allowance;DH Lon Grain 10 lb.;10.0;-3.2;-32.0;4606740.79;Branded Rice;Keila Alfaro-Visvikis;RETAIL SEDANOS;1390325;Aug
2025-08-17;El Palacio de los jugos / Rodriguez Foods;Invoice;008-06262;Arroz a Granel:Parboiled 50 LB -Bolsa Dos Hermanos.;;6.0;26.75;160.5;4606901.29;Bulk Rice;Lisset Limpio -020;Cafeteria;1390326;Aug
2025-08-17;El Palacio de los Jugos / Bird Road Restaurant;Invoice;008-06263;Arroz a Granel:Parboiled 50 LB -Bolsa Dos Hermanos.;;10.0;26.75;267.5;4607168.79;Bulk Rice;Lisset Limpio -020;Cafeteria;1390327;Aug
2025-08-17;Be Your Will LLC;Credit Memo;008-06284;Varios:Promotional Allowance;Arroz a Granel:Parboiled 50 LB -Bolsa Dos Hermanos.;-1.0;27.75;-27.75;4607141.04;Bulk Rice;Lisset Limpio -020;CAFETERIA y RESTAURANTS;1390328;Aug
2025-08-17;Sedanos Supermarkets #5;Credit Memo;008-06285;Varios:Promotional Allowance;Arroz Envasado:Parboiled 5KG Dos Hermanos.;-1.0;40.5;-40.5;4607100.54;Branded Rice;Keila Alfaro-Visvikis;RETAIL SEDANOS;1390329;Aug
2025-08-18;El Palacio de Los Jugos / Casa mía Food Restaurant inc;Invoice;008-06264;Arroz a Granel:Parboiled 50 LB -Bolsa Dos Hermanos.;;6.0;26.75;160.5;160.5;Bulk Rice;Lisset Limpio -020;Cafeteria;1390330;Aug
2025-08-18;Sedanos Supermarkets #8;Invoice;008-06286;Arroz Envasado:Long Rice 10 LB Dos Hermanos;;10.0;35.5;355.0;515.5;Branded Rice;Keila Alfaro-Visvikis;RETAIL SEDANOS;1390331;Aug
2025-08-18;Sedanos Supermarkets #8;Invoice;008-06286;Varios:Promotional Allowance;;10.0;-3.2;-32.0;483.5;Branded Rice;Keila Alfaro-Visvikis;RETAIL SEDANOS;1390332;Aug
2025-08-18;Sedanos Supermarkets #9;Invoice;008-06287;Arroz Envasado:Long Rice 10 LB Dos Hermanos;;10.0;35.5;355.0;838.5;Branded Rice;Keila Alfaro-Visvikis;RETAIL SEDANOS;1390333;Aug
2025-08-18;Sedanos Supermarkets #9;Invoice;008-06287;Arroz Envasado:Long Rice 10 LB Dos Hermanos;;10.0;-3.2;-32.0;806.5;Branded Rice;Keila Alfaro-Visvikis;RETAIL SEDANOS;1390334;Aug
2025-08-18;Sedanos Supermarkets #14;Invoice;008-06288;Arroz Envasado:Long Rice 10 LB Dos Hermanos;;10.0;35.5;355.0;1161.5;Branded Rice;Keila Alfaro-Visvikis;RETAIL SEDANOS;1390335;Aug
2025-08-18;Sedanos Supermarkets #14;Invoice;008-06288;Varios:Promotional Allowance;;10.0;-3.2;-32.0;1129.5;Branded Rice;Keila Alfaro-Visvikis;RETAIL SEDANOS;1390336;Aug
2025-08-18;Sedanos Supermarkets #17;Invoice;008-06289;Arroz Envasado:Long Rice 10 LB Dos Hermanos;;15.0;35.5;532.5;1662.0;Branded Rice;Keila Alfaro-Visvikis;RETAIL SEDANOS;1390337;Aug
2025-08-18;Sedanos Supermarkets #17;Invoice;008-06289;Varios:Promotional Allowance;;15.0;-3.2;-48.0;1614.0;Branded Rice;Keila Alfaro-Visvikis;RETAIL SEDANOS;1390338;Aug
2025-08-18;Sedanos Supermarkets #20;Invoice;008-06290;Arroz Envasado:Long Rice 10 LB Dos Hermanos;;10.0;35.5;355.0;1969.0;Branded Rice;Keila Alfaro-Visvikis;RETAIL SEDANOS;1390339;Aug
2025-08-18;Sedanos Supermarkets #20;Invoice;008-06290;Varios:Promotional Allowance;;10.0;-3.2;-32.0;1937.0;Branded Rice;Keila Alfaro-Visvikis;RETAIL SEDANOS;1390340;Aug
2025-08-18;Sedanos Supermarkets #21;Invoice;008-06291;Arroz Envasado:Long Rice 10 LB Dos Hermanos;;10.0;35.5;355.0;2292.0;Branded Rice;Keila Alfaro-Visvikis;RETAIL SEDANOS;1390341;Aug
2025-08-18;Sedanos Supermarkets #21;Invoice;008-06291;Varios:Promotional Allowance;;10.0;-3.2;-32.0;2260.0;Branded Rice;Keila Alfaro-Visvikis;RETAIL SEDANOS;1390342;Aug
2025-08-18;Sedanos Supermarkets #28;Invoice;008-06292;Arroz Envasado:Long Rice 10 LB Dos Hermanos;;30.0;35.5;1065.0;3325.0;Branded Rice;Keila Alfaro-Visvikis;RETAIL SEDANOS;1390343;Aug
2025-08-18;Sedanos Supermarkets #28;Invoice;008-06292;Varios:Promotional Allowance;;30.0;-3.2;-96.0;3229.0;Branded Rice;Keila Alfaro-Visvikis;RETAIL SEDANOS;1390344;Aug
2025-08-18;Sedanos Supermarkets #29;Invoice;008-06293;Arroz Envasado:Long Rice 10 LB Dos Hermanos;;15.0;35.5;532.5;3761.5;Branded Rice;Keila Alfaro-Visvikis;RETAIL SEDANOS;1390345;Aug
2025-08-18;Sedanos Supermarkets #29;Invoice;008-06293;Varios:Promotional Allowance;;15.0;-3.2;-48.0;3713.5;Branded Rice;Keila Alfaro-Visvikis;RETAIL SEDANOS;1390346;Aug
2025-08-18;Sedanos Supermarkets #36;Invoice;008-06294;Arroz Envasado:Long Rice 10 LB Dos Hermanos;;10.0;35.5;355.0;4068.5;Branded Rice;Keila Alfaro-Visvikis;RETAIL SEDANOS;1390347;Aug
2025-08-18;Sedanos Supermarkets #36;Invoice;008-06294;Varios:Promotional Allowance;;10.0;-3.2;-32.0;4036.5;Branded Rice;Keila Alfaro-Visvikis;RETAIL SEDANOS;1390348;Aug
