Date,Customer,TipoDocumento,Num,Producto,Descripcion,Qty,SalesPrice,Amount,Balance,Class,SalesRep,TipoCliente,ID,Month
2023-01-03,Sabor Tropical Supermarket #4,Invoice,008-01129,Arroz a Granel:Parboiled 50 LB -Bolsa Dos Hermanos.,,55.0,25.0,1375.0,1375.0,,Ruta - 019,RETAIL  DSD,1380101,Jan
2023-01-03,El Palacio de los jugos / Lita Foods Inc.,Invoice,008-01130,Arroz a Granel:Parboiled 50 LB -Bolsa Dos Hermanos.,,20.0,25.5,510.0,1885.0,,Lisset Limpio -020,Cafeteria,1380102,Jan
2023-01-04,CV of America LLC,Invoice,008-01131,Varios:Organic Rice -NI,Fc DH#135,2.0,2131.0,4262.0,6147.0,,Others - 001,OTHER,1380103,Jan
2023-01-04,Food Fair Plantation Corp,Credit Memo,008-01164,Arroz a Granel:Parboiled 50 LB -Bolsa Dos Hermanos.,,-1.0,25.5,-25.5,6121.5,,Ruta - 019,RETAIL  DSD,1380104,Jan
2023-01-09,CV of America LLC,Invoice,008-01132,Varios:Organic Rice -NI,#136,3.0,2131.33,6394.0,12515.5,,Others - 001,OTHER,1380105,Jan
2023-01-10,El Palacio de los jugos / Lita Foods Inc.,Invoice,008-01133,Arroz a Granel:Parboiled 50 LB -Bolsa Dos Hermanos.,,10.0,25.5,255.0,12770.5,,Lisset Limpio -020,Cafeteria,1380106,Jan
2023-01-10,El Palacio de Los Jugos / Casa mía Food Restaurant inc,Invoice,008-01134,Arroz a Granel:Parboiled 50 LB -Bolsa Dos Hermanos.,,10.0,25.5,255.0,13025.5,,Lisset Limpio -020,Cafeteria,1380107,Jan
2023-01-10,El Palacio de los jugos /  E & P Foods,Invoice,008-01135,Arroz a Granel:Parboiled 50 LB -Bolsa Dos Hermanos.,,15.0,25.5,382.5,13408.0,,Lisset Limpio -020,Cafeteria,1380108,Jan
2023-01-10,BRAVO - Flamingo #3,Invoice,008-01136,Arroz Envasado:Parboiled 5KG Dos Hermanos.,6 / 11lbs,5.0,38.5,192.5,13600.5,,Ruta - 019,RETAIL  DSD,1380109,Jan
2023-01-10,BRAVO - Flamingo #3,Invoice,008-01136,Arroz Envasado:Parboiled 5KG Dos Hermanos.,6 / 11lbs,1.0,0.0,0.0,13600.5,,Ruta - 019,RETAIL  DSD,1380110,Jan
2023-01-10,BRAVO - Flamingo #3,Invoice,008-01136,Arroz Envasado:Largo Fino 1kg (Long grain rice) Dos Hermanos,,1.0,16.5,16.5,13617.0,,Ruta - 019,RETAIL  DSD,1380111,Jan
2023-01-10,Albert Deli #2,Invoice,008-01137,Arroz a Granel:Parboiled 50 LB -Bolsa Dos Hermanos.,,5.0,28.0,140.0,13757.0,,Ruta - 019,CAFETERIA y RESTAURANTS,1380112,Jan
2023-01-10,Price Choice Food Market # 2,Invoice,008-01138,Arroz Envasado:Parboiled 5KG Dos Hermanos.,6 / 11lbs,10.0,38.5,385.0,14142.0,,Ruta - 019,RETAIL  DSD,1380113,Jan
2023-01-10,Price Choice Food Market # 2,Invoice,008-01138,Arroz Envasado:Parboiled 5KG Dos Hermanos.,6 / 11lbs,2.0,0.0,0.0,14142.0,,Ruta - 019,RETAIL  DSD,1380114,Jan
2023-01-10,CV of America LLC,Invoice,008-01139,Varios:Organic Rice -NI,#137,3.0,1776.0,5328.0,19470.0,,Others - 001,OTHER,1380115,Jan
2023-01-10,Rey Chavez Distributor Corp,Invoice,008-01140,Arroz a Granel:Parboiled 50 LB -Bolsa Dos Hermanos.,,55.0,25.0,1375.0,20845.0,,Ruta - 019,WHOLESALER,1380116,Jan
2023-01-10,"YummmyCo, Inc",Invoice,008-01141,Arroz a Granel:Totes Parboiled,,1.0,1283.09,1283.09,22128.09,,Armando Carpio - 017,WHOLESALER,1380117,Jan
2023-01-11,"Criollos Food USA, LLC",Invoice,008-01142,Arroz a Granel:Parboiled 50 LB -Bolsa Dos Hermanos.,,55.0,26.5,1457.5,23585.59,,Armando Carpio - 017,WHOLESALER,1380118,Jan
2023-01-12,Agrocommerce S.A. C/O Jose Miguel Infante,Invoice,008-01143,Varios:Organic Rice -NI,#139,3.0,1680.0,5040.0,28625.59,,Others - 001,OTHER,1380119,Jan
2023-01-12,El Palacio de los jugos / Lita Foods Inc.,Invoice,008-01144,Arroz a Granel:Largo Fino 50 LB -Bolsa Dos Hermanos.,,1.0,19.65,19.65,28645.24,,Lisset Limpio -020,Cafeteria,1380120,Jan
2023-01-12,El Palacio de los jugos / Lita Foods Inc.,Invoice,008-01144,Arroz a Granel:Parboiled 50 LB -Bolsa Dos Hermanos.,,10.0,25.5,255.0,28900.24,,Lisset Limpio -020,Cafeteria,1380121,Jan
2023-01-12,El Palacio de Los Jugos / Casa mía Food Restaurant inc,Invoice,008-01145,Arroz a Granel:Largo Fino 50 LB -Bolsa Dos Hermanos.,,1.0,19.65,19.65,28919.89,,Lisset Limpio -020,Cafeteria,1380122,Jan
2023-01-12,El Palacio de Los Jugos / Casa mía Food Restaurant inc,Invoice,008-01145,Arroz a Granel:Parboiled 50 LB -Bolsa Dos Hermanos.,,7.0,25.5,178.5,29098.39,,Lisset Limpio -020,Cafeteria,1380123,Jan
2023-01-12,El Palacio de los jugos /  E & P Foods,Invoice,008-01146,Arroz a Granel:Largo Fino 50 LB -Bolsa Dos Hermanos.,,12.0,19.65,235.8,29334.19,,Lisset Limpio -020,Cafeteria,1380124,Jan
2023-01-12,El Palacio de los jugos / Leti Corp.,Invoice,008-01147,Arroz a Granel:Largo Fino 50 LB -Bolsa Dos Hermanos.,,1.0,19.95,19.95,29354.14,,Lisset Limpio -020,Cafeteria,1380125,Jan
2023-01-12,Albert Food,Invoice,008-01148,Arroz a Granel:Parboiled 50 LB -Bolsa Dos Hermanos.,,10.0,25.5,255.0,29609.14,,Lisset Limpio -020,RETAIL  DSD,1380126,Jan
2023-01-12,El Palacio de los jugos / Caribe Tropical,Invoice,008-01149,Arroz a Granel:Parboiled 50 LB -Bolsa Dos Hermanos.,,8.0,25.5,204.0,29813.14,,Lisset Limpio -020,Cafeteria,1380127,Jan
2023-01-12,El Palacio de los jugos / Caribe Tropical,Invoice,008-01149,Arroz a Granel:Largo Fino 50 LB -Bolsa Dos Hermanos.,,1.0,19.65,19.65,29832.79,,Lisset Limpio -020,Cafeteria,1380128,Jan
2023-01-12,El Palacio de los jugos / J Mena Corp.,Invoice,008-01150,Arroz a Granel:Largo Fino 50 LB -Bolsa Dos Hermanos.,,5.0,19.75,98.75,29931.54,,Lisset Limpio -020,Cafeteria,1380129,Jan
2023-01-12,Agrocommerce S.A. C/O Jose Miguel Infante,Invoice,008-01151,Varios:Organic Rice -NI,#138,3.0,1680.0,5040.0,34971.54,,Others - 001,OTHER,1380130,Jan
2023-01-16,"Sun Shine Spice, Corp.",Invoice,008-01152,Arroz a Granel:Totes Parboiled,,2.0,1234.68,2469.36,37440.9,,Ruta - 019,RETAIL  DSD,1380131,Jan
2023-01-16,COD Suplies,Invoice,008-01153,Arroz a Granel:Parboiled 50 LB -Bolsa Dos Hermanos.,,55.0,25.5,1402.5,38843.4,,Ruta - 019,WHOLESALER,1380132,Jan
2023-01-16,Bake Mark USA LLC,Invoice,008-01154,Arroz a Granel:Parboiled 50 LB -Bolsa Dos Hermanos.,,1100.0,20.5,22550.0,61393.4,,Armando Carpio - 017,WHOLESALER MANUFACTURY,1380133,Jan
2023-01-17,Florencia Tinoco-Lora Good Rice Comercial,Invoice,008-01155,Arroz a Granel:Largo Fino 50 LB -Bolsa Dos Hermanos.,,1.0,0.0,0.0,61393.4,,Ruta - 019,OTHER,1380134,Jan
2023-01-17,El Palacio de los jugos / Lita Foods Inc.,Invoice,008-01156,Arroz a Granel:Parboiled 50 LB -Bolsa Dos Hermanos.,,10.0,25.5,255.0,61648.4,,Lisset Limpio -020,Cafeteria,1380135,Jan
2023-01-17,El Palacio de los jugos / Lita Foods Inc.,Invoice,008-01156,Arroz a Granel:Largo Fino 50 LB -Bolsa Dos Hermanos.,,1.0,19.65,19.65,61668.05,,Lisset Limpio -020,Cafeteria,1380136,Jan
2023-01-17,El Palacio de Los Jugos / Casa mía Food Restaurant inc,Invoice,008-01157,Arroz a Granel:Parboiled 50 LB -Bolsa Dos Hermanos.,,15.0,25.5,382.5,62050.55,,Lisset Limpio -020,Cafeteria,1380137,Jan
2023-01-17,El Palacio de Los Jugos / Casa mía Food Restaurant inc,Invoice,008-01157,Arroz a Granel:Largo Fino 50 LB -Bolsa Dos Hermanos.,,12.0,19.65,235.8,62286.35,,Lisset Limpio -020,Cafeteria,1380138,Jan
2023-01-17,El Palacio de los jugos /  E & P Foods,Invoice,008-01158,Arroz a Granel:Largo Fino 50 LB -Bolsa Dos Hermanos.,,5.0,19.65,98.25,62384.6,,Lisset Limpio -020,Cafeteria,1380139,Jan
2023-01-17,El Palacio de los jugos /  E & P Foods,Invoice,008-01158,Arroz a Granel:Parboiled 50 LB -Bolsa Dos Hermanos.,,15.0,25.5,382.5,62767.1,,Lisset Limpio -020,Cafeteria,1380140,Jan
2023-01-17,El Palacio de los jugos / Leti Corp.,Invoice,008-01159,Arroz a Granel:Largo Fino 50 LB -Bolsa Dos Hermanos.,,7.0,19.95,139.65,62906.75,,Lisset Limpio -020,Cafeteria,1380141,Jan
2023-01-17,Bravo Supermarket 5011,Invoice,008-01160,Arroz a Granel:Parboiled 50 LB -Bolsa Dos Hermanos.,,10.0,27.0,270.0,63176.75,,Ruta - 019,RETAIL BRAVO,1380142,Jan
2023-01-17,Key Food / Holywood,Invoice,008-01161,Arroz Envasado:Parboiled 5KG Dos Hermanos.,6 / 11lbs,10.0,38.5,385.0,63561.75,,Ruta - 019,RETAIL  DSD,1380143,Jan
2023-01-17,Key Food / Holywood,Invoice,008-01161,Arroz Envasado:Parboiled 5KG Dos Hermanos.,6 / 11lbs,2.0,0.0,0.0,63561.75,,Ruta - 019,RETAIL  DSD,1380144,Jan
2023-01-17,Key Food / Holywood,Invoice,008-01161,Arroz Envasado:Largo Fino 1kg (Long grain rice) Dos Hermanos,,5.0,16.5,82.5,63644.25,,Ruta - 019,RETAIL  DSD,1380145,Jan
2023-01-17,Key Food / Holywood,Invoice,008-01161,Arroz Envasado:Sushi Rice Dos Hermanos 5kg.,,6.0,10.0,60.0,63704.25,,Ruta - 019,RETAIL  DSD,1380146,Jan
2023-01-17,Key Food / Holywood,Invoice,008-01161,Arroz Envasado:Largo Fino 1kg (Long grain rice) Dos Hermanos,,1.0,0.0,0.0,63704.25,,Ruta - 019,RETAIL  DSD,1380147,Jan
2023-01-17,Agrocommerce S.A. C/O Jose Miguel Infante,Invoice,008-01162,Varios:Organic Rice -NI,#140,3.0,1680.0,5040.0,68744.25,,Others - 001,OTHER,1380148,Jan
2023-01-18,Lissete Limpio,Invoice,008-01163,Arroz Envasado:Largo Fino 1kg (Long grain rice) Dos Hermanos,,1.0,0.0,0.0,68744.25,,Lisset Limpio -020,OTHER,1380149,Jan
2023-01-19,Bravo Supermarket 5011,Credit Memo,008-01172,Arroz a Granel:Parboiled 50 LB -Bolsa Dos Hermanos.,Rotura de bolsa (S/invoice#1160),-1.0,27.0,-27.0,68717.25,,Ruta - 019,RETAIL BRAVO,1380150,Jan
2023-01-23,El Palacio de los jugos / Lita Foods Inc.,Invoice,008-01165,Arroz a Granel:Parboiled 50 LB -Bolsa Dos Hermanos.,,10.0,25.5,255.0,68972.25,,Lisset Limpio -020,Cafeteria,1380151,Jan
2023-01-23,El Palacio de Los Jugos / Casa mía Food Restaurant inc,Invoice,008-01166,Arroz a Granel:Parboiled 50 LB -Bolsa Dos Hermanos.,,22.0,25.5,561.0,69533.25,,Lisset Limpio -020,Cafeteria,1380152,Jan
2023-01-23,El Palacio de los jugos /  E & P Foods,Invoice,008-01167,Arroz a Granel:Largo Fino 50 LB -Bolsa Dos Hermanos.,,5.0,19.65,98.25,69631.5,,Lisset Limpio -020,Cafeteria,1380153,Jan
2023-01-23,El Palacio de los jugos /  E & P Foods,Invoice,008-01167,Arroz a Granel:Parboiled 50 LB -Bolsa Dos Hermanos.,,10.0,25.5,255.0,69886.5,,Lisset Limpio -020,Cafeteria,1380154,Jan
2023-01-23,El Palacio de los jugos / J Mena Corp.,Invoice,008-01168,Arroz a Granel:Largo Fino 50 LB -Bolsa Dos Hermanos.,,5.0,19.75,98.75,69985.25,,Lisset Limpio -020,Cafeteria,1380155,Jan
2023-01-23,El Palacio de los jugos / J Mena Corp.,Invoice,008-01168,Arroz a Granel:Parboiled 50 LB -Bolsa Dos Hermanos.,,5.0,25.5,127.5,70112.75,,Lisset Limpio -020,Cafeteria,1380156,Jan
2023-01-23,El Palacio de los jugos / Delicias Criollas (DIAGO FOOD_MILLER),Invoice,008-01169,Arroz a Granel:Largo Fino 50 LB -Bolsa Dos Hermanos.,,5.0,19.75,98.75,70211.5,,Lisset Limpio -020,Cafeteria,1380157,Jan
2023-01-23,El Palacio de los jugos / Delicias Criollas (DIAGO FOOD_MILLER),Invoice,008-01169,Arroz a Granel:Parboiled 50 LB -Bolsa Dos Hermanos.,,10.0,25.5,255.0,70466.5,,Lisset Limpio -020,Cafeteria,1380158,Jan
2023-01-23,"Meat Club Market, LLC.",Invoice,008-01170,Arroz Envasado:Largo Fino 1kg (Long grain rice) Dos Hermanos,,10.0,16.75,167.5,70634.0,,Lisset Limpio -020,RETAIL  DSD,1380159,Jan
2023-01-23,"Meat Club Market, LLC.",Invoice,008-01170,Arroz Envasado:Largo Fino 1kg (Long grain rice) Dos Hermanos,,1.0,0.0,0.0,70634.0,,Lisset Limpio -020,RETAIL  DSD,1380160,Jan
2023-01-23,"Meat Club Market, LLC.",Invoice,008-01170,Arroz Envasado:Parboiled 1kg Bolsa Dos Hermanos.,I8(43)JUN/ H27/H28/ H29(118) /H30,10.0,19.75,197.5,70831.5,,Lisset Limpio -020,RETAIL  DSD,1380161,Jan
2023-01-23,"Meat Club Market, LLC.",Invoice,008-01170,Arroz Envasado:Parboiled 1kg Bolsa Dos Hermanos.,I8(43)JUN/ H27/H28/ H29(118) /H30,1.0,0.0,0.0,70831.5,,Lisset Limpio -020,RETAIL  DSD,1380162,Jan
2023-01-23,Bake Mark USA LLC,Invoice,008-01171,Arroz a Granel (MWH):Arroz Parboil Bolsa 50LB Dos hermanos (Alpha),,0.0,,0.0,70831.5,,Armando Carpio - 017,WHOLESALER MANUFACTURY,1380163,Jan
2023-01-26,Brito Family Corp.,Invoice,008-01173,Arroz a Granel:Parboiled 50 LB -Bolsa Dos Hermanos.,,110.0,22.5,2475.0,73306.5,,Lisset Limpio -020,CAFETERIA y RESTAURANTS,1380164,Jan
2023-01-26,Rey Chavez Distributor #2,Invoice,008-01174,Arroz Envasado:Parboiled 5KG Dos Hermanos.,6 / 11lbs,20.0,33.0,660.0,73966.5,,Ruta - 019,WHOLESALER,1380165,Jan
2023-01-26,Rey Chavez Distributor #2,Invoice,008-01174,Arroz a Granel:Parboiled 50 LB -Bolsa Dos Hermanos.,,20.0,25.0,500.0,74466.5,,Ruta - 019,WHOLESALER,1380166,Jan
2023-01-26,Rey Chavez Distributor Corp,Invoice,008-01175,Arroz Envasado:Parboiled 5KG Dos Hermanos.,6 / 11lbs,41.0,33.0,1353.0,75819.5,,Ruta - 019,WHOLESALER,1380167,Jan
2023-01-26,Rey Chavez Distributor Corp,Credit Memo,008-01176,"Rice Snack:Rice Snack, Sour Cream & Onion DOS HERMANOS",H8,-7.0,1.35,-9.45,75810.05,,Ruta - 019,WHOLESALER,1380168,Jan
2023-01-26,Rey Chavez Distributor Corp,Credit Memo,008-01176,"Rice Snack:Rice Snack, Pizza DH",,-3.0,1.35,-4.05,75806.0,,Ruta - 019,WHOLESALER,1380169,Jan
2023-01-26,Rey Chavez Distributor Corp,Credit Memo,008-01176,Rice Snack:Rice Snack Salami Flavored DOS HERMANOS,,-19.0,1.35,-25.65,75780.35,,Ruta - 019,WHOLESALER,1380170,Jan
2023-01-26,Rey Chavez Distributor Corp,Credit Memo,008-01176,Rice Snack:Rice Snack Ham Flavored DOS HERMANOS,,-6.0,1.35,-8.1,75772.25,,Ruta - 019,WHOLESALER,1380171,Jan
2023-01-27,El Palacio de los jugos / Lita Foods Inc.,Invoice,008-01178,Arroz a Granel:Parboiled 50 LB -Bolsa Dos Hermanos.,,10.0,25.5,255.0,76027.25,,Lisset Limpio -020,Cafeteria,1380172,Jan
2023-01-27,El Palacio de los jugos / Delicias Criollas (DIAGO FOOD_MILLER),Invoice,008-01179,Arroz a Granel:Parboiled 50 LB -Bolsa Dos Hermanos.,,10.0,25.5,255.0,76282.25,,Lisset Limpio -020,Cafeteria,1380173,Jan
2023-01-27,El Palacio de los jugos / Leti Corp.,Invoice,008-01180,Arroz a Granel:Largo Fino 50 LB -Bolsa Dos Hermanos.,,7.0,19.95,139.65,76421.9,,Lisset Limpio -020,Cafeteria,1380174,Jan
2023-01-27,El Palacio de los jugos / Caribe Tropical,Invoice,008-01181,Arroz a Granel:Parboiled 50 LB -Bolsa Dos Hermanos.,,10.0,25.5,255.0,76676.9,,Lisset Limpio -020,Cafeteria,1380175,Jan
2023-01-30,El Palacio de los jugos / Lita Foods Inc.,Invoice,008-01182,Arroz a Granel:Parboiled 50 LB -Bolsa Dos Hermanos.,,10.0,25.5,255.0,76931.9,,Lisset Limpio -020,Cafeteria,1380176,Jan
2023-01-30,El Palacio de Los Jugos / Casa mía Food Restaurant inc,Invoice,008-01183,Arroz a Granel:Parboiled 50 LB -Bolsa Dos Hermanos.,,16.0,25.5,408.0,77339.9,,Lisset Limpio -020,Cafeteria,1380177,Jan
2023-01-30,El Palacio de los jugos /  E & P Foods,Invoice,008-01184,Arroz a Granel:Largo Fino 50 LB -Bolsa Dos Hermanos.,,10.0,19.65,196.5,77536.4,,Lisset Limpio -020,Cafeteria,1380178,Jan
2023-01-30,El Palacio de los jugos /  E & P Foods,Invoice,008-01184,Arroz a Granel:Parboiled 50 LB -Bolsa Dos Hermanos.,,15.0,25.5,382.5,77918.9,,Lisset Limpio -020,Cafeteria,1380179,Jan
2023-01-30,El Palacio de los jugos / J Mena Corp.,Invoice,008-01185,Arroz a Granel:Parboiled 50 LB -Bolsa Dos Hermanos.,,10.0,25.5,255.0,78173.9,,Lisset Limpio -020,Cafeteria,1380180,Jan
2023-01-30,El Palacio de los jugos / J Mena Corp.,Invoice,008-01185,Arroz a Granel:Largo Fino 50 LB -Bolsa Dos Hermanos.,,5.0,19.75,98.75,78272.65,,Lisset Limpio -020,Cafeteria,1380181,Jan
2023-01-31,"Red Diamond Food Services, LLC",Invoice,008-01186,Arroz a Granel:Largo Fino 50 LB -Bolsa Dos Hermanos.,,5.0,19.99,99.95,78372.6,,Lisset Limpio -020,CAFETERIA y RESTAURANTS,1380182,Jan
2023-01-31,Broward Meat and Fish,Invoice,008-01187,Arroz a Granel:Parboiled 50 LB -Bolsa Dos Hermanos.,,55.0,25.5,1402.5,79775.1,,Ruta - 019,RETAIL  DSD,1380183,Jan
2023-01-31,Food Fair Miramar,Invoice,008-01188,Arroz a Granel:Parboiled 50 LB -Bolsa Dos Hermanos.,,55.0,25.5,1402.5,81177.6,,Ruta - 019,RETAIL KEY FOOD,1380184,Jan
2023-01-31,Key Food - JRA 1621 Lauderhill,Invoice,008-01189,Arroz Envasado:Parboiled 5KG Dos Hermanos.,6 / 11lbs,5.0,38.5,192.5,81370.1,,Ruta - 019,RETAIL  DSD,1380185,Jan
2023-01-31,Key Food - JRA 1621 Lauderhill,Invoice,008-01189,Arroz Envasado:Parboiled 5KG Dos Hermanos.,6 / 11lbs,1.0,0.0,0.0,81370.1,,Ruta - 019,RETAIL  DSD,1380186,Jan
2023-01-31,Key Food  Lake Worth JR 1337,Invoice,008-01190,Arroz a Granel:Parboiled 50 LB -Bolsa Dos Hermanos.,,5.0,28.0,140.0,81510.1,,Ruta - 019,RETAIL KEY FOOD,1380187,Jan
2023-01-31,Key Food Lake Worth,Invoice,008-01191,Arroz a Granel:Parboiled 50 LB -Bolsa Dos Hermanos.,,5.0,28.0,140.0,81650.1,,Ruta - 019,RETAIL KEY FOOD,1380188,Jan
2023-01-31,Key Food / Holywood,Invoice,008-01192,Arroz Envasado:Parboiled 5KG Dos Hermanos.,6 / 11lbs,5.0,38.5,192.5,81842.6,,Ruta - 019,RETAIL  DSD,1380189,Jan
2023-01-31,Key Food / Holywood,Invoice,008-01192,Arroz Envasado:Parboiled 5KG Dos Hermanos.,6 / 11lbs,1.0,0.0,0.0,81842.6,,Ruta - 019,RETAIL  DSD,1380190,Jan
2023-01-31,Key Food / Holywood,Invoice,008-01192,Arroz Envasado:Largo Fino 1kg (Long grain rice) Dos Hermanos,,10.0,16.5,165.0,82007.6,,Ruta - 019,RETAIL  DSD,1380191,Jan
2023-01-31,Key Food / Holywood,Invoice,008-01192,Arroz Envasado:Largo Fino 1kg (Long grain rice) Dos Hermanos,,2.0,0.0,0.0,82007.6,,Ruta - 019,RETAIL  DSD,1380192,Jan
2023-01-31,El Palacio de los jugos /  Mires Restaurants,Invoice,008-01193,Arroz a Granel:Parboiled 50 LB -Bolsa Dos Hermanos.,,10.0,25.5,255.0,82262.6,,Lisset Limpio -020,Cafeteria,1380193,Jan
2023-01-31,El Palacio de los jugos /  Mires Restaurants,Invoice,008-01193,Arroz a Granel:Largo Fino 50 LB -Bolsa Dos Hermanos.,,10.0,19.85,198.5,82461.1,,Lisset Limpio -020,Cafeteria,1380194,Jan
2023-01-31,Key Food / Holywood,Credit Memo,008-01208,Arroz Envasado:Largo Fino 1kg (Long grain rice) Dos Hermanos,,-3.0,16.5,-49.5,82411.6,,Ruta - 019,RETAIL  DSD,1380195,Jan
2023-02-01,CV of America LLC,Invoice,008-01194,Varios:Organic Rice -NI,Fc DH#143,2.0,2448.0,4896.0,87307.6,,Others - 001,OTHER,1380196,Feb
2023-02-02,El Palacio de los jugos / Lita Foods Inc.,Invoice,008-01195,Arroz a Granel:Parboiled 50 LB -Bolsa Dos Hermanos.,,10.0,25.5,255.0,87562.6,,Lisset Limpio -020,Cafeteria,1380197,Feb
2023-02-02,El Palacio de los jugos /  E & P Foods,Invoice,008-01196,Arroz a Granel:Largo Fino 50 LB -Bolsa Dos Hermanos.,,5.0,19.65,98.25,87660.85,,Lisset Limpio -020,Cafeteria,1380198,Feb
2023-02-02,El Palacio de los jugos /  E & P Foods,Invoice,008-01196,Arroz a Granel:Parboiled 50 LB -Bolsa Dos Hermanos.,,10.0,25.5,255.0,87915.85,,Lisset Limpio -020,Cafeteria,1380199,Feb
2023-02-02,El Palacio de los jugos / Lita Foods Inc.,Invoice,008-01197,Arroz a Granel:Largo Fino 50 LB -Bolsa Dos Hermanos.,,5.0,19.65,98.25,88014.1,,Lisset Limpio -020,Cafeteria,1380200,Feb
2023-02-02,El Palacio de los jugos / Caribe Tropical,Invoice,008-01198,Arroz a Granel:Largo Fino 50 LB -Bolsa Dos Hermanos.,,6.0,19.85,119.1,88133.2,,Lisset Limpio -020,Cafeteria,1380201,Feb
2023-02-02,El Palacio de los jugos / Caribe Tropical,Invoice,008-01198,Arroz a Granel:Parboiled 50 LB -Bolsa Dos Hermanos.,,10.0,25.5,255.0,88388.2,,Lisset Limpio -020,Cafeteria,1380202,Feb
2023-02-02,El Palacio de los jugos /  EMMA FOOD CORP,Invoice,008-01199,Arroz a Granel:Largo Fino 50 LB -Bolsa Dos Hermanos.,,6.0,19.85,119.1,88507.3,,Lisset Limpio -020,Cafeteria,1380203,Feb
2023-02-02,El Palacio de los jugos /  EMMA FOOD CORP,Invoice,008-01199,Arroz a Granel:Parboiled 50 LB -Bolsa Dos Hermanos.,,8.0,25.5,204.0,88711.3,,Lisset Limpio -020,Cafeteria,1380204,Feb
2023-02-02,El Palacio de los jugos / Delicias Criollas (DIAGO FOOD_MILLER),Invoice,008-01200,Arroz a Granel:Parboiled 50 LB -Bolsa Dos Hermanos.,,12.0,25.5,306.0,89017.3,,Lisset Limpio -020,Cafeteria,1380205,Feb
2023-02-05,El Palacio de los jugos / Lita Foods Inc.,Invoice,008-01201,Arroz a Granel:Parboiled 50 LB -Bolsa Dos Hermanos.,,8.0,25.5,204.0,89221.3,,Lisset Limpio -020,Cafeteria,1380206,Feb
2023-02-05,El Palacio de los jugos / Caribe Tropical,Invoice,008-01202,Arroz a Granel:Parboiled 50 LB -Bolsa Dos Hermanos.,,8.0,25.5,204.0,89425.3,,Lisset Limpio -020,Cafeteria,1380207,Feb
2023-02-05,El Palacio de los jugos / Caribe Tropical,Invoice,008-01202,Arroz a Granel:Largo Fino 50 LB -Bolsa Dos Hermanos.,,6.0,19.85,119.1,89544.4,,Lisset Limpio -020,Cafeteria,1380208,Feb
2023-02-05,El Palacio de los jugos /  EMMA FOOD CORP,Invoice,008-01203,Arroz a Granel:Largo Fino 50 LB -Bolsa Dos Hermanos.,,6.0,19.85,119.1,89663.5,,Lisset Limpio -020,Cafeteria,1380209,Feb
2023-02-05,El Palacio de los jugos /  EMMA FOOD CORP,Invoice,008-01203,Arroz a Granel:Parboiled 50 LB -Bolsa Dos Hermanos.,,6.0,25.5,153.0,89816.5,,Lisset Limpio -020,Cafeteria,1380210,Feb
2023-02-05,Brito Family Corp.,Invoice,008-01204,Arroz a Granel:Parboiled 50 LB -Bolsa Dos Hermanos.,,110.0,22.5,2475.0,92291.5,,Lisset Limpio -020,CAFETERIA y RESTAURANTS,1380211,Feb
2023-02-05,El Palacio de los jugos / J Mena Corp.,Invoice,008-01205,Arroz a Granel:Parboiled 50 LB -Bolsa Dos Hermanos.,,10.0,25.5,255.0,92546.5,,Lisset Limpio -020,Cafeteria,1380212,Feb
2023-02-05,El Palacio de los jugos / J Mena Corp.,Invoice,008-01205,Arroz a Granel:Largo Fino 50 LB -Bolsa Dos Hermanos.,,5.0,19.75,98.75,92645.25,,Lisset Limpio -020,Cafeteria,1380213,Feb
2023-02-05,El Palacio de los jugos /  Mires Restaurants,Invoice,008-01206,Arroz a Granel:Parboiled 50 LB -Bolsa Dos Hermanos.,,10.0,25.5,255.0,92900.25,,Lisset Limpio -020,Cafeteria,1380214,Feb
2023-02-05,El Palacio de Los Jugos / Casa mía Food Restaurant inc,Invoice,008-01207,Arroz a Granel:Parboiled 50 LB -Bolsa Dos Hermanos.,,16.0,25.5,408.0,93308.25,,Lisset Limpio -020,Cafeteria,1380215,Feb
2023-02-07,El Palacio de los jugos /  E & P Foods,Invoice,008-01209,Arroz a Granel:Largo Fino 50 LB -Bolsa Dos Hermanos.,,10.0,19.65,196.5,93504.75,,Lisset Limpio -020,Cafeteria,1380216,Feb
2023-02-07,El Palacio de los jugos /  E & P Foods,Invoice,008-01209,Arroz a Granel:Parboiled 50 LB -Bolsa Dos Hermanos.,,15.0,25.5,382.5,93887.25,,Lisset Limpio -020,Cafeteria,1380217,Feb
2023-02-07,"Red Diamond Food Services, LLC",Invoice,008-01210,Arroz a Granel:Largo Fino 50 LB -Bolsa Dos Hermanos.,,5.0,19.99,99.95,93987.2,,Lisset Limpio -020,CAFETERIA y RESTAURANTS,1380218,Feb
2023-02-07,CV of America LLC,Invoice,008-01211,Varios:Organic Rice -NI,Fc DH#144,144.0,34.0,4896.0,98883.2,,Others - 001,OTHER,1380219,Feb
2023-02-07,"Garman Distributor,LLC",Invoice,008-01212,Arroz a Granel:Parboiled 50 LB -Bolsa Dos Hermanos.,,165.0,22.5,3712.5,102595.7,,Armando Carpio - 017,WHOLESALER,1380220,Feb
2023-02-07,Albert Deli #2,Invoice,008-01213,Arroz a Granel:Largo Fino 50 LB -Bolsa Dos Hermanos.,,3.0,23.0,69.0,102664.7,,Ruta - 019,CAFETERIA y RESTAURANTS,1380221,Feb
2023-02-07,Albert Deli #2,Invoice,008-01213,Arroz a Granel:Parboiled 50 LB -Bolsa Dos Hermanos.,,3.0,28.0,84.0,102748.7,,Ruta - 019,CAFETERIA y RESTAURANTS,1380222,Feb
2023-02-08,Food Fair Plantation Corp,Invoice,008-01214,Arroz Envasado:Parboiled 5KG Dos Hermanos.,6 / 11lbs,10.0,38.5,385.0,103133.7,,Ruta - 019,RETAIL  DSD,1380223,Feb
2023-02-08,Food Fair Plantation Corp,Invoice,008-01214,Arroz Envasado:Parboiled 5KG Dos Hermanos.,6 / 11lbs,2.0,0.0,0.0,103133.7,,Ruta - 019,RETAIL  DSD,1380224,Feb
2023-02-08,Food Fair Plantation Corp,Invoice,008-01214,Arroz Envasado:Sushi Rice Dos Hermanos 5kg.,,6.0,10.0,60.0,103193.7,,Ruta - 019,RETAIL  DSD,1380225,Feb
2023-02-08,Ideal Food Basket Pompano,Invoice,008-01215,Arroz Envasado:Parboiled 5KG Dos Hermanos.,6 / 11lbs,10.0,38.5,385.0,103578.7,,Ruta - 019,RETAIL  DSD,1380226,Feb
2023-02-08,Ideal Food Basket Pompano,Invoice,008-01215,Arroz Envasado:Parboiled 5KG Dos Hermanos.,6 / 11lbs,1.0,0.0,0.0,103578.7,,Ruta - 019,RETAIL  DSD,1380227,Feb
2023-02-08,Ideal Food Basket Pompano,Invoice,008-01215,Arroz Envasado:Largo Fino 1kg (Long grain rice) Dos Hermanos,,5.0,16.5,82.5,103661.2,,Ruta - 019,RETAIL  DSD,1380228,Feb
2023-02-08,Ideal Food Basket Pompano,Invoice,008-01215,Arroz Envasado:Largo Fino 1kg (Long grain rice) Dos Hermanos,,1.0,0.0,0.0,103661.2,,Ruta - 019,RETAIL  DSD,1380229,Feb
2023-02-08,Food Fair Plantation Corp,Invoice,008-01216,Arroz Envasado:Parboiled 5KG Dos Hermanos.,6 / 11lbs,10.0,38.5,385.0,104046.2,,Ruta - 019,RETAIL  DSD,1380230,Feb
2023-02-08,Food Fair Plantation Corp,Invoice,008-01216,Arroz Envasado:Parboiled 5KG Dos Hermanos.,6 / 11lbs,2.0,0.0,0.0,104046.2,,Ruta - 019,RETAIL  DSD,1380231,Feb
2023-02-08,La Ranchera Meat Market #3,Invoice,008-01217,Arroz a Granel:Largo Fino 50 LB -Bolsa Dos Hermanos.,,5.0,23.0,115.0,104161.2,,Ruta - 019,CAFETERIA y RESTAURANTS,1380232,Feb
2023-02-08,Foodtown Supermarket,Invoice,008-01218,Arroz a Granel:Parboiled 50 LB -Bolsa Dos Hermanos.,,10.0,28.0,280.0,104441.2,,Ruta - 019,CAFETERIA y RESTAURANTS,1380233,Feb
2023-02-08,CV of America LLC,Invoice,008-01219,Varios:Organic Rice -NI,Fc DH#145,144.0,34.0,4896.0,109337.2,,Others - 001,OTHER,1380234,Feb
2023-02-08,Miavana & Family,Invoice,008-01220,Arroz a Granel:Parboiled 50 LB -Bolsa Dos Hermanos.,,220.0,21.35,4697.0,114034.2,,Armando Carpio - 017,Distributor,1380235,Feb
2023-02-09,Price Choice Food Market # 6,Invoice,1221,Arroz a Granel:Parboiled 50 LB -Bolsa Dos Hermanos.,,55.0,25.5,1402.5,115436.7,,Ruta - 019,RETAIL  DSD,1380236,Feb
2023-02-09,Price Choice Food Market # 6,Invoice,1221,Arroz Envasado:Parboiled 5KG Dos Hermanos.,6 / 11lbs,5.0,38.5,192.5,115629.2,,Ruta - 019,RETAIL  DSD,1380237,Feb
2023-02-09,Price Choice Food Market # 6,Invoice,1221,Arroz Envasado:Largo Fino 1kg (Long grain rice) Dos Hermanos,,5.0,16.5,82.5,115711.7,,Ruta - 019,RETAIL  DSD,1380238,Feb
2023-02-09,Price Choice Food Market # 6,Invoice,1221,Arroz Envasado:Largo Fino 1kg (Long grain rice) Dos Hermanos,,1.0,0.0,0.0,115711.7,,Ruta - 019,RETAIL  DSD,1380239,Feb
2023-02-09,Price Choice Food Market # 6,Invoice,1221,Arroz Envasado:Parboiled 5KG Dos Hermanos.,6 / 11lbs,1.0,0.0,0.0,115711.7,,Ruta - 019,RETAIL  DSD,1380240,Feb
2023-02-09,Price Choice Food Market # 7,Invoice,008-01222,Arroz Envasado:Parboiled 5KG Dos Hermanos.,6 / 11lbs,10.0,38.5,385.0,116096.7,,Ruta - 019,RETAIL  DSD,1380241,Feb
2023-02-09,Price Choice Food Market # 7,Invoice,008-01222,Arroz Envasado:Parboiled 5KG Dos Hermanos.,6 / 11lbs,2.0,0.0,0.0,116096.7,,Ruta - 019,RETAIL  DSD,1380242,Feb
2023-02-09,El Palacio de los jugos / Lita Foods Inc.,Invoice,008-01223,Arroz a Granel:Parboiled 50 LB -Bolsa Dos Hermanos.,,10.0,25.5,255.0,116351.7,,Lisset Limpio -020,Cafeteria,1380243,Feb
2023-02-09,El Palacio de los jugos / Caribe Tropical,Invoice,008-01224,Arroz a Granel:Parboiled 50 LB -Bolsa Dos Hermanos.,,8.0,25.5,204.0,116555.7,,Lisset Limpio -020,Cafeteria,1380244,Feb
2023-02-09,El Palacio de los jugos / Caribe Tropical,Invoice,008-01224,Arroz a Granel:Largo Fino 50 LB -Bolsa Dos Hermanos.,,6.0,19.85,119.1,116674.8,,Lisset Limpio -020,Cafeteria,1380245,Feb
2023-02-09,El Palacio de los jugos /  EMMA FOOD CORP,Invoice,008-01225,Arroz a Granel:Largo Fino 50 LB -Bolsa Dos Hermanos.,,6.0,19.85,119.1,116793.9,,Lisset Limpio -020,Cafeteria,1380246,Feb
2023-02-09,El Palacio de los jugos / Delicias Criollas (DIAGO FOOD_MILLER),Invoice,008-01226,Arroz a Granel:Parboiled 50 LB -Bolsa Dos Hermanos.,,12.0,25.5,306.0,117099.9,,Lisset Limpio -020,Cafeteria,1380247,Feb
2023-02-09,El Palacio de los jugos / J Mena Corp.,Invoice,008-01227,Arroz a Granel:Parboiled 50 LB -Bolsa Dos Hermanos.,,10.0,25.5,255.0,117354.9,,Lisset Limpio -020,Cafeteria,1380248,Feb
2023-02-09,Food Fair Plantation Corp,Credit Memo,008-01277,Arroz Envasado:Sushi Rice Dos Hermanos 5kg.,,-1.0,60.0,-60.0,117294.9,,Ruta - 019,RETAIL  DSD,1380249,Feb
2023-02-09,Food Fair Plantation Corp,Credit Memo,008-01277,Arroz Envasado ((NJ)):Parboiled 5KG Dos Hermanos ((NJ)) (deleted),,-1.0,38.5,-38.5,117256.4,,Ruta - 019,RETAIL  DSD,1380250,Feb
2023-02-10,CV of America LLC,Invoice,008-01228,Varios:Organic Rice -NI,Fc DH#146,144.0,34.0,4896.0,122152.4,,Others - 001,OTHER,1380251,Feb
2023-02-10,Price Choice Food Market # 6,Credit Memo,008-01278,Arroz Envasado ((NJ)):Largo Fino 1kg (Long grain rice) Dos Hermanos ((NJ)) (deleted),,-5.0,16.5,-82.5,122069.9,,Lisset Limpio -020,RETAIL  DSD,1380252,Feb
2023-02-13,El Palacio de los jugos / Lita Foods Inc.,Invoice,008-01229,Arroz a Granel:Parboiled 50 LB -Bolsa Dos Hermanos.,,10.0,25.5,255.0,122324.9,,Lisset Limpio -020,Cafeteria,1380253,Feb
2023-02-13,El Palacio de los jugos / Lungos Sabor Inc.,Invoice,008-01230,Arroz a Granel:Largo Fino 50 LB -Bolsa Dos Hermanos.,,5.0,19.85,99.25,122424.15,,Lisset Limpio -020,Cafeteria,1380254,Feb
2023-02-13,El Palacio de los jugos / Lungos Sabor Inc.,Invoice,008-01230,Arroz a Granel:Parboiled 50 LB -Bolsa Dos Hermanos.,,6.0,25.5,153.0,122577.15,,Lisset Limpio -020,Cafeteria,1380255,Feb
2023-02-13,El Palacio de los jugos /  EMMA FOOD CORP,Invoice,008-01231,Arroz a Granel:Largo Fino 50 LB -Bolsa Dos Hermanos.,,7.0,19.85,138.95,122716.1,,Lisset Limpio -020,Cafeteria,1380256,Feb
2023-02-13,El Palacio de los jugos /  Mires Restaurants,Invoice,008-01232,Arroz a Granel:Parboiled 50 LB -Bolsa Dos Hermanos.,,5.0,25.5,127.5,122843.6,,Lisset Limpio -020,Cafeteria,1380257,Feb
2023-02-13,El Palacio de los jugos /  Mires Restaurants,Invoice,008-01232,Arroz a Granel:Largo Fino 50 LB -Bolsa Dos Hermanos.,,8.0,19.85,158.8,123002.4,,Lisset Limpio -020,Cafeteria,1380258,Feb
2023-02-13,El Palacio de Los Jugos / Casa mía Food Restaurant inc,Invoice,008-01233,Arroz a Granel:Parboiled 50 LB -Bolsa Dos Hermanos.,,16.0,25.5,408.0,123410.4,,Lisset Limpio -020,Cafeteria,1380259,Feb
2023-02-13,El Palacio de los jugos / Lita Foods Inc.,Invoice,008-01234,Arroz a Granel:Largo Fino 50 LB -Bolsa Dos Hermanos.,,10.0,19.65,196.5,123606.9,,Lisset Limpio -020,Cafeteria,1380260,Feb
2023-02-13,El Palacio de los jugos / Delicias Criollas (DIAGO FOOD_MILLER),Invoice,008-01235,Arroz a Granel:Largo Fino 50 LB -Bolsa Dos Hermanos.,,10.0,19.85,198.5,123805.4,,Lisset Limpio -020,Cafeteria,1380261,Feb
2023-02-13,El Palacio de los jugos /  E & P Foods,Invoice,008-01236,Arroz a Granel:Largo Fino 50 LB -Bolsa Dos Hermanos.,,5.0,19.65,98.25,123903.65,,Lisset Limpio -020,Cafeteria,1380262,Feb
2023-02-13,El Palacio de los jugos /  E & P Foods,Invoice,008-01236,Arroz a Granel:Parboiled 50 LB -Bolsa Dos Hermanos.,,10.0,25.5,255.0,124158.65,,Lisset Limpio -020,Cafeteria,1380263,Feb
2023-02-13,"Criollos Food USA, LLC",Invoice,008-01237,Arroz a Granel (MWH):Arroz Parboiled en Big Bag (MWH) (deleted),,3.0,1349.12,4047.36,128206.01,,Armando Carpio - 017,WHOLESALER,1380264,Feb
2023-02-13,Armando Carpio,Invoice,008-01238,Arroz Envasado:Parboiled 5KG Dos Hermanos.,6 / 11lbs,1.0,0.0,0.0,128206.01,,Armando Carpio - 017,OTHER,1380265,Feb
2023-02-13,Armando Carpio,Invoice,008-01238,Arroz Envasado:Largo Fino 1kg (Long grain rice) Dos Hermanos,,1.0,0.0,0.0,128206.01,,Armando Carpio - 017,OTHER,1380266,Feb
2023-02-13,Armando Carpio,Invoice,008-01238,Arroz Envasado:Parboiled 1kg Bolsa Dos Hermanos.,I8(43)JUN/ H27/H28/ H29(118) /H30,1.0,0.0,0.0,128206.01,,Armando Carpio - 017,OTHER,1380267,Feb
2023-02-13,Armando Carpio,Invoice,008-01238,Arroz a Granel:Parboiled 50 LB -Bolsa Dos Hermanos.,,1.0,0.0,0.0,128206.01,,Armando Carpio - 017,OTHER,1380268,Feb
2023-02-13,Armando Carpio,Invoice,008-01238,Arroz Envasado:Arroz Parboil DH 1KG cajas Dos Hermanos.,i1,1.0,0.0,0.0,128206.01,,Armando Carpio - 017,OTHER,1380269,Feb
2023-02-13,Armando Carpio,Invoice,008-01238,Arroz Envasado:Doble Carolina 1kg Caja Dos Hermanos,i2JUN,1.0,0.0,0.0,128206.01,,Armando Carpio - 017,OTHER,1380270,Feb
2023-02-14,"YummmyCo, Inc",Invoice,008-01239,Arroz a Granel:Totes Parboiled,,1.0,1349.12,1349.12,129555.13,,Armando Carpio - 017,WHOLESALER,1380271,Feb
2023-02-15,Agrocommerce S.A. C/O Jose Miguel Infante,Invoice,008-01306,Varios:Organic Rice -NI,#147,3.0,2112.0,6336.0,135891.13,,Others - 001,OTHER,1380272,Feb
2023-02-16,Bravo #1,Invoice,008-01240,Arroz Envasado:Parboiled 5KG Dos Hermanos.,6 / 11lbs,10.0,38.5,385.0,136276.13,,Ruta - 019,RETAIL BRAVO,1380273,Feb
2023-02-16,Bravo #1,Invoice,008-01240,Arroz Envasado:Parboiled 5KG Dos Hermanos.,6 / 11lbs,2.0,0.0,0.0,136276.13,,Ruta - 019,RETAIL BRAVO,1380274,Feb
2023-02-16,Sabor Tropical Supermarket #4,Invoice,008-01241,Arroz Envasado:Parboiled 5KG Dos Hermanos.,6 / 11lbs,10.0,38.5,385.0,136661.13,,Ruta - 019,RETAIL  DSD,1380275,Feb
2023-02-16,Sabor Tropical Supermarket #4,Invoice,008-01241,Arroz Envasado:Parboiled 5KG Dos Hermanos.,6 / 11lbs,2.0,0.0,0.0,136661.13,,Ruta - 019,RETAIL  DSD,1380276,Feb
2023-02-16,Rey Chavez Distributor Corp,Invoice,008-01242,Arroz a Granel:Parboiled 50 LB -Bolsa Dos Hermanos.,,55.0,25.0,1375.0,138036.13,,Ruta - 019,WHOLESALER,1380277,Feb
2023-02-16,El Palacio de los jugos / Lita Foods Inc.,Invoice,008-01244,Arroz a Granel:Parboiled 50 LB -Bolsa Dos Hermanos.,,10.0,25.5,255.0,138291.13,,Lisset Limpio -020,Cafeteria,1380278,Feb
2023-02-16,El Palacio de los jugos / Caribe Tropical,Invoice,008-01245,Arroz a Granel:Parboiled 50 LB -Bolsa Dos Hermanos.,,8.0,25.5,204.0,138495.13,,Lisset Limpio -020,Cafeteria,1380279,Feb
2023-02-16,El Palacio de los jugos / Caribe Tropical,Invoice,008-01245,Arroz a Granel:Largo Fino 50 LB -Bolsa Dos Hermanos.,,6.0,19.85,119.1,138614.23,,Lisset Limpio -020,Cafeteria,1380280,Feb
2023-02-16,El Palacio de los jugos /  EMMA FOOD CORP,Invoice,008-01246,Arroz a Granel:Largo Fino 50 LB -Bolsa Dos Hermanos.,,8.0,19.85,158.8,138773.03,,Lisset Limpio -020,Cafeteria,1380281,Feb
2023-02-16,El Palacio de los jugos / Delicias Criollas (DIAGO FOOD_MILLER),Invoice,008-01247,Arroz a Granel:Parboiled 50 LB -Bolsa Dos Hermanos.,,8.0,25.5,204.0,138977.03,,Lisset Limpio -020,Cafeteria,1380282,Feb
2023-02-16,El Palacio de Los Jugos / Casa mía Food Restaurant inc,Invoice,008-01248,Arroz a Granel:Parboiled 50 LB -Bolsa Dos Hermanos.,,7.0,25.5,178.5,139155.53,,Lisset Limpio -020,Cafeteria,1380283,Feb
2023-02-16,El Palacio de los jugos / J Mena Corp.,Invoice,008-01249,Arroz a Granel:Largo Fino 50 LB -Bolsa Dos Hermanos.,,8.0,19.75,158.0,139313.53,,Lisset Limpio -020,Cafeteria,1380284,Feb
2023-02-16,El Palacio de los jugos / J Mena Corp.,Invoice,008-01249,Arroz a Granel:Parboiled 50 LB -Bolsa Dos Hermanos.,,3.0,25.5,76.5,139390.03,,Lisset Limpio -020,Cafeteria,1380285,Feb
2023-02-16,Brito Family Corp.,Invoice,008-01250,Arroz a Granel:Parboiled 50 LB -Bolsa Dos Hermanos.,,110.0,22.5,2475.0,141865.03,,Lisset Limpio -020,CAFETERIA y RESTAURANTS,1380286,Feb
2023-02-16,"Red Diamond Food Services, LLC",Invoice,008-01251,Arroz a Granel:Largo Fino 50 LB -Bolsa Dos Hermanos.,,5.0,19.99,99.95,141964.98,,Lisset Limpio -020,CAFETERIA y RESTAURANTS,1380287,Feb
2023-02-16,"Garman Distributor,LLC",Invoice,008-01252,Arroz a Granel:Parboiled 50 LB -Bolsa Dos Hermanos.,,165.0,22.5,3712.5,145677.48,,Armando Carpio - 017,WHOLESALER,1380288,Feb
2023-02-17,"American Spice Trading Co, Inc.",Invoice,008-01253,Arroz a Granel:Parboiled 50 LB -Bolsa Dos Hermanos.,,550.0,22.0,12100.0,157777.48,,Armando Carpio - 017,WHOLESALER MANUFACTURY,1380289,Feb
2023-02-19,Amerifood,Invoice,008-01254,Arroz a Granel:Largo Fino 50 LB -Bolsa Dos Hermanos.,,55.0,23.0,1265.0,159042.48,,Ruta - 019,WHOLESALER,1380290,Feb
2023-02-19,Amerifood,Invoice,008-01254,Arroz a Granel:Parboiled 50 LB -Bolsa Dos Hermanos.,,55.0,25.5,1402.5,160444.98,,Ruta - 019,WHOLESALER,1380291,Feb
2023-02-19,Amerifood,Invoice,008-01254,Arroz Envasado:Parboiled 5KG Dos Hermanos.,6 / 11lbs,41.0,33.0,1353.0,161797.98,,Ruta - 019,WHOLESALER,1380292,Feb
2023-02-19,El Palacio de los jugos / Lita Foods Inc.,Invoice,008-01255,Arroz a Granel:Parboiled 50 LB -Bolsa Dos Hermanos.,,10.0,25.5,255.0,162052.98,,Lisset Limpio -020,Cafeteria,1380293,Feb
2023-02-19,El Palacio de los jugos /  EMMA FOOD CORP,Invoice,008-01256,Arroz a Granel:Largo Fino 50 LB -Bolsa Dos Hermanos.,,8.0,19.85,158.8,162211.78,,Lisset Limpio -020,Cafeteria,1380294,Feb
2023-02-19,El Palacio de los jugos / Caribe Tropical,Invoice,008-01257,Arroz a Granel:Parboiled 50 LB -Bolsa Dos Hermanos.,,10.0,25.5,255.0,162466.78,,Lisset Limpio -020,Cafeteria,1380295,Feb
2023-02-19,El Palacio de los jugos / Caribe Tropical,Invoice,008-01257,Arroz a Granel:Largo Fino 50 LB -Bolsa Dos Hermanos.,,5.0,19.85,99.25,162566.03,,Lisset Limpio -020,Cafeteria,1380296,Feb
2023-02-19,El Palacio de Los Jugos / Casa mía Food Restaurant inc,Invoice,008-01258,Arroz a Granel:Parboiled 50 LB -Bolsa Dos Hermanos.,,18.0,25.5,459.0,163025.03,,Lisset Limpio -020,Cafeteria,1380297,Feb
2023-02-19,El Palacio de los jugos /  Mires Restaurants,Invoice,008-01259,Arroz a Granel:Largo Fino 50 LB -Bolsa Dos Hermanos.,,8.0,19.85,158.8,163183.83,,Lisset Limpio -020,Cafeteria,1380298,Feb
2023-02-21,Albert Deli #2,Invoice,008-01260,Arroz a Granel:Largo Fino 50 LB -Bolsa Dos Hermanos.,,6.0,23.0,138.0,163321.83,,Ruta - 019,CAFETERIA y RESTAURANTS,1380299,Feb
2023-02-21,El Palacio de los jugos /  E & P Foods,Invoice,008-01261,Arroz a Granel:Largo Fino 50 LB -Bolsa Dos Hermanos.,,3.0,19.65,58.95,163380.78,,Lisset Limpio -020,Cafeteria,1380300,Feb
2023-02-21,El Palacio de los jugos /  E & P Foods,Invoice,008-01261,Arroz a Granel:Parboiled 50 LB -Bolsa Dos Hermanos.,,10.0,25.5,255.0,163635.78,,Lisset Limpio -020,Cafeteria,1380301,Feb
2023-02-21,Sedanos Supermarkets #1,Invoice,008-01262,Rice Snack:Rice Snack Cheese Flavored GR (deleted),H7(40)MAY /H17(50)AUG /i11 (60) AUG // i10 (20),1.0,0.0,0.0,163635.78,,Lisset Limpio -020,RETAIL SEDANOS,1380302,Feb
2023-02-21,Sedanos Supermarkets #1,Invoice,008-01262,"Rice Snack:Rice Snack, Sour Cream & Onion GR (deleted)",H6(41)MAY /H16(60)AUG /i10AUG (30),1.0,0.0,0.0,163635.78,,Lisset Limpio -020,RETAIL SEDANOS,1380303,Feb
2023-02-21,Sedanos Supermarkets #8,Invoice,008-01263,Rice Snack:Rice Snack Cheese Flavored GR (deleted),H7(40)MAY /H17(50)AUG /i11 (60) AUG // i10 (20),1.0,0.0,0.0,163635.78,,Lisset Limpio -020,RETAIL SEDANOS,1380304,Feb
2023-02-21,Sedanos Supermarkets #8,Invoice,008-01263,Rice Snack:Rice Snack Grilled Smoked Meat Flavored GR (deleted),H5(34)MAY/H18(37)AUG /i12(45)AUG,1.0,0.0,0.0,163635.78,,Lisset Limpio -020,RETAIL SEDANOS,1380305,Feb
2023-02-21,Sedanos Supermarkets #8,Invoice,008-01263,"Rice Snack:Rice Snack, Sour Cream & Onion GR (deleted)",H6(41)MAY /H16(60)AUG /i10AUG (30),2.0,0.0,0.0,163635.78,,Lisset Limpio -020,RETAIL SEDANOS,1380306,Feb
2023-02-21,Sedanos Supermarkets  #11,Invoice,008-01264,Rice Snack:Rice Snack Cheese Flavored GR (deleted),H7(40)MAY /H17(50)AUG /i11 (60) AUG // i10 (20),1.0,0.0,0.0,163635.78,,Lisset Limpio -020,RETAIL SEDANOS,1380307,Feb
2023-02-21,Sedanos Supermarkets  #11,Invoice,008-01264,Rice Snack:Rice Snack Grilled Smoked Meat Flavored GR (deleted),H5(34)MAY/H18(37)AUG /i12(45)AUG,2.0,0.0,0.0,163635.78,,Lisset Limpio -020,RETAIL SEDANOS,1380308,Feb
2023-02-21,Sedanos Supermarkets  #11,Invoice,008-01264,"Rice Snack:Rice Snack, Sour Cream & Onion GR (deleted)",H6(41)MAY /H16(60)AUG /i10AUG (30),1.0,0.0,0.0,163635.78,,Lisset Limpio -020,RETAIL SEDANOS,1380309,Feb
2023-02-21,Sedanos Supermarkets #9,Invoice,008-01265,Rice Snack:Rice Snack Cheese Flavored GR (deleted),H7(40)MAY /H17(50)AUG /i11 (60) AUG // i10 (20),1.0,0.0,0.0,163635.78,,Lisset Limpio -020,RETAIL SEDANOS,1380310,Feb
2023-02-21,Sedanos Supermarkets #9,Invoice,008-01265,Rice Snack:Rice Snack Grilled Smoked Meat Flavored GR (deleted),H5(34)MAY/H18(37)AUG /i12(45)AUG,1.0,0.0,0.0,163635.78,,Lisset Limpio -020,RETAIL SEDANOS,1380311,Feb
2023-02-21,Sedanos Supermarkets #9,Invoice,008-01265,"Rice Snack:Rice Snack, Sour Cream & Onion GR (deleted)",H6(41)MAY /H16(60)AUG /i10AUG (30),1.0,0.0,0.0,163635.78,,Lisset Limpio -020,RETAIL SEDANOS,1380312,Feb
2023-02-21,Sedanos Supermarkets #16,Invoice,008-01266,Rice Snack:Rice Snack Cheese Flavored GR (deleted),H7(40)MAY /H17(50)AUG /i11 (60) AUG // i10 (20),1.0,0.0,0.0,163635.78,,Lisset Limpio -020,RETAIL SEDANOS,1380313,Feb
2023-02-21,Sedanos Supermarkets #16,Invoice,008-01266,Rice Snack:Rice Snack Grilled Smoked Meat Flavored GR (deleted),H5(34)MAY/H18(37)AUG /i12(45)AUG,1.0,0.0,0.0,163635.78,,Lisset Limpio -020,RETAIL SEDANOS,1380314,Feb
2023-02-21,Sedanos Supermarkets #16,Invoice,008-01266,Varios:Exhibidor de pie Good Rice PVC,i18,1.0,0.0,0.0,163635.78,,Lisset Limpio -020,RETAIL SEDANOS,1380315,Feb
2023-02-21,Sedanos Supermarkets #43,Invoice,008-01267,Rice Snack:Rice Snack Cheese Flavored GR (deleted),H7(40)MAY /H17(50)AUG /i11 (60) AUG // i10 (20),2.0,0.0,0.0,163635.78,,Lisset Limpio -020,RETAIL SEDANOS,1380316,Feb
2023-02-21,Sedanos Supermarkets #43,Invoice,008-01267,Rice Snack:Rice Snack Grilled Smoked Meat Flavored GR (deleted),H5(34)MAY/H18(37)AUG /i12(45)AUG,1.0,0.0,0.0,163635.78,,Lisset Limpio -020,RETAIL SEDANOS,1380317,Feb
2023-02-21,Sedanos Supermarkets #43,Invoice,008-01267,"Rice Snack:Rice Snack, Sour Cream & Onion DOS HERMANOS",H8,2.0,0.0,0.0,163635.78,,Lisset Limpio -020,RETAIL SEDANOS,1380318,Feb
2023-02-22,El Palacio de los jugos / Delicias Criollas (DIAGO FOOD_MILLER),Invoice,008-01268,Arroz a Granel:Parboiled 50 LB -Bolsa Dos Hermanos.,,18.0,25.5,459.0,164094.78,,Lisset Limpio -020,Cafeteria,1380319,Feb
2023-02-22,Sedanos Supermarkets #38,Invoice,008-01269,Rice Snack:Rice Snack Cheese Flavored GR (deleted),H7(40)MAY /H17(50)AUG /i11 (60) AUG // i10 (20),2.0,0.0,0.0,164094.78,,Lisset Limpio -020,RETAIL SEDANOS,1380320,Feb
2023-02-22,Sedanos Supermarkets #38,Invoice,008-01269,Rice Snack:Rice Snack Grilled Smoked Meat Flavored GR (deleted),H5(34)MAY/H18(37)AUG /i12(45)AUG,1.0,0.0,0.0,164094.78,,Lisset Limpio -020,RETAIL SEDANOS,1380321,Feb
2023-02-22,Sedanos Supermarkets #38,Invoice,008-01269,"Rice Snack:Rice Snack, Sour Cream & Onion GR (deleted)",H6(41)MAY /H16(60)AUG /i10AUG (30),2.0,0.0,0.0,164094.78,,Lisset Limpio -020,RETAIL SEDANOS,1380322,Feb
2023-02-22,Sedanos Supermarkets #38,Invoice,008-01269,Varios:Exhibidor de pie Good Rice PVC,i18,1.0,0.0,0.0,164094.78,,Lisset Limpio -020,RETAIL SEDANOS,1380323,Feb
2023-02-22,Sedanos Supermarkets #29,Invoice,008-01270,Rice Snack:Rice Snack Cheese Flavored GR (deleted),H7(40)MAY /H17(50)AUG /i11 (60) AUG // i10 (20),3.0,0.0,0.0,164094.78,,Lisset Limpio -020,RETAIL SEDANOS,1380324,Feb
2023-02-22,Sedanos Supermarkets #29,Invoice,008-01270,"Rice Snack:Rice Snack, Sour Cream & Onion GR (deleted)",H6(41)MAY /H16(60)AUG /i10AUG (30),3.0,0.0,0.0,164094.78,,Lisset Limpio -020,RETAIL SEDANOS,1380325,Feb
2023-02-22,Sedanos Supermarkets #29,Invoice,008-01270,Rice Snack:Rice Snack Grilled Smoked Meat Flavored GR (deleted),H5(34)MAY/H18(37)AUG /i12(45)AUG,2.0,0.0,0.0,164094.78,,Lisset Limpio -020,RETAIL SEDANOS,1380326,Feb
2023-02-22,Sedanos Supermarkets #29,Invoice,008-01270,Varios:Exhibidor de pie Good Rice PVC,i18,1.0,0.0,0.0,164094.78,,Lisset Limpio -020,RETAIL SEDANOS,1380327,Feb
2023-02-22,Sedanos Supermarkets #31,Invoice,008-01271,Rice Snack:Rice Snack Cheese Flavored GR (deleted),H7(40)MAY /H17(50)AUG /i11 (60) AUG // i10 (20),2.0,0.0,0.0,164094.78,,Lisset Limpio -020,RETAIL SEDANOS,1380328,Feb
2023-02-22,Sedanos Supermarkets #31,Invoice,008-01271,Rice Snack:Rice Snack Grilled Smoked Meat Flavored GR (deleted),H5(34)MAY/H18(37)AUG /i12(45)AUG,2.0,0.0,0.0,164094.78,,Lisset Limpio -020,RETAIL SEDANOS,1380329,Feb
2023-02-22,Sedanos Supermarkets #31,Invoice,008-01271,"Rice Snack:Rice Snack, Sour Cream & Onion GR (deleted)",H6(41)MAY /H16(60)AUG /i10AUG (30),2.0,0.0,0.0,164094.78,,Lisset Limpio -020,RETAIL SEDANOS,1380330,Feb
2023-02-22,Sedanos Supermarkets #21,Invoice,008-01272,Rice Snack:Rice Snack Cheese Flavored GR (deleted),H7(40)MAY /H17(50)AUG /i11 (60) AUG // i10 (20),1.0,0.0,0.0,164094.78,,Lisset Limpio -020,RETAIL SEDANOS,1380331,Feb
2023-02-22,Sedanos Supermarkets #21,Invoice,008-01272,Rice Snack:Rice Snack Grilled Smoked Meat Flavored GR (deleted),H5(34)MAY/H18(37)AUG /i12(45)AUG,1.0,0.0,0.0,164094.78,,Lisset Limpio -020,RETAIL SEDANOS,1380332,Feb
2023-02-22,Sedanos Supermarkets #21,Invoice,008-01272,"Rice Snack:Rice Snack, Sour Cream & Onion GR (deleted)",H6(41)MAY /H16(60)AUG /i10AUG (30),1.0,0.0,0.0,164094.78,,Lisset Limpio -020,RETAIL SEDANOS,1380333,Feb
2023-02-22,Sedanos Supermarkets #42,Invoice,008-01273,Rice Snack:Rice Snack Cheese Flavored GR (deleted),H7(40)MAY /H17(50)AUG /i11 (60) AUG // i10 (20),1.0,0.0,0.0,164094.78,,Lisset Limpio -020,RETAIL SEDANOS,1380334,Feb
2023-02-22,Sedanos Supermarkets #42,Invoice,008-01273,"Rice Snack:Rice Snack, Sour Cream & Onion GR (deleted)",H6(41)MAY /H16(60)AUG /i10AUG (30),1.0,0.0,0.0,164094.78,,Lisset Limpio -020,RETAIL SEDANOS,1380335,Feb
2023-02-22,Sedanos Supermarkets #7,Invoice,008-01274,Rice Snack:Rice Snack Cheese Flavored GR (deleted),H7(40)MAY /H17(50)AUG /i11 (60) AUG // i10 (20),1.0,0.0,0.0,164094.78,,Lisset Limpio -020,RETAIL SEDANOS,1380336,Feb
2023-02-22,Sedanos Supermarkets #7,Invoice,008-01274,Rice Snack:Rice Snack Grilled Smoked Meat Flavored GR (deleted),H5(34)MAY/H18(37)AUG /i12(45)AUG,1.0,0.0,0.0,164094.78,,Lisset Limpio -020,RETAIL SEDANOS,1380337,Feb
2023-02-22,Sedanos Supermarkets #7,Invoice,008-01274,"Rice Snack:Rice Snack, Sour Cream & Onion GR (deleted)",H6(41)MAY /H16(60)AUG /i10AUG (30),1.0,0.0,0.0,164094.78,,Lisset Limpio -020,RETAIL SEDANOS,1380338,Feb
2023-02-22,Sedanos Supermarkets  #4,Invoice,008-01275,Rice Snack:Rice Snack Cheese Flavored GR (deleted),H7(40)MAY /H17(50)AUG /i11 (60) AUG // i10 (20),2.0,0.0,0.0,164094.78,,Lisset Limpio -020,RETAIL SEDANOS,1380339,Feb
2023-02-22,Sedanos Supermarkets  #4,Invoice,008-01275,Rice Snack:Rice Snack Grilled Smoked Meat Flavored GR (deleted),H5(34)MAY/H18(37)AUG /i12(45)AUG,1.0,0.0,0.0,164094.78,,Lisset Limpio -020,RETAIL SEDANOS,1380340,Feb
2023-02-22,Sedanos Supermarkets  #4,Invoice,008-01275,"Rice Snack:Rice Snack, Sour Cream & Onion GR (deleted)",H6(41)MAY /H16(60)AUG /i10AUG (30),2.0,0.0,0.0,164094.78,,Lisset Limpio -020,RETAIL SEDANOS,1380341,Feb
2023-02-22,"American Spice Trading Co, Inc.",Invoice,008-01276,Arroz a Granel:Parboiled 50 LB -Bolsa Dos Hermanos.,,550.0,22.0,12100.0,176194.78,,Armando Carpio - 017,WHOLESALER MANUFACTURY,1380342,Feb
2023-02-22,El Palacio de los jugos /  E & P Foods,Credit Memo,008-01534,Arroz a Granel:Largo Fino 50 LB -Bolsa Dos Hermanos.,No se entregó. S/Inv# 1261,-3.0,19.65,-58.95,176135.83,,Lisset Limpio -020,Cafeteria,1380343,Feb
2023-02-23,El Palacio de los jugos /  E & P Foods,Invoice,008-01279,Arroz a Granel:Parboiled 50 LB -Bolsa Dos Hermanos.,,15.0,25.5,382.5,176518.33,,Lisset Limpio -020,Cafeteria,1380344,Feb
2023-02-23,El Palacio de los jugos / Lita Foods Inc.,Invoice,008-01280,Arroz a Granel:Parboiled 50 LB -Bolsa Dos Hermanos.,,10.0,25.5,255.0,176773.33,,Lisset Limpio -020,Cafeteria,1380345,Feb
2023-02-23,El Palacio de los jugos / Caribe Tropical,Invoice,008-01281,Arroz a Granel:Parboiled 50 LB -Bolsa Dos Hermanos.,,8.0,25.5,204.0,176977.33,,Lisset Limpio -020,Cafeteria,1380346,Feb
2023-02-23,El Palacio de Los Jugos / Casa mía Food Restaurant inc,Invoice,008-01282,Arroz a Granel:Parboiled 50 LB -Bolsa Dos Hermanos.,,7.0,25.5,178.5,177155.83,,Lisset Limpio -020,Cafeteria,1380347,Feb
2023-02-23,El Palacio de los jugos / J Mena Corp.,Invoice,008-01283,Arroz a Granel:Parboiled 50 LB -Bolsa Dos Hermanos.,,10.0,25.5,255.0,177410.83,,Lisset Limpio -020,Cafeteria,1380348,Feb
2023-02-23,Sedanos Supermarkets #14,Invoice,008-01284,Rice Snack:Rice Snack Cheese Flavored GR (deleted),H7(40)MAY /H17(50)AUG /i11 (60) AUG // i10 (20),1.0,0.0,0.0,177410.83,,Lisset Limpio -020,RETAIL SEDANOS,1380349,Feb
2023-02-23,Sedanos Supermarkets #14,Invoice,008-01284,Rice Snack:Rice Snack Grilled Smoked Meat Flavored GR (deleted),H5(34)MAY/H18(37)AUG /i12(45)AUG,1.0,0.0,0.0,177410.83,,Lisset Limpio -020,RETAIL SEDANOS,1380350,Feb
2023-02-23,Sedanos Supermarkets #23,Invoice,008-01285,Rice Snack:Rice Snack Cheese Flavored GR (deleted),H7(40)MAY /H17(50)AUG /i11 (60) AUG // i10 (20),1.0,0.0,0.0,177410.83,,Lisset Limpio -020,RETAIL SEDANOS,1380351,Feb
2023-02-23,Sedanos Supermarkets #23,Invoice,008-01285,Rice Snack:Rice Snack Grilled Smoked Meat Flavored GR (deleted),H5(34)MAY/H18(37)AUG /i12(45)AUG,1.0,0.0,0.0,177410.83,,Lisset Limpio -020,RETAIL SEDANOS,1380352,Feb
2023-02-24,Agrocommerce S.A. C/O Jose Miguel Infante,Invoice,008-01307,Varios:Organic Rice -NI,#149,3.0,2112.0,6336.0,183746.83,,Others - 001,OTHER,1380353,Feb
2023-02-26,Extra Supermarket,Invoice,008-01286,Arroz Envasado:Parboiled 5KG Dos Hermanos.,6 / 11lbs,20.0,38.5,770.0,184516.83,,Ruta - 019,RETAIL  DSD,1380354,Feb
2023-02-26,Extra Supermarket,Invoice,008-01286,Arroz Envasado:Parboiled 5KG Dos Hermanos.,6 / 11lbs,4.0,0.0,0.0,184516.83,,Ruta - 019,RETAIL  DSD,1380355,Feb
2023-02-26,Extra Supermarket,Invoice,008-01286,Arroz Envasado:Largo Fino 1kg (Long grain rice) Dos Hermanos,,5.0,16.5,82.5,184599.33,,Ruta - 019,RETAIL  DSD,1380356,Feb
2023-02-26,Extra Supermarket,Invoice,008-01286,Arroz Envasado:Largo Fino 1kg (Long grain rice) Dos Hermanos,,1.0,0.0,0.0,184599.33,,Ruta - 019,RETAIL  DSD,1380357,Feb
2023-02-26,Broward Meat and Fish,Invoice,008-01287,Arroz Envasado:Parboiled 5KG Dos Hermanos.,6 / 11lbs,10.0,38.5,385.0,184984.33,,Ruta - 019,RETAIL  DSD,1380358,Feb
2023-02-26,Broward Meat and Fish,Invoice,008-01287,Arroz Envasado:Parboiled 5KG Dos Hermanos.,6 / 11lbs,2.0,0.0,0.0,184984.33,,Ruta - 019,RETAIL  DSD,1380359,Feb
2023-02-26,Broward Meat and Fish,Invoice,008-01287,Arroz Envasado:Largo Fino 1kg (Long grain rice) Dos Hermanos,,5.0,16.5,82.5,185066.83,,Ruta - 019,RETAIL  DSD,1380360,Feb
2023-02-26,Broward Meat and Fish,Invoice,008-01287,Arroz Envasado:Largo Fino 1kg (Long grain rice) Dos Hermanos,,1.0,0.0,0.0,185066.83,,Ruta - 019,RETAIL  DSD,1380361,Feb
2023-02-26,El Palacio de los jugos / Delicias Criollas (DIAGO FOOD_MILLER),Invoice,008-01288,Arroz a Granel:Parboiled 50 LB -Bolsa Dos Hermanos.,,18.0,25.5,459.0,185525.83,,Lisset Limpio -020,Cafeteria,1380362,Feb
2023-02-26,El Palacio de los jugos / Lita Foods Inc.,Invoice,008-01289,Arroz a Granel:Parboiled 50 LB -Bolsa Dos Hermanos.,,10.0,25.5,255.0,185780.83,,Lisset Limpio -020,Cafeteria,1380363,Feb
2023-02-26,El Palacio de los jugos / Caribe Tropical,Invoice,008-01290,Arroz a Granel:Parboiled 50 LB -Bolsa Dos Hermanos.,,10.0,25.5,255.0,186035.83,,Lisset Limpio -020,Cafeteria,1380364,Feb
2023-02-26,El Palacio de Los Jugos / Casa mía Food Restaurant inc,Invoice,008-01291,Arroz a Granel:Parboiled 50 LB -Bolsa Dos Hermanos.,,10.0,25.5,255.0,186290.83,,Lisset Limpio -020,Cafeteria,1380365,Feb
2023-02-26,El Palacio de los jugos /  E & P Foods,Invoice,008-01292,Arroz a Granel:Parboiled 50 LB -Bolsa Dos Hermanos.,,0.0,,0.0,186290.83,,Lisset Limpio -020,Cafeteria,1380366,Feb
2023-02-26,El Palacio de los jugos /  Mires Restaurants,Invoice,008-01293,Arroz a Granel:Parboiled 50 LB -Bolsa Dos Hermanos.,,10.0,25.5,255.0,186545.83,,Lisset Limpio -020,Cafeteria,1380367,Feb
2023-02-26,El Palacio de los jugos / Delicias Criollas (DIAGO FOOD_MILLER),Credit Memo,008-01854,Arroz a Granel:Parboiled 50 LB -Bolsa Dos Hermanos.,s/invoice 1288,-8.0,25.5,-204.0,186341.83,,Lisset Limpio -020,Cafeteria,1380368,Feb
2023-02-28,"American Spice Trading Co, Inc.",Invoice,008-01294,Arroz a Granel (MWH):Arroz Parboil Bolsa 50LB Dos hermanos (Alpha),,1045.0,22.0,22990.0,209331.83,,Armando Carpio - 017,WHOLESALER MANUFACTURY,1380369,Feb
2023-02-28,COD Suplies,Invoice,008-01295,Arroz a Granel:Parboiled 50 LB -Bolsa Dos Hermanos.,,55.0,25.5,1402.5,210734.33,,Ruta - 019,WHOLESALER,1380370,Feb
2023-02-28,"American Spice Trading Co, Inc.",Invoice,008-01296,Arroz Envasado:Parboiled 5KG Dos Hermanos.,6 / 11lbs,132.0,13.93,1838.76,212573.09,,Armando Carpio - 017,WHOLESALER MANUFACTURY,1380371,Feb
2023-03-01,Agrocommerce S.A. C/O Jose Miguel Infante,Invoice,008-01308,Varios:Organic Rice -NI,#150,3.0,2112.0,6336.0,218909.09,,Others - 001,OTHER,1380372,Mar
2023-03-02,"American Spice Trading Co, Inc.",Invoice,008-01297,Arroz a Granel (MWH):Arroz Parboil Bolsa 50LB Dos hermanos (Alpha),,55.0,22.0,1210.0,220119.09,,Armando Carpio - 017,WHOLESALER MANUFACTURY,1380373,Mar
2023-03-02,El Palacio de los jugos / Delicias Criollas (DIAGO FOOD_MILLER),Invoice,008-01298,Arroz a Granel:Parboiled 50 LB -Bolsa Dos Hermanos.,,12.0,25.5,306.0,220425.09,,Lisset Limpio -020,Cafeteria,1380374,Mar
2023-03-02,El Palacio de los jugos / Lita Foods Inc.,Invoice,008-01299,Arroz a Granel:Parboiled 50 LB -Bolsa Dos Hermanos.,,10.0,25.5,255.0,220680.09,,Lisset Limpio -020,Cafeteria,1380375,Mar
2023-03-02,El Palacio de los jugos / Caribe Tropical,Invoice,008-01300,Arroz a Granel:Parboiled 50 LB -Bolsa Dos Hermanos.,,10.0,25.5,255.0,220935.09,,Lisset Limpio -020,Cafeteria,1380376,Mar
2023-03-02,El Palacio de Los Jugos / Casa mía Food Restaurant inc,Invoice,008-01301,Arroz a Granel:Parboiled 50 LB -Bolsa Dos Hermanos.,,5.0,25.5,127.5,221062.59,,Lisset Limpio -020,Cafeteria,1380377,Mar
2023-03-02,El Palacio de los jugos /  E & P Foods,Invoice,008-01302,Arroz a Granel:Parboiled 50 LB -Bolsa Dos Hermanos.,,10.0,25.5,255.0,221317.59,,Lisset Limpio -020,Cafeteria,1380378,Mar
2023-03-02,El Palacio de los jugos / J Mena Corp.,Invoice,008-01303,Arroz a Granel:Parboiled 50 LB -Bolsa Dos Hermanos.,,10.0,25.5,255.0,221572.59,,Lisset Limpio -020,Cafeteria,1380379,Mar
2023-03-02,Key Food Kimberly Blvd.,Invoice,008-01304,Arroz a Granel:Parboiled 50 LB -Bolsa Dos Hermanos.,,55.0,25.5,1402.5,222975.09,,Ruta - 019,RETAIL  DSD,1380380,Mar
2023-03-02,Festival Supermarket #1,Invoice,008-01305,Arroz Envasado:Parboiled 5KG Dos Hermanos.,6 / 11lbs,20.0,38.5,770.0,223745.09,,Lisset Limpio -020,RETAIL  DSD,1380381,Mar
2023-03-02,Festival Supermarket #1,Invoice,008-01305,Arroz Envasado:Parboiled 5KG Dos Hermanos.,6 / 11lbs,4.0,0.0,0.0,223745.09,,Lisset Limpio -020,RETAIL  DSD,1380382,Mar
2023-03-05,MIRI Supermarket,Credit Memo,008-01320,Arroz Envasado:Parboiled 5KG Dos Hermanos.,6 / 11lbs,-1.0,38.5,-38.5,223706.59,,Ruta - 019,RETAIL  DSD,1380383,Mar
2023-03-06,MIRI Supermarket,Invoice,008-01309,Arroz Envasado:Parboiled 5KG Dos Hermanos.,6 / 11lbs,10.0,38.5,385.0,224091.59,,Ruta - 019,RETAIL  DSD,1380384,Mar
2023-03-06,MIRI Supermarket,Invoice,008-01309,Arroz Envasado:Parboiled 5KG Dos Hermanos.,6 / 11lbs,2.0,0.0,0.0,224091.59,,Ruta - 019,RETAIL  DSD,1380385,Mar
2023-03-06,El Palacio de los jugos / Lita Foods Inc.,Invoice,008-01310,Arroz a Granel:Parboiled 50 LB -Bolsa Dos Hermanos.,,10.0,25.5,255.0,224346.59,,Lisset Limpio -020,Cafeteria,1380386,Mar
2023-03-06,El Palacio de Los Jugos / Casa mía Food Restaurant inc,Invoice,008-01311,Arroz a Granel:Parboiled 50 LB -Bolsa Dos Hermanos.,,25.0,25.5,637.5,224984.09,,Lisset Limpio -020,Cafeteria,1380387,Mar
2023-03-06,El Palacio de los jugos / Delicias Criollas (DIAGO FOOD_MILLER),Invoice,008-01312,Arroz a Granel:Parboiled 50 LB -Bolsa Dos Hermanos.,,10.0,25.5,255.0,225239.09,,Lisset Limpio -020,Cafeteria,1380388,Mar
2023-03-06,"Meat Club Market, LLC.",Invoice,008-01313,Arroz Envasado:Sushi Rice Dos Hermanos.,i7OCT/i9NOV,4.0,23.0,92.0,225331.09,,Lisset Limpio -020,RETAIL  DSD,1380389,Mar
2023-03-06,Victoria Fresh Market,Credit Memo,008-01314,Rice Snack:Rice Snack Ham Flavored DOS HERMANOS,,-1.0,20.0,-20.0,225311.09,,Ruta - 019,RETAIL  DSD,1380390,Mar
2023-03-06,Victoria Fresh Market,Credit Memo,008-01314,"Rice Snack:Rice Snack, Pizza DH",,-2.0,20.0,-40.0,225271.09,,Ruta - 019,RETAIL  DSD,1380391,Mar
2023-03-06,Victoria Fresh Market,Credit Memo,008-01314,Rice Snack:Rice Snack Salami Flavored DOS HERMANOS,,-1.0,20.0,-20.0,225251.09,,Ruta - 019,RETAIL  DSD,1380392,Mar
2023-03-06,Victoria Fresh Market,Credit Memo,008-01314,"Rice Snack:Rice Snack, Sour Cream & Onion DOS HERMANOS",,-1.0,20.0,-20.0,225231.09,,Ruta - 019,RETAIL  DSD,1380393,Mar
2023-03-07,Festival Supermarket,Invoice,008-01315,Arroz Envasado:Parboiled 5KG Dos Hermanos.,6 / 11lbs,25.0,38.5,962.5,226193.59,,Ruta - 019,RETAIL  DSD,1380394,Mar
2023-03-07,Festival Supermarket,Invoice,008-01315,Arroz Envasado:Parboiled 5KG Dos Hermanos.,6 / 11lbs,5.0,0.0,0.0,226193.59,,Ruta - 019,RETAIL  DSD,1380395,Mar
2023-03-07,Festival Supermarket,Invoice,008-01315,Arroz a Granel:Parboiled 50 LB -Bolsa Dos Hermanos.,,10.0,25.5,255.0,226448.59,,Ruta - 019,RETAIL  DSD,1380396,Mar
2023-03-07,Key Foods - 10301 Royal Palm Food Corp.,Invoice,008-01316,Arroz Envasado:Parboiled 5KG Dos Hermanos.,6 / 11lbs,10.0,38.5,385.0,226833.59,,Ruta - 019,RETAIL KEY FOOD,1380397,Mar
2023-03-07,Key Foods - 10301 Royal Palm Food Corp.,Invoice,008-01316,Arroz Envasado:Parboiled 5KG Dos Hermanos.,6 / 11lbs,2.0,0.0,0.0,226833.59,,Ruta - 019,RETAIL KEY FOOD,1380398,Mar
2023-03-07,Key Foods - 10301 Royal Palm Food Corp.,Invoice,008-01316,,,,0.0,0.0,226833.59,,Ruta - 019,RETAIL KEY FOOD,1380399,Mar
2023-03-07,Key Food  Lake Worth JR 1337,Invoice,008-01317,Arroz Envasado:Parboiled 5KG Dos Hermanos.,6 / 11lbs,10.0,38.5,385.0,227218.59,,Ruta - 019,RETAIL KEY FOOD,1380400,Mar
2023-03-07,Key Food  Lake Worth JR 1337,Invoice,008-01317,Arroz Envasado:Parboiled 5KG Dos Hermanos.,6 / 11lbs,2.0,0.0,0.0,227218.59,,Ruta - 019,RETAIL KEY FOOD,1380401,Mar
2023-03-07,Key Food  Lake Worth JR 1337,Invoice,008-01317,Arroz a Granel:Parboiled 50 LB -Bolsa Dos Hermanos.,,5.0,28.0,140.0,227358.59,,Ruta - 019,RETAIL KEY FOOD,1380402,Mar
2023-03-07,Broward Meat & Fish,Invoice,008-01318,Arroz Envasado:Parboiled 5KG Dos Hermanos.,6 / 11lbs,10.0,38.5,385.0,227743.59,,Ruta - 019,RETAIL  DSD,1380403,Mar
2023-03-07,Broward Meat & Fish,Invoice,008-01318,Arroz Envasado:Parboiled 5KG Dos Hermanos.,6 / 11lbs,2.0,0.0,0.0,227743.59,,Ruta - 019,RETAIL  DSD,1380404,Mar
2023-03-07,Broward Meat & Fish,Invoice,008-01318,Arroz Envasado:Largo Fino 1kg (Long grain rice) Dos Hermanos,,5.0,16.5,82.5,227826.09,,Ruta - 019,RETAIL  DSD,1380405,Mar
2023-03-07,Broward Meat & Fish,Invoice,008-01318,Arroz Envasado:Largo Fino 1kg (Long grain rice) Dos Hermanos,,1.0,0.0,0.0,227826.09,,Ruta - 019,RETAIL  DSD,1380406,Mar
2023-03-07,Key Foods - 10301 Royal Palm Food Corp.,Credit Memo,008-01319,Arroz Envasado:Organico LF Dos Hermanos,i6OCT/ i9NOV,-0.9167,24.0,-22.0,227804.09,,Ruta - 019,RETAIL KEY FOOD,1380407,Mar
2023-03-07,Key Foods - 10301 Royal Palm Food Corp.,Credit Memo,008-01319,Arroz Envasado:Carnaroli Dos Hermanos,i5JUN,-0.825,30.0,-24.75,227779.34,,Ruta - 019,RETAIL KEY FOOD,1380408,Mar
2023-03-07,Key Foods - 10301 Royal Palm Food Corp.,Credit Memo,008-01319,Arroz Envasado:Yamani Integral Dos Hermanos,i6OCT/i9NOV,-0.0625,24.0,-1.5,227777.84,,Ruta - 019,RETAIL KEY FOOD,1380409,Mar
2023-03-07,Key Foods - 10301 Royal Palm Food Corp.,Credit Memo,008-01319,Arroz Envasado:Aromatic Type Rice Dos Hermanos.,i7OCT/I9NOV,-0.439,20.5,-9.0,227768.84,,Ruta - 019,RETAIL KEY FOOD,1380410,Mar
2023-03-07,Sedanos Supermarkets #27,Invoice,008-01321,Rice Snack:Rice Snack Cheese Flavored GR (deleted),H7(40)MAY /H17(50)AUG /i11 (60) AUG // i10 (20),2.0,0.0,0.0,227768.84,,Lisset Limpio -020,RETAIL SEDANOS,1380411,Mar
2023-03-07,Sedanos Supermarkets #27,Invoice,008-01321,Rice Snack:Rice Snack Grilled Smoked Meat Flavored GR (deleted),H5(34)MAY/H18(37)AUG /i12(45)AUG,2.0,0.0,0.0,227768.84,,Lisset Limpio -020,RETAIL SEDANOS,1380412,Mar
2023-03-07,Sedanos Supermarkets #27,Invoice,008-01321,"Rice Snack:Rice Snack, Sour Cream & Onion GR (deleted)",H6(41)MAY /H16(60)AUG /i10AUG (30),2.0,0.0,0.0,227768.84,,Lisset Limpio -020,RETAIL SEDANOS,1380413,Mar
2023-03-07,Sedanos Supermarkets #34,Invoice,008-01322,Rice Snack:Rice Snack Cheese Flavored GR (deleted),H7(40)MAY /H17(50)AUG /i11 (60) AUG // i10 (20),3.0,0.0,0.0,227768.84,,Lisset Limpio -020,RETAIL SEDANOS,1380414,Mar
2023-03-07,Sedanos Supermarkets #34,Invoice,008-01322,Rice Snack:Rice Snack Grilled Smoked Meat Flavored GR (deleted),H5(34)MAY/H18(37)AUG /i12(45)AUG,2.0,0.0,0.0,227768.84,,Lisset Limpio -020,RETAIL SEDANOS,1380415,Mar
2023-03-07,Sedanos Supermarkets #34,Invoice,008-01322,"Rice Snack:Rice Snack, Sour Cream & Onion GR (deleted)",H6(41)MAY /H16(60)AUG /i10AUG (30),3.0,0.0,0.0,227768.84,,Lisset Limpio -020,RETAIL SEDANOS,1380416,Mar
2023-03-07,Sedanos Supermarkets #20,Invoice,008-01323,Rice Snack:Rice Snack Cheese Flavored GR (deleted),H7(40)MAY /H17(50)AUG /i11 (60) AUG // i10 (20),2.0,0.0,0.0,227768.84,,Lisset Limpio -020,RETAIL SEDANOS,1380417,Mar
2023-03-07,Sedanos Supermarkets #20,Invoice,008-01323,Rice Snack:Rice Snack Grilled Smoked Meat Flavored GR (deleted),H5(34)MAY/H18(37)AUG /i12(45)AUG,2.0,0.0,0.0,227768.84,,Lisset Limpio -020,RETAIL SEDANOS,1380418,Mar
2023-03-07,Sedanos Supermarkets #20,Invoice,008-01323,"Rice Snack:Rice Snack, Sour Cream & Onion GR (deleted)",H6(41)MAY /H16(60)AUG /i10AUG (30),1.0,0.0,0.0,227768.84,,Lisset Limpio -020,RETAIL SEDANOS,1380419,Mar
2023-03-07,Sedanos Supermarkets #36,Invoice,008-01324,Rice Snack:Rice Snack Cheese Flavored GR (deleted),H7(40)MAY /H17(50)AUG /i11 (60) AUG // i10 (20),2.0,0.0,0.0,227768.84,,Lisset Limpio -020,RETAIL SEDANOS,1380420,Mar
2023-03-07,Sedanos Supermarkets #36,Invoice,008-01324,"Rice Snack:Rice Snack, Sour Cream & Onion GR (deleted)",H6(41)MAY /H16(60)AUG /i10AUG (30),2.0,0.0,0.0,227768.84,,Lisset Limpio -020,RETAIL SEDANOS,1380421,Mar
2023-03-07,Sedanos Supermarkets #36,Invoice,008-01324,Rice Snack:Rice Snack Grilled Smoked Meat Flavored GR (deleted),H5(34)MAY/H18(37)AUG /i12(45)AUG,1.0,0.0,0.0,227768.84,,Lisset Limpio -020,RETAIL SEDANOS,1380422,Mar
2023-03-09,Sabor Tropical Supermarket #6,Invoice,008-01325,Arroz Envasado:Parboiled 5KG Dos Hermanos.,6 / 11lbs,10.0,38.5,385.0,228153.84,,Lisset Limpio -020,RETAIL KEY FOOD,1380423,Mar
2023-03-09,Sabor Tropical Supermarket #6,Invoice,008-01325,Arroz Envasado:Parboiled 5KG Dos Hermanos.,6 / 11lbs,2.0,0.0,0.0,228153.84,,Lisset Limpio -020,RETAIL KEY FOOD,1380424,Mar
2023-03-09,Sabor Tropical Supermarket #6,Invoice,008-01325,Arroz Envasado:Largo Fino 1kg (Long grain rice) Dos Hermanos,,1.0,0.0,0.0,228153.84,,Lisset Limpio -020,RETAIL KEY FOOD,1380425,Mar
2023-03-09,Sabor Tropical Supermarket #6,Invoice,008-01325,Arroz Envasado:Parboiled 1kg Bolsa Dos Hermanos.,I8(43)JUN/ H27/H28/ H29(118) /H30,1.0,0.0,0.0,228153.84,,Lisset Limpio -020,RETAIL KEY FOOD,1380426,Mar
2023-03-09,El Gaitero Supermarket II,Invoice,008-01326,Arroz Envasado:Largo Fino 1kg (Long grain rice) Dos Hermanos,,10.0,16.5,165.0,228318.84,,Ruta - 019,RETAIL  DSD,1380427,Mar
2023-03-09,El Gaitero Supermarket II,Invoice,008-01326,Arroz Envasado:Largo Fino 1kg (Long grain rice) Dos Hermanos,,2.0,0.0,0.0,228318.84,,Ruta - 019,RETAIL  DSD,1380428,Mar
2023-03-09,El Palacio de los jugos / Delicias Criollas (DIAGO FOOD_MILLER),Invoice,008-01327,Arroz a Granel:Parboiled 50 LB -Bolsa Dos Hermanos.,,10.0,25.5,255.0,228573.84,,Lisset Limpio -020,Cafeteria,1380429,Mar
2023-03-09,El Palacio de los jugos / Caribe Tropical,Invoice,008-01328,Arroz a Granel:Parboiled 50 LB -Bolsa Dos Hermanos.,,10.0,25.5,255.0,228828.84,,Lisset Limpio -020,Cafeteria,1380430,Mar
2023-03-09,El Palacio de los jugos /  E & P Foods,Invoice,008-01329,Arroz a Granel:Parboiled 50 LB -Bolsa Dos Hermanos.,,15.0,25.5,382.5,229211.34,,Lisset Limpio -020,Cafeteria,1380431,Mar
2023-03-09,El Palacio de los jugos / J Mena Corp.,Invoice,008-01330,Arroz a Granel:Parboiled 50 LB -Bolsa Dos Hermanos.,,10.0,25.5,255.0,229466.34,,Lisset Limpio -020,Cafeteria,1380432,Mar
2023-03-09,El Palacio de los jugos /  Mires Restaurants,Invoice,008-01331,Arroz a Granel:Parboiled 50 LB -Bolsa Dos Hermanos.,,6.0,25.5,153.0,229619.34,,Lisset Limpio -020,Cafeteria,1380433,Mar
2023-03-09,Key Food 119 St.,Invoice,008-01332,Arroz Envasado:Largo Fino 1kg (Long grain rice) Dos Hermanos,,10.0,16.5,165.0,229784.34,,Lisset Limpio -020,RETAIL KEY FOOD,1380434,Mar
2023-03-09,Key Food 119 St.,Invoice,008-01332,Arroz Envasado:Largo Fino 1kg (Long grain rice) Dos Hermanos,,1.0,0.0,0.0,229784.34,,Lisset Limpio -020,RETAIL KEY FOOD,1380435,Mar
2023-03-09,El Palacio de los jugos / Lita Foods Inc.,Invoice,008-01333,Arroz a Granel:Parboiled 50 LB -Bolsa Dos Hermanos.,,10.0,25.5,255.0,230039.34,,Lisset Limpio -020,Cafeteria,1380436,Mar
2023-03-13,El Palacio de los jugos / Lita Foods Inc.,Invoice,008-01334,Arroz a Granel:Parboiled 50 LB -Bolsa Dos Hermanos.,,10.0,25.5,255.0,230294.34,,Lisset Limpio -020,Cafeteria,1380437,Mar
2023-03-13,El Palacio de los jugos / Caribe Tropical,Invoice,008-01335,Arroz a Granel:Parboiled 50 LB -Bolsa Dos Hermanos.,,10.0,25.5,255.0,230549.34,,Lisset Limpio -020,Cafeteria,1380438,Mar
2023-03-13,El Palacio de Los Jugos / Casa mía Food Restaurant inc,Invoice,008-01336,Arroz a Granel:Parboiled 50 LB -Bolsa Dos Hermanos.,,15.0,25.5,382.5,230931.84,,Lisset Limpio -020,Cafeteria,1380439,Mar
2023-03-13,El Palacio de los jugos /  EMMA FOOD CORP,Invoice,008-01337,Arroz a Granel:Parboiled 50 LB -Bolsa Dos Hermanos.,,10.0,25.5,255.0,231186.84,,Lisset Limpio -020,Cafeteria,1380440,Mar
2023-03-13,Key Food Weston,Invoice,008-01338,Arroz Envasado:Parboiled 5KG Dos Hermanos.,6 / 11lbs,30.0,38.5,1155.0,232341.84,,Lisset Limpio -020,RETAIL  DSD,1380441,Mar
2023-03-13,Key Food Weston,Invoice,008-01338,Arroz Envasado:Parboiled 5KG Dos Hermanos.,6 / 11lbs,6.0,0.0,0.0,232341.84,,Lisset Limpio -020,RETAIL  DSD,1380442,Mar
2023-03-13,Foodtown Supermarket,Invoice,008-01339,Arroz Envasado:Parboiled 5KG Dos Hermanos.,6 / 11lbs,20.0,38.5,770.0,233111.84,,Ruta - 019,CAFETERIA y RESTAURANTS,1380443,Mar
2023-03-13,Foodtown Supermarket,Invoice,008-01339,Arroz Envasado:Parboiled 5KG Dos Hermanos.,6 / 11lbs,4.0,0.0,0.0,233111.84,,Ruta - 019,CAFETERIA y RESTAURANTS,1380444,Mar
2023-03-13,Price Choice Food Market # 7,Invoice,008-01340,Arroz Envasado:Parboiled 5KG Dos Hermanos.,6 / 11lbs,10.0,38.5,385.0,233496.84,,Ruta - 019,RETAIL  DSD,1380445,Mar
2023-03-13,Price Choice Food Market # 7,Invoice,008-01340,Arroz Envasado:Parboiled 5KG Dos Hermanos.,6 / 11lbs,2.0,0.0,0.0,233496.84,,Ruta - 019,RETAIL  DSD,1380446,Mar
2023-03-13,Price Choice Food Market # 7,Invoice,008-01340,Arroz Envasado:Largo Fino 1kg (Long grain rice) Dos Hermanos,,5.0,16.5,82.5,233579.34,,Ruta - 019,RETAIL  DSD,1380447,Mar
2023-03-13,Price Choice Food Market # 7,Invoice,008-01340,Arroz Envasado:Largo Fino 1kg (Long grain rice) Dos Hermanos,,1.0,0.0,0.0,233579.34,,Ruta - 019,RETAIL  DSD,1380448,Mar
2023-03-13,Agrocommerce S.A. C/O Jose Miguel Infante,Invoice,008-01341,Varios:Organic Rice -NI,#152,3.0,2112.0,6336.0,239915.34,,Others - 001,OTHER,1380449,Mar
2023-03-14,Albert Deli #2,Invoice,008-01342,Arroz a Granel:Parboiled 50 LB -Bolsa Dos Hermanos.,,6.0,28.0,168.0,240083.34,,Ruta - 019,CAFETERIA y RESTAURANTS,1380450,Mar
2023-03-15,Agrocommerce S.A. C/O Jose Miguel Infante,Invoice,008-01345,Varios:Organic Rice -NI,#153,3.0,2112.0,6336.0,246419.34,,Others - 001,OTHER,1380451,Mar
2023-03-16,Sedanos Supermarkets #24,Invoice,008-01343,Rice Snack:Rice Snack Cheese Flavored GR (deleted),H7(40)MAY /H17(50)AUG /i11 (60) AUG // i10 (20),2.0,0.0,0.0,246419.34,,Lisset Limpio -020,RETAIL SEDANOS,1380452,Mar
2023-03-16,Sedanos Supermarkets #24,Invoice,008-01343,Rice Snack:Rice Snack Grilled Smoked Meat Flavored GR (deleted),H5(34)MAY/H18(37)AUG /i12(45)AUG,2.0,0.0,0.0,246419.34,,Lisset Limpio -020,RETAIL SEDANOS,1380453,Mar
2023-03-16,Sedanos Supermarkets #24,Invoice,008-01343,"Rice Snack:Rice Snack, Sour Cream & Onion GR (deleted)",H6(41)MAY /H16(60)AUG /i10AUG (30),1.0,0.0,0.0,246419.34,,Lisset Limpio -020,RETAIL SEDANOS,1380454,Mar
2023-03-16,Festival Supermarket #35- Southgate,Invoice,008-01344,Rice Snack:Rice Snack Cheese Flavored GR (deleted),H7(40)MAY /H17(50)AUG /i11 (60) AUG // i10 (20),2.0,0.0,0.0,246419.34,,Lisset Limpio -020,RETAIL  DSD,1380455,Mar
2023-03-16,Festival Supermarket #35- Southgate,Invoice,008-01344,Rice Snack:Rice Snack Grilled Smoked Meat Flavored GR (deleted),H5(34)MAY/H18(37)AUG /i12(45)AUG,1.0,0.0,0.0,246419.34,,Lisset Limpio -020,RETAIL  DSD,1380456,Mar
2023-03-16,Festival Supermarket #35- Southgate,Invoice,008-01344,"Rice Snack:Rice Snack, Sour Cream & Onion GR (deleted)",H6(41)MAY /H16(60)AUG /i10AUG (30),2.0,0.0,0.0,246419.34,,Lisset Limpio -020,RETAIL  DSD,1380457,Mar
2023-03-16,El Palacio de los jugos / Delicias Criollas (DIAGO FOOD_MILLER),Invoice,008-01346,Arroz a Granel:Parboiled 50 LB -Bolsa Dos Hermanos.,,12.0,25.5,306.0,246725.34,,Lisset Limpio -020,Cafeteria,1380458,Mar
2023-03-16,El Palacio de los jugos /  Mires Restaurants,Invoice,008-01347,Arroz a Granel:Parboiled 50 LB -Bolsa Dos Hermanos.,,10.0,25.5,255.0,246980.34,,Lisset Limpio -020,Cafeteria,1380459,Mar
2023-03-16,El Palacio de los jugos / Lita Foods Inc.,Invoice,008-01348,Arroz a Granel:Parboiled 50 LB -Bolsa Dos Hermanos.,,10.0,25.5,255.0,247235.34,,Lisset Limpio -020,Cafeteria,1380460,Mar
2023-03-16,El Palacio de los jugos / J Mena Corp.,Invoice,008-01349,Arroz a Granel:Parboiled 50 LB -Bolsa Dos Hermanos.,,10.0,25.5,255.0,247490.34,,Lisset Limpio -020,Cafeteria,1380461,Mar
2023-03-16,Ideal Food Basket Davie Cafeteria,Invoice,008-01350,Arroz a Granel:Parboiled 50 LB -Bolsa Dos Hermanos.,,5.0,28.0,140.0,247630.34,,Ruta - 019,CAFETERIA y RESTAURANTS,1380462,Mar
2023-03-16,Ideal Food Basket Davie Cafeteria,Invoice,008-01350,Arroz Envasado:Largo Fino 1kg (Long grain rice) Dos Hermanos,,1.0,0.0,0.0,247630.34,,Ruta - 019,CAFETERIA y RESTAURANTS,1380463,Mar
2023-03-16,Bake Mark USA LLC,Invoice,008-01351,Arroz a Granel (MWH):Arroz Parboiled en Big Bag (MWH) (deleted),,0.0,,0.0,247630.34,,Armando Carpio - 017,WHOLESALER MANUFACTURY,1380464,Mar
2023-03-17,Agrocommerce S.A. C/O Jose Miguel Infante,Invoice,008-01352,Varios:Organic Rice -NI,#154,3.0,2112.0,6336.0,253966.34,,Others - 001,OTHER,1380465,Mar
2023-03-20,El Palacio de los jugos / Delicias Criollas (DIAGO FOOD_MILLER),Invoice,008-01353,Arroz a Granel:Parboiled 50 LB -Bolsa Dos Hermanos.,,10.0,25.5,255.0,254221.34,,Lisset Limpio -020,Cafeteria,1380466,Mar
2023-03-20,El Palacio de los jugos / Lita Foods Inc.,Invoice,008-01354,Arroz a Granel:Parboiled 50 LB -Bolsa Dos Hermanos.,,10.0,25.5,255.0,254476.34,,Lisset Limpio -020,Cafeteria,1380467,Mar
2023-03-20,El Palacio de los jugos / Caribe Tropical,Invoice,008-01355,Arroz a Granel:Parboiled 50 LB -Bolsa Dos Hermanos.,,10.0,25.5,255.0,254731.34,,Lisset Limpio -020,Cafeteria,1380468,Mar
2023-03-20,El Palacio de los jugos /  E & P Foods,Invoice,008-01356,Arroz a Granel:Parboiled 50 LB -Bolsa Dos Hermanos.,,15.0,25.5,382.5,255113.84,,Lisset Limpio -020,Cafeteria,1380469,Mar
2023-03-20,El Palacio de Los Jugos / Casa mía Food Restaurant inc,Invoice,008-01357,Arroz a Granel:Parboiled 50 LB -Bolsa Dos Hermanos.,,20.0,25.5,510.0,255623.84,,Lisset Limpio -020,Cafeteria,1380470,Mar
2023-03-20,Lissete Limpio,Invoice,008-01358,Arroz Envasado:Largo Fino 1kg (Long grain rice) Dos Hermanos,,1.0,0.0,0.0,255623.84,,Lisset Limpio -020,OTHER,1380471,Mar
2023-03-20,Lissete Limpio,Invoice,008-01358,Arroz Envasado:Parboiled 1kg Bolsa Dos Hermanos.,I8(43)JUN/ H27/H28/ H29(118) /H30,1.0,0.0,0.0,255623.84,,Lisset Limpio -020,OTHER,1380472,Mar
2023-03-21,Miavana & Family,Invoice,008-01359,Arroz a Granel:Parboiled 50 LB -Bolsa Dos Hermanos.,,220.0,21.5,4730.0,260353.84,,Armando Carpio - 017,Distributor,1380473,Mar
2023-03-21,Bake Mark USA LLC,Invoice,008-01360,Arroz a Granel (MWH):Arroz Parboiled en Big Bag (MWH) (deleted),,0.0,,0.0,260353.84,,Armando Carpio - 017,WHOLESALER MANUFACTURY,1380474,Mar
2023-03-22,Extra Supermarket N.J.,Invoice,008-01361,Arroz Envasado ((NJ)):Parboiled 5KG Dos Hermanos ((NJ)) (deleted),,41.0,32.5,1332.5,261686.34,,Armando Carpio - 017,RETAIL  DSD,1380475,Mar
2023-03-22,"Criollos Food USA, LLC",Invoice,008-01362,Arroz a Granel (MWH):Arroz Parboiled en Big Bag (MWH) (deleted),,3.0,1349.28,4047.84,265734.18,,Armando Carpio - 017,WHOLESALER,1380476,Mar
2023-03-22,Bake Mark USA LLC,Invoice,008-01363,Arroz a Granel:Parboiled 50 LB -Bolsa Dos Hermanos.,,0.0,,0.0,265734.18,,Armando Carpio - 017,WHOLESALER MANUFACTURY,1380477,Mar
2023-03-22,Key Food 7th Ave manager Alex,Invoice,008-01364,Arroz Envasado:Parboiled 5KG Dos Hermanos.,6 / 11lbs,10.0,38.6,386.0,266120.18,,Ruta - 019,RETAIL  DSD,1380478,Mar
2023-03-22,Key Food 7th Ave manager Alex,Invoice,008-01364,Arroz Envasado:Parboiled 5KG Dos Hermanos.,6 / 11lbs,2.0,0.0,0.0,266120.18,,Ruta - 019,RETAIL  DSD,1380479,Mar
2023-03-22,Key Food 7th Ave manager Alex,Invoice,008-01364,Arroz Envasado:Largo Fino 1kg (Long grain rice) Dos Hermanos,,5.0,16.5,82.5,266202.68,,Ruta - 019,RETAIL  DSD,1380480,Mar
2023-03-22,Key Food 7th Ave manager Alex,Invoice,008-01364,Arroz Envasado:Largo Fino 1kg (Long grain rice) Dos Hermanos,,1.0,0.0,0.0,266202.68,,Ruta - 019,RETAIL  DSD,1380481,Mar
2023-03-22,Key Food 7th Ave manager Alex,Invoice,008-01364,Arroz a Granel:Largo Fino 50 LB -Bolsa Dos Hermanos.,,10.0,25.5,255.0,266457.68,,Ruta - 019,RETAIL  DSD,1380482,Mar
2023-03-22,Key Food 119 St.,Invoice,008-01365,Arroz Envasado:Parboiled 5KG Dos Hermanos.,6 / 11lbs,10.0,38.5,385.0,266842.68,,Ruta - 019,RETAIL KEY FOOD,1380483,Mar
2023-03-22,Key Food 119 St.,Invoice,008-01365,Arroz Envasado:Parboiled 5KG Dos Hermanos.,6 / 11lbs,2.0,0.0,0.0,266842.68,,Ruta - 019,RETAIL KEY FOOD,1380484,Mar
2023-03-22,Key Food 119 St.,Invoice,008-01365,Arroz Envasado:Largo Fino 1kg (Long grain rice) Dos Hermanos,,5.0,16.5,82.5,266925.18,,Ruta - 019,RETAIL KEY FOOD,1380485,Mar
2023-03-22,Key Food 119 St.,Invoice,008-01365,Arroz Envasado:Largo Fino 1kg (Long grain rice) Dos Hermanos,,1.0,0.0,0.0,266925.18,,Ruta - 019,RETAIL KEY FOOD,1380486,Mar
2023-03-22,Key Food 119 St.,Invoice,008-01365,Arroz a Granel:Parboiled 50 LB -Bolsa Dos Hermanos.,,5.0,25.5,127.5,267052.68,,Ruta - 019,RETAIL KEY FOOD,1380487,Mar
2023-03-23,Agrocommerce S.A. C/O Jose Miguel Infante,Invoice,008-01377,Varios:Organic Rice -NI,inv#155,3.0,2064.0,6192.0,273244.68,,Others - 001,OTHER,1380488,Mar
2023-03-24,El Palacio de los jugos /  EMMA FOOD CORP,Invoice,008-01366,Arroz a Granel:Parboiled 50 LB -Bolsa Dos Hermanos.,,10.0,25.5,255.0,273499.68,,Lisset Limpio -020,Cafeteria,1380489,Mar
2023-03-24,El Palacio de los jugos /  EMMA FOOD CORP,Invoice,008-01366,Spices:AS Chicken Base Pail (deleted),1/30 lb.,1.0,40.25,40.25,273539.93,,Lisset Limpio -020,Cafeteria,1380490,Mar
2023-03-24,El Palacio de los jugos /  EMMA FOOD CORP,Invoice,008-01366,Spices:AS Sazon (All Seasoning) (deleted),1/30 lb,1.0,40.6,40.6,273580.53,,Lisset Limpio -020,Cafeteria,1380491,Mar
2023-03-24,El Palacio de los jugos /  EMMA FOOD CORP,Invoice,008-01366,Spices:AS Cumin Ground,4 / 4 lb,1.0,50.25,50.25,273630.78,,Lisset Limpio -020,Cafeteria,1380492,Mar
2023-03-24,El Palacio de los jugos /  EMMA FOOD CORP,Invoice,008-01366,Liquids:AS Marinating Sauce (Mojo),,1.0,15.0,15.0,273645.78,,Lisset Limpio -020,Cafeteria,1380493,Mar
2023-03-24,El Palacio de los jugos /  EMMA FOOD CORP,Invoice,008-01366,Liquids:AS White Vinegar,4/1 Gl.,1.0,9.5,9.5,273655.28,,Lisset Limpio -020,Cafeteria,1380494,Mar
2023-03-24,El Palacio de los jugos /  EMMA FOOD CORP,Invoice,008-01366,Liquids:AS Cooking Wine,4/1 Gl.,1.0,13.4,13.4,273668.68,,Lisset Limpio -020,Cafeteria,1380495,Mar
2023-03-24,El Palacio de los jugos /  EMMA FOOD CORP,Invoice,008-01366,,,,,0.0,273668.68,,Lisset Limpio -020,Cafeteria,1380496,Mar
2023-03-24,El Palacio de los jugos /  E & P Foods,Invoice,008-01367,Arroz a Granel:Parboiled 50 LB -Bolsa Dos Hermanos.,,10.0,25.5,255.0,273923.68,,Lisset Limpio -020,Cafeteria,1380497,Mar
2023-03-24,El Palacio de los jugos /  E & P Foods,Invoice,008-01367,Liquids:AS Marinating Sauce (Mojo),,2.0,15.0,30.0,273953.68,,Lisset Limpio -020,Cafeteria,1380498,Mar
2023-03-24,El Palacio de los jugos /  E & P Foods,Invoice,008-01367,Liquids:AS Cooking Wine,4/1 Gl.,3.0,13.35,40.05,273993.73,,Lisset Limpio -020,Cafeteria,1380499,Mar
2023-03-24,El Palacio de los jugos / Lita Foods Inc.,Invoice,008-01368,Arroz a Granel:Parboiled 50 LB -Bolsa Dos Hermanos.,,15.0,25.5,382.5,274376.23,,Lisset Limpio -020,Cafeteria,1380500,Mar
2023-03-24,El Palacio de los jugos / J Mena Corp.,Invoice,008-01369,Arroz a Granel:Parboiled 50 LB -Bolsa Dos Hermanos.,,10.0,25.5,255.0,274631.23,,Lisset Limpio -020,Cafeteria,1380501,Mar
2023-03-24,El Palacio de los jugos / J Mena Corp.,Invoice,008-01369,Spices:AS Chicken Base Pail (deleted),1/30 lb.,1.0,40.25,40.25,274671.48,,Lisset Limpio -020,Cafeteria,1380502,Mar
2023-03-24,El Palacio de los jugos / J Mena Corp.,Invoice,008-01369,Spices:AS Sazon (All Seasoning) (deleted),1/30 lb,1.0,40.6,40.6,274712.08,,Lisset Limpio -020,Cafeteria,1380503,Mar
2023-03-24,El Palacio de los jugos / J Mena Corp.,Invoice,008-01369,Spices:AS Cumin Ground,4 / 4 lb,1.0,50.25,50.25,274762.33,,Lisset Limpio -020,Cafeteria,1380504,Mar
2023-03-24,El Palacio de los jugos / J Mena Corp.,Invoice,008-01369,Liquids:AS Marinating Sauce (Mojo),,2.0,15.0,30.0,274792.33,,Lisset Limpio -020,Cafeteria,1380505,Mar
2023-03-24,El Palacio de los jugos / J Mena Corp.,Invoice,008-01369,Liquids:AS Bitter Orange,,1.0,16.85,16.85,274809.18,,Lisset Limpio -020,Cafeteria,1380506,Mar
2023-03-24,El Palacio de los jugos / J Mena Corp.,Invoice,008-01369,Spices:AS Whole Bay Leaves,4/12 OZ,1.0,20.7,20.7,274829.88,,Lisset Limpio -020,Cafeteria,1380507,Mar
2023-03-24,El Palacio de los jugos / Delicias Criollas (DIAGO FOOD_MILLER),Invoice,008-01370,Arroz a Granel:Parboiled 50 LB -Bolsa Dos Hermanos.,,12.0,25.5,306.0,275135.88,,Lisset Limpio -020,Cafeteria,1380508,Mar
2023-03-24,El Palacio de los jugos / Delicias Criollas (DIAGO FOOD_MILLER),Invoice,008-01370,Spices:AS Whole Bay Leaves,4/12 OZ,1.0,20.7,20.7,275156.58,,Lisset Limpio -020,Cafeteria,1380509,Mar
2023-03-24,El Palacio de los jugos / Delicias Criollas (DIAGO FOOD_MILLER),Invoice,008-01370,Liquids:AS Marinating Sauce (Mojo),,1.0,15.0,15.0,275171.58,,Lisset Limpio -020,Cafeteria,1380510,Mar
2023-03-24,Bake Mark USA LLC,Invoice,008-01371,Arroz a Granel:Parboiled 50 LB -Bolsa Dos Hermanos.,,0.0,,0.0,275171.58,,Armando Carpio - 017,WHOLESALER MANUFACTURY,1380511,Mar
2023-03-27,El Palacio de los jugos /  EMMA FOOD CORP,Invoice,008-01372,Arroz a Granel:Parboiled 50 LB -Bolsa Dos Hermanos.,,8.0,25.5,204.0,275375.58,,Lisset Limpio -020,Cafeteria,1380512,Mar
2023-03-27,El Palacio de los jugos /  EMMA FOOD CORP,Invoice,008-01372,Arroz a Granel:Largo Fino 50 LB -Bolsa Dos Hermanos.,,1.0,20.0,20.0,275395.58,,Lisset Limpio -020,Cafeteria,1380513,Mar
2023-03-27,El Palacio de los jugos / Lita Foods Inc.,Invoice,008-01373,Arroz a Granel:Parboiled 50 LB -Bolsa Dos Hermanos.,,10.0,25.5,255.0,275650.58,,Lisset Limpio -020,Cafeteria,1380514,Mar
2023-03-27,El Palacio de Los Jugos / Casa mía Food Restaurant inc,Invoice,008-01374,Arroz a Granel:Parboiled 50 LB -Bolsa Dos Hermanos.,,15.0,25.5,382.5,276033.08,,Lisset Limpio -020,Cafeteria,1380515,Mar
2023-03-27,El Palacio de los jugos / Caribe Tropical,Invoice,008-01375,Arroz a Granel:Parboiled 50 LB -Bolsa Dos Hermanos.,,10.0,25.5,255.0,276288.08,,Lisset Limpio -020,Cafeteria,1380516,Mar
2023-03-27,El Palacio de los jugos /  Mires Restaurants,Invoice,008-01376,Arroz a Granel:Parboiled 50 LB -Bolsa Dos Hermanos.,,8.0,25.5,204.0,276492.08,,Lisset Limpio -020,Cafeteria,1380517,Mar
2023-03-27,CV of America LLC,Invoice,008-01378,Varios:Organic Rice -NI,Fc DH#156,144.0,34.5,4968.0,281460.08,,Others - 001,OTHER,1380518,Mar
2023-03-28,Bake Mark USA LLC,Invoice,008-01382,Arroz a Granel (MWH):Arroz Parboiled en Big Bag (MWH) (deleted),,20.0,1053.97,21079.34,302539.42,,Armando Carpio - 017,WHOLESALER MANUFACTURY,1380519,Mar
2023-03-29,Amerifood,Invoice,008-01379,Arroz Envasado:Parboiled 5KG Dos Hermanos.,6 / 11lbs,41.0,33.0,1353.0,303892.42,,Ruta - 019,WHOLESALER,1380520,Mar
2023-03-29,Amerifood,Invoice,008-01379,Arroz Envasado:Largo Fino 1kg (Long grain rice) Dos Hermanos,,120.0,13.5,1620.0,305512.42,,Ruta - 019,WHOLESALER,1380521,Mar
2023-03-29,Amerifood,Invoice,008-01379,Arroz Envasado:Parboiled 1kg Bolsa Dos Hermanos.,I8(43)JUN/ H27/H28/ H29(118) /H30,120.0,15.5,1860.0,307372.42,,Ruta - 019,WHOLESALER,1380522,Mar
2023-03-29,One and Only Logistics,Invoice,008-01380,Arroz a Granel ((NJ)):Arroz Parboil Bolsa 50LB Dos hermanos ((NJ)) (deleted),,55.0,25.5,1402.5,308774.92,,Armando Carpio - 017,OTHER,1380523,Mar
2023-03-29,"American Spice Trading Co, Inc.",Invoice,008-01381,Arroz a Granel:Parboiled 50 LB -Bolsa Dos Hermanos.,,110.0,22.0,2420.0,311194.92,,Armando Carpio - 017,WHOLESALER MANUFACTURY,1380524,Mar
2023-03-29,Bake Mark USA LLC,Invoice,008-01383,Arroz a Granel (MWH):Arroz Parboiled en Big Bag (MWH) (deleted),,20.0,1053.97,21079.4,332274.32,,Armando Carpio - 017,WHOLESALER MANUFACTURY,1380525,Mar
2023-03-30,El Palacio de los jugos / J Mena Corp.,Invoice,008-01384,Arroz a Granel:Parboiled 50 LB -Bolsa Dos Hermanos.,,10.0,25.5,255.0,332529.32,,Lisset Limpio -020,Cafeteria,1380526,Mar
2023-03-30,El Palacio de los jugos / J Mena Corp.,Invoice,008-01384,Spices:AS Sazon (All Seasoning) (deleted),1/30 lb,1.0,46.59,46.59,332575.91,,Lisset Limpio -020,Cafeteria,1380527,Mar
2023-03-30,El Palacio de los jugos /  EMMA FOOD CORP,Invoice,008-01385,Arroz a Granel:Parboiled 50 LB -Bolsa Dos Hermanos.,,10.0,25.5,255.0,332830.91,,Lisset Limpio -020,Cafeteria,1380528,Mar
2023-03-30,El Palacio de los jugos / Delicias Criollas (DIAGO FOOD_MILLER),Invoice,008-01386,Arroz a Granel:Parboiled 50 LB -Bolsa Dos Hermanos.,,10.0,25.5,255.0,333085.91,,Lisset Limpio -020,Cafeteria,1380529,Mar
2023-03-30,El Palacio de los jugos / Caribe Tropical,Invoice,008-01387,Arroz a Granel:Parboiled 50 LB -Bolsa Dos Hermanos.,,10.0,25.5,255.0,333340.91,,Lisset Limpio -020,Cafeteria,1380530,Mar
2023-03-30,El Palacio de Los Jugos / Casa mía Food Restaurant inc,Invoice,008-01388,Arroz a Granel:Parboiled 50 LB -Bolsa Dos Hermanos.,,5.0,25.5,127.5,333468.41,,Lisset Limpio -020,Cafeteria,1380531,Mar
2023-03-30,El Palacio de los jugos /  E & P Foods,Invoice,008-01389,Arroz a Granel:Parboiled 50 LB -Bolsa Dos Hermanos.,,15.0,25.5,382.5,333850.91,,Lisset Limpio -020,Cafeteria,1380532,Mar
2023-03-30,El Palacio de los jugos /  E & P Foods,Invoice,008-01389,Liquids:AS Marinating Sauce (Mojo),,5.0,15.0,75.0,333925.91,,Lisset Limpio -020,Cafeteria,1380533,Mar
2023-03-30,El Palacio de los jugos / Lita Foods Inc.,Invoice,008-01390,Arroz a Granel:Parboiled 50 LB -Bolsa Dos Hermanos.,,7.0,25.5,178.5,334104.41,,Lisset Limpio -020,Cafeteria,1380534,Mar
2023-03-31,Global Distributors,Invoice,008-01391,Arroz a Granel (MWH):Arroz Parboil Bolsa 50LB Dos hermanos (Alpha),,420.0,25.5,10710.0,344814.41,,Ruta - 019,CAFETERIA y RESTAURANTS,1380535,Mar
2023-03-31,El Palacio de los jugos / Leti Corp.,Invoice,008-01392,Arroz a Granel:Parboiled 50 LB -Bolsa Dos Hermanos.,,7.0,25.5,178.5,344992.91,,Lisset Limpio -020,Cafeteria,1380536,Mar
2023-03-31,Amerifood,Invoice,008-01393,Arroz a Granel (MWH):Arroz Parboil Bolsa 50LB Dos hermanos (Alpha),,165.0,25.0,4125.0,349117.91,,Ruta - 019,WHOLESALER,1380537,Mar
2023-03-31,Sabor Tropical Supermarket #4,Invoice,008-01394,Arroz a Granel (MWH):Arroz Parboil Bolsa 50LB Dos hermanos (Alpha),,55.0,25.5,1402.5,350520.41,,Lisset Limpio -020,RETAIL  DSD,1380538,Mar
2023-03-31,"American Spice Trading Co, Inc.",Invoice,008-01395,Arroz a Granel (MWH):Arroz Parboil Bolsa 50LB Dos hermanos (Alpha),,1100.0,22.5,24750.0,375270.41,,Armando Carpio - 017,WHOLESALER MANUFACTURY,1380539,Mar
2023-03-31,Rey Chavez Distributor Corp,Invoice,008-01396,Arroz a Granel (MWH):Arroz Parboil Bolsa 50LB Dos hermanos (Alpha),,55.0,25.5,1402.5,376672.91,,Ruta - 019,WHOLESALER,1380540,Mar
2023-03-31,Sabor Tropical Supermarket #4,Credit Memo,008-01853,Arroz a Granel (MWH):Arroz Parboil Bolsa 50LB Dos hermanos (Alpha),s/invoice 1394,-10.0,25.5,-255.0,376417.91,,Ruta - 019,RETAIL  DSD,1380541,Mar
2023-04-03,El Palacio de los jugos / Caribe Tropical,Invoice,008-01397,Arroz a Granel (MWH):Arroz Parboil Bolsa 50LB Dos hermanos (Alpha),,10.0,25.5,255.0,376672.91,,Lisset Limpio -020,Cafeteria,1380542,Apr
2023-04-03,El Palacio de Los Jugos / Casa mía Food Restaurant inc,Invoice,008-01398,Arroz a Granel (MWH):Arroz Parboil Bolsa 50LB Dos hermanos (Alpha),,20.0,25.5,510.0,377182.91,,Lisset Limpio -020,Cafeteria,1380543,Apr
2023-04-03,El Palacio de los jugos /  Mires Restaurants,Invoice,008-01399,Arroz a Granel (MWH):Arroz Parboil Bolsa 50LB Dos hermanos (Alpha),,10.0,25.5,255.0,377437.91,,Lisset Limpio -020,Cafeteria,1380544,Apr
2023-04-03,Key Food 119 St.,Credit Memo,008-01400,Arroz Envasado:Largo Fino 1kg (Long grain rice) Dos Hermanos,,-5.0,16.5,-82.5,377355.41,,Lisset Limpio -020,RETAIL KEY FOOD,1380545,Apr
2023-04-03,Key Food 119 St.,Credit Memo,008-01400,Arroz Envasado:Largo Fino 1kg (Long grain rice) Dos Hermanos,,-1.0,0.0,0.0,377355.41,,Lisset Limpio -020,RETAIL KEY FOOD,1380546,Apr
2023-04-03,El Palacio de los jugos / Delicias Criollas (DIAGO FOOD_MILLER),Credit Memo,008-01401,Spices:AS Whole Bay Leaves,4/12 OZ,-1.0,20.7,-20.7,377334.71,,Lisset Limpio -020,Cafeteria,1380547,Apr
2023-04-03,El Palacio de los jugos / J Mena Corp.,Credit Memo,008-01402,Spices:AS Sazon (All Seasoning) (deleted),1/30 lb,-1.0,40.6,-40.6,377294.11,,Lisset Limpio -020,Cafeteria,1380548,Apr
2023-04-03,El Palacio de los jugos /  EMMA FOOD CORP,Credit Memo,008-01403,Arroz a Granel:Parboiled 50 LB -Bolsa Dos Hermanos.,,-3.0,25.0,-75.0,377219.11,,Lisset Limpio -020,Cafeteria,1380549,Apr
2023-04-03,El Palacio de los jugos /  E & P Foods,Credit Memo,008-01483,Liquids:AS Cooking Wine,4/1 Gl.,-2.0,15.5,-31.0,377188.11,,Lisset Limpio -020,Cafeteria,1380550,Apr
2023-04-04,CV of America LLC,Invoice,008-01410,Varios:Organic Rice -NI,Fc DH#158,144.0,34.5,4968.0,382156.11,,Others - 001,OTHER,1380551,Apr
2023-04-05,Bravo 5851 Lake Worth Road,Invoice,008-01405,Arroz Envasado:Parboiled 5KG Dos Hermanos.,6 / 11lbs,10.0,38.5,385.0,382541.11,,Ruta - 019,RETAIL  DSD,1380552,Apr
2023-04-05,Bravo 5851 Lake Worth Road,Invoice,008-01405,Arroz Envasado:Parboiled 5KG Dos Hermanos.,6 / 11lbs,2.0,0.0,0.0,382541.11,,Ruta - 019,RETAIL  DSD,1380553,Apr
2023-04-05,Bravo 5851 Lake Worth Road,Invoice,008-01405,Arroz Envasado:Largo Fino 1kg (Long grain rice) Dos Hermanos,,5.0,16.5,82.5,382623.61,,Ruta - 019,RETAIL  DSD,1380554,Apr
2023-04-05,Bravo 5851 Lake Worth Road,Invoice,008-01405,Arroz Envasado:Largo Fino 1kg (Long grain rice) Dos Hermanos,,1.0,0.0,0.0,382623.61,,Ruta - 019,RETAIL  DSD,1380555,Apr
2023-04-05,Bravo 5851 Lake Worth Road,Invoice,008-01406,Arroz a Granel:Parboiled 50 LB -Bolsa Dos Hermanos.,,10.0,28.0,280.0,382903.61,,Ruta - 019,RETAIL  DSD,1380556,Apr
2023-04-05,Food Fair Plantation Corp,Invoice,008-01407,Arroz Envasado:Parboiled 5KG Dos Hermanos.,6 / 11lbs,10.0,38.5,385.0,383288.61,,Ruta - 019,RETAIL  DSD,1380557,Apr
2023-04-05,Food Fair Plantation Corp,Invoice,008-01407,Arroz Envasado:Parboiled 5KG Dos Hermanos.,6 / 11lbs,2.0,0.0,0.0,383288.61,,Ruta - 019,RETAIL  DSD,1380558,Apr
2023-04-05,Food Fair Plantation Corp,Invoice,008-01407,Arroz Envasado:Largo Fino 1kg (Long grain rice) Dos Hermanos,,5.0,16.5,82.5,383371.11,,Ruta - 019,RETAIL  DSD,1380559,Apr
2023-04-05,Food Fair Plantation Corp,Invoice,008-01407,Arroz Envasado:Largo Fino 1kg (Long grain rice) Dos Hermanos,,1.0,0.0,0.0,383371.11,,Ruta - 019,RETAIL  DSD,1380560,Apr
2023-04-05,Key Food / Holywood,Invoice,008-01408,Arroz Envasado:Largo Fino 1kg (Long grain rice) Dos Hermanos,,10.0,16.5,165.0,383536.11,,Ruta - 019,RETAIL  DSD,1380561,Apr
2023-04-05,Key Food / Holywood,Invoice,008-01408,Arroz Envasado:Largo Fino 1kg (Long grain rice) Dos Hermanos,,2.0,0.0,0.0,383536.11,,Ruta - 019,RETAIL  DSD,1380562,Apr
2023-04-05,Superior Meat and Fish,Invoice,008-01409,Arroz Envasado:Parboiled 5KG Dos Hermanos.,6 / 11lbs,10.0,38.5,385.0,383921.11,,Ruta - 019,RETAIL  DSD,1380563,Apr
2023-04-05,Superior Meat and Fish,Invoice,008-01409,Arroz Envasado:Parboiled 5KG Dos Hermanos.,6 / 11lbs,2.0,,0.0,383921.11,,Ruta - 019,RETAIL  DSD,1380564,Apr
2023-04-06,El Palacio de los jugos / Delicias Criollas (DIAGO FOOD_MILLER),Invoice,008-01411,Arroz a Granel:Parboiled 50 LB -Bolsa Dos Hermanos.,,15.0,25.5,382.5,384303.61,,Lisset Limpio -020,Cafeteria,1380565,Apr
2023-04-06,El Palacio de los jugos /  EMMA FOOD CORP,Invoice,008-01412,Arroz a Granel:Parboiled 50 LB -Bolsa Dos Hermanos.,,10.0,25.5,255.0,384558.61,,Lisset Limpio -020,Cafeteria,1380566,Apr
2023-04-06,El Palacio de Los Jugos / Casa mía Food Restaurant inc,Invoice,008-01413,Arroz a Granel:Parboiled 50 LB -Bolsa Dos Hermanos.,,5.0,25.5,127.5,384686.11,,Lisset Limpio -020,Cafeteria,1380567,Apr
2023-04-06,El Palacio de los jugos /  E & P Foods,Invoice,008-01414,Arroz a Granel:Parboiled 50 LB -Bolsa Dos Hermanos.,,15.0,25.5,382.5,385068.61,,Lisset Limpio -020,Cafeteria,1380568,Apr
2023-04-06,El Palacio de los jugos / J Mena Corp.,Invoice,008-01415,Arroz a Granel:Parboiled 50 LB -Bolsa Dos Hermanos.,,10.0,25.5,255.0,385323.61,,Lisset Limpio -020,Cafeteria,1380569,Apr
2023-04-06,El Palacio de los jugos / Leti Corp.,Invoice,008-01416,Arroz a Granel:Parboiled 50 LB -Bolsa Dos Hermanos.,,8.0,25.5,204.0,385527.61,,Lisset Limpio -020,Cafeteria,1380570,Apr
2023-04-06,El Palacio de los jugos / Lita Foods Inc.,Invoice,008-01417,Arroz a Granel:Parboiled 50 LB -Bolsa Dos Hermanos.,,10.0,25.5,255.0,385782.61,,Lisset Limpio -020,Cafeteria,1380571,Apr
2023-04-10,El Palacio de los jugos /  EMMA FOOD CORP,Invoice,008-01418,Arroz a Granel:Parboiled 50 LB -Bolsa Dos Hermanos.,,10.0,25.5,255.0,386037.61,,Lisset Limpio -020,Cafeteria,1380572,Apr
2023-04-10,El Palacio de los jugos / Lita Foods Inc.,Invoice,008-01419,Arroz a Granel:Parboiled 50 LB -Bolsa Dos Hermanos.,,15.0,25.5,382.5,386420.11,,Lisset Limpio -020,Cafeteria,1380573,Apr
2023-04-10,"Meat Club Market, LLC.",Invoice,008-01420,Arroz Envasado:Sushi Rice Dos Hermanos 5kg.,,2.0,60.0,120.0,386540.11,,Lisset Limpio -020,RETAIL  DSD,1380574,Apr
2023-04-10,"Meat Club Market, LLC.",Invoice,008-01420,Arroz Envasado:Sushi Rice Dos Hermanos.,i7OCT/i9NOV,5.0,20.0,100.0,386640.11,,Lisset Limpio -020,RETAIL  DSD,1380575,Apr
2023-04-10,Food Fair Plantation Corp,Invoice,008-01421,Arroz Envasado:Parboiled 1kg Bolsa Dos Hermanos.,I8(43)JUN/ H27/H28/ H29(118) /H30,10.0,19.0,190.0,386830.11,,Ruta - 019,RETAIL  DSD,1380576,Apr
2023-04-10,Bake Mark USA LLC,Invoice,008-01422,Arroz a Granel:Totes Parboiled,,20.0,1053.77,21075.36,407905.47,,Armando Carpio - 017,WHOLESALER MANUFACTURY,1380577,Apr
2023-04-11,COD Suplies,Invoice,008-01423,Arroz a Granel:Parboiled 50 LB -Bolsa Dos Hermanos.,,55.0,25.5,1402.5,409307.97,,Ruta - 019,WHOLESALER,1380578,Apr
2023-04-11,Key Food / Holywood,Invoice,008-01424,Arroz Envasado:Parboiled 5KG Dos Hermanos.,6 / 11lbs,10.0,38.5,385.0,409692.97,,Ruta - 019,RETAIL  DSD,1380579,Apr
2023-04-11,Key Food / Holywood,Invoice,008-01424,Arroz Envasado:Parboiled 5KG Dos Hermanos.,6 / 11lbs,2.0,0.0,0.0,409692.97,,Ruta - 019,RETAIL  DSD,1380580,Apr
2023-04-11,Broward Meat & Fish,Invoice,008-01425,Arroz Envasado:Sushi Rice Dos Hermanos 5kg.,,1.0,60.0,60.0,409752.97,,Ruta - 019,RETAIL  DSD,1380581,Apr
2023-04-11,Broward Meat & Fish,Invoice,008-01425,Arroz Envasado:Largo Fino 1kg (Long grain rice) Dos Hermanos,,5.0,16.5,82.5,409835.47,,Ruta - 019,RETAIL  DSD,1380582,Apr
2023-04-11,Broward Meat & Fish,Invoice,008-01425,Arroz Envasado:Largo Fino 1kg (Long grain rice) Dos Hermanos,,1.0,0.0,0.0,409835.47,,Ruta - 019,RETAIL  DSD,1380583,Apr
2023-04-13,Soriano Brothers PB,Invoice,008-01426,Arroz a Granel:Largo Fino 50 LB -Bolsa Dos Hermanos.,,1.0,0.0,0.0,409835.47,,Lisset Limpio -020,CAFETERIA y RESTAURANTS,1380584,Apr
2023-04-13,Soriano Brothers PB,Invoice,008-01426,Arroz a Granel:Parboiled 50 LB -Bolsa Dos Hermanos.,,1.0,,0.0,409835.47,,Lisset Limpio -020,CAFETERIA y RESTAURANTS,1380585,Apr
2023-04-13,El Palacio de los jugos / J Mena Corp.,Invoice,008-01427,Arroz a Granel:Parboiled 50 LB -Bolsa Dos Hermanos.,,15.0,25.5,382.5,410217.97,,Lisset Limpio -020,Cafeteria,1380586,Apr
2023-04-13,El Palacio de los jugos / J Mena Corp.,Invoice,008-01427,Spices:AS Chicken Base Pail (deleted),1/30 lb.,1.0,60.0,60.0,410277.97,,Lisset Limpio -020,Cafeteria,1380587,Apr
2023-04-13,El Palacio de los jugos / J Mena Corp.,Invoice,008-01427,Spices:AS Sazon (All Seasoning) (deleted),1/30 lb,1.0,56.0,56.0,410333.97,,Lisset Limpio -020,Cafeteria,1380588,Apr
2023-04-13,Rey Chavez Distributor Corp,Invoice,008-01428,Arroz a Granel:Parboiled 50 LB -Bolsa Dos Hermanos.,,55.0,25.0,1375.0,411708.97,,Ruta - 019,WHOLESALER,1380589,Apr
2023-04-13,Rey Chavez Distributor Corp,Invoice,008-01428,Arroz Envasado:Parboiled 5KG Dos Hermanos.,6 / 11lbs,41.0,33.0,1353.0,413061.97,,Ruta - 019,WHOLESALER,1380590,Apr
2023-04-13,"American Spice Trading Co, Inc.",Invoice,008-01429,Arroz a Granel:Parboiled 50 LB -Bolsa Dos Hermanos.,,25.0,22.5,562.5,413624.47,,Armando Carpio - 017,WHOLESALER MANUFACTURY,1380591,Apr
2023-04-13,El Palacio de los jugos /  EMMA FOOD CORP,Invoice,008-01430,Arroz a Granel:Parboiled 50 LB -Bolsa Dos Hermanos.,,10.0,25.5,255.0,413879.47,,Lisset Limpio -020,Cafeteria,1380592,Apr
2023-04-13,El Palacio de los jugos / Lita Foods Inc.,Invoice,008-01431,Arroz a Granel:Parboiled 50 LB -Bolsa Dos Hermanos.,,10.0,25.5,255.0,414134.47,,Lisset Limpio -020,Cafeteria,1380593,Apr
2023-04-13,El Palacio de los jugos / Delicias Criollas (DIAGO FOOD_MILLER),Invoice,008-01432,Arroz a Granel:Parboiled 50 LB -Bolsa Dos Hermanos.,,12.0,25.5,306.0,414440.47,,Lisset Limpio -020,Cafeteria,1380594,Apr
2023-04-13,El Palacio de Los Jugos / Casa mía Food Restaurant inc,Invoice,008-01433,Arroz a Granel:Parboiled 50 LB -Bolsa Dos Hermanos.,,15.0,25.5,382.5,414822.97,,Lisset Limpio -020,Cafeteria,1380595,Apr
2023-04-13,El Palacio de los jugos /  E & P Foods,Invoice,008-01434,Arroz a Granel:Parboiled 50 LB -Bolsa Dos Hermanos.,,15.0,25.5,382.5,415205.47,,Lisset Limpio -020,Cafeteria,1380596,Apr
2023-04-13,El Palacio de los jugos /  E & P Foods,Invoice,008-01434,Liquids:AS Marinating Sauce (Mojo),,3.0,20.0,60.0,415265.47,,Lisset Limpio -020,Cafeteria,1380597,Apr
2023-04-13,El Palacio de los jugos /  E & P Foods,Invoice,008-01434,Liquids:AS Cooking Wine,4/1 Gl.,2.0,15.5,31.0,415296.47,,Lisset Limpio -020,Cafeteria,1380598,Apr
2023-04-13,El Palacio de los jugos /  Mires Restaurants,Invoice,008-01435,Arroz a Granel:Parboiled 50 LB -Bolsa Dos Hermanos.,,10.0,25.5,255.0,415551.47,,Lisset Limpio -020,Cafeteria,1380599,Apr
2023-04-14,"Key Food - Kabfra, LLC",Credit Memo,008-01506,TRADE DISCOUNT:TRADE DISCOUNT,Variacion precio invoice 1452 (parboiled 50lb bolsa dh),-6.0,0.5,-3.0,415548.47,,Ruta - 019,RETAIL  DSD,1380600,Apr
2023-04-17,Bake Mark USA LLC,Invoice,008-01436,Arroz a Granel (MWH):Arroz Parboil Bolsa 50LB Dos hermanos (Alpha),,550.0,20.9,11495.0,427043.47,,Armando Carpio - 017,WHOLESALER MANUFACTURY,1380601,Apr
2023-04-17,Bake Mark USA LLC,Invoice,008-01436,Arroz a Granel:Totes Parboiled,,10.0,1053.77,10537.7,437581.17,,Armando Carpio - 017,WHOLESALER MANUFACTURY,1380602,Apr
2023-04-17,El Palacio de los jugos /  EMMA FOOD CORP,Invoice,008-01437,Arroz a Granel:Parboiled 50 LB -Bolsa Dos Hermanos.,,10.0,25.5,255.0,437836.17,,Lisset Limpio -020,Cafeteria,1380603,Apr
2023-04-17,El Palacio de los jugos / Santa Clara Sabor,Invoice,008-01438,Arroz a Granel:Parboiled 50 LB -Bolsa Dos Hermanos.,,15.0,25.5,382.5,438218.67,,Lisset Limpio -020,Cafeteria,1380604,Apr
2023-04-17,El Palacio de los jugos / Lita Foods Inc.,Invoice,008-01439,Arroz a Granel:Parboiled 50 LB -Bolsa Dos Hermanos.,,10.0,25.5,255.0,438473.67,,Lisset Limpio -020,Cafeteria,1380605,Apr
2023-04-17,El Palacio de los jugos / Delicias Criollas (DIAGO FOOD_MILLER),Invoice,008-01440,Arroz a Granel:Parboiled 50 LB -Bolsa Dos Hermanos.,,10.0,25.5,255.0,438728.67,,Lisset Limpio -020,Cafeteria,1380606,Apr
2023-04-17,El Palacio de los jugos / Sahilys Cafe,Invoice,008-01441,Arroz a Granel:Parboiled 50 LB -Bolsa Dos Hermanos.,,12.0,25.5,306.0,439034.67,,Lisset Limpio -020,Cafeteria,1380607,Apr
2023-04-17,Albert Deli #2,Invoice,008-01442,Arroz a Granel:Parboiled 50 LB -Bolsa Dos Hermanos.,,5.0,28.0,140.0,439174.67,,Ruta - 019,CAFETERIA y RESTAURANTS,1380608,Apr
2023-04-19,El Palacio de los jugos / Leti Corp.,Invoice,008-01443,Arroz a Granel:Parboiled 50 LB -Bolsa Dos Hermanos.,,10.0,25.5,255.0,439429.67,,Lisset Limpio -020,Cafeteria,1380609,Apr
2023-04-20,Bake Mark USA LLC,Invoice,008-01444,Arroz a Granel (MWH):Arroz Parboil Bolsa 50LB Dos hermanos (Alpha),,1099.0,20.5,22529.5,461959.17,,Armando Carpio - 017,WHOLESALER MANUFACTURY,1380610,Apr
2023-04-20,Florencia Tinoco-Lora Good Rice Comercial,Invoice,008-01445,Rice Snack:Rice Snack Cheese Flavored GR (deleted),H7(40)MAY /H17(50)AUG /i11 (60) AUG // i10 (20),1.0,0.0,0.0,461959.17,,Armando Carpio - 017,OTHER,1380611,Apr
2023-04-20,Florencia Tinoco-Lora Good Rice Comercial,Invoice,008-01445,Rice Snack:Rice Snack Grilled Smoked Meat Flavored GR (deleted),H5(34)MAY/H18(37)AUG /i12(45)AUG,1.0,0.0,0.0,461959.17,,Armando Carpio - 017,OTHER,1380612,Apr
2023-04-20,Florencia Tinoco-Lora Good Rice Comercial,Invoice,008-01445,"Rice Snack:Rice Snack, Sour Cream & Onion GR (deleted)",H6(41)MAY /H16(60)AUG /i10AUG (30),1.0,0.0,0.0,461959.17,,Armando Carpio - 017,OTHER,1380613,Apr
2023-04-20,Florencia Tinoco-Lora Good Rice Comercial,Invoice,008-01445,Arroz Envasado:Largo Fino 1kg (Long grain rice) Dos Hermanos,,2.0,0.0,0.0,461959.17,,Armando Carpio - 017,OTHER,1380614,Apr
2023-04-20,Armando Carpio,Invoice,008-01446,Arroz Envasado ((NJ)):Largo Fino 1kg (Long grain rice) Dos Hermanos ((NJ)) (deleted),,1.0,0.0,0.0,461959.17,,Armando Carpio - 017,OTHER,1380615,Apr
2023-04-20,Armando Carpio,Invoice,008-01446,Arroz Envasado ((NJ)):Parboiled 1kg Bolsa Dos Hermanos ((NJ)) (deleted),,1.0,0.0,0.0,461959.17,,Armando Carpio - 017,OTHER,1380616,Apr
2023-04-20,Armando Carpio,Invoice,008-01446,Arroz Envasado ((NJ)):Parboiled 5KG Dos Hermanos ((NJ)) (deleted),,1.0,0.0,0.0,461959.17,,Armando Carpio - 017,OTHER,1380617,Apr
2023-04-21,El Palacio de Los Jugos / Casa mía Food Restaurant inc,Invoice,008-01447,Arroz a Granel:Parboiled 50 LB -Bolsa Dos Hermanos.,,20.0,25.5,510.0,462469.17,,Lisset Limpio -020,Cafeteria,1380618,Apr
2023-04-21,El Palacio de los jugos /  E & P Foods,Invoice,008-01448,Arroz a Granel:Parboiled 50 LB -Bolsa Dos Hermanos.,,15.0,25.5,382.5,462851.67,,Lisset Limpio -020,Cafeteria,1380619,Apr
2023-04-21,El Palacio de los jugos /  E & P Foods,Invoice,008-01448,Liquids:AS Marinating Sauce (Mojo),,2.0,20.0,40.0,462891.67,,Lisset Limpio -020,Cafeteria,1380620,Apr
2023-04-21,El Palacio de los jugos /  EMMA FOOD CORP,Invoice,008-01449,Arroz a Granel:Parboiled 50 LB -Bolsa Dos Hermanos.,,10.0,25.5,255.0,463146.67,,Lisset Limpio -020,Cafeteria,1380621,Apr
2023-04-21,El Palacio de los jugos / Lita Foods Inc.,Invoice,008-01450,Arroz a Granel:Parboiled 50 LB -Bolsa Dos Hermanos.,,10.0,25.5,255.0,463401.67,,Lisset Limpio -020,Cafeteria,1380622,Apr
2023-04-21,El Palacio de los jugos /  Mires Restaurants,Invoice,008-01451,Arroz a Granel:Largo Fino 50 LB -Bolsa Dos Hermanos.,,15.0,20.85,312.75,463714.42,,Lisset Limpio -020,Cafeteria,1380623,Apr
2023-04-21,"Key Food - Kabfra, LLC",Invoice,008-01452,Arroz a Granel:Parboiled 50 LB -Bolsa Dos Hermanos.,,6.0,28.5,171.0,463885.42,,Ruta - 019,RETAIL  DSD,1380624,Apr
2023-04-21,"Key Food - Kabfra, LLC",Invoice,008-01452,Arroz a Granel:Largo Fino 50 LB -Bolsa Dos Hermanos.,,8.0,23.0,184.0,464069.42,,Ruta - 019,RETAIL  DSD,1380625,Apr
2023-04-21,Soriano Brothers PB,Invoice,008-01453,Arroz a Granel:Parboiled 50 LB -Bolsa Dos Hermanos.,,10.0,24.5,245.0,464314.42,,Lisset Limpio -020,CAFETERIA y RESTAURANTS,1380626,Apr
2023-04-21,Soriano Brothers PB,Invoice,008-01453,Arroz a Granel:Largo Fino 50 LB -Bolsa Dos Hermanos.,,5.0,21.0,105.0,464419.42,,Lisset Limpio -020,CAFETERIA y RESTAURANTS,1380627,Apr
2023-04-21,Soriano Brothers PB,Invoice,008-01453,Spices:AS Sazon (All Seasoning) (deleted),1/30 lb,3.0,61.5,184.5,464603.92,,Lisset Limpio -020,CAFETERIA y RESTAURANTS,1380628,Apr
2023-04-21,Soriano Brothers PB,Invoice,008-01453,Spices:AS Cumin Ground,4 / 4 lb,1.0,50.0,50.0,464653.92,,Lisset Limpio -020,CAFETERIA y RESTAURANTS,1380629,Apr
2023-04-21,Soriano Brothers PB,Invoice,008-01453,Liquids:AS White Vinegar,4/1 Gl.,2.0,12.0,24.0,464677.92,,Lisset Limpio -020,CAFETERIA y RESTAURANTS,1380630,Apr
2023-04-21,Soriano Brothers PB,Invoice,008-01453,Liquids:AS Marinating Sauce (Mojo),,5.0,20.0,100.0,464777.92,,Lisset Limpio -020,CAFETERIA y RESTAURANTS,1380631,Apr
2023-04-21,Soriano Brothers PB,Invoice,008-01453,Spices:AS Chicken Base Pail (deleted),1/30 lb.,2.0,60.0,120.0,464897.92,,Lisset Limpio -020,CAFETERIA y RESTAURANTS,1380632,Apr
2023-04-21,Soriano Brothers PB,Invoice,008-01453,Spices:AS Whole Bay Leaves,4/12 OZ,1.0,28.0,28.0,464925.92,,Lisset Limpio -020,CAFETERIA y RESTAURANTS,1380633,Apr
2023-04-21,El Palacio de los jugos / Sahilys Cafe,Invoice,008-01454,Arroz a Granel:Largo Fino 50 LB -Bolsa Dos Hermanos.,,1.0,20.85,20.85,464946.77,,Lisset Limpio -020,Cafeteria,1380634,Apr
2023-04-21,"El Toro Loco Meat Distribution, LLC",Invoice,008-01455,Arroz a Granel:Largo Fino 50 LB -Bolsa Dos Hermanos.,,50.0,20.5,1025.0,465971.77,,Lisset Limpio -020,CAFETERIA y RESTAURANTS,1380635,Apr
2023-04-24,El Palacio de Los Jugos / Casa mía Food Restaurant inc,Invoice,008-01456,Arroz a Granel:Parboiled 50 LB -Bolsa Dos Hermanos.,,15.0,25.5,382.5,466354.27,,Lisset Limpio -020,Cafeteria,1380636,Apr
2023-04-24,El Palacio de los jugos / Delicias Criollas (DIAGO FOOD_MILLER),Invoice,008-01457,Arroz a Granel:Parboiled 50 LB -Bolsa Dos Hermanos.,,10.0,25.5,255.0,466609.27,,Lisset Limpio -020,Cafeteria,1380637,Apr
2023-04-24,El Palacio de los jugos / Delicias Criollas (DIAGO FOOD_MILLER),Invoice,008-01457,Arroz a Granel:Largo Fino 50 LB -Bolsa Dos Hermanos.,,10.0,20.85,208.5,466817.77,,Lisset Limpio -020,Cafeteria,1380638,Apr
2023-04-24,El Palacio de los jugos /  EMMA FOOD CORP,Invoice,008-01458,Arroz a Granel:Largo Fino 50 LB -Bolsa Dos Hermanos.,,6.0,20.85,125.1,466942.87,,Lisset Limpio -020,Cafeteria,1380639,Apr
2023-04-24,El Palacio de los jugos / Lita Foods Inc.,Invoice,008-01459,Arroz a Granel:Parboiled 50 LB -Bolsa Dos Hermanos.,,10.0,25.5,255.0,467197.87,,Lisset Limpio -020,Cafeteria,1380640,Apr
2023-04-24,El Palacio de los jugos / Lita Foods Inc.,Invoice,008-01459,Arroz a Granel:Largo Fino 50 LB -Bolsa Dos Hermanos.,,7.0,20.85,145.95,467343.82,,Lisset Limpio -020,Cafeteria,1380641,Apr
2023-04-24,Amerifood,Invoice,008-01460,Arroz a Granel:Largo Fino 50 LB -Bolsa Dos Hermanos.,,220.0,21.5,4730.0,472073.82,,Ruta - 019,WHOLESALER,1380642,Apr
2023-04-24,Sabor Tropical Supermarket #4,Invoice,008-01461,Arroz Envasado:Parboiled 5KG Dos Hermanos.,6 / 11lbs,10.0,38.5,385.0,472458.82,,Ruta - 019,RETAIL  DSD,1380643,Apr
2023-04-24,Sabor Tropical Supermarket #4,Invoice,008-01461,Arroz Envasado:Parboiled 5KG Dos Hermanos.,6 / 11lbs,2.0,0.0,0.0,472458.82,,Ruta - 019,RETAIL  DSD,1380644,Apr
2023-04-24,Sabor Tropical Supermarket #4,Invoice,008-01461,Arroz Envasado:Sushi Rice Dos Hermanos.,i7OCT/i9NOV,1.0,20.0,20.0,472478.82,,Ruta - 019,RETAIL  DSD,1380645,Apr
2023-04-24,Rey Chavez Distributor #2,Invoice,008-01462,Arroz a Granel:Parboiled 50 LB -Bolsa Dos Hermanos.,,25.0,25.0,625.0,473103.82,,Ruta - 019,WHOLESALER,1380646,Apr
2023-04-24,Sabor Tropical Supermarket #4,Credit Memo,008-01463,Arroz Envasado:Yamani Integral Dos Hermanos,i6OCT/i9NOV,-20.0,1.0,-20.0,473083.82,,Ruta - 019,RETAIL  DSD,1380647,Apr
2023-04-24,Sabor Tropical Supermarket #4,Credit Memo,008-01463,Arroz Envasado:Sushi Rice Dos Hermanos.,i7OCT/i9NOV,-1.0,14.0,-14.0,473069.82,,Ruta - 019,RETAIL  DSD,1380648,Apr
2023-04-24,Bake Mark USA LLC,Invoice,008-01464,Arroz a Granel (MWH):Arroz Parboil Bolsa 50LB Dos hermanos (Alpha),,1045.0,20.5,21422.5,494492.32,,Armando Carpio - 017,WHOLESALER MANUFACTURY,1380649,Apr
2023-04-25,BRAVO - Flamingo #3,Invoice,008-01465,Arroz Envasado:Parboiled 5KG Dos Hermanos.,6 / 11lbs,10.0,38.5,385.0,494877.32,,Ruta - 019,RETAIL  DSD,1380650,Apr
2023-04-25,BRAVO - Flamingo #3,Invoice,008-01465,Arroz Envasado:Parboiled 5KG Dos Hermanos.,6 / 11lbs,2.0,0.0,0.0,494877.32,,Ruta - 019,RETAIL  DSD,1380651,Apr
2023-04-25,BRAVO - Flamingo #3,Invoice,008-01465,Arroz Envasado:Largo Fino 1kg (Long grain rice) Dos Hermanos,,5.0,16.5,82.5,494959.82,,Ruta - 019,RETAIL  DSD,1380652,Apr
2023-04-25,BRAVO - Flamingo #3,Invoice,008-01465,Arroz Envasado:Largo Fino 1kg (Long grain rice) Dos Hermanos,,1.0,0.0,0.0,494959.82,,Ruta - 019,RETAIL  DSD,1380653,Apr
2023-04-25,BRAVO - Flamingo #3,Invoice,008-01465,Arroz Envasado:Sushi Rice Dos Hermanos.,i7OCT/i9NOV,1.0,25.0,25.0,494984.82,,Ruta - 019,RETAIL  DSD,1380654,Apr
2023-04-25,Albert Deli #2,Invoice,008-01466,Arroz a Granel:Largo Fino 50 LB -Bolsa Dos Hermanos.,,10.0,23.0,230.0,495214.82,,Ruta - 019,CAFETERIA y RESTAURANTS,1380655,Apr
2023-04-25,Amerifood,Invoice,008-01467,Arroz a Granel:Parboiled 50 LB -Bolsa Dos Hermanos.,,55.0,25.0,1375.0,496589.82,,Ruta - 019,WHOLESALER,1380656,Apr
2023-04-25,Key Food Weston,Invoice,008-01468,Arroz Envasado:Parboiled 5KG Dos Hermanos.,6 / 11lbs,30.0,38.5,1155.0,497744.82,,Lisset Limpio -020,RETAIL  DSD,1380657,Apr
2023-04-25,Key Food Weston,Invoice,008-01468,Arroz Envasado:Parboiled 5KG Dos Hermanos.,6 / 11lbs,6.0,0.0,0.0,497744.82,,Lisset Limpio -020,RETAIL  DSD,1380658,Apr
2023-04-25,El Palacio de los jugos / Caribe Tropical,Invoice,008-01469,Arroz a Granel:Parboiled 50 LB -Bolsa Dos Hermanos.,,3.0,25.5,76.5,497821.32,,Lisset Limpio -020,Cafeteria,1380659,Apr
2023-04-26,Qualipack Inc,Invoice,008-01470,Arroz a Granel ((NJ)):Arroz Parboil Bolsa 50LB Dos hermanos ((NJ)) (deleted),,1100.0,21.0,23100.0,520921.32,,Armando Carpio - 017,OTHER,1380660,Apr
2023-04-27,El Palacio de los jugos /  Mires Restaurants,Invoice,008-01471,Arroz a Granel:Parboiled 50 LB -Bolsa Dos Hermanos.,,10.0,25.5,255.0,521176.32,,Lisset Limpio -020,Cafeteria,1380661,Apr
2023-04-27,Food-Star Supermarket,Invoice,008-01472,Arroz Envasado:Parboiled 5KG Dos Hermanos.,6 / 11lbs,10.0,38.5,385.0,521561.32,,Lisset Limpio -020,RETAIL  DSD,1380662,Apr
2023-04-27,Food-Star Supermarket,Invoice,008-01472,Arroz Envasado:Parboiled 5KG Dos Hermanos.,6 / 11lbs,2.0,0.0,0.0,521561.32,,Lisset Limpio -020,RETAIL  DSD,1380663,Apr
2023-04-27,Food-Star Supermarket,Invoice,008-01472,Arroz Envasado:Largo Fino 1kg (Long grain rice) Dos Hermanos,,10.0,16.5,165.0,521726.32,,Lisset Limpio -020,RETAIL  DSD,1380664,Apr
2023-04-27,Food-Star Supermarket,Invoice,008-01472,Arroz Envasado:Largo Fino 1kg (Long grain rice) Dos Hermanos,,1.0,0.0,0.0,521726.32,,Lisset Limpio -020,RETAIL  DSD,1380665,Apr
2023-04-27,Price Choice Food Market # 6,Invoice,008-01473,Arroz Envasado:Parboiled 5KG Dos Hermanos.,6 / 11lbs,10.0,38.5,385.0,522111.32,,Lisset Limpio -020,RETAIL  DSD,1380666,Apr
2023-04-27,Price Choice Food Market # 6,Invoice,008-01473,Arroz Envasado:Parboiled 5KG Dos Hermanos.,6 / 11lbs,2.0,0.0,0.0,522111.32,,Lisset Limpio -020,RETAIL  DSD,1380667,Apr
2023-04-27,Rinconcito Cubano,Invoice,008-01474,Arroz a Granel:Largo Fino 50 LB -Bolsa Dos Hermanos.,,1.0,20.85,20.85,522132.17,,Lisset Limpio -020,CAFETERIA y RESTAURANTS,1380668,Apr
2023-04-27,Rinconcito Cubano,Invoice,008-01474,Arroz a Granel:Parboiled 50 LB -Bolsa Dos Hermanos.,,1.0,25.5,25.5,522157.67,,Lisset Limpio -020,CAFETERIA y RESTAURANTS,1380669,Apr
2023-04-27,El Palacio de los jugos /  EMMA FOOD CORP,Invoice,008-01475,Arroz a Granel:Largo Fino 50 LB -Bolsa Dos Hermanos.,,6.0,20.85,125.1,522282.77,,Lisset Limpio -020,Cafeteria,1380670,Apr
2023-04-27,El Palacio de los jugos /  EMMA FOOD CORP,Invoice,008-01475,Arroz a Granel:Parboiled 50 LB -Bolsa Dos Hermanos.,,10.0,25.5,255.0,522537.77,,Lisset Limpio -020,Cafeteria,1380671,Apr
2023-04-27,El Palacio de los jugos / Caribe Tropical,Invoice,008-01476,Arroz a Granel:Largo Fino 50 LB -Bolsa Dos Hermanos.,,7.0,20.85,145.95,522683.72,,Lisset Limpio -020,Cafeteria,1380672,Apr
2023-04-27,El Palacio de los jugos / Caribe Tropical,Invoice,008-01476,Arroz a Granel:Parboiled 50 LB -Bolsa Dos Hermanos.,,7.0,25.5,178.5,522862.22,,Lisset Limpio -020,Cafeteria,1380673,Apr
2023-04-27,Sedanos Supermarkets #5,Invoice,008-01477,Rice Snack:Rice Snack Grilled Smoked Meat Flavored GR (deleted),H5(34)MAY/H18(37)AUG /i12(45)AUG,1.0,0.0,0.0,522862.22,,Lisset Limpio -020,RETAIL SEDANOS,1380674,Apr
2023-04-27,Sedanos Supermarkets #5,Invoice,008-01477,Rice Snack:Rice Snack Cheese Flavored GR (deleted),H7(40)MAY /H17(50)AUG /i11 (60) AUG // i10 (20),1.0,0.0,0.0,522862.22,,Lisset Limpio -020,RETAIL SEDANOS,1380675,Apr
2023-04-27,Sedanos Supermarkets #5,Invoice,008-01477,"Rice Snack:Rice Snack, Sour Cream & Onion GR (deleted)",H6(41)MAY /H16(60)AUG /i10AUG (30),1.0,0.0,0.0,522862.22,,Lisset Limpio -020,RETAIL SEDANOS,1380676,Apr
2023-04-27,El Palacio de Los Jugos / Casa mía Food Restaurant inc,Invoice,008-01478,Arroz a Granel:Parboiled 50 LB -Bolsa Dos Hermanos.,,9.0,25.5,229.5,523091.72,,Lisset Limpio -020,Cafeteria,1380677,Apr
2023-04-27,El Palacio de los jugos /  E & P Foods,Invoice,008-01479,Arroz a Granel:Largo Fino 50 LB -Bolsa Dos Hermanos.,,15.0,20.85,312.75,523404.47,,Lisset Limpio -020,Cafeteria,1380678,Apr
2023-04-27,El Palacio de los jugos /  E & P Foods,Invoice,008-01479,Arroz a Granel:Parboiled 50 LB -Bolsa Dos Hermanos.,,15.0,25.5,382.5,523786.97,,Lisset Limpio -020,Cafeteria,1380679,Apr
2023-04-27,El Palacio de los jugos /  E & P Foods,Invoice,008-01479,Liquids:AS Marinating Sauce (Mojo),,2.0,20.0,40.0,523826.97,,Lisset Limpio -020,Cafeteria,1380680,Apr
2023-04-27,El Palacio de los jugos / Santa Clara Sabor,Invoice,008-01480,Arroz a Granel:Largo Fino 50 LB -Bolsa Dos Hermanos.,,1.0,20.85,20.85,523847.82,,Lisset Limpio -020,Cafeteria,1380681,Apr
2023-04-27,"Almendares Courier Solutions, Inc.",Invoice,008-01481,Arroz Envasado:Largo Fino 1kg (Long grain rice) Dos Hermanos,,240.0,13.5,3240.0,527087.82,,Armando Carpio - 017,WHOLESALER,1380682,Apr
2023-04-27,"Almendares Courier Solutions, Inc.",Invoice,008-01481,Arroz Envasado:Parboiled 5KG Dos Hermanos.,6 / 11lbs,5.0,0.0,0.0,527087.82,,Armando Carpio - 017,WHOLESALER,1380683,Apr
2023-04-28,"American Spice Trading Co, Inc.",Invoice,008-01482,Arroz a Granel (MWH):Arroz Parboil Bolsa 50LB Dos hermanos (Alpha),,1100.0,22.0,24200.0,551287.82,,Armando Carpio - 017,WHOLESALER MANUFACTURY,1380684,Apr
2023-04-28,Food-Star Supermarket,Credit Memo,008-01507,Arroz Envasado:Largo Fino 1kg (Long grain rice) Dos Hermanos,,-10.0,16.5,-165.0,551122.82,,Lisset Limpio -020,RETAIL  DSD,1380685,Apr
2023-04-28,Food-Star Supermarket,Credit Memo,008-01507,Arroz Envasado:Largo Fino 1kg (Long grain rice) Dos Hermanos,,-1.0,0.0,0.0,551122.82,,Lisset Limpio -020,RETAIL  DSD,1380686,Apr
2023-05-01,El Palacio de Los Jugos / Casa mía Food Restaurant inc,Invoice,008-01484,Arroz a Granel:Parboiled 50 LB -Bolsa Dos Hermanos.,,5.0,25.5,127.5,551250.32,,Lisset Limpio -020,Cafeteria,1380687,May
2023-05-01,El Palacio de los jugos /  EMMA FOOD CORP,Invoice,008-01485,Arroz a Granel:Largo Fino 50 LB -Bolsa Dos Hermanos.,,4.0,20.85,83.4,551333.72,,Lisset Limpio -020,Cafeteria,1380688,May
2023-05-01,El Palacio de los jugos / Caribe Tropical,Invoice,008-01486,Arroz a Granel:Parboiled 50 LB -Bolsa Dos Hermanos.,,8.0,25.5,204.0,551537.72,,Lisset Limpio -020,Cafeteria,1380689,May
2023-05-01,El Palacio de los jugos / Caribe Tropical,Invoice,008-01486,Arroz a Granel:Largo Fino 50 LB -Bolsa Dos Hermanos.,,5.0,20.85,104.25,551641.97,,Lisset Limpio -020,Cafeteria,1380690,May
2023-05-01,Rincon Cubano #4,Invoice,008-01487,Arroz a Granel:Parboiled 50 LB -Bolsa Dos Hermanos.,,1.0,25.5,25.5,551667.47,,Lisset Limpio -020,CAFETERIA y RESTAURANTS,1380691,May
2023-05-01,Rincon Cubano #4,Invoice,008-01487,Arroz a Granel:Largo Fino 50 LB -Bolsa Dos Hermanos.,,1.0,20.85,20.85,551688.32,,Lisset Limpio -020,CAFETERIA y RESTAURANTS,1380692,May
2023-05-01,Soriano Brothers,Invoice,008-01488,Arroz a Granel:Parboiled 50 LB -Bolsa Dos Hermanos.,,15.0,25.5,382.5,552070.82,,Lisset Limpio -020,CAFETERIA y RESTAURANTS,1380693,May
2023-05-01,Soriano Brothers,Invoice,008-01488,Arroz a Granel:Largo Fino 50 LB -Bolsa Dos Hermanos.,,3.0,20.85,62.55,552133.37,,Lisset Limpio -020,CAFETERIA y RESTAURANTS,1380694,May
2023-05-01,Sorianos Brothers,Invoice,008-01489,Arroz a Granel:Parboiled 50 LB -Bolsa Dos Hermanos.,,15.0,25.5,382.5,552515.87,,Lisset Limpio -020,CAFETERIA y RESTAURANTS,1380695,May
2023-05-01,Sorianos Brothers,Invoice,008-01489,Arroz a Granel:Largo Fino 50 LB -Bolsa Dos Hermanos.,,3.0,20.85,62.55,552578.42,,Lisset Limpio -020,CAFETERIA y RESTAURANTS,1380696,May
2023-05-01,El Palacio de los jugos / Delicias Criollas (DIAGO FOOD_MILLER),Invoice,008-01490,Arroz a Granel:Parboiled 50 LB -Bolsa Dos Hermanos.,,10.0,25.5,255.0,552833.42,,Lisset Limpio -020,Cafeteria,1380697,May
2023-05-01,El Palacio de los jugos / Santa Clara Sabor,Invoice,008-01491,Arroz a Granel:Largo Fino 50 LB -Bolsa Dos Hermanos.,,10.0,20.85,208.5,553041.92,,Lisset Limpio -020,Cafeteria,1380698,May
2023-05-01,El Palacio de los jugos / Lita Foods Inc.,Invoice,008-01492,Arroz a Granel:Parboiled 50 LB -Bolsa Dos Hermanos.,,10.0,25.5,255.0,553296.92,,Lisset Limpio -020,Cafeteria,1380699,May
2023-05-01,El Palacio de los jugos / Lita Foods Inc.,Invoice,008-01492,,,,25.5,0.0,553296.92,,Lisset Limpio -020,Cafeteria,1380700,May
2023-05-01,Sedanos Supermarkets #42,Invoice,008-01493,Rice Snack:Rice Snack Cheese Flavored GR (deleted),H7(40)MAY /H17(50)AUG /i11 (60) AUG // i10 (20),1.0,14.9,14.9,553311.82,,Lisset Limpio -020,RETAIL SEDANOS,1380701,May
2023-05-01,Sedanos Supermarkets #42,Invoice,008-01493,Rice Snack:Rice Snack Grilled Smoked Meat Flavored GR (deleted),H5(34)MAY/H18(37)AUG /i12(45)AUG,1.0,14.9,14.9,553326.72,,Lisset Limpio -020,RETAIL SEDANOS,1380702,May
2023-05-01,Sedanos Supermarkets #42,Invoice,008-01493,"Rice Snack:Rice Snack, Sour Cream & Onion GR (deleted)",H6(41)MAY /H16(60)AUG /i10AUG (30),1.0,14.9,14.9,553341.62,,Lisset Limpio -020,RETAIL SEDANOS,1380703,May
2023-05-01,Sedanos Supermarkets #7,Invoice,008-01494,Rice Snack:Rice Snack Cheese Flavored GR (deleted),H7(40)MAY /H17(50)AUG /i11 (60) AUG // i10 (20),1.0,14.9,14.9,553356.52,,Lisset Limpio -020,RETAIL SEDANOS,1380704,May
2023-05-01,Sedanos Supermarkets #7,Invoice,008-01494,Rice Snack:Rice Snack Grilled Smoked Meat Flavored GR (deleted),H5(34)MAY/H18(37)AUG /i12(45)AUG,1.0,14.9,14.9,553371.42,,Lisset Limpio -020,RETAIL SEDANOS,1380705,May
2023-05-01,Sedanos Supermarkets #7,Invoice,008-01494,"Rice Snack:Rice Snack, Sour Cream & Onion GR (deleted)",H6(41)MAY /H16(60)AUG /i10AUG (30),1.0,14.9,14.9,553386.32,,Lisset Limpio -020,RETAIL SEDANOS,1380706,May
2023-05-01,Sedanos Supermarkets #7,Invoice,008-01494,,Discount,,,-0.89,553385.43,,Lisset Limpio -020,RETAIL SEDANOS,1380707,May
2023-05-01,Bake Mark USA LLC,Invoice,008-01495,Arroz a Granel (MWH):Arroz Parboil Bolsa 50LB Dos hermanos (Alpha),,1100.0,20.5,22550.0,575935.43,,Armando Carpio - 017,WHOLESALER MANUFACTURY,1380708,May
2023-05-01,Bake Mark USA LLC,Invoice,008-01496,Arroz a Granel (MWH):Arroz Parboil Bolsa 50LB Dos hermanos (Alpha),,1100.0,20.5,22550.0,598485.43,,Armando Carpio - 017,WHOLESALER MANUFACTURY,1380709,May
2023-05-01,BRAVO - Flamingo #3,Invoice,008-01587,Arroz Envasado:Largo Fino 1kg (Long grain rice) Dos Hermanos,,10.0,16.5,165.0,598650.43,,Ruta - 019,RETAIL  DSD,1380710,May
2023-05-01,BRAVO - Flamingo #3,Invoice,008-01587,Arroz Envasado:Largo Fino 1kg (Long grain rice) Dos Hermanos,,2.0,0.0,0.0,598650.43,,Ruta - 019,RETAIL  DSD,1380711,May
2023-05-02,Price Choice Food Market # 2,Invoice,008-01497,Arroz Envasado:Parboiled 5KG Dos Hermanos.,6 / 11lbs,10.0,38.5,385.0,599035.43,,Ruta - 019,RETAIL  DSD,1380712,May
2023-05-02,Price Choice Food Market # 2,Invoice,008-01497,Arroz Envasado:Parboiled 5KG Dos Hermanos.,6 / 11lbs,2.0,0.0,0.0,599035.43,,Ruta - 019,RETAIL  DSD,1380713,May
2023-05-02,Price Choice Food Market# 9,Invoice,008-01498,Arroz Envasado:Parboiled 5KG Dos Hermanos.,6 / 11lbs,10.0,38.5,385.0,599420.43,,Ruta - 019,RETAIL  DSD,1380714,May
2023-05-02,Price Choice Food Market# 9,Invoice,008-01498,Arroz Envasado:Parboiled 5KG Dos Hermanos.,6 / 11lbs,2.0,0.0,0.0,599420.43,,Ruta - 019,RETAIL  DSD,1380715,May
2023-05-02,Deli Price Choice 9,Invoice,008-01499,Arroz a Granel:Largo Fino 50 LB -Bolsa Dos Hermanos.,,6.0,23.0,138.0,599558.43,,Ruta - 019,RETAIL  DSD,1380716,May
2023-05-02,Price Choice Food Market # 7,Invoice,008-01500,Arroz Envasado:Largo Fino 1kg (Long grain rice) Dos Hermanos,,10.0,16.5,165.0,599723.43,,Ruta - 019,RETAIL  DSD,1380717,May
2023-05-02,Price Choice Food Market # 7,Invoice,008-01500,Arroz Envasado:Largo Fino 1kg (Long grain rice) Dos Hermanos,,2.0,0.0,0.0,599723.43,,Ruta - 019,RETAIL  DSD,1380718,May
2023-05-02,La Ranchera Meat Market #3,Invoice,008-01501,Arroz a Granel:Largo Fino 50 LB -Bolsa Dos Hermanos.,,8.0,23.0,184.0,599907.43,,Ruta - 019,CAFETERIA y RESTAURANTS,1380719,May
2023-05-02,La Ranchera Meat Market #3,Invoice,008-01501,Arroz Envasado:Largo Fino 1kg (Long grain rice) Dos Hermanos,,5.0,16.5,82.5,599989.93,,Ruta - 019,CAFETERIA y RESTAURANTS,1380720,May
2023-05-02,La Ranchera Meat Market #3,Invoice,008-01501,Varios:Sales,,1.0,0.0,0.0,599989.93,,Ruta - 019,CAFETERIA y RESTAURANTS,1380721,May
2023-05-02,Key Food / Holywood,Invoice,008-01502,Arroz Envasado:Sushi Rice Dos Hermanos 5kg.,,2.0,60.0,120.0,600109.93,,Ruta - 019,RETAIL  DSD,1380722,May
2023-05-02,Key Food / Holywood,Invoice,008-01502,Arroz Envasado:Largo Fino 1kg (Long grain rice) Dos Hermanos,,5.0,16.5,82.5,600192.43,,Ruta - 019,RETAIL  DSD,1380723,May
2023-05-02,Key Food / Holywood,Invoice,008-01502,Arroz Envasado:Largo Fino 1kg (Long grain rice) Dos Hermanos,,1.0,0.0,0.0,600192.43,,Ruta - 019,RETAIL  DSD,1380724,May
2023-05-02,Bravo 5851 Lake Worth Road,Invoice,008-01503,Arroz a Granel:Largo Fino 50 LB -Bolsa Dos Hermanos.,,10.0,23.0,230.0,600422.43,,Ruta - 019,RETAIL  DSD,1380725,May
2023-05-02,Bravo 5851 Lake Worth Road,Invoice,008-01503,Arroz a Granel:Parboiled 50 LB -Bolsa Dos Hermanos.,,5.0,28.0,140.0,600562.43,,Ruta - 019,RETAIL  DSD,1380726,May
2023-05-02,Neighbors Food Market / Luis Diaz,Invoice,008-01504,Arroz Envasado:Parboiled 5KG Dos Hermanos.,6 / 11lbs,10.0,38.5,385.0,600947.43,,Ruta - 019,RETAIL  DSD,1380727,May
2023-05-02,Neighbors Food Market / Luis Diaz,Invoice,008-01504,Arroz a Granel:Parboiled 50 LB -Bolsa Dos Hermanos.,,2.0,0.0,0.0,600947.43,,Ruta - 019,RETAIL  DSD,1380728,May
2023-05-02,Neighbors Food Market / Luis Diaz,Invoice,008-01504,Arroz a Granel:Largo Fino 50 LB -Bolsa Dos Hermanos.,,5.0,23.0,115.0,601062.43,,Ruta - 019,RETAIL  DSD,1380729,May
2023-05-02,Ideal Food Basket Davie Cafeteria,Invoice,008-01505,Arroz a Granel:Largo Fino 50 LB -Bolsa Dos Hermanos.,,4.0,23.0,92.0,601154.43,,Ruta - 019,CAFETERIA y RESTAURANTS,1380730,May
2023-05-02,Ideal Food Basket Davie Cafeteria,Invoice,008-01505,Arroz a Granel:Parboiled 50 LB -Bolsa Dos Hermanos.,,2.0,28.0,56.0,601210.43,,Ruta - 019,CAFETERIA y RESTAURANTS,1380731,May
2023-05-03,Price Choice Food Market # 7,Credit Memo,008-01520,Arroz Envasado:Largo Fino 1kg (Long grain rice) Dos Hermanos,,-2.0,15.0,-30.0,601180.43,,Ruta - 019,RETAIL  DSD,1380732,May
2023-05-04,Amerifood,Invoice,008-01508,Arroz a Granel:Parboiled 50 LB -Bolsa Dos Hermanos.,,110.0,25.0,2750.0,603930.43,,Ruta - 019,WHOLESALER,1380733,May
2023-05-04,Soriano Brothers PB,Invoice,008-01517,Arroz a Granel:Largo Fino 50 LB -Bolsa Dos Hermanos.,,3.0,20.85,62.55,603992.98,,Lisset Limpio -020,CAFETERIA y RESTAURANTS,1380734,May
2023-05-04,Miavana & Family,Invoice,008-01518,Arroz a Granel:Parboiled 50 LB -Bolsa Dos Hermanos.,,220.0,21.5,4730.0,608722.98,,Armando Carpio - 017,Distributor,1380735,May
2023-05-04,Bake Mark USA LLC,Invoice,008-01519,Arroz a Granel:Parboiled 50 LB -Bolsa Dos Hermanos.,,440.0,20.5,9020.0,617742.98,,Armando Carpio - 017,WHOLESALER MANUFACTURY,1380736,May
2023-05-05,El Palacio de Los Jugos / Casa mía Food Restaurant inc,Invoice,008-01509,Arroz a Granel:Parboiled 50 LB -Bolsa Dos Hermanos.,,15.0,25.5,382.5,618125.48,,Lisset Limpio -020,Cafeteria,1380737,May
2023-05-05,El Palacio de los jugos /  EMMA FOOD CORP,Invoice,008-01510,Arroz a Granel:Largo Fino 50 LB -Bolsa Dos Hermanos.,,5.0,20.85,104.25,618229.73,,Lisset Limpio -020,Cafeteria,1380738,May
2023-05-05,El Palacio de los jugos / Caribe Tropical,Invoice,008-01511,Arroz a Granel:Parboiled 50 LB -Bolsa Dos Hermanos.,,10.0,25.5,255.0,618484.73,,Lisset Limpio -020,Cafeteria,1380739,May
2023-05-05,El Palacio de los jugos / Delicias Criollas (DIAGO FOOD_MILLER),Invoice,008-01512,Arroz a Granel:Parboiled 50 LB -Bolsa Dos Hermanos.,,10.0,25.5,255.0,618739.73,,Lisset Limpio -020,Cafeteria,1380740,May
2023-05-05,El Palacio de los jugos / Delicias Criollas (DIAGO FOOD_MILLER),Invoice,008-01512,Arroz a Granel:Largo Fino 50 LB -Bolsa Dos Hermanos.,,9.0,20.85,187.65,618927.38,,Lisset Limpio -020,Cafeteria,1380741,May
2023-05-05,El Palacio de los jugos / Lita Foods Inc.,Invoice,008-01513,Arroz a Granel:Parboiled 50 LB -Bolsa Dos Hermanos.,,9.0,25.5,229.5,619156.88,,Lisset Limpio -020,Cafeteria,1380742,May
2023-05-05,El Palacio de los jugos / Lita Foods Inc.,Invoice,008-01513,Arroz a Granel:Largo Fino 50 LB -Bolsa Dos Hermanos.,,7.0,20.85,145.95,619302.83,,Lisset Limpio -020,Cafeteria,1380743,May
2023-05-05,El Palacio de los jugos / J Mena Corp.,Invoice,008-01514,Arroz a Granel:Largo Fino 50 LB -Bolsa Dos Hermanos.,,8.0,20.85,166.8,619469.63,,Lisset Limpio -020,Cafeteria,1380744,May
2023-05-05,El Palacio de los jugos / J Mena Corp.,Invoice,008-01514,Liquids:AS Marinating Sauce (Mojo),,1.0,20.0,20.0,619489.63,,Lisset Limpio -020,Cafeteria,1380745,May
2023-05-05,El Palacio de los jugos / J Mena Corp.,Invoice,008-01514,Spices:AS Whole Bay Leaves,4/12 OZ,1.0,28.0,28.0,619517.63,,Lisset Limpio -020,Cafeteria,1380746,May
2023-05-05,Soriano Brothers PB,Invoice,008-01515,Arroz a Granel:Parboiled 50 LB -Bolsa Dos Hermanos.,,4.0,25.5,102.0,619619.63,,Lisset Limpio -020,CAFETERIA y RESTAURANTS,1380747,May
2023-05-05,Soriano Brothers PB,Invoice,008-01515,Arroz a Granel:Largo Fino 50 LB -Bolsa Dos Hermanos.,,4.0,20.85,83.4,619703.03,,Lisset Limpio -020,CAFETERIA y RESTAURANTS,1380748,May
2023-05-05,El Palacio de los jugos /  E & P Foods,Invoice,008-01516,Arroz a Granel:Parboiled 50 LB -Bolsa Dos Hermanos.,,15.0,25.5,382.5,620085.53,,Lisset Limpio -020,Cafeteria,1380749,May
2023-05-05,El Palacio de los jugos /  E & P Foods,Invoice,008-01516,Liquids:AS Marinating Sauce (Mojo),,2.0,20.0,40.0,620125.53,,Lisset Limpio -020,Cafeteria,1380750,May
2023-05-05,Bake Mark USA LLC,Invoice,008-01521,Arroz a Granel:Parboiled 50 LB -Bolsa Dos Hermanos.,,220.0,20.5,4510.0,624635.53,,Armando Carpio - 017,WHOLESALER MANUFACTURY,1380751,May
2023-05-08,Sabor Tropical Supermarket #4,Invoice,008-01522,Arroz a Granel:Largo Fino 50 LB -Bolsa Dos Hermanos.,,4.0,23.0,92.0,624727.53,,Ruta - 019,RETAIL  DSD,1380752,May
2023-05-08,Sabor Tropical Supermarket #4,Invoice,008-01522,Arroz a Granel:Parboiled 50 LB -Bolsa Dos Hermanos.,,55.0,25.5,1402.5,626130.03,,Ruta - 019,RETAIL  DSD,1380753,May
2023-05-08,Key Food Pembroke,Invoice,008-01523,Arroz Envasado:Parboiled 5KG Dos Hermanos.,6 / 11lbs,10.0,38.5,385.0,626515.03,,Ruta - 019,RETAIL  DSD,1380754,May
2023-05-08,Key Food Pembroke,Invoice,008-01523,Arroz Envasado:Parboiled 5KG Dos Hermanos.,6 / 11lbs,2.0,0.0,0.0,626515.03,,Ruta - 019,RETAIL  DSD,1380755,May
2023-05-08,El Palacio de Los Jugos / Casa mía Food Restaurant inc,Invoice,008-01524,Arroz a Granel:Parboiled 50 LB -Bolsa Dos Hermanos.,,8.0,25.5,204.0,626719.03,,Lisset Limpio -020,Cafeteria,1380756,May
2023-05-08,El Palacio de los jugos / Caribe Tropical,Invoice,008-01525,Arroz a Granel:Parboiled 50 LB -Bolsa Dos Hermanos.,,8.0,25.5,204.0,626923.03,,Lisset Limpio -020,Cafeteria,1380757,May
2023-05-08,Soriano Brothers,Invoice,008-01526,Arroz a Granel:Parboiled 50 LB -Bolsa Dos Hermanos.,,55.0,25.5,1402.5,628325.53,,Lisset Limpio -020,CAFETERIA y RESTAURANTS,1380758,May
2023-05-08,El Palacio de los jugos / Lita Foods Inc.,Invoice,008-01527,Arroz a Granel:Parboiled 50 LB -Bolsa Dos Hermanos.,,10.0,25.5,255.0,628580.53,,Lisset Limpio -020,Cafeteria,1380759,May
2023-05-08,El Palacio de los jugos /  Mires Restaurants,Invoice,008-01528,Arroz a Granel:Parboiled 50 LB -Bolsa Dos Hermanos.,,10.0,25.5,255.0,628835.53,,Lisset Limpio -020,Cafeteria,1380760,May
2023-05-08,El Palacio de los jugos / Delicias Criollas (DIAGO FOOD_MILLER),Invoice,008-01529,Arroz a Granel:Parboiled 50 LB -Bolsa Dos Hermanos.,,10.0,25.5,255.0,629090.53,,Lisset Limpio -020,Cafeteria,1380761,May
2023-05-08,Bake Mark USA LLC,Invoice,008-01530,Arroz a Granel (MWH):Arroz Parboil Bolsa 50LB Dos hermanos (Alpha),,1100.0,20.5,22550.0,651640.53,,Armando Carpio - 017,WHOLESALER MANUFACTURY,1380762,May
2023-05-08,Soriano Brothers PB,Invoice,008-01531,Arroz a Granel:Parboiled 50 LB -Bolsa Dos Hermanos.,,8.0,25.5,204.0,651844.53,,Lisset Limpio -020,CAFETERIA y RESTAURANTS,1380763,May
2023-05-09,BA Food Imports,Credit Memo,008-01532,Tostadas de Arroz:Tostadas de Arroz Sin Sal 120gr,iE/iG/iH/i24/,-34.0,15.7,-533.8,651310.73,,Armando Carpio - 017,WHOLESALER,1380764,May
2023-05-09,BA Food Imports,Credit Memo,008-01532,Tostadas de Arroz:Tostadas de Arroz Saladas 120gr,iC/ii/iD/i16,-29.0,15.7,-455.3,650855.43,,Armando Carpio - 017,WHOLESALER,1380765,May
2023-05-09,BA Food Imports,Credit Memo,008-01532,Tostadas de Arroz:Tostadas de Arroz Dulce DH 120Gr.,iF/iB/iA/i16,-20.0,15.7,-314.0,650541.43,,Armando Carpio - 017,WHOLESALER,1380766,May
2023-05-09,BA Food Imports,Credit Memo,008-01532,Rice Snack NJ:Rice Snack Sour Cream & Onion Dos Hermanos ((NJ)) (deleted),,-12.0,15.5,-186.0,650355.43,,Armando Carpio - 017,WHOLESALER,1380767,May
2023-05-09,BA Food Imports,Credit Memo,008-01532,"Rice Snack NJ:Rice Snacks Ham, Dos Hermanos ((NJ)) (deleted)",,-12.0,15.5,-186.0,650169.43,,Armando Carpio - 017,WHOLESALER,1380768,May
2023-05-09,BA Food Imports,Credit Memo,008-01532,Rice Snack NJ:Rice Snack Grilled Smocked Dos Hermanos ((NJ)) (deleted),,-9.0,15.5,-139.5,650029.93,,Armando Carpio - 017,WHOLESALER,1380769,May
2023-05-09,BA Food Imports,Credit Memo,008-01532,Rice Snack NJ:Rice Snack Salami Dos Hermanos ((NJ)) (deleted),,-15.0,15.5,-232.5,649797.43,,Armando Carpio - 017,WHOLESALER,1380770,May
2023-05-11,Bake Mark USA LLC,Invoice,008-01533,Arroz a Granel (MWH):Arroz Parboil Bolsa 50LB Dos hermanos (Alpha),Se entregaron dos bultos menos (ver adjunto),1100.0,20.5,22550.0,672347.43,,Armando Carpio - 017,WHOLESALER MANUFACTURY,1380771,May
2023-05-12,El Palacio de Los Jugos / Casa mía Food Restaurant inc,Invoice,008-01535,Arroz a Granel:Parboiled 50 LB -Bolsa Dos Hermanos.,,15.0,25.5,382.5,672729.93,,Lisset Limpio -020,Cafeteria,1380772,May
2023-05-12,El Palacio de los jugos / Caribe Tropical,Invoice,008-01536,Arroz a Granel:Parboiled 50 LB -Bolsa Dos Hermanos.,,12.0,25.5,306.0,673035.93,,Lisset Limpio -020,Cafeteria,1380773,May
2023-05-12,El Palacio de los jugos / Delicias Criollas (DIAGO FOOD_MILLER),Invoice,008-01537,Arroz a Granel:Parboiled 50 LB -Bolsa Dos Hermanos.,,10.0,25.5,255.0,673290.93,,Lisset Limpio -020,Cafeteria,1380774,May
2023-05-12,El Palacio de los jugos /  E & P Foods,Invoice,008-01538,Arroz a Granel:Parboiled 50 LB -Bolsa Dos Hermanos.,,20.0,25.5,510.0,673800.93,,Lisset Limpio -020,Cafeteria,1380775,May
2023-05-12,El Palacio de los jugos / Lita Foods Inc.,Invoice,008-01539,Arroz a Granel:Parboiled 50 LB -Bolsa Dos Hermanos.,,6.0,25.5,153.0,673953.93,,Lisset Limpio -020,Cafeteria,1380776,May
2023-05-12,COD Suplies,Invoice,008-01540,Arroz a Granel:Parboiled 50 LB -Bolsa Dos Hermanos.,,45.0,25.5,1147.5,675101.43,,Ruta - 019,WHOLESALER,1380777,May
2023-05-12,Price Choice Food Market # 6,Invoice,008-01541,Arroz Envasado:Parboiled 5KG Dos Hermanos.,6 / 11lbs,25.0,38.5,962.5,676063.93,,Lisset Limpio -020,RETAIL  DSD,1380778,May
2023-05-12,Price Choice Food Market # 6,Invoice,008-01541,Arroz Envasado:Parboiled 5KG Dos Hermanos.,6 / 11lbs,6.0,0.0,0.0,676063.93,,Lisset Limpio -020,RETAIL  DSD,1380779,May
2023-05-12,COD Suplies,Credit Memo,008-01542,Arroz a Granel:Parboiled 50 LB -Bolsa Dos Hermanos.,,0.0,,0.0,676063.93,,Ruta - 019,WHOLESALER,1380780,May
2023-05-16,Global Distributors,Credit Memo,008-01543,Arroz a Granel (MWH):Arroz Parboil Bolsa 50LB Dos hermanos (Alpha),,-35.0,25.5,-892.5,675171.43,,Ruta - 019,CAFETERIA y RESTAURANTS,1380781,May
2023-05-19,El Palacio de los jugos / Caribe Tropical,Invoice,008-01544,Arroz a Granel:Parboiled 50 LB -Bolsa Dos Hermanos.,,10.0,25.5,255.0,675426.43,,Lisset Limpio -020,Cafeteria,1380782,May
2023-05-19,El Palacio de los jugos / Delicias Criollas (DIAGO FOOD_MILLER),Invoice,008-01545,Arroz a Granel:Parboiled 50 LB -Bolsa Dos Hermanos.,,10.0,25.5,255.0,675681.43,,Lisset Limpio -020,Cafeteria,1380783,May
2023-05-19,El Palacio de los jugos /  E & P Foods,Invoice,008-01546,Arroz a Granel:Parboiled 50 LB -Bolsa Dos Hermanos.,,20.0,25.5,510.0,676191.43,,Lisset Limpio -020,Cafeteria,1380784,May
2023-05-19,El Palacio de los jugos /  E & P Foods,Invoice,008-01546,Liquids:AS Marinating Sauce (Mojo),,6.0,20.0,120.0,676311.43,,Lisset Limpio -020,Cafeteria,1380785,May
2023-05-19,Soriano Brothers PB,Invoice,008-01547,Arroz a Granel:Parboiled 50 LB -Bolsa Dos Hermanos.,,20.0,25.5,510.0,676821.43,,Lisset Limpio -020,CAFETERIA y RESTAURANTS,1380786,May
2023-05-19,El Palacio de los jugos /  EMMA FOOD CORP,Invoice,008-01548,Arroz a Granel:Parboiled 50 LB -Bolsa Dos Hermanos.,,2.0,25.5,51.0,676872.43,,Lisset Limpio -020,Cafeteria,1380787,May
2023-05-22,El Palacio de los jugos / Caribe Tropical,Invoice,008-01549,Arroz a Granel:Parboiled 50 LB -Bolsa Dos Hermanos.,,10.0,25.5,255.0,677127.43,,Lisset Limpio -020,Cafeteria,1380788,May
2023-05-22,Soriano Brothers,Invoice,008-01550,Arroz a Granel:Parboiled 50 LB -Bolsa Dos Hermanos.,,55.0,25.5,1402.5,678529.93,,Lisset Limpio -020,CAFETERIA y RESTAURANTS,1380789,May
2023-05-22,El Palacio de los jugos / Lita Foods Inc.,Invoice,008-01551,Arroz a Granel:Parboiled 50 LB -Bolsa Dos Hermanos.,,10.0,25.5,255.0,678784.93,,Lisset Limpio -020,Cafeteria,1380790,May
2023-05-22,Brito Family Corp.,Invoice,008-01552,Arroz a Granel:Parboiled 50 LB -Bolsa Dos Hermanos.,,110.0,24.5,2695.0,681479.93,,Lisset Limpio -020,CAFETERIA y RESTAURANTS,1380791,May
2023-05-22,Soriano Brothers PB,Invoice,008-01553,Arroz a Granel:Parboiled 50 LB -Bolsa Dos Hermanos.,,15.0,24.5,367.5,681847.43,,Lisset Limpio -020,CAFETERIA y RESTAURANTS,1380792,May
2023-05-22,El Palacio de Los Jugos / Casa mía Food Restaurant inc,Invoice,008-01554,Arroz a Granel:Parboiled 50 LB -Bolsa Dos Hermanos.,,5.0,25.5,127.5,681974.93,,Lisset Limpio -020,Cafeteria,1380793,May
2023-05-22,El Palacio de los jugos / Delicias Criollas (DIAGO FOOD_MILLER),Invoice,008-01555,Arroz a Granel:Parboiled 50 LB -Bolsa Dos Hermanos.,,10.0,25.5,255.0,682229.93,,Lisset Limpio -020,Cafeteria,1380794,May
2023-05-22,Total Food - AE&O Supermarket Inc.,Invoice,008-01556,Arroz a Granel:Parboiled 50 LB -Bolsa Dos Hermanos.,,10.0,25.5,255.0,682484.93,,Ruta - 019,RETAIL  DSD,1380795,May
2023-05-22,El Palacio de Los Jugos / Casa mía Food Restaurant inc,Credit Memo,008-01557,Arroz a Granel:Parboiled 50 LB -Bolsa Dos Hermanos.,,-5.0,25.5,-127.5,682357.43,,Lisset Limpio -020,Cafeteria,1380796,May
2023-05-23,"El Toro Loco Meat Distribution, LLC",Invoice,008-01558,Arroz a Granel:Largo Fino 50 LB -Bolsa Dos Hermanos.,,55.0,20.5,1127.5,683484.93,,Lisset Limpio -020,CAFETERIA y RESTAURANTS,1380797,May
2023-05-23,Soriano Brothers PB,Invoice,008-01559,Arroz a Granel:Largo Fino 50 LB -Bolsa Dos Hermanos.,,20.0,21.0,420.0,683904.93,,Lisset Limpio -020,CAFETERIA y RESTAURANTS,1380798,May
2023-05-23,Soriano Brothers,Invoice,008-01560,Arroz a Granel:Largo Fino 50 LB -Bolsa Dos Hermanos.,,55.0,21.0,1155.0,685059.93,,Lisset Limpio -020,CAFETERIA y RESTAURANTS,1380799,May
2023-05-23,El Palacio de los jugos /  EMMA FOOD CORP,Invoice,008-01561,Arroz a Granel:Parboiled 50 LB -Bolsa Dos Hermanos.,,10.0,25.5,255.0,685314.93,,Lisset Limpio -020,Cafeteria,1380800,May
2023-05-23,El Palacio de los jugos /  E & P Foods,Invoice,008-01562,Arroz a Granel:Parboiled 50 LB -Bolsa Dos Hermanos.,,10.0,25.5,255.0,685569.93,,Lisset Limpio -020,Cafeteria,1380801,May
2023-05-23,El Palacio de los jugos /  E & P Foods,Invoice,008-01562,Arroz a Granel:Largo Fino 50 LB -Bolsa Dos Hermanos.,,15.0,21.0,315.0,685884.93,,Lisset Limpio -020,Cafeteria,1380802,May
2023-05-24,Albert Deli #2,Invoice,008-01563,Arroz a Granel:Largo Fino 50 LB -Bolsa Dos Hermanos.,,10.0,23.0,230.0,686114.93,,Ruta - 019,CAFETERIA y RESTAURANTS,1380803,May
2023-05-24,Key Food Lake Worth,Invoice,008-01564,Arroz Envasado:Parboiled 5KG Dos Hermanos.,6 / 11lbs,10.0,38.5,385.0,686499.93,,Ruta - 019,RETAIL KEY FOOD,1380804,May
2023-05-24,Key Food Lake Worth,Invoice,008-01564,Arroz Envasado:Parboiled 5KG Dos Hermanos.,6 / 11lbs,2.0,0.0,0.0,686499.93,,Ruta - 019,RETAIL KEY FOOD,1380805,May
2023-05-24,Key Food Lake Worth,Invoice,008-01564,Arroz Envasado:Largo Fino 1kg (Long grain rice) Dos Hermanos,,5.0,16.5,82.5,686582.43,,Ruta - 019,RETAIL KEY FOOD,1380806,May
2023-05-24,Key Food Lake Worth,Invoice,008-01564,Arroz Envasado:Largo Fino 1kg (Long grain rice) Dos Hermanos,,1.0,0.0,0.0,686582.43,,Ruta - 019,RETAIL KEY FOOD,1380807,May
2023-05-24,La Ranchera Meat Market #3,Invoice,008-01565,Arroz a Granel:Largo Fino 50 LB -Bolsa Dos Hermanos.,,10.0,23.0,230.0,686812.43,,Ruta - 019,CAFETERIA y RESTAURANTS,1380808,May
2023-05-24,Foodtown Supermarket,Invoice,008-01566,Arroz a Granel:Largo Fino 50 LB -Bolsa Dos Hermanos.,,1.0,23.0,23.0,686835.43,,Ruta - 019,CAFETERIA y RESTAURANTS,1380809,May
2023-05-24,Foodtown Supermarket,Invoice,008-01566,Arroz a Granel:Parboiled 50 LB -Bolsa Dos Hermanos.,,10.0,28.0,280.0,687115.43,,Ruta - 019,CAFETERIA y RESTAURANTS,1380810,May
2023-05-24,Foodtown Supermarket,Invoice,008-01566,Arroz Envasado:Parboiled 5KG Dos Hermanos.,6 / 11lbs,25.0,38.5,962.5,688077.93,,Ruta - 019,CAFETERIA y RESTAURANTS,1380811,May
2023-05-24,Foodtown Supermarket,Invoice,008-01566,Arroz Envasado:Parboiled 5KG Dos Hermanos.,6 / 11lbs,6.0,0.0,0.0,688077.93,,Ruta - 019,CAFETERIA y RESTAURANTS,1380812,May
2023-05-24,Foodtown Supermarket,Invoice,008-01566,Arroz Envasado:Largo Fino 1kg (Long grain rice) Dos Hermanos,,5.0,16.5,82.5,688160.43,,Ruta - 019,CAFETERIA y RESTAURANTS,1380813,May
2023-05-24,Foodtown Supermarket,Invoice,008-01566,Arroz Envasado:Largo Fino 1kg (Long grain rice) Dos Hermanos,,1.0,0.0,0.0,688160.43,,Ruta - 019,CAFETERIA y RESTAURANTS,1380814,May
2023-05-24,"Key Food - Kabfra, LLC",Invoice,008-01567,Arroz a Granel:Largo Fino 50 LB -Bolsa Dos Hermanos.,,5.0,23.0,115.0,688275.43,,Ruta - 019,RETAIL  DSD,1380815,May
2023-05-24,"Key Food - Kabfra, LLC",Invoice,008-01567,Arroz a Granel:Parboiled 50 LB -Bolsa Dos Hermanos.,,10.0,28.5,285.0,688560.43,,Ruta - 019,RETAIL  DSD,1380816,May
2023-05-24,Agrocommerce S.A. C/O Jose Miguel Infante,Invoice,008-01568,Varios:Organic Rice -NI,Inv #170,1.0,5904.0,5904.0,694464.43,,Others - 001,OTHER,1380817,May
2023-05-25,"YummmyCo, Inc",Invoice,008-01569,Arroz a Granel:Parboiled 50 LB -Bolsa Dos Hermanos.,,55.0,24.75,1361.25,695825.68,,Armando Carpio - 017,WHOLESALER,1380818,May
2023-05-26,El Palacio de los jugos / Lita Foods Inc.,Invoice,008-01570,Arroz a Granel:Largo Fino 50 LB -Bolsa Dos Hermanos.,,10.0,21.0,210.0,696035.68,,Lisset Limpio -020,Cafeteria,1380819,May
2023-05-26,El Palacio de Los Jugos / Casa mía Food Restaurant inc,Invoice,008-01571,Arroz a Granel:Parboiled 50 LB -Bolsa Dos Hermanos.,,10.0,25.5,255.0,696290.68,,Lisset Limpio -020,Cafeteria,1380820,May
2023-05-26,El Palacio de Los Jugos / Casa mía Food Restaurant inc,Invoice,008-01571,Arroz a Granel:Largo Fino 50 LB -Bolsa Dos Hermanos.,,1.0,21.0,21.0,696311.68,,Lisset Limpio -020,Cafeteria,1380821,May
2023-05-26,El Palacio de los jugos /  EMMA FOOD CORP,Invoice,008-01572,Arroz a Granel:Parboiled 50 LB -Bolsa Dos Hermanos.,,6.0,25.5,153.0,696464.68,,Lisset Limpio -020,Cafeteria,1380822,May
2023-05-26,El Palacio de los jugos /  EMMA FOOD CORP,Invoice,008-01572,Arroz a Granel:Largo Fino 50 LB -Bolsa Dos Hermanos.,,6.0,21.0,126.0,696590.68,,Lisset Limpio -020,Cafeteria,1380823,May
2023-05-26,El Palacio de los jugos / Caribe Tropical,Invoice,008-01573,Arroz a Granel:Largo Fino 50 LB -Bolsa Dos Hermanos.,,12.0,21.0,252.0,696842.68,,Lisset Limpio -020,Cafeteria,1380824,May
2023-05-26,El Palacio de los jugos / Caribe Tropical,Invoice,008-01573,Arroz a Granel:Parboiled 50 LB -Bolsa Dos Hermanos.,,12.0,25.5,306.0,697148.68,,Lisset Limpio -020,Cafeteria,1380825,May
2023-05-26,El Palacio de los jugos /  Mires Restaurants,Invoice,008-01574,Arroz a Granel:Parboiled 50 LB -Bolsa Dos Hermanos.,,6.0,25.5,153.0,697301.68,,Lisset Limpio -020,Cafeteria,1380826,May
2023-05-26,El Palacio de los jugos /  Mires Restaurants,Invoice,008-01574,Arroz a Granel:Largo Fino 50 LB -Bolsa Dos Hermanos.,,6.0,21.0,126.0,697427.68,,Lisset Limpio -020,Cafeteria,1380827,May
2023-05-26,El Palacio de los jugos / Delicias Criollas (DIAGO FOOD_MILLER),Invoice,008-01575,Arroz a Granel:Parboiled 50 LB -Bolsa Dos Hermanos.,,10.0,25.5,255.0,697682.68,,Lisset Limpio -020,Cafeteria,1380828,May
2023-05-26,El Palacio de los jugos / Delicias Criollas (DIAGO FOOD_MILLER),Invoice,008-01575,Arroz a Granel:Largo Fino 50 LB -Bolsa Dos Hermanos.,,10.0,21.0,210.0,697892.68,,Lisset Limpio -020,Cafeteria,1380829,May
2023-05-26,Ideal Food Basket Davie Cafeteria,Invoice,008-01576,Arroz a Granel:Largo Fino 50 LB -Bolsa Dos Hermanos.,,5.0,23.0,115.0,698007.68,,Ruta - 019,CAFETERIA y RESTAURANTS,1380830,May
2023-05-29,Bake Mark USA LLC,Credit Memo,008-01577,Arroz a Granel (MWH):Arroz Parboil Bolsa 50LB Dos hermanos (Alpha),,-8.0,20.5,-164.0,697843.68,,Armando Carpio - 017,WHOLESALER MANUFACTURY,1380831,May
2023-05-30,El Palacio de los jugos / Delicias Criollas (DIAGO FOOD_MILLER),Invoice,008-01578,Arroz a Granel:Parboiled 50 LB -Bolsa Dos Hermanos.,,10.0,25.5,255.0,698098.68,,Lisset Limpio -020,Cafeteria,1380832,May
2023-05-30,El Palacio de los jugos / Delicias Criollas (DIAGO FOOD_MILLER),Invoice,008-01578,Arroz a Granel:Largo Fino 50 LB -Bolsa Dos Hermanos.,,5.0,21.0,105.0,698203.68,,Lisset Limpio -020,Cafeteria,1380833,May
2023-05-30,El Palacio de los jugos / Lita Foods Inc.,Invoice,008-01579,Arroz a Granel:Largo Fino 50 LB -Bolsa Dos Hermanos.,,6.0,21.0,126.0,698329.68,,Lisset Limpio -020,Cafeteria,1380834,May
2023-05-30,El Palacio de los jugos / Lita Foods Inc.,Invoice,008-01579,Arroz a Granel:Parboiled 50 LB -Bolsa Dos Hermanos.,,10.0,25.5,255.0,698584.68,,Lisset Limpio -020,Cafeteria,1380835,May
2023-05-30,El Palacio de Los Jugos / Casa mía Food Restaurant inc,Invoice,008-01580,Arroz a Granel:Parboiled 50 LB -Bolsa Dos Hermanos.,,6.0,25.5,153.0,698737.68,,Lisset Limpio -020,Cafeteria,1380836,May
2023-05-30,El Palacio de los jugos /  E & P Foods,Invoice,008-01581,Liquids:AS Marinating Sauce (Mojo),,0.0,0.0,0.0,698737.68,,Lisset Limpio -020,Cafeteria,1380837,May
2023-05-30,El Palacio de los jugos /  E & P Foods,Invoice,008-01581,Arroz a Granel:Parboiled 50 LB -Bolsa Dos Hermanos.,,15.0,25.5,382.5,699120.18,,Lisset Limpio -020,Cafeteria,1380838,May
2023-05-30,El Palacio de los jugos /  E & P Foods,Invoice,008-01581,Arroz a Granel:Largo Fino 50 LB -Bolsa Dos Hermanos.,,15.0,21.0,315.0,699435.18,,Lisset Limpio -020,Cafeteria,1380839,May
2023-05-30,El Palacio de los jugos /  EMMA FOOD CORP,Invoice,008-01582,Arroz a Granel:Parboiled 50 LB -Bolsa Dos Hermanos.,,10.0,25.5,255.0,699690.18,,Lisset Limpio -020,Cafeteria,1380840,May
2023-05-30,El Palacio de los jugos /  EMMA FOOD CORP,Invoice,008-01582,Arroz a Granel:Largo Fino 50 LB -Bolsa Dos Hermanos.,,6.0,21.0,126.0,699816.18,,Lisset Limpio -020,Cafeteria,1380841,May
2023-05-30,"American Spice Trading Co, Inc.",Invoice,008-01583,Arroz a Granel:Parboiled 50 LB -Bolsa Dos Hermanos.,,220.0,22.5,4950.0,704766.18,,Armando Carpio - 017,WHOLESALER MANUFACTURY,1380842,May
2023-05-30,"American Spice Trading Co, Inc.",Invoice,008-01584,Arroz a Granel:Parboiled 50 LB -Bolsa Dos Hermanos.,,1100.0,22.0,24200.0,728966.18,,Armando Carpio - 017,WHOLESALER MANUFACTURY,1380843,May
2023-05-30,Key Food Lake Worth,Credit Memo,008-01585,Arroz Envasado:Parboiled 5KG Dos Hermanos.,6 / 11lbs,-10.0,38.5,-385.0,728581.18,,Ruta - 019,RETAIL KEY FOOD,1380844,May
2023-05-30,Key Food Lake Worth,Credit Memo,008-01585,Arroz Envasado:Largo Fino 1kg (Long grain rice) Dos Hermanos,,-5.0,16.5,-82.5,728498.68,,Ruta - 019,RETAIL KEY FOOD,1380845,May
2023-05-31,Malaga Distributor Corp.,Invoice,008-01586,Arroz a Granel:Parboiled 50 LB -Bolsa Dos Hermanos.,,55.0,25.5,1402.5,729901.18,,Ruta - 019,RETAIL  DSD,1380846,May
2023-05-31,Malaga Distributor Corp.,Invoice,008-01586,Arroz a Granel:Largo Fino 50 LB -Bolsa Dos Hermanos.,,20.0,21.5,430.0,730331.18,,Ruta - 019,RETAIL  DSD,1380847,May
2023-05-31,Sedanos Supermarkets #22,Credit Memo,008-01591,TRADE DISCOUNT:Commercial samples,,-1.0,14.79,-14.79,730316.39,,Lisset Limpio -020,RETAIL SEDANOS,1380848,May
2023-05-31,Sedanos Supermarkets #34,Credit Memo,008-01592,TRADE DISCOUNT:Commercial samples,Sobre invoice 8-800,-1.0,72.5,-72.5,730243.89,,Lisset Limpio -020,RETAIL SEDANOS,1380849,May
2023-05-31,Mango Supermarket Inc.,Credit Memo,008-01599,TRADE DISCOUNT:Commercial samples,,-1.0,333.75,-333.75,729910.14,,Ruta - 019,RETAIL  DSD,1380850,May
2023-05-31,Key Foods - 10301 Royal Palm Food Corp.,Credit Memo,008-01600,TRADE DISCOUNT:Commercial samples,,-1.0,73.81,-73.81,729836.33,,Ruta - 019,RETAIL KEY FOOD,1380851,May
2023-05-31,Meat Giant Corp,Credit Memo,008-01602,TRADE DISCOUNT:Commercial samples,,-1.0,93.64,-93.64,729742.69,,Ruta - 019,RETAIL  DSD,1380852,May
2023-05-31,Super Supermarket / N.J.,Credit Memo,008-01646,TRADE DISCOUNT:Commercial samples,MERCADERIA DEVUELTA POR EL CLIENTE,-1.0,4701.06,-4701.06,725041.63,,Armando Carpio - 017,RETAIL  DSD,1380853,May
2023-06-01,"Key Food - Kabfra, LLC",Invoice,008-01588,Arroz a Granel:Largo Fino 50 LB -Bolsa Dos Hermanos.,,10.0,23.0,230.0,725271.63,,Ruta - 019,RETAIL  DSD,1380854,Jun
2023-06-01,Key Food Weston,Invoice,008-01589,Arroz Envasado:Parboiled 5KG Dos Hermanos.,6 / 11lbs,36.0,38.5,1386.0,726657.63,,Lisset Limpio -020,RETAIL  DSD,1380855,Jun
2023-06-01,Key Food Weston,Invoice,008-01589,Arroz Envasado:Parboiled 5KG Dos Hermanos.,6 / 11lbs,5.0,0.0,0.0,726657.63,,Lisset Limpio -020,RETAIL  DSD,1380856,Jun
2023-06-01,Miavana & Family,Invoice,008-01590,Arroz a Granel:Parboiled 50 LB -Bolsa Dos Hermanos.,,220.0,21.5,4730.0,731387.63,,Armando Carpio - 017,Distributor,1380857,Jun
2023-06-02,Soriano Brothers PB,Invoice,008-01593,Arroz a Granel:Largo Fino 50 LB -Bolsa Dos Hermanos.,,5.0,21.0,105.0,731492.63,,Lisset Limpio -020,CAFETERIA y RESTAURANTS,1380858,Jun
2023-06-02,Soriano Brothers PB,Invoice,008-01593,Arroz a Granel:Parboiled 50 LB -Bolsa Dos Hermanos.,,5.0,24.5,122.5,731615.13,,Lisset Limpio -020,CAFETERIA y RESTAURANTS,1380859,Jun
2023-06-02,El Palacio de los jugos /  EMMA FOOD CORP,Invoice,008-01594,Arroz a Granel:Parboiled 50 LB -Bolsa Dos Hermanos.,,8.0,25.5,204.0,731819.13,,Lisset Limpio -020,Cafeteria,1380860,Jun
2023-06-02,El Palacio de Los Jugos / Casa mía Food Restaurant inc,Invoice,008-01595,Arroz a Granel:Parboiled 50 LB -Bolsa Dos Hermanos.,,8.0,25.5,204.0,732023.13,,Lisset Limpio -020,Cafeteria,1380861,Jun
2023-06-02,El Palacio de los jugos / Caribe Tropical,Invoice,008-01596,Arroz a Granel:Parboiled 50 LB -Bolsa Dos Hermanos.,,10.0,25.5,255.0,732278.13,,Lisset Limpio -020,Cafeteria,1380862,Jun
2023-06-02,El Palacio de los jugos / Caribe Tropical,Invoice,008-01596,Arroz a Granel:Largo Fino 50 LB -Bolsa Dos Hermanos.,,5.0,21.0,105.0,732383.13,,Lisset Limpio -020,Cafeteria,1380863,Jun
2023-06-02,El Palacio de los jugos / Lita Foods Inc.,Invoice,008-01597,Arroz a Granel:Largo Fino 50 LB -Bolsa Dos Hermanos.,,5.0,21.0,105.0,732488.13,,Lisset Limpio -020,Cafeteria,1380864,Jun
2023-06-02,El Palacio de los jugos / Lita Foods Inc.,Invoice,008-01597,Arroz a Granel:Parboiled 50 LB -Bolsa Dos Hermanos.,,10.0,25.5,255.0,732743.13,,Lisset Limpio -020,Cafeteria,1380865,Jun
2023-06-02,Armando Carpio,Invoice,008-01598,Rice Snack:Rice Snack Cheese Flavored GR (deleted),H7(40)MAY /H17(50)AUG /i11 (60) AUG // i10 (20),2.0,0.0,0.0,732743.13,,Armando Carpio - 017,OTHER,1380866,Jun
2023-06-02,Armando Carpio,Invoice,008-01598,Rice Snack:Rice Snack Grilled Smoked Meat Flavored GR (deleted),H5(34)MAY/H18(37)AUG /i12(45)AUG,1.0,0.0,0.0,732743.13,,Armando Carpio - 017,OTHER,1380867,Jun
2023-06-02,Armando Carpio,Invoice,008-01598,"Rice Snack:Rice Snack, Sour Cream & Onion GR (deleted)",H6(41)MAY /H16(60)AUG /i10AUG (30),1.0,0.0,0.0,732743.13,,Armando Carpio - 017,OTHER,1380868,Jun
2023-06-02,Armando Carpio,Invoice,008-01598,Rice Cakes:Rice Cakes salty DH,,1.0,0.0,0.0,732743.13,,Armando Carpio - 017,OTHER,1380869,Jun
2023-06-02,Armando Carpio,Invoice,008-01598,Rice Snack:Rice Snack Ham Flavored DOS HERMANOS,,3.0,0.0,0.0,732743.13,,Armando Carpio - 017,OTHER,1380870,Jun
2023-06-02,Armando Carpio,Invoice,008-01598,Rice Snack:Rice Snack Salami Flavored DOS HERMANOS,,3.0,0.0,0.0,732743.13,,Armando Carpio - 017,OTHER,1380871,Jun
2023-06-02,Armando Carpio,Invoice,008-01598,Rice Snack:Rice Snack Grilled Smoked Meat Flavored DOS HERMANOS,H9,3.0,0.0,0.0,732743.13,,Armando Carpio - 017,OTHER,1380872,Jun
2023-06-02,Armando Carpio,Invoice,008-01598,Arroz a Granel:Largo Fino 50 LB -Bolsa Dos Hermanos.,,1.0,0.0,0.0,732743.13,,Armando Carpio - 017,OTHER,1380873,Jun
2023-06-02,Armando Carpio,Invoice,008-01598,Arroz Envasado:Parboiled 5KG Dos Hermanos.,6 / 11lbs,1.0,0.0,0.0,732743.13,,Armando Carpio - 017,OTHER,1380874,Jun
2023-06-02,Armando Carpio,Invoice,008-01598,Arroz Envasado:Largo Fino 1kg (Long grain rice) Dos Hermanos,,3.0,0.0,0.0,732743.13,,Armando Carpio - 017,OTHER,1380875,Jun
2023-06-02,Seabra Foods Parkland,Credit Memo,008-01601,TRADE DISCOUNT:Commercial samples,Inv 984,-1.0,105.0,-105.0,732638.13,,Ruta - 019,RETAIL  DSD,1380876,Jun
2023-06-02,Key Food Weston,Credit Memo,008-01613,Arroz Envasado:Parboiled 5KG Dos Hermanos.,6 / 11lbs,-36.0,38.5,-1386.0,731252.13,,Lisset Limpio -020,RETAIL  DSD,1380877,Jun
2023-06-05,El Palacio de los jugos /  Mires Restaurants,Invoice,008-01603,Arroz a Granel:Parboiled 50 LB -Bolsa Dos Hermanos.,,10.0,25.5,255.0,731507.13,,Lisset Limpio -020,Cafeteria,1380878,Jun
2023-06-05,Soriano Brothers,Invoice,008-01604,Arroz a Granel:Parboiled 50 LB -Bolsa Dos Hermanos.,,55.0,25.5,1402.5,732909.63,,Lisset Limpio -020,CAFETERIA y RESTAURANTS,1380879,Jun
2023-06-05,El Palacio de los jugos /  EMMA FOOD CORP,Invoice,008-01605,Arroz a Granel:Parboiled 50 LB -Bolsa Dos Hermanos.,,9.0,25.5,229.5,733139.13,,Lisset Limpio -020,Cafeteria,1380880,Jun
2023-06-05,El Palacio de los jugos /  EMMA FOOD CORP,Invoice,008-01605,Arroz a Granel:Largo Fino 50 LB -Bolsa Dos Hermanos.,,5.0,21.0,105.0,733244.13,,Lisset Limpio -020,Cafeteria,1380881,Jun
2023-06-05,El Palacio de los jugos / J Mena Corp.,Invoice,008-01606,Arroz a Granel:Largo Fino 50 LB -Bolsa Dos Hermanos.,,10.0,21.0,210.0,733454.13,,Lisset Limpio -020,Cafeteria,1380882,Jun
2023-06-05,El Palacio de los jugos / J Mena Corp.,Invoice,008-01606,Spices:AS Whole Bay Leaves,4/12 OZ,1.0,28.0,28.0,733482.13,,Lisset Limpio -020,Cafeteria,1380883,Jun
2023-06-05,El Palacio de los jugos / J Mena Corp.,Invoice,008-01606,Spices:AS Cumin Ground,4 / 4 lb,1.0,50.25,50.25,733532.38,,Lisset Limpio -020,Cafeteria,1380884,Jun
2023-06-05,Soriano Brothers PB,Invoice,008-01607,Arroz a Granel:Largo Fino 50 LB -Bolsa Dos Hermanos.,,6.0,21.0,126.0,733658.38,,Lisset Limpio -020,CAFETERIA y RESTAURANTS,1380885,Jun
2023-06-05,Soriano Brothers PB,Invoice,008-01607,Arroz a Granel:Parboiled 50 LB -Bolsa Dos Hermanos.,,10.0,25.5,255.0,733913.38,,Lisset Limpio -020,CAFETERIA y RESTAURANTS,1380886,Jun
2023-06-05,El Palacio de los jugos / Delicias Criollas (DIAGO FOOD_MILLER),Invoice,008-01608,Arroz a Granel:Parboiled 50 LB -Bolsa Dos Hermanos.,,10.0,25.5,255.0,734168.38,,Lisset Limpio -020,Cafeteria,1380887,Jun
2023-06-05,El Palacio de los jugos / Caribe Tropical,Invoice,008-01609,Arroz a Granel:Parboiled 50 LB -Bolsa Dos Hermanos.,,10.0,25.5,255.0,734423.38,,Lisset Limpio -020,Cafeteria,1380888,Jun
2023-06-05,El Palacio de los jugos / Caribe Tropical,Invoice,008-01609,Arroz a Granel:Largo Fino 50 LB -Bolsa Dos Hermanos.,,6.0,21.5,129.0,734552.38,,Lisset Limpio -020,Cafeteria,1380889,Jun
2023-06-05,El Palacio de Los Jugos / Casa mía Food Restaurant inc,Invoice,008-01610,Arroz a Granel:Parboiled 50 LB -Bolsa Dos Hermanos.,,10.0,25.5,255.0,734807.38,,Lisset Limpio -020,Cafeteria,1380890,Jun
2023-06-05,El Palacio de los jugos / Lita Foods Inc.,Invoice,008-01611,Arroz a Granel:Largo Fino 50 LB -Bolsa Dos Hermanos.,,6.0,21.0,126.0,734933.38,,Lisset Limpio -020,Cafeteria,1380891,Jun
2023-06-05,El Palacio de los jugos / Lita Foods Inc.,Invoice,008-01611,Arroz a Granel:Parboiled 50 LB -Bolsa Dos Hermanos.,,6.0,25.5,153.0,735086.38,,Lisset Limpio -020,Cafeteria,1380892,Jun
2023-06-05,El Palacio de los jugos /  E & P Foods,Invoice,008-01612,Arroz a Granel:Parboiled 50 LB -Bolsa Dos Hermanos.,,15.0,25.5,382.5,735468.88,,Lisset Limpio -020,Cafeteria,1380893,Jun
2023-06-05,El Palacio de los jugos /  E & P Foods,Invoice,008-01612,Arroz a Granel:Largo Fino 50 LB -Bolsa Dos Hermanos.,,15.0,21.0,315.0,735783.88,,Lisset Limpio -020,Cafeteria,1380894,Jun
2023-06-05,El Palacio de los jugos /  E & P Foods,Invoice,008-01612,Liquids:AS Marinating Sauce (Mojo),,6.0,20.0,120.0,735903.88,,Lisset Limpio -020,Cafeteria,1380895,Jun
2023-06-07,"El Toro Loco Meat Distribution, LLC",Invoice,008-01614,Arroz a Granel:Largo Fino 50 LB -Bolsa Dos Hermanos.,,55.0,20.5,1127.5,737031.38,,Lisset Limpio -020,CAFETERIA y RESTAURANTS,1380896,Jun
2023-06-07,Total Food - AE&O Supermarket Inc.,Invoice,008-01615,Arroz a Granel:Parboiled 50 LB -Bolsa Dos Hermanos.,,10.0,25.5,255.0,737286.38,,Ruta - 019,RETAIL  DSD,1380897,Jun
2023-06-07,Extra Supermarket,Invoice,008-01616,Arroz Envasado:Parboiled 5KG Dos Hermanos.,6 / 11lbs,10.0,38.5,385.0,737671.38,,Ruta - 019,RETAIL  DSD,1380898,Jun
2023-06-07,Extra Supermarket,Invoice,008-01616,Arroz Envasado:Parboiled 5KG Dos Hermanos.,6 / 11lbs,2.0,0.0,0.0,737671.38,,Ruta - 019,RETAIL  DSD,1380899,Jun
2023-06-07,Price Choice Food Market # 2,Credit Memo,008-01618,Arroz Envasado:Sushi Rice Dos Hermanos.,i7OCT/i9NOV,0.0,,0.0,737671.38,,Ruta - 019,RETAIL  DSD,1380900,Jun
2023-06-07,"Virtue Distributor, Inc",Invoice,008-01619,Arroz Envasado:Parboiled 5KG Dos Hermanos.,6 / 11lbs,5.0,32.52,162.6,737833.98,,Armando Carpio - 017,Distributor,1380901,Jun
2023-06-07,"Virtue Distributor, Inc",Invoice,008-01619,Arroz Envasado:Sushi Rice Dos Hermanos.,i7OCT/i9NOV,5.0,14.5,72.5,737906.48,,Armando Carpio - 017,Distributor,1380902,Jun
2023-06-08,Sedanos Supermarkets #42,Credit Memo,008-01620,TRADE DISCOUNT:Commercial samples,,-1.0,1.56,-1.56,737904.92,,Lisset Limpio -020,RETAIL SEDANOS,1380903,Jun
2023-06-08,Sedanos Supermarkets #42,Credit Memo,008-01621,TRADE DISCOUNT:Commercial samples,,-1.0,0.58,-0.58,737904.34,,Lisset Limpio -020,RETAIL SEDANOS,1380904,Jun
2023-06-08,Sedanos Supermarkets #42,Credit Memo,008-01622,TRADE DISCOUNT:Commercial samples,,-1.0,0.87,-0.87,737903.47,,Lisset Limpio -020,RETAIL SEDANOS,1380905,Jun
2023-06-08,Sedanos Supermarkets #42,Credit Memo,008-01623,TRADE DISCOUNT:Commercial samples,,-1.0,0.87,-0.87,737902.6,,Lisset Limpio -020,RETAIL SEDANOS,1380906,Jun
2023-06-08,Sedanos Supermarkets #42,Credit Memo,008-01624,TRADE DISCOUNT:Commercial samples,,-1.0,0.87,-0.87,737901.73,,Lisset Limpio -020,RETAIL SEDANOS,1380907,Jun
2023-06-08,Sedanos Supermarkets #42,Credit Memo,008-01625,TRADE DISCOUNT:Commercial samples,,-1.0,0.87,-0.87,737900.86,,Lisset Limpio -020,RETAIL SEDANOS,1380908,Jun
2023-06-09,El Palacio de los jugos /  Mires Restaurants,Invoice,008-01626,Arroz a Granel:Largo Fino 50 LB -Bolsa Dos Hermanos.,,5.0,21.0,105.0,738005.86,,Lisset Limpio -020,Cafeteria,1380909,Jun
2023-06-09,El Palacio de los jugos /  EMMA FOOD CORP,Invoice,008-01627,Arroz a Granel:Parboiled 50 LB -Bolsa Dos Hermanos.,,9.0,25.5,229.5,738235.36,,Lisset Limpio -020,Cafeteria,1380910,Jun
2023-06-09,El Palacio de los jugos /  EMMA FOOD CORP,Invoice,008-01627,Arroz a Granel:Largo Fino 50 LB -Bolsa Dos Hermanos.,,6.0,21.0,126.0,738361.36,,Lisset Limpio -020,Cafeteria,1380911,Jun
2023-06-09,El Palacio de Los Jugos / Casa mía Food Restaurant inc,Invoice,008-01628,Arroz a Granel:Parboiled 50 LB -Bolsa Dos Hermanos.,,12.0,25.5,306.0,738667.36,,Lisset Limpio -020,Cafeteria,1380912,Jun
2023-06-09,El Palacio de los jugos / Lita Foods Inc.,Invoice,008-01629,Arroz a Granel:Parboiled 50 LB -Bolsa Dos Hermanos.,,7.0,25.5,178.5,738845.86,,Lisset Limpio -020,Cafeteria,1380913,Jun
2023-06-09,El Palacio de los jugos / Caribe Tropical,Invoice,008-01630,Arroz a Granel:Parboiled 50 LB -Bolsa Dos Hermanos.,,8.0,25.5,204.0,739049.86,,Lisset Limpio -020,Cafeteria,1380914,Jun
2023-06-09,El Palacio de los jugos / Caribe Tropical,Invoice,008-01630,Arroz a Granel:Largo Fino 50 LB -Bolsa Dos Hermanos.,,5.0,21.0,105.0,739154.86,,Lisset Limpio -020,Cafeteria,1380915,Jun
2023-06-09,Soriano Brothers PB,Invoice,008-01631,Arroz a Granel:Parboiled 50 LB -Bolsa Dos Hermanos.,,10.0,24.5,245.0,739399.86,,Lisset Limpio -020,CAFETERIA y RESTAURANTS,1380916,Jun
2023-06-09,Soriano Brothers PB,Invoice,008-01631,Arroz a Granel:Largo Fino 50 LB -Bolsa Dos Hermanos.,,10.0,21.0,210.0,739609.86,,Lisset Limpio -020,CAFETERIA y RESTAURANTS,1380917,Jun
2023-06-09,El Palacio de los jugos / Delicias Criollas (DIAGO FOOD_MILLER),Invoice,008-01632,Arroz a Granel:Parboiled 50 LB -Bolsa Dos Hermanos.,,10.0,25.5,255.0,739864.86,,Lisset Limpio -020,Cafeteria,1380918,Jun
2023-06-12,"American Spice Trading Co, Inc.",Invoice,008-01633,Arroz a Granel:Parboiled 50 LB -Bolsa Dos Hermanos.,,400.0,22.0,8800.0,748664.86,,Armando Carpio - 017,WHOLESALER MANUFACTURY,1380919,Jun
2023-06-12,"American Spice Trading Co, Inc.",Invoice,008-01634,Arroz a Granel:Parboiled 50 LB -Bolsa Dos Hermanos.,,400.0,22.0,8800.0,757464.86,,Armando Carpio - 017,WHOLESALER MANUFACTURY,1380920,Jun
2023-06-12,"American Spice Trading Co, Inc.",Invoice,008-01635,Arroz a Granel (MWH):Arroz Parboil Bolsa 50LB Dos hermanos (Alpha),,1100.0,22.0,24200.0,781664.86,,Armando Carpio - 017,WHOLESALER MANUFACTURY,1380921,Jun
2023-06-12,Festival Supermarket #1,Invoice,008-01636,Arroz Envasado:Parboiled 5KG Dos Hermanos.,6 / 11lbs,10.0,39.5,395.0,782059.86,,Lisset Limpio -020,RETAIL  DSD,1380922,Jun
2023-06-12,Festival Supermarket #1,Invoice,008-01636,Arroz Envasado:Parboiled 5KG Dos Hermanos.,6 / 11lbs,2.0,0.0,0.0,782059.86,,Lisset Limpio -020,RETAIL  DSD,1380923,Jun
2023-06-12,El Palacio de los jugos / Lita Foods Inc.,Invoice,008-01637,Arroz a Granel:Largo Fino 50 LB -Bolsa Dos Hermanos.,,5.0,21.0,105.0,782164.86,,Lisset Limpio -020,Cafeteria,1380924,Jun
2023-06-12,El Palacio de los jugos / Lita Foods Inc.,Invoice,008-01637,Arroz a Granel:Parboiled 50 LB -Bolsa Dos Hermanos.,,10.0,25.5,255.0,782419.86,,Lisset Limpio -020,Cafeteria,1380925,Jun
2023-06-12,El Palacio de los jugos /  Mires Restaurants,Invoice,008-01638,Arroz a Granel:Parboiled 50 LB -Bolsa Dos Hermanos.,,10.0,25.5,255.0,782674.86,,Lisset Limpio -020,Cafeteria,1380926,Jun
2023-06-12,El Palacio de los jugos /  EMMA FOOD CORP,Invoice,008-01639,Arroz a Granel:Parboiled 50 LB -Bolsa Dos Hermanos.,,7.0,25.5,178.5,782853.36,,Lisset Limpio -020,Cafeteria,1380927,Jun
2023-06-12,El Palacio de los jugos /  EMMA FOOD CORP,Invoice,008-01639,Arroz a Granel:Largo Fino 50 LB -Bolsa Dos Hermanos.,,5.0,21.0,105.0,782958.36,,Lisset Limpio -020,Cafeteria,1380928,Jun
2023-06-12,El Palacio de Los Jugos / Casa mía Food Restaurant inc,Invoice,008-01640,Arroz a Granel:Parboiled 50 LB -Bolsa Dos Hermanos.,,8.0,25.5,204.0,783162.36,,Lisset Limpio -020,Cafeteria,1380929,Jun
2023-06-12,El Palacio de los jugos / Caribe Tropical,Invoice,008-01641,Arroz a Granel:Parboiled 50 LB -Bolsa Dos Hermanos.,,9.0,25.5,229.5,783391.86,,Lisset Limpio -020,Cafeteria,1380930,Jun
2023-06-12,El Palacio de los jugos / Caribe Tropical,Invoice,008-01641,Arroz a Granel:Largo Fino 50 LB -Bolsa Dos Hermanos.,,6.0,21.0,126.0,783517.86,,Lisset Limpio -020,Cafeteria,1380931,Jun
2023-06-12,"Virtue Distributor, Inc",Invoice,008-01642,Arroz Envasado:Largo Fino 1kg (Long grain rice) Dos Hermanos,,80.0,13.2,1056.0,784573.86,,Armando Carpio - 017,Distributor,1380932,Jun
2023-06-12,"Virtue Distributor, Inc",Invoice,008-01642,Arroz Envasado:Parboiled 1kg Bolsa Dos Hermanos.,I8(43)JUN/ H27/H28/ H29(118) /H30,40.0,15.2,608.0,785181.86,,Armando Carpio - 017,Distributor,1380933,Jun
2023-06-12,El Palacio de los jugos /  E & P Foods,Invoice,008-01643,Arroz a Granel:Parboiled 50 LB -Bolsa Dos Hermanos.,,20.0,25.5,510.0,785691.86,,Lisset Limpio -020,Cafeteria,1380934,Jun
2023-06-12,El Palacio de los jugos /  E & P Foods,Invoice,008-01643,Liquids:AS Marinating Sauce (Mojo),,5.0,20.0,100.0,785791.86,,Lisset Limpio -020,Cafeteria,1380935,Jun
2023-06-12,Bake Mark USA LLC,Credit Memo,008-01644,Arroz a Granel:Parboiled 50 LB -Bolsa Dos Hermanos.,,-1398.0,20.5,-28659.0,757132.86,,Armando Carpio - 017,WHOLESALER MANUFACTURY,1380936,Jun
2023-06-12,Bake Mark USA LLC,Credit Memo,008-01905,Arroz a Granel:Parboiled 50 LB -Bolsa Dos Hermanos.,,-101.0,20.5,-2070.5,755062.36,,Armando Carpio - 017,WHOLESALER MANUFACTURY,1380937,Jun
2023-06-13,Ideal Food Basket,Invoice,008-01645,Arroz Envasado:Parboiled 5KG Dos Hermanos.,6 / 11lbs,5.0,38.5,192.5,755254.86,,Ruta - 019,RETAIL  DSD,1380938,Jun
2023-06-13,Ideal Food Basket,Invoice,008-01645,Arroz Envasado:Parboiled 5KG Dos Hermanos.,6 / 11lbs,1.0,0.0,0.0,755254.86,,Ruta - 019,RETAIL  DSD,1380939,Jun
2023-06-13,Ideal Food Basket,Invoice,008-01645,Arroz Envasado:Largo Fino 1kg (Long grain rice) Dos Hermanos,,5.0,16.5,82.5,755337.36,,Ruta - 019,RETAIL  DSD,1380940,Jun
2023-06-13,Ideal Food Basket,Invoice,008-01645,Arroz Envasado:Largo Fino 1kg (Long grain rice) Dos Hermanos,,1.0,0.0,0.0,755337.36,,Ruta - 019,RETAIL  DSD,1380941,Jun
2023-06-13,La Barrata Supermarket,Invoice,008-01646,Arroz Envasado:Parboiled 5KG Dos Hermanos.,6 / 11lbs,5.0,38.5,192.5,755529.86,,Ruta - 019,RETAIL  DSD,1380942,Jun
2023-06-13,La Barrata Supermarket,Invoice,008-01646,Arroz Envasado:Parboiled 5KG Dos Hermanos.,6 / 11lbs,1.0,0.0,0.0,755529.86,,Ruta - 019,RETAIL  DSD,1380943,Jun
2023-06-13,La Barrata Supermarket,Invoice,008-01646,Arroz Envasado:Largo Fino 1kg (Long grain rice) Dos Hermanos,,5.0,16.5,82.5,755612.36,,Ruta - 019,RETAIL  DSD,1380944,Jun
2023-06-13,La Barrata Supermarket,Invoice,008-01646,Arroz Envasado:Largo Fino 1kg (Long grain rice) Dos Hermanos,,1.0,0.0,0.0,755612.36,,Ruta - 019,RETAIL  DSD,1380945,Jun
2023-06-13,Key Food / Holywood,Invoice,008-01647,Arroz Envasado:Parboiled 5KG Dos Hermanos.,6 / 11lbs,10.0,38.5,385.0,755997.36,,Ruta - 019,RETAIL  DSD,1380946,Jun
2023-06-13,Key Food / Holywood,Invoice,008-01647,Arroz Envasado:Parboiled 5KG Dos Hermanos.,6 / 11lbs,2.0,0.0,0.0,755997.36,,Ruta - 019,RETAIL  DSD,1380947,Jun
2023-06-13,Key Food / Holywood,Invoice,008-01647,Arroz Envasado:Largo Fino 1kg (Long grain rice) Dos Hermanos,,10.0,16.5,165.0,756162.36,,Ruta - 019,RETAIL  DSD,1380948,Jun
2023-06-13,Key Food / Holywood,Invoice,008-01647,Arroz Envasado:Parboiled 5KG Dos Hermanos.,6 / 11lbs,2.0,0.0,0.0,756162.36,,Ruta - 019,RETAIL  DSD,1380949,Jun
2023-06-13,"Virtue Distributor, Inc",Invoice,008-01648,Arroz Envasado:Parboiled 5KG Dos Hermanos.,6 / 11lbs,41.0,32.52,1333.32,757495.68,,Armando Carpio - 017,Distributor,1380950,Jun
2023-06-13,Soriano Brothers,Invoice,008-01649,Arroz a Granel:Largo Fino 50 LB -Bolsa Dos Hermanos.,,55.0,21.0,1155.0,758650.68,,Lisset Limpio -020,CAFETERIA y RESTAURANTS,1380951,Jun
2023-06-14,Miavana & Family,Invoice,008-01650,Arroz a Granel:Parboiled 50 LB -Bolsa Dos Hermanos.,,400.0,21.5,8600.0,767250.68,,Armando Carpio - 017,Distributor,1380952,Jun
2023-06-14,La Barrata Supermarket,Credit Memo,008-01651,Arroz Envasado:Parboiled 5KG Dos Hermanos.,6 / 11lbs,-5.0,38.5,-192.5,767058.18,,Ruta - 019,RETAIL  DSD,1380953,Jun
2023-06-14,La Barrata Supermarket,Credit Memo,008-01651,Arroz Envasado:Largo Fino 1kg (Long grain rice) Dos Hermanos,,-5.0,16.5,-82.5,766975.68,,Ruta - 019,RETAIL  DSD,1380954,Jun
2023-06-16,El Palacio de los jugos /  Mires Restaurants,Invoice,008-01652,Arroz a Granel:Largo Fino 50 LB -Bolsa Dos Hermanos.,,7.0,21.0,147.0,767122.68,,Lisset Limpio -020,Cafeteria,1380955,Jun
2023-06-16,El Palacio de los jugos /  EMMA FOOD CORP,Invoice,008-01653,Arroz a Granel:Parboiled 50 LB -Bolsa Dos Hermanos.,,10.0,25.5,255.0,767377.68,,Lisset Limpio -020,Cafeteria,1380956,Jun
2023-06-16,El Palacio de los jugos /  EMMA FOOD CORP,Invoice,008-01653,Arroz a Granel:Largo Fino 50 LB -Bolsa Dos Hermanos.,,5.0,21.0,105.0,767482.68,,Lisset Limpio -020,Cafeteria,1380957,Jun
2023-06-16,El Palacio de Los Jugos / Casa mía Food Restaurant inc,Invoice,008-01654,Arroz a Granel:Parboiled 50 LB -Bolsa Dos Hermanos.,,8.0,25.5,204.0,767686.68,,Lisset Limpio -020,Cafeteria,1380958,Jun
2023-06-16,El Palacio de los jugos / Lita Foods Inc.,Invoice,008-01655,Arroz a Granel:Largo Fino 50 LB -Bolsa Dos Hermanos.,,4.0,21.0,84.0,767770.68,,Lisset Limpio -020,Cafeteria,1380959,Jun
2023-06-16,El Palacio de los jugos / Lita Foods Inc.,Invoice,008-01655,Arroz a Granel:Largo Fino 50 LB -Bolsa Dos Hermanos.,,7.0,25.5,178.5,767949.18,,Lisset Limpio -020,Cafeteria,1380960,Jun
2023-06-16,El Palacio de los jugos / Caribe Tropical,Invoice,008-01656,Arroz a Granel:Parboiled 50 LB -Bolsa Dos Hermanos.,,12.0,25.5,306.0,768255.18,,Lisset Limpio -020,Cafeteria,1380961,Jun
2023-06-16,El Palacio de los jugos / Caribe Tropical,Invoice,008-01656,Arroz a Granel:Parboiled 50 LB -Bolsa Dos Hermanos.,,8.0,21.0,168.0,768423.18,,Lisset Limpio -020,Cafeteria,1380962,Jun
2023-06-16,El Palacio de los jugos / Delicias Criollas (DIAGO FOOD_MILLER),Invoice,008-01657,Arroz a Granel:Parboiled 50 LB -Bolsa Dos Hermanos.,,10.0,25.5,255.0,768678.18,,Lisset Limpio -020,Cafeteria,1380963,Jun
2023-06-16,El Palacio de los jugos / J Mena Corp.,Invoice,008-01658,Arroz a Granel:Largo Fino 50 LB -Bolsa Dos Hermanos.,,10.0,21.0,210.0,768888.18,,Lisset Limpio -020,Cafeteria,1380964,Jun
2023-06-16,"El Toro Loco Meat Distribution, LLC",Invoice,008-01659,Arroz a Granel:Largo Fino 50 LB -Bolsa Dos Hermanos.,,55.0,20.5,1127.5,770015.68,,Lisset Limpio -020,CAFETERIA y RESTAURANTS,1380965,Jun
2023-06-16,El Palacio de los jugos /  E & P Foods,Invoice,008-01660,Liquids:AS Marinating Sauce (Mojo),,5.0,20.0,100.0,770115.68,,Lisset Limpio -020,Cafeteria,1380966,Jun
2023-06-16,El Palacio de los jugos /  E & P Foods,Invoice,008-01660,Arroz a Granel:Parboiled 50 LB -Bolsa Dos Hermanos.,,15.0,25.5,382.5,770498.18,,Lisset Limpio -020,Cafeteria,1380967,Jun
2023-06-16,Brito Family Corp.,Invoice,008-01661,Arroz a Granel:Parboiled 50 LB -Bolsa Dos Hermanos.,,50.0,24.5,1225.0,771723.18,,Lisset Limpio -020,CAFETERIA y RESTAURANTS,1380968,Jun
2023-06-16,Ideal Food Basket Davie Cafeteria,Invoice,008-01662,Arroz a Granel:Largo Fino 50 LB -Bolsa Dos Hermanos.,,8.0,23.0,184.0,771907.18,,Ruta - 019,CAFETERIA y RESTAURANTS,1380969,Jun
2023-06-16,Miami Warehouse Logistics,Invoice,008-01663,Arroz a Granel (MWH):Arroz Parboil Bolsa 50LB Dos hermanos (Alpha),,110.0,25.5,2805.0,774712.18,,Armando Carpio - 017,OTHER,1380970,Jun
2023-06-19,El Palacio de los jugos /  EMMA FOOD CORP,Invoice,008-01664,Arroz a Granel:Parboiled 50 LB -Bolsa Dos Hermanos.,,10.0,25.5,255.0,774967.18,,Lisset Limpio -020,Cafeteria,1380971,Jun
2023-06-19,El Palacio de los jugos /  EMMA FOOD CORP,Invoice,008-01664,Arroz a Granel:Largo Fino 50 LB -Bolsa Dos Hermanos.,,5.0,21.0,105.0,775072.18,,Lisset Limpio -020,Cafeteria,1380972,Jun
2023-06-19,El Palacio de Los Jugos / Casa mía Food Restaurant inc,Invoice,008-01665,Arroz a Granel:Parboiled 50 LB -Bolsa Dos Hermanos.,,15.0,25.5,382.5,775454.68,,Lisset Limpio -020,Cafeteria,1380973,Jun
2023-06-19,El Palacio de los jugos / Lita Foods Inc.,Invoice,008-01666,Arroz a Granel:Largo Fino 50 LB -Bolsa Dos Hermanos.,,4.0,21.0,84.0,775538.68,,Lisset Limpio -020,Cafeteria,1380974,Jun
2023-06-19,El Palacio de los jugos / Lita Foods Inc.,Invoice,008-01666,Arroz a Granel:Parboiled 50 LB -Bolsa Dos Hermanos.,,10.0,25.5,255.0,775793.68,,Lisset Limpio -020,Cafeteria,1380975,Jun
2023-06-19,El Palacio de los jugos / Caribe Tropical,Invoice,008-01667,Arroz a Granel:Parboiled 50 LB -Bolsa Dos Hermanos.,,8.0,25.5,204.0,775997.68,,Lisset Limpio -020,Cafeteria,1380976,Jun
2023-06-19,El Palacio de los jugos / Delicias Criollas (DIAGO FOOD_MILLER),Invoice,008-01668,Arroz a Granel:Parboiled 50 LB -Bolsa Dos Hermanos.,,10.0,25.5,255.0,776252.68,,Lisset Limpio -020,Cafeteria,1380977,Jun
2023-06-19,Brito Family Corp.,Invoice,008-01669,Arroz a Granel:Parboiled 50 LB -Bolsa Dos Hermanos.,,60.0,24.5,1470.0,777722.68,,Lisset Limpio -020,CAFETERIA y RESTAURANTS,1380978,Jun
2023-06-19,Soriano Brothers,Invoice,008-01670,Arroz a Granel:Parboiled 50 LB -Bolsa Dos Hermanos.,,55.0,25.5,1402.5,779125.18,,Lisset Limpio -020,CAFETERIA y RESTAURANTS,1380979,Jun
2023-06-19,"Virtue Distributor, Inc",Invoice,008-01671,Arroz a Granel:Largo Fino 50 LB -Bolsa Dos Hermanos.,,55.0,21.0,1155.0,780280.18,,Armando Carpio - 017,Distributor,1380980,Jun
2023-06-19,"Virtue Distributor, Inc",Invoice,008-01671,Arroz a Granel:Parboiled 50 LB -Bolsa Dos Hermanos.,,55.0,22.5,1237.5,781517.68,,Armando Carpio - 017,Distributor,1380981,Jun
2023-06-19,"Virtue Distributor, Inc",Invoice,008-01672,Arroz Envasado:Aromatic Type Rice Dos Hermanos.,i7OCT/I9NOV,5.0,14.5,72.5,781590.18,,Armando Carpio - 017,Distributor,1380982,Jun
2023-06-19,"Virtue Distributor, Inc",Invoice,008-01672,Arroz Envasado:Carnaroli Dos Hermanos,i5JUN,5.0,22.5,112.5,781702.68,,Armando Carpio - 017,Distributor,1380983,Jun
2023-06-19,"Virtue Distributor, Inc",Invoice,008-01672,Arroz Envasado:Organico LF Dos Hermanos,i6OCT/ i9NOV,5.0,24.0,120.0,781822.68,,Armando Carpio - 017,Distributor,1380984,Jun
2023-06-19,"American Spice Trading Co, Inc.",Credit Memo,008-01673,Arroz a Granel:Parboiled 50 LB -Bolsa Dos Hermanos.,,0.0,,0.0,781822.68,,Armando Carpio - 017,WHOLESALER MANUFACTURY,1380985,Jun
2023-06-20,El Gaitero Supermarket II,Invoice,008-01674,Arroz Envasado:Largo Fino 1kg (Long grain rice) Dos Hermanos,,10.0,16.5,165.0,781987.68,,Ruta - 019,RETAIL  DSD,1380986,Jun
2023-06-20,El Gaitero Supermarket II,Invoice,008-01674,Arroz Envasado:Largo Fino 1kg (Long grain rice) Dos Hermanos,,2.0,0.0,0.0,781987.68,,Ruta - 019,RETAIL  DSD,1380987,Jun
2023-06-20,Food Giant Market  10 Ave.,Invoice,008-01675,Arroz Envasado:Largo Fino 1kg (Long grain rice) Dos Hermanos,,5.0,16.5,82.5,782070.18,,Lisset Limpio -020,RETAIL  DSD,1380988,Jun
2023-06-20,Food Giant Market  10 Ave.,Invoice,008-01675,Arroz Envasado:Largo Fino 1kg (Long grain rice) Dos Hermanos,,1.0,0.0,0.0,782070.18,,Lisset Limpio -020,RETAIL  DSD,1380989,Jun
2023-06-20,Food Giant Market  10 Ave.,Invoice,008-01675,Arroz Envasado:Parboiled 5KG Dos Hermanos.,6 / 11lbs,5.0,38.5,192.5,782262.68,,Lisset Limpio -020,RETAIL  DSD,1380990,Jun
2023-06-20,Food Giant Market  10 Ave.,Invoice,008-01675,Arroz Envasado:Parboiled 5KG Dos Hermanos.,6 / 11lbs,1.0,0.0,0.0,782262.68,,Lisset Limpio -020,RETAIL  DSD,1380991,Jun
2023-06-20,Total Food - AE&O Supermarket Inc.,Invoice,008-01676,Arroz a Granel:Parboiled 50 LB -Bolsa Dos Hermanos.,,12.0,25.5,306.0,782568.68,,Ruta - 019,RETAIL  DSD,1380992,Jun
2023-06-20,Brito Family Corp.,Invoice,008-01677,Arroz a Granel:Parboiled 50 LB -Bolsa Dos Hermanos.,,55.0,24.5,1347.5,783916.18,,Lisset Limpio -020,CAFETERIA y RESTAURANTS,1380993,Jun
2023-06-21,Price Choice Food Market # 6,Invoice,008-01678,Arroz Envasado:Parboiled 5KG Dos Hermanos.,6 / 11lbs,25.0,38.5,962.5,784878.68,,Ruta - 019,RETAIL  DSD,1380994,Jun
2023-06-21,Price Choice Food Market # 6,Invoice,008-01678,Arroz Envasado:Parboiled 5KG Dos Hermanos.,6 / 11lbs,6.0,0.0,0.0,784878.68,,Ruta - 019,RETAIL  DSD,1380995,Jun
2023-06-21,Malaga Distributor Corp.,Invoice,008-01679,Arroz a Granel:Parboiled 50 LB -Bolsa Dos Hermanos.,,55.0,25.5,1402.5,786281.18,,Ruta - 019,RETAIL  DSD,1380996,Jun
2023-06-21,El Palacio de los jugos /  Mires Restaurants,Credit Memo,008-01680,Arroz a Granel:Largo Fino 50 LB -Bolsa Dos Hermanos.,,-1.0,21.0,-21.0,786260.18,,Lisset Limpio -020,Cafeteria,1380997,Jun
2023-06-23,El Palacio de los jugos / Lita Foods Inc.,Invoice,008-01683,Arroz a Granel:Largo Fino 50 LB -Bolsa Dos Hermanos.,,3.0,21.0,63.0,786323.18,,Lisset Limpio -020,Cafeteria,1380998,Jun
2023-06-23,El Palacio de los jugos / Lita Foods Inc.,Invoice,008-01683,Arroz a Granel:Parboiled 50 LB -Bolsa Dos Hermanos.,,10.0,25.5,255.0,786578.18,,Lisset Limpio -020,Cafeteria,1380999,Jun
2023-06-23,El Palacio de los jugos /  Mires Restaurants,Invoice,008-01684,Arroz a Granel:Parboiled 50 LB -Bolsa Dos Hermanos.,,8.0,25.5,204.0,786782.18,,Lisset Limpio -020,Cafeteria,1381000,Jun
2023-06-23,El Palacio de los jugos /  Mires Restaurants,Invoice,008-01684,Arroz a Granel:Largo Fino 50 LB -Bolsa Dos Hermanos.,,5.0,21.0,105.0,786887.18,,Lisset Limpio -020,Cafeteria,1381001,Jun
2023-06-23,El Palacio de los jugos /  EMMA FOOD CORP,Invoice,008-01685,Arroz a Granel:Parboiled 50 LB -Bolsa Dos Hermanos.,,5.0,21.0,105.0,786992.18,,Lisset Limpio -020,Cafeteria,1381002,Jun
2023-06-23,El Palacio de los jugos /  EMMA FOOD CORP,Invoice,008-01685,Arroz a Granel:Parboiled 50 LB -Bolsa Dos Hermanos.,,5.0,25.5,127.5,787119.68,,Lisset Limpio -020,Cafeteria,1381003,Jun
2023-06-23,El Palacio de Los Jugos / Casa mía Food Restaurant inc,Invoice,008-01686,Arroz a Granel:Largo Fino 50 LB -Bolsa Dos Hermanos.,,8.0,25.5,204.0,787323.68,,Lisset Limpio -020,Cafeteria,1381004,Jun
2023-06-23,El Palacio de los jugos / Caribe Tropical,Invoice,008-01687,Arroz a Granel:Largo Fino 50 LB -Bolsa Dos Hermanos.,,7.0,21.0,147.0,787470.68,,Lisset Limpio -020,Cafeteria,1381005,Jun
2023-06-23,El Palacio de los jugos / Caribe Tropical,Invoice,008-01687,Arroz a Granel:Parboiled 50 LB -Bolsa Dos Hermanos.,,7.0,25.5,178.5,787649.18,,Lisset Limpio -020,Cafeteria,1381006,Jun
2023-06-23,El Palacio de los jugos / Caribe Tropical,Invoice,008-01687,,*Inv. Corrected,,,0.0,787649.18,,Lisset Limpio -020,Cafeteria,1381007,Jun
2023-06-23,El Palacio de los jugos /  E & P Foods,Invoice,008-01688,Arroz a Granel:Parboiled 50 LB -Bolsa Dos Hermanos.,,5.0,25.5,127.5,787776.68,,Lisset Limpio -020,Cafeteria,1381008,Jun
2023-06-23,El Palacio de los jugos /  E & P Foods,Invoice,008-01688,Arroz a Granel:Largo Fino 50 LB -Bolsa Dos Hermanos.,,10.0,21.0,210.0,787986.68,,Lisset Limpio -020,Cafeteria,1381009,Jun
2023-06-23,COD Suplies,Invoice,008-01689,Arroz a Granel:Parboiled 50 LB -Bolsa Dos Hermanos.,,10.0,25.5,255.0,788241.68,,Ruta - 019,WHOLESALER,1381010,Jun
2023-06-23,Food Fair Plantation Corp,Invoice,008-01690,Arroz a Granel:Largo Fino 50 LB -Bolsa Dos Hermanos.,,20.0,21.5,430.0,788671.68,,Ruta - 019,RETAIL  DSD,1381011,Jun
2023-06-26,El Palacio de los jugos /  Mires Restaurants,Invoice,008-01691,Arroz a Granel:Parboiled 50 LB -Bolsa Dos Hermanos.,,5.0,25.5,127.5,788799.18,,Lisset Limpio -020,Cafeteria,1381012,Jun
2023-06-26,El Palacio de los jugos /  Mires Restaurants,Invoice,008-01691,Arroz a Granel:Largo Fino 50 LB -Bolsa Dos Hermanos.,,5.0,21.0,105.0,788904.18,,Lisset Limpio -020,Cafeteria,1381013,Jun
2023-06-26,El Palacio de los jugos /  EMMA FOOD CORP,Invoice,008-01692,Arroz a Granel:Parboiled 50 LB -Bolsa Dos Hermanos.,,5.0,25.5,127.5,789031.68,,Lisset Limpio -020,Cafeteria,1381014,Jun
2023-06-26,El Palacio de los jugos /  EMMA FOOD CORP,Invoice,008-01692,Arroz a Granel:Largo Fino 50 LB -Bolsa Dos Hermanos.,,5.0,21.0,105.0,789136.68,,Lisset Limpio -020,Cafeteria,1381015,Jun
2023-06-26,El Palacio de Los Jugos / Casa mía Food Restaurant inc,Invoice,008-01693,Arroz a Granel:Parboiled 50 LB -Bolsa Dos Hermanos.,,8.0,25.5,204.0,789340.68,,Lisset Limpio -020,Cafeteria,1381016,Jun
2023-06-26,El Palacio de los jugos / Lita Foods Inc.,Invoice,008-01694,Arroz a Granel:Largo Fino 50 LB -Bolsa Dos Hermanos.,,3.0,21.0,63.0,789403.68,,Lisset Limpio -020,Cafeteria,1381017,Jun
2023-06-26,El Palacio de los jugos / Lita Foods Inc.,Invoice,008-01694,Arroz a Granel:Parboiled 50 LB -Bolsa Dos Hermanos.,,10.0,25.5,255.0,789658.68,,Lisset Limpio -020,Cafeteria,1381018,Jun
2023-06-26,El Palacio de los jugos / Caribe Tropical,Invoice,008-01695,Arroz a Granel:Parboiled 50 LB -Bolsa Dos Hermanos.,,6.0,25.5,153.0,789811.68,,Lisset Limpio -020,Cafeteria,1381019,Jun
2023-06-26,El Palacio de los jugos / Caribe Tropical,Invoice,008-01695,Arroz a Granel:Largo Fino 50 LB -Bolsa Dos Hermanos.,,5.0,21.0,105.0,789916.68,,Lisset Limpio -020,Cafeteria,1381020,Jun
2023-06-26,El Palacio de los jugos / Delicias Criollas (DIAGO FOOD_MILLER),Invoice,008-01696,Arroz a Granel:Parboiled 50 LB -Bolsa Dos Hermanos.,,10.0,25.5,255.0,790171.68,,Lisset Limpio -020,Cafeteria,1381021,Jun
2023-06-26,El Palacio de los jugos / J Mena Corp.,Invoice,008-01697,Arroz a Granel:Largo Fino 50 LB -Bolsa Dos Hermanos.,,10.0,21.0,210.0,790381.68,,Lisset Limpio -020,Cafeteria,1381022,Jun
2023-06-28,"American Spice Trading Co, Inc.",Invoice,008-01698,Arroz a Granel:Parboiled 50 LB -Bolsa Dos Hermanos.,,1100.0,22.0,24200.0,814581.68,,Armando Carpio - 017,WHOLESALER MANUFACTURY,1381023,Jun
2023-06-28,"Key Food - Kabfra, LLC",Invoice,008-01700,Arroz a Granel:Largo Fino 50 LB -Bolsa Dos Hermanos.,,10.0,23.0,230.0,814811.68,,Ruta - 019,RETAIL  DSD,1381024,Jun
2023-06-28,"Key Food - Kabfra, LLC",Invoice,008-01700,Arroz Envasado:Largo Fino 1kg (Long grain rice) Dos Hermanos,,5.0,16.5,82.5,814894.18,,Ruta - 019,RETAIL  DSD,1381025,Jun
2023-06-28,"Key Food - Kabfra, LLC",Invoice,008-01700,Arroz Envasado:Largo Fino 1kg (Long grain rice) Dos Hermanos,,1.0,0.0,0.0,814894.18,,Ruta - 019,RETAIL  DSD,1381026,Jun
2023-06-28,COD Suplies,Invoice,008-01701,Arroz a Granel:Parboiled 50 LB -Bolsa Dos Hermanos.,,45.0,25.5,1147.5,816041.68,,Ruta - 019,WHOLESALER,1381027,Jun
2023-06-28,COD Suplies,Invoice,008-01701,Arroz a Granel:Largo Fino 50 LB -Bolsa Dos Hermanos.,,55.0,21.5,1182.5,817224.18,,Ruta - 019,WHOLESALER,1381028,Jun
2023-06-28,Rey Chavez Distributor Corp,Invoice,008-01702,Arroz a Granel:Parboiled 50 LB -Bolsa Dos Hermanos.,,55.0,25.0,1375.0,818599.18,,Ruta - 019,WHOLESALER,1381029,Jun
2023-06-28,Rey Chavez Distributor Corp,Invoice,008-01702,Arroz Envasado:Parboiled 5KG Dos Hermanos.,6 / 11lbs,41.0,33.0,1353.0,819952.18,,Ruta - 019,WHOLESALER,1381030,Jun
2023-06-28,Broward Meat & Fish,Invoice,008-01703,Arroz Envasado:Sushi Rice Dos Hermanos 5kg.,,6.0,10.0,60.0,820012.18,,Ruta - 019,RETAIL  DSD,1381031,Jun
2023-06-28,Broward Meat & Fish,Invoice,008-01703,Arroz Envasado:Sushi Rice Dos Hermanos.,.,2.0,20.0,40.0,820052.18,,Ruta - 019,RETAIL  DSD,1381032,Jun
2023-06-28,Albert Deli #2,Invoice,008-01704,Arroz a Granel:Largo Fino 50 LB -Bolsa Dos Hermanos.,,8.0,23.0,184.0,820236.18,,Ruta - 019,CAFETERIA y RESTAURANTS,1381033,Jun
2023-06-28,Albert Deli #2,Invoice,008-01704,Arroz a Granel:Parboiled 50 LB -Bolsa Dos Hermanos.,,2.0,28.0,56.0,820292.18,,Ruta - 019,CAFETERIA y RESTAURANTS,1381034,Jun
2023-06-28,Albert Deli #2,Invoice,008-01704,Rice Snack:Rice Snack Grilled Smoked Meat Flavored DOS HERMANOS,H9,1.0,0.0,0.0,820292.18,,Ruta - 019,CAFETERIA y RESTAURANTS,1381035,Jun
2023-06-28,Albert Deli #2,Invoice,008-01704,Rice Snack:Rice Snack Cheese Flavored DOS HERMANOS,H10/H20,1.0,0.0,0.0,820292.18,,Ruta - 019,CAFETERIA y RESTAURANTS,1381036,Jun
2023-06-28,Albert Deli #2,Invoice,008-01704,Rice Snack:Rice Snack Ham Flavored DOS HERMANOS,,1.0,0.0,0.0,820292.18,,Ruta - 019,CAFETERIA y RESTAURANTS,1381037,Jun
2023-06-28,Albert Deli #2,Invoice,008-01704,Rice Snack:Rice Snack Cheese Flavored DOS HERMANOS,H10/H20,-1.0,0.0,0.0,820292.18,,Ruta - 019,CAFETERIA y RESTAURANTS,1381038,Jun
2023-06-28,Albert Deli #2,Invoice,008-01704,Rice Snack:Rice Snack Ham Flavored DOS HERMANOS,,-1.0,0.0,0.0,820292.18,,Ruta - 019,CAFETERIA y RESTAURANTS,1381039,Jun
2023-06-29,"American Spice Trading Co, Inc.",Invoice,008-01705,Arroz a Granel:Parboiled 50 LB -Bolsa Dos Hermanos.,,400.0,22.0,8800.0,829092.18,,Armando Carpio - 017,WHOLESALER MANUFACTURY,1381040,Jun
2023-06-30,El Palacio de los jugos /  E & P Foods,Invoice,008-01706,Arroz a Granel:Largo Fino 50 LB -Bolsa Dos Hermanos.,,10.0,21.0,210.0,829302.18,,Lisset Limpio -020,Cafeteria,1381041,Jun
2023-06-30,El Palacio de los jugos /  E & P Foods,Invoice,008-01706,Arroz a Granel:Parboiled 50 LB -Bolsa Dos Hermanos.,,20.0,25.5,510.0,829812.18,,Lisset Limpio -020,Cafeteria,1381042,Jun
2023-06-30,El Palacio de los jugos /  E & P Foods,Invoice,008-01706,Liquids:AS Marinating Sauce (Mojo),,4.0,20.0,80.0,829892.18,,Lisset Limpio -020,Cafeteria,1381043,Jun
2023-06-30,El Palacio de los jugos / Lita Foods Inc.,Invoice,008-01707,Arroz a Granel:Largo Fino 50 LB -Bolsa Dos Hermanos.,,3.0,21.0,63.0,829955.18,,Lisset Limpio -020,Cafeteria,1381044,Jun
2023-06-30,El Palacio de los jugos / Lita Foods Inc.,Invoice,008-01707,Arroz a Granel:Parboiled 50 LB -Bolsa Dos Hermanos.,,8.0,25.5,204.0,830159.18,,Lisset Limpio -020,Cafeteria,1381045,Jun
2023-06-30,El Palacio de los jugos / Lita Foods Inc.,Invoice,008-01707,Arroz a Granel:Largo Fino 50 LB -Bolsa Dos Hermanos.,S/Inv Firmada,1.0,21.0,21.0,830180.18,,Lisset Limpio -020,Cafeteria,1381046,Jun
2023-06-30,El Palacio de los jugos / Sahilys Cafe,Invoice,008-01708,Arroz a Granel:Parboiled 50 LB -Bolsa Dos Hermanos.,,1.0,0.01,0.01,830180.19,,Lisset Limpio -020,Cafeteria,1381047,Jun
2023-06-30,Soriano Brothers PB,Invoice,008-01709,Rice Snack:Rice Snack Grilled Smoked Meat Flavored DOS HERMANOS,H9,1.0,0.01,0.01,830180.2,,Lisset Limpio -020,CAFETERIA y RESTAURANTS,1381048,Jun
2023-06-30,Soriano Brothers PB,Invoice,008-01709,Rice Snack:Rice Snack Ham Flavored DOS HERMANOS,,1.0,0.0,0.0,830180.2,,Lisset Limpio -020,CAFETERIA y RESTAURANTS,1381049,Jun
2023-06-30,Soriano Brothers PB,Invoice,008-01709,Rice Snack:Rice Snack Salami Flavored DOS HERMANOS,,1.0,0.0,0.0,830180.2,,Lisset Limpio -020,CAFETERIA y RESTAURANTS,1381050,Jun
2023-06-30,Soriano Brothers PB,Invoice,008-01709,"Rice Snack:Rice Snack, Sour Cream & Onion DOS HERMANOS",H8,1.0,0.0,0.0,830180.2,,Lisset Limpio -020,CAFETERIA y RESTAURANTS,1381051,Jun
2023-06-30,El Palacio de los jugos / Santa Clara Sabor,Invoice,008-01710,Arroz a Granel:Parboiled 50 LB -Bolsa Dos Hermanos.,,1.0,0.01,0.01,830180.21,,Lisset Limpio -020,Cafeteria,1381052,Jun
2023-06-30,El Palacio de los jugos / Caribe Tropical,Invoice,008-01711,Arroz a Granel:Parboiled 50 LB -Bolsa Dos Hermanos.,,8.0,25.5,204.0,830384.21,,Lisset Limpio -020,Cafeteria,1381053,Jun
2023-06-30,El Palacio de los jugos / Caribe Tropical,Invoice,008-01711,Arroz a Granel:Largo Fino 50 LB -Bolsa Dos Hermanos.,,6.0,21.0,126.0,830510.21,,Lisset Limpio -020,Cafeteria,1381054,Jun
2023-06-30,Soriano Brothers PB,Invoice,008-01712,Arroz a Granel:Largo Fino 50 LB -Bolsa Dos Hermanos.,,7.0,21.0,147.0,830657.21,,Lisset Limpio -020,CAFETERIA y RESTAURANTS,1381055,Jun
2023-06-30,Soriano Brothers PB,Invoice,008-01712,Arroz a Granel:Parboiled 50 LB -Bolsa Dos Hermanos.,,10.0,25.5,255.0,830912.21,,Lisset Limpio -020,CAFETERIA y RESTAURANTS,1381056,Jun
2023-06-30,El Palacio de los jugos /  EMMA FOOD CORP,Invoice,008-01713,Arroz a Granel:Parboiled 50 LB -Bolsa Dos Hermanos.,,10.0,25.5,255.0,831167.21,,Lisset Limpio -020,Cafeteria,1381057,Jun
2023-06-30,El Palacio de los jugos / Delicias Criollas (DIAGO FOOD_MILLER),Invoice,008-01714,Arroz a Granel:Parboiled 50 LB -Bolsa Dos Hermanos.,,10.0,25.5,255.0,831422.21,,Lisset Limpio -020,Cafeteria,1381058,Jun
2023-06-30,El Palacio de Los Jugos / Casa mía Food Restaurant inc,Invoice,008-01715,Arroz a Granel:Parboiled 50 LB -Bolsa Dos Hermanos.,,15.0,25.5,382.5,831804.71,,Lisset Limpio -020,Cafeteria,1381059,Jun
2023-06-30,Total Food - AE&O Supermarket Inc.,Invoice,008-01716,Arroz a Granel:Parboiled 50 LB -Bolsa Dos Hermanos.,,12.0,25.5,306.0,832110.71,,Ruta - 019,RETAIL  DSD,1381060,Jun
2023-07-02,El Palacio de los jugos /  Mires Restaurants,Invoice,008-01717,Arroz a Granel:Parboiled 50 LB -Bolsa Dos Hermanos.,,8.0,25.5,204.0,832314.71,,Lisset Limpio -020,Cafeteria,1381061,Jul
2023-07-02,El Palacio de Los Jugos / Casa mía Food Restaurant inc,Invoice,008-01718,Arroz a Granel:Parboiled 50 LB -Bolsa Dos Hermanos.,,6.0,25.5,153.0,832467.71,,Lisset Limpio -020,Cafeteria,1381062,Jul
2023-07-02,Soriano Brothers,Invoice,008-01719,Arroz a Granel:Parboiled 50 LB -Bolsa Dos Hermanos.,,55.0,25.5,1402.5,833870.21,,Lisset Limpio -020,CAFETERIA y RESTAURANTS,1381063,Jul
2023-07-02,El Palacio de los jugos / Lita Foods Inc.,Invoice,008-01720,Arroz a Granel:Parboiled 50 LB -Bolsa Dos Hermanos.,,15.0,25.5,382.5,834252.71,,Lisset Limpio -020,Cafeteria,1381064,Jul
2023-07-02,El Palacio de los jugos / Caribe Tropical,Invoice,008-01721,Arroz a Granel:Largo Fino 50 LB -Bolsa Dos Hermanos.,,6.0,21.0,126.0,834378.71,,Lisset Limpio -020,Cafeteria,1381065,Jul
2023-07-02,El Palacio de los jugos / Caribe Tropical,Invoice,008-01721,Arroz a Granel:Parboiled 50 LB -Bolsa Dos Hermanos.,,6.0,25.5,153.0,834531.71,,Lisset Limpio -020,Cafeteria,1381066,Jul
2023-07-02,El Palacio de los jugos /  EMMA FOOD CORP,Invoice,008-01722,Arroz a Granel:Largo Fino 50 LB -Bolsa Dos Hermanos.,,5.0,21.0,105.0,834636.71,,Lisset Limpio -020,Cafeteria,1381067,Jul
2023-07-02,El Palacio de los jugos /  EMMA FOOD CORP,Invoice,008-01722,Arroz a Granel:Parboiled 50 LB -Bolsa Dos Hermanos.,,10.0,25.5,255.0,834891.71,,Lisset Limpio -020,Cafeteria,1381068,Jul
2023-07-02,El Palacio de los jugos / Santa Clara Sabor,Invoice,008-01723,Arroz a Granel:Largo Fino 50 LB -Bolsa Dos Hermanos.,,10.0,21.0,210.0,835101.71,,Lisset Limpio -020,Cafeteria,1381069,Jul
2023-07-02,Ideal Food Basket Davie Cafeteria,Invoice,008-01724,Arroz a Granel:Largo Fino 50 LB -Bolsa Dos Hermanos.,,8.0,23.0,184.0,835285.71,,Ruta - 019,CAFETERIA y RESTAURANTS,1381070,Jul
2023-07-03,El Palacio de los jugos / Sahilys Cafe,Invoice,008-01725,Arroz a Granel:Parboiled 50 LB -Bolsa Dos Hermanos.,,5.0,25.5,127.5,835413.21,,Lisset Limpio -020,Cafeteria,1381071,Jul
2023-07-03,El Palacio de los jugos / Sahilys Cafe,Invoice,008-01725,Arroz a Granel:Largo Fino 50 LB -Bolsa Dos Hermanos.,,1.0,21.0,21.0,835434.21,,Lisset Limpio -020,Cafeteria,1381072,Jul
2023-07-05,Soriano Brothers,Invoice,008-01726,Arroz a Granel:Largo Fino 50 LB -Bolsa Dos Hermanos.,,25.0,21.0,525.0,835959.21,,Lisset Limpio -020,CAFETERIA y RESTAURANTS,1381073,Jul
2023-07-05,Miavana & Family,Invoice,008-01727,Arroz a Granel:Parboiled 50 LB -Bolsa Dos Hermanos.,,220.0,21.5,4730.0,840689.21,,Armando Carpio - 017,Distributor,1381074,Jul
2023-07-05,El Palacio de los jugos / Delicias Criollas (DIAGO FOOD_MILLER),Invoice,008-01728,Arroz a Granel:Parboiled 50 LB -Bolsa Dos Hermanos.,,16.0,25.5,408.0,841097.21,,Lisset Limpio -020,Cafeteria,1381075,Jul
2023-07-05,Sorianos Brothers,Invoice,008-01729,Arroz a Granel:Largo Fino 50 LB -Bolsa Dos Hermanos.,,30.0,21.0,630.0,841727.21,,Lisset Limpio -020,CAFETERIA y RESTAURANTS,1381076,Jul
2023-07-05,Key Foods  / Ivan,Invoice,008-01730,Arroz Envasado:Parboiled 5KG Dos Hermanos.,6 / 11lbs,10.0,38.5,385.0,842112.21,,Lisset Limpio -020,RETAIL  DSD,1381077,Jul
2023-07-05,Key Foods  / Ivan,Invoice,008-01730,Arroz Envasado:Parboiled 5KG Dos Hermanos.,6 / 11lbs,2.0,0.0,0.0,842112.21,,Lisset Limpio -020,RETAIL  DSD,1381078,Jul
2023-07-05,Key Foods  / Ivan,Invoice,008-01730,Arroz a Granel:Largo Fino 50 LB -Bolsa Dos Hermanos.,,2.0,21.0,42.0,842154.21,,Lisset Limpio -020,RETAIL  DSD,1381079,Jul
2023-07-06,El Palacio de los jugos /  E & P Foods,Invoice,008-01731,Arroz a Granel:Parboiled 50 LB -Bolsa Dos Hermanos.,,15.0,25.5,382.5,842536.71,,Lisset Limpio -020,Cafeteria,1381080,Jul
2023-07-06,El Palacio de los jugos /  E & P Foods,Invoice,008-01731,Arroz a Granel:Largo Fino 50 LB -Bolsa Dos Hermanos.,,10.0,21.0,210.0,842746.71,,Lisset Limpio -020,Cafeteria,1381081,Jul
2023-07-06,El Palacio de los jugos / Caribe Tropical,Invoice,008-01732,Arroz a Granel:Parboiled 50 LB -Bolsa Dos Hermanos.,,10.0,25.5,255.0,843001.71,,Lisset Limpio -020,Cafeteria,1381082,Jul
2023-07-06,El Palacio de los jugos / Caribe Tropical,Invoice,008-01732,Arroz a Granel:Largo Fino 50 LB -Bolsa Dos Hermanos.,,6.0,21.0,126.0,843127.71,,Lisset Limpio -020,Cafeteria,1381083,Jul
2023-07-06,El Palacio de los jugos /  EMMA FOOD CORP,Invoice,008-01733,Arroz a Granel:Parboiled 50 LB -Bolsa Dos Hermanos.,,10.0,25.5,255.0,843382.71,,Lisset Limpio -020,Cafeteria,1381084,Jul
2023-07-06,El Palacio de los jugos /  EMMA FOOD CORP,Invoice,008-01733,Arroz a Granel:Largo Fino 50 LB -Bolsa Dos Hermanos.,,4.0,21.0,84.0,843466.71,,Lisset Limpio -020,Cafeteria,1381085,Jul
2023-07-06,El Palacio de los jugos / J Mena Corp.,Invoice,008-01734,Arroz a Granel:Largo Fino 50 LB -Bolsa Dos Hermanos.,,10.0,21.0,210.0,843676.71,,Lisset Limpio -020,Cafeteria,1381086,Jul
2023-07-06,El Palacio de los jugos / Sahilys Cafe,Invoice,008-01735,Arroz a Granel:Largo Fino 50 LB -Bolsa Dos Hermanos.,,4.0,21.0,84.0,843760.71,,Lisset Limpio -020,Cafeteria,1381087,Jul
2023-07-06,El Palacio de los jugos / Sahilys Cafe,Invoice,008-01735,Arroz a Granel:Parboiled 50 LB -Bolsa Dos Hermanos.,,10.0,25.5,255.0,844015.71,,Lisset Limpio -020,Cafeteria,1381088,Jul
2023-07-06,El Palacio de los jugos / Lita Foods Inc.,Invoice,008-01736,Arroz a Granel:Parboiled 50 LB -Bolsa Dos Hermanos.,,5.0,25.5,127.5,844143.21,,Lisset Limpio -020,Cafeteria,1381089,Jul
2023-07-06,El Palacio de los jugos / Lita Foods Inc.,Invoice,008-01736,Arroz a Granel:Largo Fino 50 LB -Bolsa Dos Hermanos.,,3.0,21.0,63.0,844206.21,,Lisset Limpio -020,Cafeteria,1381090,Jul
2023-07-06,"El Toro Loco Meat Distribution, LLC",Invoice,008-01737,Arroz a Granel:Largo Fino 50 LB -Bolsa Dos Hermanos.,,55.0,20.5,1127.5,845333.71,,Lisset Limpio -020,CAFETERIA y RESTAURANTS,1381091,Jul
2023-07-09,El Palacio de los jugos / Santa Clara Sabor,Invoice,008-01738,Arroz a Granel:Largo Fino 50 LB -Bolsa Dos Hermanos.,,10.0,21.0,210.0,845543.71,,Lisset Limpio -020,Cafeteria,1381092,Jul
2023-07-09,El Palacio de los jugos / Santa Clara Sabor,Invoice,008-01738,Arroz a Granel:Parboiled 50 LB -Bolsa Dos Hermanos.,,2.0,25.5,51.0,845594.71,,Lisset Limpio -020,Cafeteria,1381093,Jul
2023-07-09,El Palacio de los jugos /  EMMA FOOD CORP,Invoice,008-01739,Arroz a Granel:Largo Fino 50 LB -Bolsa Dos Hermanos.,,5.0,21.0,105.0,845699.71,,Lisset Limpio -020,Cafeteria,1381094,Jul
2023-07-09,El Palacio de los jugos / Caribe Tropical,Invoice,008-01740,Arroz a Granel:Parboiled 50 LB -Bolsa Dos Hermanos.,,7.0,25.5,178.5,845878.21,,Lisset Limpio -020,Cafeteria,1381095,Jul
2023-07-09,El Palacio de los jugos / Caribe Tropical,Invoice,008-01740,Arroz a Granel:Largo Fino 50 LB -Bolsa Dos Hermanos.,,5.0,21.0,105.0,845983.21,,Lisset Limpio -020,Cafeteria,1381096,Jul
2023-07-09,Soriano Brothers PB,Invoice,008-01741,Arroz a Granel:Largo Fino 50 LB -Bolsa Dos Hermanos.,,5.0,21.0,105.0,846088.21,,Lisset Limpio -020,CAFETERIA y RESTAURANTS,1381097,Jul
2023-07-09,Soriano Brothers PB,Invoice,008-01741,Arroz a Granel:Parboiled 50 LB -Bolsa Dos Hermanos.,,7.0,25.5,178.5,846266.71,,Lisset Limpio -020,CAFETERIA y RESTAURANTS,1381098,Jul
2023-07-09,El Palacio de los jugos / Sahilys Cafe,Invoice,008-01742,Arroz a Granel:Largo Fino 50 LB -Bolsa Dos Hermanos.,,15.0,21.0,315.0,846581.71,,Lisset Limpio -020,Cafeteria,1381099,Jul
2023-07-09,El Palacio de los jugos /  Mires Restaurants,Invoice,008-01743,Arroz a Granel:Parboiled 50 LB -Bolsa Dos Hermanos.,,10.0,25.5,255.0,846836.71,,Lisset Limpio -020,Cafeteria,1381100,Jul
2023-07-09,El Palacio de los jugos /  Mires Restaurants,Invoice,008-01743,Arroz a Granel:Largo Fino 50 LB -Bolsa Dos Hermanos.,,6.0,21.0,126.0,846962.71,,Lisset Limpio -020,Cafeteria,1381101,Jul
2023-07-09,El Palacio de los jugos / Lita Foods Inc.,Invoice,008-01744,Arroz a Granel:Parboiled 50 LB -Bolsa Dos Hermanos.,,7.0,25.5,178.5,847141.21,,Lisset Limpio -020,Cafeteria,1381102,Jul
2023-07-09,El Palacio de los jugos / Lita Foods Inc.,Invoice,008-01744,Arroz a Granel:Largo Fino 50 LB -Bolsa Dos Hermanos.,,3.0,21.0,63.0,847204.21,,Lisset Limpio -020,Cafeteria,1381103,Jul
2023-07-09,Key Foods  / Ivan,Invoice,008-01745,Arroz a Granel:Largo Fino 50 LB -Bolsa Dos Hermanos.,,25.0,21.0,525.0,847729.21,,Lisset Limpio -020,RETAIL  DSD,1381104,Jul
2023-07-12,Global Distributors,Invoice,008-01746,Arroz a Granel:Largo Fino 50 LB -Bolsa Dos Hermanos.,,220.0,21.5,4730.0,852459.21,,Ruta - 019,CAFETERIA y RESTAURANTS,1381105,Jul
2023-07-12,Los paraditos chinesse,Invoice,008-01747,Arroz a Granel:Parboiled 50 LB -Bolsa Dos Hermanos.,,10.0,25.0,250.0,852709.21,,Lisset Limpio -020,CAFETERIA y RESTAURANTS,1381106,Jul
2023-07-12,Los paraditos chinesse,Invoice,008-01747,Arroz a Granel:Largo Fino 50 LB -Bolsa Dos Hermanos.,,5.0,21.0,105.0,852814.21,,Lisset Limpio -020,CAFETERIA y RESTAURANTS,1381107,Jul
2023-07-12,Foodtown Supermarket,Invoice,008-01748,Arroz a Granel:Parboiled 50 LB -Bolsa Dos Hermanos.,,10.0,28.0,280.0,853094.21,,Ruta - 019,CAFETERIA y RESTAURANTS,1381108,Jul
2023-07-12,Foodtown Supermarket,Invoice,008-01748,Arroz Envasado:Parboiled 5KG Dos Hermanos.,6 / 11lbs,25.0,39.5,987.5,854081.71,,Ruta - 019,CAFETERIA y RESTAURANTS,1381109,Jul
2023-07-12,Foodtown Supermarket,Invoice,008-01748,Arroz Envasado:Parboiled 5KG Dos Hermanos.,6 / 11lbs,6.0,0.0,0.0,854081.71,,Ruta - 019,CAFETERIA y RESTAURANTS,1381110,Jul
2023-07-13,Amerifood,Invoice,008-01749,Arroz Envasado:Parboiled 1kg Bolsa Dos Hermanos.,.,120.0,15.5,1860.0,855941.71,,Ruta - 019,WHOLESALER,1381111,Jul
2023-07-13,Amerifood,Invoice,008-01749,Arroz Envasado:Largo Fino 1kg (Long grain rice) Dos Hermanos,,120.0,13.5,1620.0,857561.71,,Ruta - 019,WHOLESALER,1381112,Jul
2023-07-13,El Palacio de los jugos / Lita Foods Inc.,Invoice,008-01750,Arroz a Granel:Largo Fino 50 LB -Bolsa Dos Hermanos.,,5.0,21.0,105.0,857666.71,,Lisset Limpio -020,Cafeteria,1381113,Jul
2023-07-13,El Palacio de los jugos / Lita Foods Inc.,Invoice,008-01750,Arroz a Granel:Parboiled 50 LB -Bolsa Dos Hermanos.,,10.0,25.5,255.0,857921.71,,Lisset Limpio -020,Cafeteria,1381114,Jul
2023-07-13,El Palacio de los jugos /  E & P Foods,Invoice,008-01751,Arroz a Granel:Parboiled 50 LB -Bolsa Dos Hermanos.,,12.0,25.5,306.0,858227.71,,Lisset Limpio -020,Cafeteria,1381115,Jul
2023-07-13,El Palacio de los jugos /  E & P Foods,Invoice,008-01751,Arroz a Granel:Largo Fino 50 LB -Bolsa Dos Hermanos.,,10.0,21.0,210.0,858437.71,,Lisset Limpio -020,Cafeteria,1381116,Jul
2023-07-13,El Palacio de los jugos / Delicias Criollas (DIAGO FOOD_MILLER),Invoice,008-01752,Arroz a Granel:Parboiled 50 LB -Bolsa Dos Hermanos.,,15.0,25.5,382.5,858820.21,,Lisset Limpio -020,Cafeteria,1381117,Jul
2023-07-13,El Palacio de los jugos / Caribe Tropical,Invoice,008-01753,Arroz a Granel:Largo Fino 50 LB -Bolsa Dos Hermanos.,,5.0,21.0,105.0,858925.21,,Lisset Limpio -020,Cafeteria,1381118,Jul
2023-07-13,El Palacio de los jugos / Caribe Tropical,Invoice,008-01753,Arroz a Granel:Parboiled 50 LB -Bolsa Dos Hermanos.,,6.0,25.5,153.0,859078.21,,Lisset Limpio -020,Cafeteria,1381119,Jul
2023-07-13,El Palacio de los jugos /  EMMA FOOD CORP,Invoice,008-01754,Arroz a Granel:Largo Fino 50 LB -Bolsa Dos Hermanos.,,5.0,21.0,105.0,859183.21,,Lisset Limpio -020,Cafeteria,1381120,Jul
2023-07-13,El Palacio de los jugos /  EMMA FOOD CORP,Invoice,008-01754,Arroz a Granel:Parboiled 50 LB -Bolsa Dos Hermanos.,,1.0,25.5,25.5,859208.71,,Lisset Limpio -020,Cafeteria,1381121,Jul
2023-07-13,El Palacio de los jugos / Santa Clara Sabor,Invoice,008-01755,Arroz a Granel:Largo Fino 50 LB -Bolsa Dos Hermanos.,,10.0,21.0,210.0,859418.71,,Lisset Limpio -020,Cafeteria,1381122,Jul
2023-07-17,El Palacio de los jugos / Lita Foods Inc.,Invoice,008-01756,Arroz a Granel:Largo Fino 50 LB -Bolsa Dos Hermanos.,,3.0,21.0,63.0,859481.71,,Lisset Limpio -020,Cafeteria,1381123,Jul
2023-07-17,El Palacio de los jugos / Lita Foods Inc.,Invoice,008-01756,Arroz a Granel:Parboiled 50 LB -Bolsa Dos Hermanos.,,7.0,25.5,178.5,859660.21,,Lisset Limpio -020,Cafeteria,1381124,Jul
2023-07-17,El Palacio de los jugos /  Mires Restaurants,Invoice,008-01757,Arroz a Granel:Largo Fino 50 LB -Bolsa Dos Hermanos.,,5.0,21.0,105.0,859765.21,,Lisset Limpio -020,Cafeteria,1381125,Jul
2023-07-17,El Palacio de los jugos /  Mires Restaurants,Invoice,008-01757,Arroz a Granel:Parboiled 50 LB -Bolsa Dos Hermanos.,,6.0,25.5,153.0,859918.21,,Lisset Limpio -020,Cafeteria,1381126,Jul
2023-07-17,El Palacio de los jugos / Caribe Tropical,Invoice,008-01758,Arroz a Granel:Largo Fino 50 LB -Bolsa Dos Hermanos.,,7.0,21.0,147.0,860065.21,,Lisset Limpio -020,Cafeteria,1381127,Jul
2023-07-17,El Palacio de los jugos / Caribe Tropical,Invoice,008-01758,Arroz a Granel:Parboiled 50 LB -Bolsa Dos Hermanos.,,10.0,25.5,255.0,860320.21,,Lisset Limpio -020,Cafeteria,1381128,Jul
2023-07-17,El Palacio de los jugos /  EMMA FOOD CORP,Invoice,008-01759,Arroz a Granel:Largo Fino 50 LB -Bolsa Dos Hermanos.,,7.0,21.0,147.0,860467.21,,Lisset Limpio -020,Cafeteria,1381129,Jul
2023-07-17,Amerifood,Invoice,008-01760,Arroz a Granel:Largo Fino 50 LB -Bolsa Dos Hermanos.,,55.0,21.5,1182.5,861649.71,,Ruta - 019,WHOLESALER,1381130,Jul
2023-07-18,Key Food Weston,Invoice,008-01761,Arroz Envasado:Parboiled 5KG Dos Hermanos.,6 / 11lbs,10.0,39.5,395.0,862044.71,,Lisset Limpio -020,RETAIL  DSD,1381131,Jul
2023-07-18,Key Food Weston,Invoice,008-01761,Arroz Envasado:Parboiled 5KG Dos Hermanos.,6 / 11lbs,2.0,0.0,0.0,862044.71,,Lisset Limpio -020,RETAIL  DSD,1381132,Jul
2023-07-18,Soriano Brothers PB,Invoice,008-01762,Arroz a Granel:Parboiled 50 LB -Bolsa Dos Hermanos.,,10.0,25.5,255.0,862299.71,,Lisset Limpio -020,CAFETERIA y RESTAURANTS,1381133,Jul
2023-07-18,Soriano Brothers PB,Invoice,008-01762,Arroz a Granel:Largo Fino 50 LB -Bolsa Dos Hermanos.,,10.0,21.0,210.0,862509.71,,Lisset Limpio -020,CAFETERIA y RESTAURANTS,1381134,Jul
2023-07-18,Sorianos Brothers,Invoice,008-01763,Arroz a Granel:Parboiled 50 LB -Bolsa Dos Hermanos.,,25.0,25.5,637.5,863147.21,,Lisset Limpio -020,CAFETERIA y RESTAURANTS,1381135,Jul
2023-07-18,Soriano Brothers,Invoice,008-01764,Arroz a Granel:Parboiled 50 LB -Bolsa Dos Hermanos.,,30.0,25.5,765.0,863912.21,,Lisset Limpio -020,CAFETERIA y RESTAURANTS,1381136,Jul
2023-07-18,El Palacio de los jugos / J Mena Corp.,Invoice,008-01765,Arroz a Granel:Largo Fino 50 LB -Bolsa Dos Hermanos.,,10.0,21.0,210.0,864122.21,,Lisset Limpio -020,Cafeteria,1381137,Jul
2023-07-18,El Palacio de los jugos / J Mena Corp.,Invoice,008-01765,Spices:AS Whole Bay Leaves,4/12 OZ,1.0,28.0,28.0,864150.21,,Lisset Limpio -020,Cafeteria,1381138,Jul
2023-07-18,El Palacio de los jugos / J Mena Corp.,Invoice,008-01765,Spices:AS Cumin Ground,4 / 4 lb,1.0,50.25,50.25,864200.46,,Lisset Limpio -020,Cafeteria,1381139,Jul
2023-07-19,"Almendares Courier Solutions, Inc.",Invoice,008-01766,Arroz a Granel:Largo Fino 50 LB -Bolsa Dos Hermanos.,,880.0,21.0,18480.0,882680.46,,Armando Carpio - 017,WHOLESALER,1381140,Jul
2023-07-21,Total Food - AE&O Supermarket Inc.,Invoice,008-01767,Arroz a Granel:Parboiled 50 LB -Bolsa Dos Hermanos.,,14.0,25.5,357.0,883037.46,,Ruta - 019,RETAIL  DSD,1381141,Jul
2023-07-21,El Palacio de los jugos /  EMMA FOOD CORP,Invoice,008-01768,Arroz a Granel:Largo Fino 50 LB -Bolsa Dos Hermanos.,,4.0,21.0,84.0,883121.46,,Lisset Limpio -020,Cafeteria,1381142,Jul
2023-07-21,El Palacio de los jugos /  EMMA FOOD CORP,Invoice,008-01768,Arroz a Granel:Parboiled 50 LB -Bolsa Dos Hermanos.,,6.0,25.5,153.0,883274.46,,Lisset Limpio -020,Cafeteria,1381143,Jul
2023-07-21,El Palacio de los jugos / Caribe Tropical,Invoice,008-01770,Arroz a Granel:Largo Fino 50 LB -Bolsa Dos Hermanos.,,5.0,21.0,105.0,883379.46,,Lisset Limpio -020,Cafeteria,1381144,Jul
2023-07-21,El Palacio de los jugos / Caribe Tropical,Invoice,008-01770,Arroz a Granel:Parboiled 50 LB -Bolsa Dos Hermanos.,,10.0,25.5,255.0,883634.46,,Lisset Limpio -020,Cafeteria,1381145,Jul
2023-07-21,El Palacio de los jugos / Sahilys Cafe,Invoice,008-01771,Arroz a Granel:Largo Fino 50 LB -Bolsa Dos Hermanos.,,5.0,21.0,105.0,883739.46,,Lisset Limpio -020,Cafeteria,1381146,Jul
2023-07-21,El Palacio de los jugos / Sahilys Cafe,Invoice,008-01771,Arroz a Granel:Parboiled 50 LB -Bolsa Dos Hermanos.,,1.0,25.5,25.5,883764.96,,Lisset Limpio -020,Cafeteria,1381147,Jul
2023-07-21,El Palacio de los jugos / Delicias Criollas (DIAGO FOOD_MILLER),Invoice,008-01772,Arroz a Granel:Parboiled 50 LB -Bolsa Dos Hermanos.,,15.0,25.5,382.5,884147.46,,Lisset Limpio -020,Cafeteria,1381148,Jul
2023-07-21,Los paraditos chinesse,Invoice,008-01773,Arroz a Granel:Largo Fino 50 LB -Bolsa Dos Hermanos.,,10.0,21.0,210.0,884357.46,,Lisset Limpio -020,CAFETERIA y RESTAURANTS,1381149,Jul
2023-07-21,Los paraditos chinesse,Invoice,008-01773,Arroz a Granel:Parboiled 50 LB -Bolsa Dos Hermanos.,,5.0,25.5,127.5,884484.96,,Lisset Limpio -020,CAFETERIA y RESTAURANTS,1381150,Jul
2023-07-21,La Perla Del Sur,Invoice,008-01774,Arroz a Granel:Largo Fino 50 LB -Bolsa Dos Hermanos.,,5.0,21.0,105.0,884589.96,,Lisset Limpio -020,CAFETERIA y RESTAURANTS,1381151,Jul
2023-07-21,La Perla Del Sur,Invoice,008-01774,Arroz a Granel:Parboiled 50 LB -Bolsa Dos Hermanos.,,5.0,25.5,127.5,884717.46,,Lisset Limpio -020,CAFETERIA y RESTAURANTS,1381152,Jul
2023-07-21,El Palacio de los jugos / Lita Foods Inc.,Invoice,008-01775,Arroz a Granel:Parboiled 50 LB -Bolsa Dos Hermanos.,,7.0,25.5,178.5,884895.96,,Lisset Limpio -020,Cafeteria,1381153,Jul
2023-07-21,El Palacio de los jugos / Lita Foods Inc.,Invoice,008-01775,Arroz a Granel:Largo Fino 50 LB -Bolsa Dos Hermanos.,,3.0,21.0,63.0,884958.96,,Lisset Limpio -020,Cafeteria,1381154,Jul
2023-07-21,El Palacio de los jugos / Santa Clara Sabor,Invoice,008-01776,Arroz a Granel:Largo Fino 50 LB -Bolsa Dos Hermanos.,,10.0,21.0,210.0,885168.96,,Lisset Limpio -020,Cafeteria,1381155,Jul
2023-07-23,El Palacio de los jugos /  EMMA FOOD CORP,Invoice,008-01777,Arroz a Granel:Parboiled 50 LB -Bolsa Dos Hermanos.,,8.0,21.0,168.0,885336.96,,Lisset Limpio -020,Cafeteria,1381156,Jul
2023-07-23,El Palacio de los jugos / Lita Foods Inc.,Invoice,008-01778,Arroz a Granel:Largo Fino 50 LB -Bolsa Dos Hermanos.,,3.0,21.0,63.0,885399.96,,Lisset Limpio -020,Cafeteria,1381157,Jul
2023-07-23,El Palacio de los jugos / Lita Foods Inc.,Invoice,008-01778,Arroz a Granel:Parboiled 50 LB -Bolsa Dos Hermanos.,,8.0,25.5,204.0,885603.96,,Lisset Limpio -020,Cafeteria,1381158,Jul
2023-07-23,El Palacio de los jugos / Sahilys Cafe,Invoice,008-01779,Arroz a Granel:Largo Fino 50 LB -Bolsa Dos Hermanos.,,6.0,21.0,126.0,885729.96,,Lisset Limpio -020,Cafeteria,1381159,Jul
2023-07-23,El Palacio de los jugos / J Mena Corp.,Invoice,008-01780,Arroz a Granel:Largo Fino 50 LB -Bolsa Dos Hermanos.,,10.0,21.0,210.0,885939.96,,Lisset Limpio -020,Cafeteria,1381160,Jul
2023-07-23,El Palacio de los jugos /  Mires Restaurants,Invoice,008-01781,Arroz a Granel:Parboiled 50 LB -Bolsa Dos Hermanos.,,6.0,25.5,153.0,886092.96,,Lisset Limpio -020,Cafeteria,1381161,Jul
2023-07-23,El Palacio de los jugos / Caribe Tropical,Invoice,008-01782,Arroz a Granel:Largo Fino 50 LB -Bolsa Dos Hermanos.,,5.0,21.0,105.0,886197.96,,Lisset Limpio -020,Cafeteria,1381162,Jul
2023-07-23,El Palacio de los jugos / Caribe Tropical,Invoice,008-01782,Arroz a Granel:Parboiled 50 LB -Bolsa Dos Hermanos.,,10.0,25.5,255.0,886452.96,,Lisset Limpio -020,Cafeteria,1381163,Jul
2023-07-23,El Palacio de los jugos / Santa Clara Sabor,Invoice,008-01783,Arroz a Granel:Largo Fino 50 LB -Bolsa Dos Hermanos.,,5.0,21.0,105.0,886557.96,,Lisset Limpio -020,Cafeteria,1381164,Jul
2023-07-23,El Palacio de los jugos / Santa Clara Sabor,Invoice,008-01783,Arroz a Granel:Parboiled 50 LB -Bolsa Dos Hermanos.,,1.0,25.5,25.5,886583.46,,Lisset Limpio -020,Cafeteria,1381165,Jul
2023-07-23,El Palacio de los jugos / Lita Foods Inc.,Invoice,008-01784,Arroz a Granel:Largo Fino 50 LB -Bolsa Dos Hermanos.,,1.0,21.0,21.0,886604.46,,Lisset Limpio -020,Cafeteria,1381166,Jul
2023-07-23,El Palacio de los jugos / Lita Foods Inc.,Invoice,008-01784,Arroz a Granel:Parboiled 50 LB -Bolsa Dos Hermanos.,,2.0,25.5,51.0,886655.46,,Lisset Limpio -020,Cafeteria,1381167,Jul
2023-07-23,"Virtue Distributor, Inc",Invoice,008-01785,Arroz a Granel:Largo Fino 50 LB -Bolsa Dos Hermanos.,,55.0,21.0,1155.0,887810.46,,Armando Carpio - 017,Distributor,1381168,Jul
2023-07-23,El Palacio de los jugos / Caribe Tropical,Credit Memo,008-01786,Arroz a Granel:Largo Fino 50 LB -Bolsa Dos Hermanos.,S/ INVOICE 1753,-1.0,21.0,-21.0,887789.46,,Lisset Limpio -020,Cafeteria,1381169,Jul
2023-07-25,"American Spice Trading Co, Inc.",Invoice,008-01787,Arroz a Granel:Parboiled 50 LB -Bolsa Dos Hermanos.,,1100.0,22.0,24200.0,911989.46,,Armando Carpio - 017,WHOLESALER MANUFACTURY,1381170,Jul
2023-07-27,La Ranchera Meat Market #3,Invoice,008-01788,Arroz a Granel:Largo Fino 50 LB -Bolsa Dos Hermanos.,,10.0,23.0,230.0,912219.46,,Ruta - 019,CAFETERIA y RESTAURANTS,1381171,Jul
2023-07-27,La Ranchera Meat Market #3,Invoice,008-01788,Arroz Envasado:Largo Fino 1kg (Long grain rice) Dos Hermanos,,5.0,16.5,82.5,912301.96,,Ruta - 019,CAFETERIA y RESTAURANTS,1381172,Jul
2023-07-27,La Ranchera Meat Market #3,Invoice,008-01788,Arroz Envasado:Largo Fino 1kg (Long grain rice) Dos Hermanos,,1.0,0.0,0.0,912301.96,,Ruta - 019,CAFETERIA y RESTAURANTS,1381173,Jul
2023-07-27,El Palacio de los jugos / Lita Foods Inc.,Invoice,008-01789,Arroz a Granel:Largo Fino 50 LB -Bolsa Dos Hermanos.,,4.0,21.0,84.0,912385.96,,Lisset Limpio -020,Cafeteria,1381174,Jul
2023-07-27,El Palacio de los jugos / Lita Foods Inc.,Invoice,008-01789,Arroz a Granel:Parboiled 50 LB -Bolsa Dos Hermanos.,,10.0,25.5,255.0,912640.96,,Lisset Limpio -020,Cafeteria,1381175,Jul
2023-07-27,El Palacio de los jugos / Santa Clara Sabor,Invoice,008-01790,Arroz a Granel:Largo Fino 50 LB -Bolsa Dos Hermanos.,,10.0,21.0,210.0,912850.96,,Lisset Limpio -020,Cafeteria,1381176,Jul
2023-07-27,El Palacio de los jugos / Santa Clara Sabor,Invoice,008-01790,Arroz a Granel:Parboiled 50 LB -Bolsa Dos Hermanos.,,2.0,25.5,51.0,912901.96,,Lisset Limpio -020,Cafeteria,1381177,Jul
2023-07-27,El Palacio de Los Jugos / Casa mía Food Restaurant inc,Invoice,008-01791,Arroz a Granel:Parboiled 50 LB -Bolsa Dos Hermanos.,,12.0,25.5,306.0,913207.96,,Lisset Limpio -020,Cafeteria,1381178,Jul
2023-07-27,El Palacio de los jugos / Caribe Tropical,Invoice,008-01792,Arroz a Granel:Parboiled 50 LB -Bolsa Dos Hermanos.,,15.0,20.5,307.5,913515.46,,Lisset Limpio -020,Cafeteria,1381179,Jul
2023-07-27,El Palacio de los jugos / Delicias Criollas (DIAGO FOOD_MILLER),Invoice,008-01793,Arroz a Granel:Parboiled 50 LB -Bolsa Dos Hermanos.,,12.0,25.5,306.0,913821.46,,Lisset Limpio -020,Cafeteria,1381180,Jul
2023-07-27,El Palacio de los jugos / Delicias Criollas (DIAGO FOOD_MILLER),Invoice,008-01793,Arroz a Granel:Largo Fino 50 LB -Bolsa Dos Hermanos.,,4.0,21.0,84.0,913905.46,,Lisset Limpio -020,Cafeteria,1381181,Jul
2023-07-27,"El Toro Loco Meat Distribution, LLC",Invoice,008-01794,Arroz a Granel:Largo Fino 50 LB -Bolsa Dos Hermanos.,,55.0,20.5,1127.5,915032.96,,Lisset Limpio -020,CAFETERIA y RESTAURANTS,1381182,Jul
2023-07-27,Soriano Brothers PB,Invoice,008-01795,Arroz a Granel:Largo Fino 50 LB -Bolsa Dos Hermanos.,,5.0,21.0,105.0,915137.96,,Lisset Limpio -020,CAFETERIA y RESTAURANTS,1381183,Jul
2023-07-27,Soriano Brothers PB,Invoice,008-01795,Arroz a Granel:Parboiled 50 LB -Bolsa Dos Hermanos.,,5.0,25.5,127.5,915265.46,,Lisset Limpio -020,CAFETERIA y RESTAURANTS,1381184,Jul
2023-07-27,El Palacio de los jugos /  Mires Restaurants,Invoice,008-01796,Arroz a Granel:Largo Fino 50 LB -Bolsa Dos Hermanos.,,6.0,21.0,126.0,915391.46,,Lisset Limpio -020,Cafeteria,1381185,Jul
2023-07-27,El Palacio de los jugos /  Mires Restaurants,Invoice,008-01796,Arroz a Granel:Parboiled 50 LB -Bolsa Dos Hermanos.,,2.0,25.5,51.0,915442.46,,Lisset Limpio -020,Cafeteria,1381186,Jul
2023-07-30,El Palacio de los jugos /  EMMA FOOD CORP,Invoice,008-01797,Arroz a Granel:Parboiled 50 LB -Bolsa Dos Hermanos.,,6.0,20.5,123.0,915565.46,,Lisset Limpio -020,Cafeteria,1381187,Jul
2023-07-30,"Meat Club Market, LLC.",Invoice,008-01798,Arroz Envasado:Sushi Rice Dos Hermanos 5kg.,,12.0,10.0,120.0,915685.46,,Lisset Limpio -020,RETAIL  DSD,1381188,Jul
2023-07-30,"Meat Club Market, LLC.",Invoice,008-01798,Arroz Envasado:Largo Fino 1kg (Long grain rice) Dos Hermanos,,2.0,16.5,33.0,915718.46,,Lisset Limpio -020,RETAIL  DSD,1381189,Jul
2023-07-30,Soriano Brothers PB,Invoice,008-01799,Arroz a Granel:Largo Fino 50 LB -Bolsa Dos Hermanos.,,5.0,21.0,105.0,915823.46,,Lisset Limpio -020,CAFETERIA y RESTAURANTS,1381190,Jul
2023-07-30,Soriano Brothers PB,Invoice,008-01799,Arroz a Granel:Parboiled 50 LB -Bolsa Dos Hermanos.,,7.0,25.5,178.5,916001.96,,Lisset Limpio -020,CAFETERIA y RESTAURANTS,1381191,Jul
2023-07-30,El Palacio de los jugos / Santa Clara Sabor,Invoice,008-01800,Arroz a Granel:Largo Fino 50 LB -Bolsa Dos Hermanos.,,10.0,21.0,210.0,916211.96,,Lisset Limpio -020,Cafeteria,1381192,Jul
2023-07-30,El Palacio de los jugos / Santa Clara Sabor,Invoice,008-01800,Arroz a Granel:Parboiled 50 LB -Bolsa Dos Hermanos.,,15.0,25.5,382.5,916594.46,,Lisset Limpio -020,Cafeteria,1381193,Jul
2023-07-30,El Palacio de los jugos / Lita Foods Inc.,Invoice,008-01801,Arroz a Granel:Largo Fino 50 LB -Bolsa Dos Hermanos.,,3.0,21.0,63.0,916657.46,,Lisset Limpio -020,Cafeteria,1381194,Jul
2023-07-30,El Palacio de los jugos / Lita Foods Inc.,Invoice,008-01801,Arroz a Granel:Parboiled 50 LB -Bolsa Dos Hermanos.,,6.0,25.5,153.0,916810.46,,Lisset Limpio -020,Cafeteria,1381195,Jul
2023-07-30,El Palacio de los jugos /  Mires Restaurants,Invoice,008-01802,Arroz a Granel:Parboiled 50 LB -Bolsa Dos Hermanos.,,5.0,21.0,105.0,916915.46,,Lisset Limpio -020,Cafeteria,1381196,Jul
2023-07-30,El Palacio de Los Jugos / Casa mía Food Restaurant inc,Invoice,008-01803,Arroz a Granel:Parboiled 50 LB -Bolsa Dos Hermanos.,,5.0,25.5,127.5,917042.96,,Lisset Limpio -020,Cafeteria,1381197,Jul
2023-07-30,El Palacio de los jugos / Sahilys Cafe,Invoice,008-01804,Arroz a Granel:Largo Fino 50 LB -Bolsa Dos Hermanos.,,6.0,21.0,126.0,917168.96,,Lisset Limpio -020,Cafeteria,1381198,Jul
2023-07-31,Soriano Brothers,Invoice,008-01805,Arroz a Granel:Largo Fino 50 LB -Bolsa Dos Hermanos.,,30.0,21.0,630.0,917798.96,,Lisset Limpio -020,CAFETERIA y RESTAURANTS,1381199,Jul
2023-07-31,Sorianos Brothers,Invoice,008-01806,Arroz a Granel:Largo Fino 50 LB -Bolsa Dos Hermanos.,,25.0,21.0,525.0,918323.96,,Lisset Limpio -020,CAFETERIA y RESTAURANTS,1381200,Jul
2023-07-31,House of Bagels,Invoice,008-01807,Rice Snack:Rice Snack Cheese Flavored GR (deleted),H7(40)MAY /H17(50)AUG /i11 (60) AUG // i10 (20),1.0,0.0,0.0,918323.96,,Armando Carpio - 017,OTHER,1381201,Jul
2023-07-31,House of Bagels,Invoice,008-01807,Rice Snack:Rice Snack Grilled Smoked Meat Flavored GR (deleted),H5(34)MAY/H18(37)AUG /i12(45)AUG,1.0,0.0,0.0,918323.96,,Armando Carpio - 017,OTHER,1381202,Jul
2023-07-31,House of Bagels,Invoice,008-01807,"Rice Snack:Rice Snack, Sour Cream & Onion GR (deleted)",H6(41)MAY /H16(60)AUG /i10AUG (30),1.0,0.0,0.0,918323.96,,Armando Carpio - 017,OTHER,1381203,Jul
2023-08-01,Brito Family Corp.,Invoice,008-01808,Arroz a Granel:Parboiled 50 LB -Bolsa Dos Hermanos.,,110.0,24.5,2695.0,921018.96,,Lisset Limpio -020,CAFETERIA y RESTAURANTS,1381204,Aug
2023-08-01,Festival Supermarket #1,Invoice,008-01809,Arroz Envasado:Parboiled 5KG Dos Hermanos.,6 / 11lbs,10.0,39.5,395.0,921413.96,,Lisset Limpio -020,RETAIL  DSD,1381205,Aug
2023-08-01,Festival Supermarket #1,Invoice,008-01809,Arroz Envasado:Parboiled 5KG Dos Hermanos.,6 / 11lbs,2.0,0.0,0.0,921413.96,,Lisset Limpio -020,RETAIL  DSD,1381206,Aug
2023-08-03,El Palacio de los jugos / Delicias Criollas (DIAGO FOOD_MILLER),Credit Memo,008-01833,Arroz a Granel:Parboiled 50 LB -Bolsa Dos Hermanos.,Invoice 1819 -2 parboiled,-2.0,25.5,-51.0,921362.96,,Lisset Limpio -020,Cafeteria,1381207,Aug
2023-08-04,El Palacio de los jugos /  Mires Restaurants,Invoice,008-01810,Arroz a Granel:Largo Fino 50 LB -Bolsa Dos Hermanos.,,5.0,21.0,105.0,921467.96,,Lisset Limpio -020,Cafeteria,1381208,Aug
2023-08-04,El Palacio de los jugos /  Mires Restaurants,Invoice,008-01810,Arroz a Granel:Parboiled 50 LB -Bolsa Dos Hermanos.,,5.0,25.5,127.5,921595.46,,Lisset Limpio -020,Cafeteria,1381209,Aug
2023-08-04,El Palacio de los jugos / Caribe Tropical,Invoice,008-01811,Arroz a Granel:Parboiled 50 LB -Bolsa Dos Hermanos.,,10.0,25.5,255.0,921850.46,,Lisset Limpio -020,Cafeteria,1381210,Aug
2023-08-04,Price Choice Food Market # 6,Invoice,008-01812,Arroz Envasado:Parboiled 5KG Dos Hermanos.,6 / 11lbs,4.0,0.0,0.0,921850.46,,Lisset Limpio -020,RETAIL  DSD,1381211,Aug
2023-08-04,Price Choice Food Market # 6,Invoice,008-01812,Arroz Envasado:Parboiled 5KG Dos Hermanos.,6 / 11lbs,20.0,38.5,770.0,922620.46,,Lisset Limpio -020,RETAIL  DSD,1381212,Aug
2023-08-04,Price Choice Food Market # 6,Invoice,008-01812,Arroz a Granel:Largo Fino 50 LB -Bolsa Dos Hermanos.,,10.0,21.0,210.0,922830.46,,Lisset Limpio -020,RETAIL  DSD,1381213,Aug
2023-08-04,El Palacio de Los Jugos / Casa mía Food Restaurant inc,Invoice,008-01813,Arroz a Granel:Parboiled 50 LB -Bolsa Dos Hermanos.,,6.0,25.5,153.0,922983.46,,Lisset Limpio -020,Cafeteria,1381214,Aug
2023-08-04,Soriano Brothers PB,Invoice,008-01814,Arroz a Granel:Largo Fino 50 LB -Bolsa Dos Hermanos.,,5.0,21.0,105.0,923088.46,,Lisset Limpio -020,CAFETERIA y RESTAURANTS,1381215,Aug
2023-08-04,Soriano Brothers PB,Invoice,008-01814,Arroz a Granel:Parboiled 50 LB -Bolsa Dos Hermanos.,,6.0,25.5,153.0,923241.46,,Lisset Limpio -020,CAFETERIA y RESTAURANTS,1381216,Aug
2023-08-04,El Palacio de los jugos /  EMMA FOOD CORP,Invoice,008-01815,Arroz a Granel:Parboiled 50 LB -Bolsa Dos Hermanos.,,10.0,25.5,255.0,923496.46,,Lisset Limpio -020,Cafeteria,1381217,Aug
2023-08-04,El Palacio de los jugos / Sahilys Cafe,Invoice,008-01816,Arroz a Granel:Largo Fino 50 LB -Bolsa Dos Hermanos.,,6.0,21.0,126.0,923622.46,,Lisset Limpio -020,Cafeteria,1381218,Aug
2023-08-04,Los paraditos chinesse,Invoice,008-01817,Arroz a Granel:Largo Fino 50 LB -Bolsa Dos Hermanos.,,10.0,21.0,210.0,923832.46,,Lisset Limpio -020,CAFETERIA y RESTAURANTS,1381219,Aug
2023-08-04,Los paraditos chinesse,Invoice,008-01817,Arroz a Granel:Parboiled 50 LB -Bolsa Dos Hermanos.,,10.0,25.5,255.0,924087.46,,Lisset Limpio -020,CAFETERIA y RESTAURANTS,1381220,Aug
2023-08-04,La Perla Del Sur,Invoice,008-01818,Arroz a Granel:Largo Fino 50 LB -Bolsa Dos Hermanos.,,5.0,21.0,105.0,924192.46,,Lisset Limpio -020,CAFETERIA y RESTAURANTS,1381221,Aug
2023-08-04,La Perla Del Sur,Invoice,008-01818,Arroz a Granel:Parboiled 50 LB -Bolsa Dos Hermanos.,,5.0,25.5,127.5,924319.96,,Lisset Limpio -020,CAFETERIA y RESTAURANTS,1381222,Aug
2023-08-04,El Palacio de los jugos / Delicias Criollas (DIAGO FOOD_MILLER),Invoice,008-01819,Arroz a Granel:Parboiled 50 LB -Bolsa Dos Hermanos.,,15.0,25.5,382.5,924702.46,,Lisset Limpio -020,Cafeteria,1381223,Aug
2023-08-04,El Palacio de los jugos / Lita Foods Inc.,Invoice,008-01820,Arroz a Granel:Parboiled 50 LB -Bolsa Dos Hermanos.,,10.0,25.5,255.0,924957.46,,Lisset Limpio -020,Cafeteria,1381224,Aug
2023-08-07,El Palacio de los jugos / Santa Clara Sabor,Invoice,008-01821,Arroz a Granel:Largo Fino 50 LB -Bolsa Dos Hermanos.,,10.0,21.0,210.0,925167.46,,Lisset Limpio -020,Cafeteria,1381225,Aug
2023-08-07,El Palacio de los jugos / Santa Clara Sabor,Invoice,008-01821,Arroz a Granel:Parboiled 50 LB -Bolsa Dos Hermanos.,,15.0,25.5,382.5,925549.96,,Lisset Limpio -020,Cafeteria,1381226,Aug
2023-08-07,Soriano Brothers PB,Invoice,008-01822,Arroz a Granel:Largo Fino 50 LB -Bolsa Dos Hermanos.,,5.0,21.0,105.0,925654.96,,Lisset Limpio -020,CAFETERIA y RESTAURANTS,1381227,Aug
2023-08-07,Soriano Brothers PB,Invoice,008-01822,Arroz a Granel:Parboiled 50 LB -Bolsa Dos Hermanos.,,5.0,25.5,127.5,925782.46,,Lisset Limpio -020,CAFETERIA y RESTAURANTS,1381228,Aug
2023-08-07,El Palacio de los jugos / Caribe Tropical,Invoice,008-01823,Arroz a Granel:Parboiled 50 LB -Bolsa Dos Hermanos.,,8.0,25.5,204.0,925986.46,,Lisset Limpio -020,Cafeteria,1381229,Aug
2023-08-07,Price Choice Food Market # 6,Invoice,008-01824,Arroz Envasado:Parboiled 5KG Dos Hermanos.,6 / 11lbs,5.0,38.5,192.5,926178.96,,Lisset Limpio -020,RETAIL  DSD,1381230,Aug
2023-08-07,Price Choice Food Market # 6,Invoice,008-01824,Arroz Envasado:Parboiled 5KG Dos Hermanos.,6 / 11lbs,2.0,0.0,0.0,926178.96,,Lisset Limpio -020,RETAIL  DSD,1381231,Aug
2023-08-07,El Palacio de los jugos / Lita Foods Inc.,Invoice,008-01825,Arroz a Granel:Parboiled 50 LB -Bolsa Dos Hermanos.,,10.0,25.5,255.0,926433.96,,Lisset Limpio -020,Cafeteria,1381232,Aug
2023-08-07,El Palacio de los jugos /  EMMA FOOD CORP,Invoice,008-01826,Arroz a Granel:Parboiled 50 LB -Bolsa Dos Hermanos.,,8.0,25.5,204.0,926637.96,,Lisset Limpio -020,Cafeteria,1381233,Aug
2023-08-07,El Palacio de los jugos / Delicias Criollas (DIAGO FOOD_MILLER),Invoice,008-01827,Arroz a Granel:Parboiled 50 LB -Bolsa Dos Hermanos.,,5.0,25.5,127.5,926765.46,,Lisset Limpio -020,Cafeteria,1381234,Aug
2023-08-07,Sorianos Brothers,Invoice,008-01828,Arroz a Granel:Parboiled 50 LB -Bolsa Dos Hermanos.,,25.0,25.5,637.5,927402.96,,Lisset Limpio -020,CAFETERIA y RESTAURANTS,1381235,Aug
2023-08-07,Soriano Brothers,Invoice,008-01829,Arroz a Granel:Parboiled 50 LB -Bolsa Dos Hermanos.,,35.0,25.5,892.5,928295.46,,Lisset Limpio -020,CAFETERIA y RESTAURANTS,1381236,Aug
2023-08-07,El Palacio de los jugos / J Mena Corp.,Invoice,008-01830,Arroz a Granel:Largo Fino 50 LB -Bolsa Dos Hermanos.,,10.0,21.0,210.0,928505.46,,Lisset Limpio -020,Cafeteria,1381237,Aug
2023-08-08,Shell Station,Invoice,008-01831,Rice Snack:Rice Snack Salami Flavored DOS HERMANOS,,1.0,0.0,0.0,928505.46,,Armando Carpio - 017,OTHER,1381238,Aug
2023-08-08,Shell Station,Invoice,008-01831,Rice Snack:Rice Snack Ham Flavored DOS HERMANOS,,1.0,0.0,0.0,928505.46,,Armando Carpio - 017,OTHER,1381239,Aug
2023-08-08,Shell Station,Invoice,008-01831,"Rice Snack:Rice Snack, Sour Cream & Onion DOS HERMANOS",H8,1.0,0.0,0.0,928505.46,,Armando Carpio - 017,OTHER,1381240,Aug
2023-08-08,El Palacio de Los Jugos / Casa mía Food Restaurant inc,Invoice,008-01832,Arroz a Granel:Parboiled 50 LB -Bolsa Dos Hermanos.,,15.0,25.5,382.5,928887.96,,Lisset Limpio -020,Cafeteria,1381241,Aug
2023-08-10,Soriano Brothers PB,Invoice,008-01834,Arroz a Granel:Largo Fino 50 LB -Bolsa Dos Hermanos.,,5.0,21.0,105.0,928992.96,,Lisset Limpio -020,CAFETERIA y RESTAURANTS,1381242,Aug
2023-08-10,Soriano Brothers PB,Invoice,008-01834,Arroz a Granel:Parboiled 50 LB -Bolsa Dos Hermanos.,,5.0,25.5,127.5,929120.46,,Lisset Limpio -020,CAFETERIA y RESTAURANTS,1381243,Aug
2023-08-10,Sabor Tropical Supermarket #4,Invoice,008-01835,Arroz a Granel:Parboiled 50 LB -Bolsa Dos Hermanos.,,25.0,25.5,637.5,929757.96,,Lisset Limpio -020,RETAIL  DSD,1381244,Aug
2023-08-10,El Palacio de Los Jugos / Casa mía Food Restaurant inc,Invoice,008-01836,Arroz a Granel:Parboiled 50 LB -Bolsa Dos Hermanos.,,8.0,25.5,204.0,929961.96,,Lisset Limpio -020,Cafeteria,1381245,Aug
2023-08-10,El Palacio de los jugos / Caribe Tropical,Invoice,008-01837,Arroz a Granel:Parboiled 50 LB -Bolsa Dos Hermanos.,,10.0,25.5,255.0,930216.96,,Lisset Limpio -020,Cafeteria,1381246,Aug
2023-08-10,El Palacio de los jugos / Lita Foods Inc.,Invoice,008-01838,Arroz a Granel:Parboiled 50 LB -Bolsa Dos Hermanos.,,10.0,25.5,255.0,930471.96,,Lisset Limpio -020,Cafeteria,1381247,Aug
2023-08-10,El Palacio de los jugos / Delicias Criollas (DIAGO FOOD_MILLER),Invoice,008-01839,Arroz a Granel:Parboiled 50 LB -Bolsa Dos Hermanos.,,10.0,25.5,255.0,930726.96,,Lisset Limpio -020,Cafeteria,1381248,Aug
2023-08-10,El Palacio de los jugos / Sahilys Cafe,Invoice,008-01840,Arroz a Granel:Largo Fino 50 LB -Bolsa Dos Hermanos.,,6.0,21.0,126.0,930852.96,,Lisset Limpio -020,Cafeteria,1381249,Aug
2023-08-10,El Palacio de los jugos / Sahilys Cafe,Invoice,008-01840,Arroz a Granel:Parboiled 50 LB -Bolsa Dos Hermanos.,,2.0,25.5,51.0,930903.96,,Lisset Limpio -020,Cafeteria,1381250,Aug
2023-08-10,El Palacio de los jugos /  EMMA FOOD CORP,Invoice,008-01841,Arroz a Granel:Parboiled 50 LB -Bolsa Dos Hermanos.,,10.0,25.5,255.0,931158.96,,Lisset Limpio -020,Cafeteria,1381251,Aug
2023-08-10,Food-Star Supermarket,Invoice,008-01842,Arroz Envasado:Parboiled 5KG Dos Hermanos.,6 / 11lbs,10.0,39.5,395.0,931553.96,,Lisset Limpio -020,RETAIL  DSD,1381252,Aug
2023-08-10,Food-Star Supermarket,Invoice,008-01842,Arroz Envasado:Parboiled 5KG Dos Hermanos.,6 / 11lbs,2.0,0.0,0.0,931553.96,,Lisset Limpio -020,RETAIL  DSD,1381253,Aug
2023-08-10,El Palacio de los jugos /  Mires Restaurants,Invoice,008-01843,Arroz a Granel:Largo Fino 50 LB -Bolsa Dos Hermanos.,,3.0,21.0,63.0,931616.96,,Lisset Limpio -020,Cafeteria,1381254,Aug
2023-08-10,El Palacio de los jugos /  Mires Restaurants,Invoice,008-01843,Arroz a Granel:Parboiled 50 LB -Bolsa Dos Hermanos.,,3.0,25.5,76.5,931693.46,,Lisset Limpio -020,Cafeteria,1381255,Aug
2023-08-14,El Palacio de los jugos /  Mires Restaurants,Invoice,008-01844,Arroz a Granel:Largo Fino 50 LB -Bolsa Dos Hermanos.,,5.0,21.0,105.0,931798.46,,Lisset Limpio -020,Cafeteria,1381256,Aug
2023-08-14,El Palacio de los jugos /  Mires Restaurants,Invoice,008-01844,Arroz a Granel:Parboiled 50 LB -Bolsa Dos Hermanos.,,5.0,27.5,137.5,931935.96,,Lisset Limpio -020,Cafeteria,1381257,Aug
2023-08-14,Soriano Brothers PB,Invoice,008-01845,Arroz a Granel:Largo Fino 50 LB -Bolsa Dos Hermanos.,,0.0,,0.0,931935.96,,Lisset Limpio -020,CAFETERIA y RESTAURANTS,1381258,Aug
2023-08-14,Soriano Brothers PB,Invoice,008-01845,Arroz a Granel:Parboiled 50 LB -Bolsa Dos Hermanos.,,0.0,,0.0,931935.96,,Lisset Limpio -020,CAFETERIA y RESTAURANTS,1381259,Aug
2023-08-14,El Palacio de los jugos / Caribe Tropical,Invoice,008-01846,Arroz a Granel:Parboiled 50 LB -Bolsa Dos Hermanos.,,6.0,27.5,165.0,932100.96,,Lisset Limpio -020,Cafeteria,1381260,Aug
2023-08-14,El Palacio de Los Jugos / Casa mía Food Restaurant inc,Invoice,008-01847,Arroz a Granel:Parboiled 50 LB -Bolsa Dos Hermanos.,,6.0,27.5,165.0,932265.96,,Lisset Limpio -020,Cafeteria,1381261,Aug
2023-08-14,El Palacio de los jugos / Lita Foods Inc.,Invoice,008-01848,Arroz a Granel:Parboiled 50 LB -Bolsa Dos Hermanos.,,10.0,27.5,275.0,932540.96,,Lisset Limpio -020,Cafeteria,1381262,Aug
2023-08-14,El Palacio de los jugos /  EMMA FOOD CORP,Invoice,008-01849,Arroz a Granel:Parboiled 50 LB -Bolsa Dos Hermanos.,,6.0,27.5,165.0,932705.96,,Lisset Limpio -020,Cafeteria,1381263,Aug
2023-08-14,El Palacio de los jugos / Sahilys Cafe,Invoice,008-01850,Arroz a Granel:Largo Fino 50 LB -Bolsa Dos Hermanos.,,6.0,21.0,126.0,932831.96,,Lisset Limpio -020,Cafeteria,1381264,Aug
2023-08-14,El Palacio de los jugos / Santa Clara Sabor,Invoice,008-01851,Arroz a Granel:Largo Fino 50 LB -Bolsa Dos Hermanos.,,15.0,21.0,315.0,933146.96,,Lisset Limpio -020,Cafeteria,1381265,Aug
2023-08-14,El Palacio de los jugos / Santa Clara Sabor,Invoice,008-01851,Arroz a Granel:Parboiled 50 LB -Bolsa Dos Hermanos.,,15.0,27.5,412.5,933559.46,,Lisset Limpio -020,Cafeteria,1381266,Aug
2023-08-14,Bake Mark USA LLC,Invoice,008-01852,Arroz a Granel:Parboiled 50 LB -Bolsa Dos Hermanos.,,1100.0,22.15,24365.0,957924.46,,Armando Carpio - 017,WHOLESALER MANUFACTURY,1381267,Aug
2023-08-18,Soriano Brothers PB,Invoice,008-01855,Arroz a Granel:Largo Fino 50 LB -Bolsa Dos Hermanos.,,5.0,21.0,105.0,958029.46,,Lisset Limpio -020,CAFETERIA y RESTAURANTS,1381268,Aug
2023-08-18,Soriano Brothers PB,Invoice,008-01855,Arroz a Granel:Parboiled 50 LB -Bolsa Dos Hermanos.,,5.0,27.5,137.5,958166.96,,Lisset Limpio -020,CAFETERIA y RESTAURANTS,1381269,Aug
2023-08-18,El Palacio de los jugos /  EMMA FOOD CORP,Invoice,008-01856,Arroz a Granel:Parboiled 50 LB -Bolsa Dos Hermanos.,,10.0,27.5,275.0,958441.96,,Lisset Limpio -020,Cafeteria,1381270,Aug
2023-08-18,El Palacio de los jugos / Delicias Criollas (DIAGO FOOD_MILLER),Invoice,008-01857,Arroz a Granel:Parboiled 50 LB -Bolsa Dos Hermanos.,,10.0,27.5,275.0,958716.96,,Lisset Limpio -020,Cafeteria,1381271,Aug
2023-08-18,El Palacio de los jugos / Lita Foods Inc.,Invoice,008-01858,Arroz a Granel:Parboiled 50 LB -Bolsa Dos Hermanos.,,10.0,27.5,275.0,958991.96,,Lisset Limpio -020,Cafeteria,1381272,Aug
2023-08-18,El Palacio de Los Jugos / Casa mía Food Restaurant inc,Invoice,008-01859,Arroz a Granel:Parboiled 50 LB -Bolsa Dos Hermanos.,,10.0,27.5,275.0,959266.96,,Lisset Limpio -020,Cafeteria,1381273,Aug
2023-08-18,El Palacio de los jugos / Sahilys Cafe,Invoice,008-01860,Arroz a Granel:Largo Fino 50 LB -Bolsa Dos Hermanos.,,6.0,21.0,126.0,959392.96,,Lisset Limpio -020,Cafeteria,1381274,Aug
2023-08-18,"El Toro Loco Meat Distribution, LLC",Invoice,008-01861,Arroz a Granel:Largo Fino 50 LB -Bolsa Dos Hermanos.,,55.0,21.0,1155.0,960547.96,,Lisset Limpio -020,CAFETERIA y RESTAURANTS,1381275,Aug
2023-08-18,COD Suplies,Invoice,008-01862,Arroz a Granel:Parboiled 50 LB -Bolsa Dos Hermanos.,,55.0,25.5,1402.5,961950.46,,Ruta - 019,WHOLESALER,1381276,Aug
2023-08-21,El Palacio de los jugos / Santa Clara Sabor,Invoice,008-01863,Arroz a Granel:Largo Fino 50 LB -Bolsa Dos Hermanos.,,0.0,,0.0,961950.46,,Lisset Limpio -020,Cafeteria,1381277,Aug
2023-08-21,El Palacio de los jugos /  Mires Restaurants,Invoice,008-01864,Arroz a Granel:Parboiled 50 LB -Bolsa Dos Hermanos.,,5.0,27.5,137.5,962087.96,,Lisset Limpio -020,Cafeteria,1381278,Aug
2023-08-21,El Palacio de los jugos /  Mires Restaurants,Invoice,008-01864,Arroz a Granel:Largo Fino 50 LB -Bolsa Dos Hermanos.,,5.0,21.0,105.0,962192.96,,Lisset Limpio -020,Cafeteria,1381279,Aug
2023-08-21,El Palacio de Los Jugos / Casa mía Food Restaurant inc,Invoice,008-01866,Arroz a Granel:Parboiled 50 LB -Bolsa Dos Hermanos.,,10.0,27.5,275.0,962467.96,,Lisset Limpio -020,Cafeteria,1381280,Aug
2023-08-21,El Palacio de los jugos / Caribe Tropical,Invoice,008-01867,Arroz a Granel:Parboiled 50 LB -Bolsa Dos Hermanos.,,10.0,27.5,275.0,962742.96,,Lisset Limpio -020,Cafeteria,1381281,Aug
2023-08-21,El Palacio de los jugos / Delicias Criollas (DIAGO FOOD_MILLER),Invoice,008-01868,Arroz a Granel:Parboiled 50 LB -Bolsa Dos Hermanos.,,10.0,27.5,275.0,963017.96,,Lisset Limpio -020,Cafeteria,1381282,Aug
2023-08-21,El Palacio de los jugos /  EMMA FOOD CORP,Invoice,008-01869,Arroz a Granel:Parboiled 50 LB -Bolsa Dos Hermanos.,,6.0,27.5,165.0,963182.96,,Lisset Limpio -020,Cafeteria,1381283,Aug
2023-08-21,El Palacio de los jugos /  EMMA FOOD CORP,Invoice,008-01869,Arroz a Granel:Largo Fino 50 LB -Bolsa Dos Hermanos.,,5.0,21.0,105.0,963287.96,,Lisset Limpio -020,Cafeteria,1381284,Aug
2023-08-21,El Palacio de los jugos / Lita Foods Inc.,Invoice,008-01870,Arroz a Granel:Parboiled 50 LB -Bolsa Dos Hermanos.,,10.0,27.5,275.0,963562.96,,Lisset Limpio -020,Cafeteria,1381285,Aug
2023-08-21,Soriano Brothers,Invoice,008-01871,Arroz a Granel:Largo Fino 50 LB -Bolsa Dos Hermanos.,,25.0,21.0,525.0,964087.96,,Lisset Limpio -020,CAFETERIA y RESTAURANTS,1381286,Aug
2023-08-21,Soriano Brothers,Invoice,008-01871,Arroz a Granel:Parboiled 50 LB -Bolsa Dos Hermanos.,,25.0,27.5,687.5,964775.46,,Lisset Limpio -020,CAFETERIA y RESTAURANTS,1381287,Aug
2023-08-21,Los paraditos chinesse,Invoice,008-01872,Arroz a Granel:Parboiled 50 LB -Bolsa Dos Hermanos.,,10.0,27.5,275.0,965050.46,,Lisset Limpio -020,CAFETERIA y RESTAURANTS,1381288,Aug
2023-08-21,Los paraditos chinesse,Invoice,008-01872,Arroz a Granel:Largo Fino 50 LB -Bolsa Dos Hermanos.,,10.0,21.0,210.0,965260.46,,Lisset Limpio -020,CAFETERIA y RESTAURANTS,1381289,Aug
2023-08-21,El Palacio de los jugos / Sahilys Cafe,Invoice,008-01873,Arroz a Granel:Largo Fino 50 LB -Bolsa Dos Hermanos.,,7.0,21.0,147.0,965407.46,,Lisset Limpio -020,Cafeteria,1381290,Aug
2023-08-21,Bake Mark USA LLC,Invoice,008-01874,Arroz a Granel:Parboiled 50 LB -Bolsa Dos Hermanos.,,1100.0,22.15,24365.0,989772.46,,Armando Carpio - 017,WHOLESALER MANUFACTURY,1381291,Aug
2023-08-21,El Palacio de los jugos / Santa Clara Sabor,Invoice,008-01875,Arroz a Granel:Largo Fino 50 LB -Bolsa Dos Hermanos.,,15.0,21.0,315.0,990087.46,,Lisset Limpio -020,Cafeteria,1381292,Aug
2023-08-22,"Criollos Food USA, LLC",Invoice,008-01876,Arroz a Granel:Parboiled 50 LB -Bolsa Dos Hermanos.,,110.0,25.5,2805.0,992892.46,,Armando Carpio - 017,WHOLESALER,1381293,Aug
2023-08-22,Amerifood,Invoice,008-01877,Arroz a Granel:Largo Fino 50 LB -Bolsa Dos Hermanos.,,55.0,23.0,1265.0,994157.46,,Ruta - 019,WHOLESALER,1381294,Aug
2023-08-22,Amerifood,Invoice,008-01877,Arroz a Granel:Parboiled 50 LB -Bolsa Dos Hermanos.,,55.0,25.5,1402.5,995559.96,,Ruta - 019,WHOLESALER,1381295,Aug
2023-08-22,Amerifood,Invoice,008-01877,Arroz Envasado:Largo Fino 1kg (Long grain rice) Dos Hermanos,,120.0,13.5,1620.0,997179.96,,Ruta - 019,WHOLESALER,1381296,Aug
2023-08-22,Amerifood,Invoice,008-01877,Arroz Envasado:Parboiled 1kg Bolsa Dos Hermanos.,.,120.0,15.5,1860.0,999039.96,,Ruta - 019,WHOLESALER,1381297,Aug
2023-08-22,Price Choice Food Market # 2,Invoice,008-01878,Arroz a Granel:Largo Fino 50 LB -Bolsa Dos Hermanos.,,0.0,,0.0,999039.96,,Ruta - 019,RETAIL  DSD,1381298,Aug
2023-08-22,Price Choice Food Market # 2,Invoice,008-01879,Arroz a Granel:Largo Fino 50 LB -Bolsa Dos Hermanos.,,10.0,21.0,210.0,999249.96,,Ruta - 019,RETAIL  DSD,1381299,Aug
2023-08-22,Bake Mark USA LLC,Invoice,008-01880,Arroz a Granel:Parboiled 50 LB -Bolsa Dos Hermanos.,,1100.0,22.15,24365.0,1023614.96,,Armando Carpio - 017,WHOLESALER MANUFACTURY,1381300,Aug
2023-08-23,"YummmyCo, Inc",Invoice,008-01881,Arroz a Granel:Parboiled 50 LB -Bolsa Dos Hermanos.,,55.0,24.53,1349.15,1024964.11,,Armando Carpio - 017,WHOLESALER,1381301,Aug
2023-08-23,Miavana & Family,Invoice,008-01882,Arroz a Granel:Parboiled 50 LB -Bolsa Dos Hermanos.,,330.0,21.5,7095.0,1032059.11,,Armando Carpio - 017,Distributor,1381302,Aug
2023-08-24,El Palacio de los jugos / Delicias Criollas (DIAGO FOOD_MILLER),Invoice,008-01883,Arroz a Granel:Parboiled 50 LB -Bolsa Dos Hermanos.,,0.0,,0.0,1032059.11,,Lisset Limpio -020,Cafeteria,1381303,Aug
2023-08-24,El Palacio de los jugos / Lita Foods Inc.,Invoice,008-01884,Arroz a Granel:Parboiled 50 LB -Bolsa Dos Hermanos.,,10.0,27.5,275.0,1032334.11,,Lisset Limpio -020,Cafeteria,1381304,Aug
2023-08-24,Soriano Brothers PB,Invoice,008-01885,Arroz a Granel:Largo Fino 50 LB -Bolsa Dos Hermanos.,,6.0,21.0,126.0,1032460.11,,Lisset Limpio -020,CAFETERIA y RESTAURANTS,1381305,Aug
2023-08-24,Soriano Brothers PB,Invoice,008-01885,Arroz a Granel:Parboiled 50 LB -Bolsa Dos Hermanos.,,6.0,27.5,165.0,1032625.11,,Lisset Limpio -020,CAFETERIA y RESTAURANTS,1381306,Aug
2023-08-24,El Palacio de Los Jugos / Casa mía Food Restaurant inc,Invoice,008-01886,Arroz a Granel:Parboiled 50 LB -Bolsa Dos Hermanos.,,10.0,27.5,275.0,1032900.11,,Lisset Limpio -020,Cafeteria,1381307,Aug
2023-08-24,El Palacio de los jugos / Lita Foods Inc.,Invoice,008-01887,Arroz a Granel:Parboiled 50 LB -Bolsa Dos Hermanos.,,0.0,,0.0,1032900.11,,Lisset Limpio -020,Cafeteria,1381308,Aug
2023-08-24,El Palacio de los jugos /  EMMA FOOD CORP,Invoice,008-01888,Arroz a Granel:Largo Fino 50 LB -Bolsa Dos Hermanos.,,5.0,21.0,105.0,1033005.11,,Lisset Limpio -020,Cafeteria,1381309,Aug
2023-08-24,El Palacio de los jugos /  EMMA FOOD CORP,Invoice,008-01888,Arroz a Granel:Parboiled 50 LB -Bolsa Dos Hermanos.,,5.0,27.5,137.5,1033142.61,,Lisset Limpio -020,Cafeteria,1381310,Aug
2023-08-24,El Palacio de los jugos / Caribe Tropical,Invoice,008-01889,Arroz a Granel:Parboiled 50 LB -Bolsa Dos Hermanos.,,7.0,27.5,192.5,1033335.11,,Lisset Limpio -020,Cafeteria,1381311,Aug
2023-08-24,El Palacio de los jugos / J Mena Corp.,Invoice,008-01890,Arroz a Granel:Largo Fino 50 LB -Bolsa Dos Hermanos.,,10.0,21.0,210.0,1033545.11,,Lisset Limpio -020,Cafeteria,1381312,Aug
2023-08-25,Brito Family Corp.,Invoice,008-01891,Arroz a Granel:Parboiled 50 LB -Bolsa Dos Hermanos.,,110.0,24.5,2695.0,1036240.11,,Lisset Limpio -020,CAFETERIA y RESTAURANTS,1381313,Aug
2023-08-28,"Virtue Distributor, Inc",Invoice,008-01892,Arroz a Granel:Largo Fino 50 LB -Bolsa Dos Hermanos.,PO 2706,55.0,21.0,1155.0,1037395.11,,Armando Carpio - 017,Distributor,1381314,Aug
2023-08-28,El Palacio de los jugos / Santa Clara Sabor,Invoice,008-01893,Arroz a Granel:Largo Fino 50 LB -Bolsa Dos Hermanos.,,0.0,,0.0,1037395.11,,Lisset Limpio -020,Cafeteria,1381315,Aug
2023-08-28,El Palacio de los jugos / Delicias Criollas (DIAGO FOOD_MILLER),Invoice,008-01894,Arroz a Granel:Parboiled 50 LB -Bolsa Dos Hermanos.,,0.0,,0.0,1037395.11,,Lisset Limpio -020,Cafeteria,1381316,Aug
2023-08-28,El Palacio de los jugos / Delicias Criollas (DIAGO FOOD_MILLER),Invoice,008-01895,Arroz a Granel:Parboiled 50 LB -Bolsa Dos Hermanos.,,10.0,27.5,275.0,1037670.11,,Lisset Limpio -020,Cafeteria,1381317,Aug
2023-08-28,El Palacio de los jugos /  EMMA FOOD CORP,Invoice,008-01896,Arroz a Granel:Largo Fino 50 LB -Bolsa Dos Hermanos.,,5.0,21.0,105.0,1037775.11,,Lisset Limpio -020,Cafeteria,1381318,Aug
2023-08-28,El Palacio de los jugos /  EMMA FOOD CORP,Invoice,008-01896,Arroz a Granel:Parboiled 50 LB -Bolsa Dos Hermanos.,,8.0,27.5,220.0,1037995.11,,Lisset Limpio -020,Cafeteria,1381319,Aug
2023-08-28,Sorianos Brothers,Invoice,008-01897,Arroz a Granel:Parboiled 50 LB -Bolsa Dos Hermanos.,,25.0,27.5,687.5,1038682.61,,Lisset Limpio -020,CAFETERIA y RESTAURANTS,1381320,Aug
2023-08-28,Soriano Brothers,Invoice,008-01898,Arroz a Granel:Parboiled 50 LB -Bolsa Dos Hermanos.,,25.0,27.5,687.5,1039370.11,,Lisset Limpio -020,CAFETERIA y RESTAURANTS,1381321,Aug
2023-08-28,El Palacio de los jugos / Caribe Tropical,Invoice,008-01899,Arroz a Granel:Parboiled 50 LB -Bolsa Dos Hermanos.,,6.0,27.5,165.0,1039535.11,,Lisset Limpio -020,Cafeteria,1381322,Aug
2023-08-28,El Palacio de los jugos / Lita Foods Inc.,Invoice,008-01900,Arroz a Granel:Parboiled 50 LB -Bolsa Dos Hermanos.,,10.0,27.5,275.0,1039810.11,,Lisset Limpio -020,Cafeteria,1381323,Aug
2023-08-28,El Palacio de Los Jugos / Casa mía Food Restaurant inc,Invoice,008-01901,Arroz a Granel:Parboiled 50 LB -Bolsa Dos Hermanos.,,10.0,27.5,275.0,1040085.11,,Lisset Limpio -020,Cafeteria,1381324,Aug
2023-08-28,El Palacio de los jugos / Sahilys Cafe,Invoice,008-01902,Arroz a Granel:Largo Fino 50 LB -Bolsa Dos Hermanos.,,6.0,21.0,126.0,1040211.11,,Lisset Limpio -020,Cafeteria,1381325,Aug
2023-08-28,Extra Supermarket,Invoice,008-01903,Arroz Envasado:Parboiled 5KG Dos Hermanos.,6 / 11lbs,10.0,39.5,395.0,1040606.11,,Lisset Limpio -020,RETAIL  DSD,1381326,Aug
2023-08-28,Extra Supermarket,Invoice,008-01903,Arroz Envasado:Parboiled 5KG Dos Hermanos.,6 / 11lbs,2.0,0.0,0.0,1040606.11,,Lisset Limpio -020,RETAIL  DSD,1381327,Aug
2023-08-29,Total Food - AE&O Supermarket Inc.,Invoice,008-01904,Arroz a Granel:Parboiled 50 LB -Bolsa Dos Hermanos.,,8.0,27.5,220.0,1040826.11,,Ruta - 019,RETAIL  DSD,1381328,Aug
2023-08-29,"American Spice Trading Co, Inc.",Invoice,008-01906,Arroz a Granel:Parboiled 50 LB -Bolsa Dos Hermanos.,,1100.0,22.0,24200.0,1065026.11,,Armando Carpio - 017,WHOLESALER MANUFACTURY,1381329,Aug
2023-08-30,Bake Mark USA LLC,Invoice,008-01907,Arroz a Granel:Parboiled 50 LB -Bolsa Dos Hermanos.,,1100.0,22.15,24365.0,1089391.11,,Armando Carpio - 017,WHOLESALER MANUFACTURY,1381330,Aug
2023-08-31,"El Toro Loco Meat Distribution, LLC",Invoice,008-01908,Arroz a Granel:Largo Fino 50 LB -Bolsa Dos Hermanos.,,55.0,21.0,1155.0,1090546.11,,Lisset Limpio -020,CAFETERIA y RESTAURANTS,1381331,Aug
2023-08-31,"American Spice Trading Co, Inc.",Invoice,008-01909,Arroz a Granel:Parboiled 50 LB -Bolsa Dos Hermanos.,,1100.0,22.0,24200.0,1114746.11,,Armando Carpio - 017,WHOLESALER MANUFACTURY,1381332,Aug
2023-08-31,El Palacio de Los Jugos / Casa mía Food Restaurant inc,Invoice,008-01910,Arroz a Granel:Parboiled 50 LB -Bolsa Dos Hermanos.,,12.0,27.5,330.0,1115076.11,,Lisset Limpio -020,Cafeteria,1381333,Aug
2023-08-31,Price Choice Food Market # 6,Invoice,008-01911,Arroz a Granel:Largo Fino 50 LB -Bolsa Dos Hermanos.,,20.0,21.0,420.0,1115496.11,,Lisset Limpio -020,RETAIL  DSD,1381334,Aug
2023-08-31,Soriano Brothers PB,Invoice,008-01912,Arroz a Granel:Largo Fino 50 LB -Bolsa Dos Hermanos.,,6.0,21.0,126.0,1115622.11,,Lisset Limpio -020,CAFETERIA y RESTAURANTS,1381335,Aug
2023-08-31,Soriano Brothers PB,Invoice,008-01912,Arroz a Granel:Parboiled 50 LB -Bolsa Dos Hermanos.,,7.0,27.5,192.5,1115814.61,,Lisset Limpio -020,CAFETERIA y RESTAURANTS,1381336,Aug
2023-08-31,Soriano Brothers PB,Invoice,008-01912,Dry Beans:Dry Beans - Black Beans 50,Dry Black Beans 50 lb,1.0,37.5,37.5,1115852.11,,Lisset Limpio -020,CAFETERIA y RESTAURANTS,1381337,Aug
2023-08-31,El Palacio de los jugos / Delicias Criollas (DIAGO FOOD_MILLER),Invoice,008-01913,Arroz a Granel:Parboiled 50 LB -Bolsa Dos Hermanos.,,10.0,27.5,275.0,1116127.11,,Lisset Limpio -020,Cafeteria,1381338,Aug
2023-08-31,El Palacio de los jugos / Caribe Tropical,Invoice,008-01914,Arroz a Granel:Parboiled 50 LB -Bolsa Dos Hermanos.,,10.0,27.5,275.0,1116402.11,,Lisset Limpio -020,Cafeteria,1381339,Aug
2023-08-31,El Palacio de los jugos /  EMMA FOOD CORP,Invoice,008-01915,Arroz a Granel:Largo Fino 50 LB -Bolsa Dos Hermanos.,,8.0,21.0,168.0,1116570.11,,Lisset Limpio -020,Cafeteria,1381340,Aug
2023-08-31,El Palacio de los jugos /  EMMA FOOD CORP,Invoice,008-01915,Arroz a Granel:Parboiled 50 LB -Bolsa Dos Hermanos.,,10.0,27.5,275.0,1116845.11,,Lisset Limpio -020,Cafeteria,1381341,Aug
2023-09-01,"El Toro Loco Meat Distribution, LLC",Invoice,008-01916,Arroz a Granel:Largo Fino 50 LB -Bolsa Dos Hermanos.,,110.0,21.0,2310.0,1119155.11,,Lisset Limpio -020,CAFETERIA y RESTAURANTS,1381342,Sep
2023-09-02,El Palacio de los jugos / Sahilys Cafe,Invoice,008-01917,Arroz a Granel:Largo Fino 50 LB -Bolsa Dos Hermanos.,,10.0,21.0,210.0,1119365.11,,Lisset Limpio -020,Cafeteria,1381343,Sep
2023-09-04,Soriano Brothers PB,Invoice,008-01918,Arroz a Granel:Parboiled 50 LB -Bolsa Dos Hermanos.,,6.0,27.5,165.0,1119530.11,,Lisset Limpio -020,CAFETERIA y RESTAURANTS,1381344,Sep
2023-09-04,El Palacio de los jugos / Lita Foods Inc.,Invoice,008-01919,Arroz a Granel:Parboiled 50 LB -Bolsa Dos Hermanos.,,5.0,27.5,137.5,1119667.61,,Lisset Limpio -020,Cafeteria,1381345,Sep
2023-09-04,El Palacio de los jugos / Lita Foods Inc.,Invoice,008-01919,Dry Beans:Dry Beans - Black Beans 50,Dry Black Beans 50 lb,1.0,37.5,37.5,1119705.11,,Lisset Limpio -020,Cafeteria,1381346,Sep
2023-09-04,"Meat Club Market, LLC.",Invoice,008-01920,Arroz Envasado:Sushi Rice Dos Hermanos.,.,5.0,20.0,100.0,1119805.11,,Lisset Limpio -020,RETAIL  DSD,1381347,Sep
2023-09-04,El Palacio de los jugos /  EMMA FOOD CORP,Invoice,008-01921,Arroz a Granel:Largo Fino 50 LB -Bolsa Dos Hermanos.,,3.0,21.0,63.0,1119868.11,,Lisset Limpio -020,Cafeteria,1381348,Sep
2023-09-04,El Palacio de los jugos /  EMMA FOOD CORP,Invoice,008-01921,Arroz a Granel:Parboiled 50 LB -Bolsa Dos Hermanos.,,5.0,27.5,137.5,1120005.61,,Lisset Limpio -020,Cafeteria,1381349,Sep
2023-09-04,El Palacio de los jugos /  Mires Restaurants,Invoice,008-01922,Arroz a Granel:Largo Fino 50 LB -Bolsa Dos Hermanos.,,6.0,21.0,126.0,1120131.61,,Lisset Limpio -020,Cafeteria,1381350,Sep
2023-09-05,El Palacio de Los Jugos / Casa mía Food Restaurant inc,Invoice,008-01923,Arroz a Granel:Parboiled 50 LB -Bolsa Dos Hermanos.,,10.0,27.5,275.0,1120406.61,,Lisset Limpio -020,Cafeteria,1381351,Sep
2023-09-05,Los paraditos chinesse,Invoice,008-01924,Arroz a Granel:Largo Fino 50 LB -Bolsa Dos Hermanos.,,10.0,21.0,210.0,1120616.61,,Lisset Limpio -020,CAFETERIA y RESTAURANTS,1381352,Sep
2023-09-05,Los paraditos chinesse,Invoice,008-01924,Arroz a Granel:Parboiled 50 LB -Bolsa Dos Hermanos.,,3.0,27.5,82.5,1120699.11,,Lisset Limpio -020,CAFETERIA y RESTAURANTS,1381353,Sep
2023-09-07,El Palacio de los jugos / Caribe Tropical,Invoice,008-01925,Arroz a Granel:Parboiled 50 LB -Bolsa Dos Hermanos.,,10.0,27.5,275.0,1120974.11,,Lisset Limpio -020,Cafeteria,1381354,Sep
2023-09-07,El Palacio de los jugos / Caribe Tropical,Invoice,008-01925,Dry Beans:Dry Beans - Black Beans 50,Dry Black Beans 50 lb,1.0,37.5,37.5,1121011.61,,Lisset Limpio -020,Cafeteria,1381355,Sep
2023-09-07,El Palacio de los jugos / Caribe Tropical,Invoice,008-01925,Liquids:AS Marinating Sauce (Mojo),,1.0,17.0,17.0,1121028.61,,Lisset Limpio -020,Cafeteria,1381356,Sep
2023-09-07,El Palacio de Los Jugos / Casa mía Food Restaurant inc,Invoice,008-01926,Arroz a Granel:Parboiled 50 LB -Bolsa Dos Hermanos.,,5.0,27.5,137.5,1121166.11,,Lisset Limpio -020,Cafeteria,1381357,Sep
2023-09-07,El Palacio de los jugos / Sahilys Cafe,Invoice,008-01927,Arroz a Granel:Largo Fino 50 LB -Bolsa Dos Hermanos.,,5.0,21.0,105.0,1121271.11,,Lisset Limpio -020,Cafeteria,1381358,Sep
2023-09-07,"El Toro Loco Meat Distribution, LLC",Invoice,008-01928,Dry Beans:Dry Beans - Black Beans 50,Dry Black Beans 50 lb,1.0,37.5,37.5,1121308.61,,Lisset Limpio -020,CAFETERIA y RESTAURANTS,1381359,Sep
2023-09-07,Key Food / Holywood,Invoice,008-01929,Arroz Envasado:Largo Fino 1kg (Long grain rice) Dos Hermanos,,10.0,13.2,132.0,1121440.61,,Lisset Limpio -020,RETAIL  DSD,1381360,Sep
2023-09-07,Key Food / Holywood,Invoice,008-01929,Arroz Envasado:Largo Fino 1kg (Long grain rice) Dos Hermanos,,2.0,0.0,0.0,1121440.61,,Lisset Limpio -020,RETAIL  DSD,1381361,Sep
2023-09-07,Key Food / Holywood,Invoice,008-01930,Arroz Envasado:Largo Fino 1kg (Long grain rice) Dos Hermanos,,1.0,0.0,0.0,1121440.61,,Lisset Limpio -020,RETAIL  DSD,1381362,Sep
2023-09-07,El Palacio de los jugos / Lita Foods Inc.,Invoice,008-01931,Arroz a Granel:Parboiled 50 LB -Bolsa Dos Hermanos.,,10.0,27.5,275.0,1121715.61,,Lisset Limpio -020,Cafeteria,1381363,Sep
2023-09-07,El Palacio de los jugos /  EMMA FOOD CORP,Invoice,008-01932,Arroz a Granel:Parboiled 50 LB -Bolsa Dos Hermanos.,,5.0,27.5,137.5,1121853.11,,Lisset Limpio -020,Cafeteria,1381364,Sep
2023-09-07,El Palacio de los jugos / Santa Clara Sabor,Invoice,008-01933,Arroz a Granel:Largo Fino 50 LB -Bolsa Dos Hermanos.,,10.0,21.0,210.0,1122063.11,,Lisset Limpio -020,Cafeteria,1381365,Sep
2023-09-07,Key Foods  / Ivan,Invoice,008-01934,Arroz a Granel:Largo Fino 50 LB -Bolsa Dos Hermanos.,,10.0,21.5,215.0,1122278.11,,Lisset Limpio -020,RETAIL  DSD,1381366,Sep
2023-09-10,Festival Supermarket #1,Invoice,008-01935,Arroz Envasado:Parboiled 5KG Dos Hermanos.,6 / 11lbs,10.0,40.5,405.0,1122683.11,,Lisset Limpio -020,RETAIL  DSD,1381367,Sep
2023-09-10,Festival Supermarket #1,Invoice,008-01935,Arroz Envasado:Parboiled 5KG Dos Hermanos.,6 / 11lbs,2.0,0.0,0.0,1122683.11,,Lisset Limpio -020,RETAIL  DSD,1381368,Sep
2023-09-10,El Palacio de los jugos / Lungos Sabor Inc.,Invoice,008-01936,Arroz a Granel:Largo Fino 50 LB -Bolsa Dos Hermanos.,,1.0,0.0,0.0,1122683.11,,Lisset Limpio -020,Cafeteria,1381369,Sep
2023-09-10,El Palacio de los jugos / Lungos Sabor Inc.,Invoice,008-01936,Arroz a Granel:Parboiled 50 LB -Bolsa Dos Hermanos.,,1.0,0.0,0.0,1122683.11,,Lisset Limpio -020,Cafeteria,1381370,Sep
2023-09-10,Armando Carpio,Invoice,008-01937,Arroz Envasado:Parboiled 1kg Bolsa Dos Hermanos.,.,2.0,0.0,0.0,1122683.11,,Armando Carpio - 017,OTHER,1381371,Sep
2023-09-10,Armando Carpio,Invoice,008-01937,Arroz Envasado:Largo Fino 1kg (Long grain rice) Dos Hermanos,,2.0,0.0,0.0,1122683.11,,Armando Carpio - 017,OTHER,1381372,Sep
2023-09-10,El Palacio de los jugos /  Mires Restaurants,Invoice,008-01938,Arroz a Granel:Largo Fino 50 LB -Bolsa Dos Hermanos.,,6.0,21.0,126.0,1122809.11,,Lisset Limpio -020,Cafeteria,1381373,Sep
2023-09-10,Soriano Brothers PB,Invoice,008-01939,Arroz a Granel:Largo Fino 50 LB -Bolsa Dos Hermanos.,,6.0,21.0,126.0,1122935.11,,Lisset Limpio -020,CAFETERIA y RESTAURANTS,1381374,Sep
2023-09-10,Soriano Brothers PB,Invoice,008-01939,Arroz a Granel:Parboiled 50 LB -Bolsa Dos Hermanos.,,4.0,27.5,110.0,1123045.11,,Lisset Limpio -020,CAFETERIA y RESTAURANTS,1381375,Sep
2023-09-10,El Palacio de los jugos /  EMMA FOOD CORP,Invoice,008-01940,Arroz a Granel:Parboiled 50 LB -Bolsa Dos Hermanos.,,10.0,27.5,275.0,1123320.11,,Lisset Limpio -020,Cafeteria,1381376,Sep
2023-09-10,El Palacio de los jugos / Lita Foods Inc.,Invoice,008-01941,Arroz a Granel:Parboiled 50 LB -Bolsa Dos Hermanos.,,10.0,27.5,275.0,1123595.11,,Lisset Limpio -020,Cafeteria,1381377,Sep
2023-09-10,El Palacio de los jugos / Lita Foods Inc.,Invoice,008-01941,,,,,0.0,1123595.11,,Lisset Limpio -020,Cafeteria,1381378,Sep
2023-09-10,El Palacio de los jugos / Caribe Tropical,Invoice,008-01942,Arroz a Granel:Largo Fino 50 LB -Bolsa Dos Hermanos.,,8.0,21.0,168.0,1123763.11,,Lisset Limpio -020,Cafeteria,1381379,Sep
2023-09-10,El Palacio de los jugos / Caribe Tropical,Invoice,008-01942,Liquids:AS Marinating Sauce (Mojo),,1.0,17.0,17.0,1123780.11,,Lisset Limpio -020,Cafeteria,1381380,Sep
2023-09-10,El Palacio de los jugos / Sahilys Cafe,Invoice,008-01943,Arroz a Granel:Largo Fino 50 LB -Bolsa Dos Hermanos.,,6.0,21.0,126.0,1123906.11,,Lisset Limpio -020,Cafeteria,1381381,Sep
2023-09-14,La Ranchera Meat Market #3,Invoice,008-01945,Arroz a Granel:Largo Fino 50 LB -Bolsa Dos Hermanos.,,20.0,23.0,460.0,1124366.11,,Ruta - 019,CAFETERIA y RESTAURANTS,1381382,Sep
2023-09-14,La Ranchera Meat Market #3,Invoice,008-01945,Arroz Envasado:Largo Fino 1kg (Long grain rice) Dos Hermanos,,1.0,0.0,0.0,1124366.11,,Ruta - 019,CAFETERIA y RESTAURANTS,1381383,Sep
2023-09-14,La Ranchera Meat Market #3,Invoice,008-01945,Arroz a Granel:Largo Fino 50 LB -Bolsa Dos Hermanos.,,1.0,0.0,0.0,1124366.11,,Ruta - 019,CAFETERIA y RESTAURANTS,1381384,Sep
2023-09-14,El Palacio de los jugos / Delicias Criollas (DIAGO FOOD_MILLER),Invoice,008-01946,Arroz a Granel:Parboiled 50 LB -Bolsa Dos Hermanos.,,12.0,26.0,312.0,1124678.11,,Lisset Limpio -020,Cafeteria,1381385,Sep
2023-09-14,El Palacio de los jugos / Sahilys Cafe,Invoice,008-01947,Arroz a Granel:Largo Fino 50 LB -Bolsa Dos Hermanos.,,0.0,,0.0,1124678.11,,Lisset Limpio -020,Cafeteria,1381386,Sep
2023-09-14,El Palacio de los jugos / Lita Foods Inc.,Invoice,008-01948,Arroz a Granel:Parboiled 50 LB -Bolsa Dos Hermanos.,,10.0,27.5,275.0,1124953.11,,Lisset Limpio -020,Cafeteria,1381387,Sep
2023-09-14,El Palacio de los jugos / Santa Clara Sabor,Invoice,008-01949,Arroz a Granel:Largo Fino 50 LB -Bolsa Dos Hermanos.,,10.0,21.0,210.0,1125163.11,,Lisset Limpio -020,Cafeteria,1381388,Sep
2023-09-14,El Palacio de los jugos / Sahilys Cafe,Invoice,008-01950,Arroz a Granel:Largo Fino 50 LB -Bolsa Dos Hermanos.,,0.0,,0.0,1125163.11,,Lisset Limpio -020,Cafeteria,1381389,Sep
2023-09-14,Soriano Brothers PB,Invoice,008-01951,Arroz a Granel:Largo Fino 50 LB -Bolsa Dos Hermanos.,,5.0,21.0,105.0,1125268.11,,Lisset Limpio -020,CAFETERIA y RESTAURANTS,1381390,Sep
2023-09-14,Soriano Brothers PB,Invoice,008-01951,Arroz a Granel:Parboiled 50 LB -Bolsa Dos Hermanos.,,5.0,27.5,137.5,1125405.61,,Lisset Limpio -020,CAFETERIA y RESTAURANTS,1381391,Sep
2023-09-14,BRAVO - Flamingo #3,Invoice,008-01952,Arroz Envasado:Parboiled 5KG Dos Hermanos.,6 / 11lbs,10.0,38.5,385.0,1125790.61,,Ruta - 019,RETAIL  DSD,1381392,Sep
2023-09-14,BRAVO - Flamingo #3,Invoice,008-01952,Arroz Envasado:Parboiled 5KG Dos Hermanos.,6 / 11lbs,2.0,0.0,0.0,1125790.61,,Ruta - 019,RETAIL  DSD,1381393,Sep
2023-09-14,El Palacio de los jugos /  EMMA FOOD CORP,Invoice,008-01953,Arroz a Granel:Parboiled 50 LB -Bolsa Dos Hermanos.,,5.0,27.5,137.5,1125928.11,,Lisset Limpio -020,Cafeteria,1381394,Sep
2023-09-14,El Palacio de los jugos / Caribe Tropical,Invoice,008-01954,Arroz a Granel:Parboiled 50 LB -Bolsa Dos Hermanos.,,9.0,27.5,247.5,1126175.61,,Lisset Limpio -020,Cafeteria,1381395,Sep
2023-09-14,Rey Chavez Distributor Corp,Invoice,008-01955,Arroz a Granel:Parboiled 50 LB -Bolsa Dos Hermanos.,,55.0,25.0,1375.0,1127550.61,,Lisset Limpio -020,WHOLESALER,1381396,Sep
2023-09-14,Amerifood,Invoice,008-01956,Arroz a Granel:Largo Fino 50 LB -Bolsa Dos Hermanos.,,110.0,23.0,2530.0,1130080.61,,Ruta - 019,WHOLESALER,1381397,Sep
2023-09-15,"American Spice Trading Co, Inc.",Invoice,008-01957,Arroz a Granel:Parboiled 50 LB -Bolsa Dos Hermanos.,,1100.0,22.0,24200.0,1154280.61,,Armando Carpio - 017,WHOLESALER MANUFACTURY,1381398,Sep
2023-09-15,"American Spice Trading Co, Inc.",Invoice,008-01958,Arroz a Granel:Parboiled 50 LB -Bolsa Dos Hermanos.,,1100.0,22.0,24200.0,1178480.61,,Armando Carpio - 017,WHOLESALER MANUFACTURY,1381399,Sep
2023-09-18,Albert Deli #2,Invoice,008-01959,Arroz a Granel:Largo Fino 50 LB -Bolsa Dos Hermanos.,,10.0,21.5,215.0,1178695.61,,Lisset Limpio -020,CAFETERIA y RESTAURANTS,1381400,Sep
2023-09-18,Albert Deli #2,Invoice,008-01959,Dry Beans:Dry Beans - Black Beans 50,Dry Black Beans 50 lb,1.0,37.5,37.5,1178733.11,,Lisset Limpio -020,CAFETERIA y RESTAURANTS,1381401,Sep
2023-09-18,Fritanga Momotombo,Invoice,008-01960,Arroz a Granel:Largo Fino 50 LB -Bolsa Dos Hermanos.,,5.0,22.0,110.0,1178843.11,,Lisset Limpio -020,CAFETERIA y RESTAURANTS,1381402,Sep
2023-09-18,El Palacio de los jugos / Caribe Tropical,Invoice,008-01961,Arroz a Granel:Parboiled 50 LB -Bolsa Dos Hermanos.,,10.0,27.5,275.0,1179118.11,,Lisset Limpio -020,Cafeteria,1381403,Sep
2023-09-18,El Palacio de los jugos / Santa Clara Sabor,Invoice,008-01962,Arroz a Granel:Largo Fino 50 LB -Bolsa Dos Hermanos.,,10.0,21.0,210.0,1179328.11,,Lisset Limpio -020,Cafeteria,1381404,Sep
2023-09-18,El Palacio de los jugos / Lita Foods Inc.,Invoice,008-01963,Arroz a Granel:Parboiled 50 LB -Bolsa Dos Hermanos.,,8.0,27.5,220.0,1179548.11,,Lisset Limpio -020,Cafeteria,1381405,Sep
2023-09-18,El Palacio de los jugos /  EMMA FOOD CORP,Invoice,008-01964,Arroz a Granel:Parboiled 50 LB -Bolsa Dos Hermanos.,,9.0,27.5,247.5,1179795.61,,Lisset Limpio -020,Cafeteria,1381406,Sep
2023-09-18,El Palacio de los jugos / Sahilys Cafe,Invoice,008-01965,Arroz a Granel:Largo Fino 50 LB -Bolsa Dos Hermanos.,,7.0,21.0,147.0,1179942.61,,Lisset Limpio -020,Cafeteria,1381407,Sep
2023-09-18,"El Toro Loco Meat Distribution, LLC",Invoice,008-01966,Dry Beans:Dry Beans - Black Beans 50,Dry Black Beans 50 lb,1.0,37.5,37.5,1179980.11,,Lisset Limpio -020,CAFETERIA y RESTAURANTS,1381408,Sep
2023-09-18,Malaga Distributor Corp.,Credit Memo,008-01967,Arroz a Granel:Parboiled 50 LB -Bolsa Dos Hermanos.,,-9.0,25.5,-229.5,1179750.61,,Ruta - 019,RETAIL  DSD,1381409,Sep
2023-09-18,Malaga Distributor Corp.,Credit Memo,008-01968,Varios:Producto vencido/deteriorado (no impacta en inventario),,-11.0,25.5,-280.5,1179470.11,,Ruta - 019,RETAIL  DSD,1381410,Sep
2023-09-18,El Palacio de los jugos / Lita Foods Inc.,Invoice,008-01969,Dry Beans:Dry Beans - Black Beans 50,Dry Black Beans 50 lb,1.0,37.5,37.5,1179507.61,,Lisset Limpio -020,Cafeteria,1381411,Sep
2023-09-18,El Palacio de Los Jugos / Casa mía Food Restaurant inc,Invoice,008-01970,Dry Beans:Dry Beans - Black Beans 50,Dry Black Beans 50 lb,1.0,37.5,37.5,1179545.11,,Lisset Limpio -020,Cafeteria,1381412,Sep
2023-09-18,El Palacio de los jugos / Sahilys Cafe,Invoice,008-01971,Liquids:AS Marinating Sauce (Mojo),,2.0,17.0,34.0,1179579.11,,Lisset Limpio -020,Cafeteria,1381413,Sep
2023-09-18,Price Choice Food Market # 6,Invoice,008-01972,Arroz Envasado:Parboiled 5KG Dos Hermanos.,6 / 11lbs,25.0,38.5,962.5,1180541.61,,Lisset Limpio -020,RETAIL  DSD,1381414,Sep
2023-09-18,Price Choice Food Market # 6,Invoice,008-01972,Arroz Envasado:Parboiled 5KG Dos Hermanos.,6 / 11lbs,6.0,0.0,0.0,1180541.61,,Lisset Limpio -020,RETAIL  DSD,1381415,Sep
2023-09-18,Brito Family Corp.,Invoice,008-01973,Arroz a Granel:Parboiled 50 LB -Bolsa Dos Hermanos.,,110.0,25.5,2805.0,1183346.61,,Lisset Limpio -020,CAFETERIA y RESTAURANTS,1381416,Sep
2023-09-20,Global Supply,Invoice,008-01974,Arroz a Granel:Largo Fino 50 LB -Bolsa Dos Hermanos.,,1.0,0.0,0.0,1183346.61,,Armando Carpio - 017,WHOLESALER,1381417,Sep
2023-09-20,Global Supply,Invoice,008-01974,Arroz a Granel:Largo Fino 50 LB -Bolsa Dos Hermanos.,,1.0,0.0,0.0,1183346.61,,Armando Carpio - 017,WHOLESALER,1381418,Sep
2023-09-20,Global Supply,Invoice,008-01974,Arroz Envasado:Largo Fino 1kg (Long grain rice) Dos Hermanos,,1.0,0.0,0.0,1183346.61,,Armando Carpio - 017,WHOLESALER,1381419,Sep
2023-09-20,Global Supply,Invoice,008-01974,Arroz Envasado:Parboiled 1kg Bolsa Dos Hermanos.,.,1.0,0.0,0.0,1183346.61,,Armando Carpio - 017,WHOLESALER,1381420,Sep
2023-09-21,Soriano Brothers PB,Invoice,008-01975,Arroz a Granel:Largo Fino 50 LB -Bolsa Dos Hermanos.,,6.0,21.0,126.0,1183472.61,,Lisset Limpio -020,CAFETERIA y RESTAURANTS,1381421,Sep
2023-09-21,Soriano Brothers PB,Invoice,008-01975,Arroz a Granel:Parboiled 50 LB -Bolsa Dos Hermanos.,,5.0,25.5,127.5,1183600.11,,Lisset Limpio -020,CAFETERIA y RESTAURANTS,1381422,Sep
2023-09-21,Rey Chavez Distributor Corp,Invoice,008-01976,Arroz a Granel:Parboiled 50 LB -Bolsa Dos Hermanos.,,55.0,25.0,1375.0,1184975.11,,Lisset Limpio -020,WHOLESALER,1381423,Sep
2023-09-21,El Palacio de los jugos /  EMMA FOOD CORP,Invoice,008-01977,Arroz a Granel:Parboiled 50 LB -Bolsa Dos Hermanos.,,9.0,25.5,229.5,1185204.61,,Lisset Limpio -020,Cafeteria,1381424,Sep
2023-09-21,El Palacio de los jugos / Caribe Tropical,Invoice,008-01980,Arroz a Granel:Parboiled 50 LB -Bolsa Dos Hermanos.,,7.0,25.5,178.5,1185383.11,,Lisset Limpio -020,Cafeteria,1381425,Sep
2023-09-21,El Palacio de los jugos / Caribe Tropical,Invoice,008-01980,Liquids:AS Marinating Sauce (Mojo),,1.0,17.0,17.0,1185400.11,,Lisset Limpio -020,Cafeteria,1381426,Sep
2023-09-21,El Palacio de los jugos / Lungos Sabor Inc.,Invoice,008-01981,Arroz a Granel:Largo Fino 50 LB -Bolsa Dos Hermanos.,,6.0,21.0,126.0,1185526.11,,Lisset Limpio -020,Cafeteria,1381427,Sep
2023-09-21,El Palacio de los jugos / Santa Clara Sabor,Invoice,008-01982,Arroz a Granel:Largo Fino 50 LB -Bolsa Dos Hermanos.,,10.0,21.0,210.0,1185736.11,,Lisset Limpio -020,Cafeteria,1381428,Sep
2023-09-21,Los paraditos chinesse,Invoice,008-01983,Arroz a Granel:Largo Fino 50 LB -Bolsa Dos Hermanos.,,10.0,21.0,210.0,1185946.11,,Lisset Limpio -020,CAFETERIA y RESTAURANTS,1381429,Sep
2023-09-21,Los paraditos chinesse,Invoice,008-01983,Arroz a Granel:Parboiled 50 LB -Bolsa Dos Hermanos.,,5.0,25.5,127.5,1186073.61,,Lisset Limpio -020,CAFETERIA y RESTAURANTS,1381430,Sep
2023-09-21,El Palacio de los jugos / Lita Foods Inc.,Invoice,008-01984,Arroz a Granel:Parboiled 50 LB -Bolsa Dos Hermanos.,,8.0,25.5,204.0,1186277.61,,Lisset Limpio -020,Cafeteria,1381431,Sep
2023-09-21,Soriano Brothers,Invoice,008-01985,Arroz a Granel:Largo Fino 50 LB -Bolsa Dos Hermanos.,,20.0,21.0,420.0,1186697.61,,Lisset Limpio -020,CAFETERIA y RESTAURANTS,1381432,Sep
2023-09-21,Soriano Brothers,Invoice,008-01985,Arroz a Granel:Parboiled 50 LB -Bolsa Dos Hermanos.,,20.0,25.5,510.0,1187207.61,,Lisset Limpio -020,CAFETERIA y RESTAURANTS,1381433,Sep
2023-09-21,Sabor Tropical Supermarket #4,Invoice,008-01986,Arroz a Granel:Parboiled 50 LB -Bolsa Dos Hermanos.,,20.0,25.5,510.0,1187717.61,,Lisset Limpio -020,RETAIL  DSD,1381434,Sep
2023-09-21,Festival Supermarket #35- Southgate,Invoice,008-01987,Arroz Envasado:Parboiled 5KG Dos Hermanos.,6 / 11lbs,41.0,40.5,1660.5,1189378.11,,Ruta - 019,RETAIL  DSD,1381435,Sep
2023-09-21,Festival Supermarket #35- Southgate,Invoice,008-01987,Arroz Envasado:Parboiled 5KG Dos Hermanos.,6 / 11lbs,41.0,0.0,0.0,1189378.11,,Ruta - 019,RETAIL  DSD,1381436,Sep
2023-09-25,El Palacio de los jugos / Lita Foods Inc.,Invoice,008-01990,Arroz a Granel:Parboiled 50 LB -Bolsa Dos Hermanos.,,7.0,25.5,178.5,1189556.61,,Lisset Limpio -020,Cafeteria,1381437,Sep
2023-09-25,El Palacio de los jugos / Caribe Tropical,Invoice,008-01991,Arroz a Granel:Parboiled 50 LB -Bolsa Dos Hermanos.,,8.0,25.5,204.0,1189760.61,,Lisset Limpio -020,Cafeteria,1381438,Sep
2023-09-25,El Palacio de los jugos /  EMMA FOOD CORP,Invoice,008-01992,Arroz a Granel:Parboiled 50 LB -Bolsa Dos Hermanos.,,10.0,25.5,255.0,1190015.61,,Lisset Limpio -020,Cafeteria,1381439,Sep
2023-09-25,El Palacio de los jugos / Santa Clara Sabor,Invoice,008-01993,Arroz a Granel:Largo Fino 50 LB -Bolsa Dos Hermanos.,,15.0,21.0,315.0,1190330.61,,Lisset Limpio -020,Cafeteria,1381440,Sep
2023-09-25,El Palacio de los jugos / Sahilys Cafe,Invoice,008-01994,Arroz a Granel:Largo Fino 50 LB -Bolsa Dos Hermanos.,,8.0,21.0,168.0,1190498.61,,Lisset Limpio -020,Cafeteria,1381441,Sep
2023-09-25,El Palacio de los jugos / Sahilys Cafe,Invoice,008-01994,Liquids:AS Marinating Sauce (Mojo),,2.0,17.0,34.0,1190532.61,,Lisset Limpio -020,Cafeteria,1381442,Sep
2023-09-25,El Palacio de los jugos / Lungos Sabor Inc.,Invoice,008-01995,Arroz a Granel:Largo Fino 50 LB -Bolsa Dos Hermanos.,,6.0,21.0,126.0,1190658.61,,Lisset Limpio -020,Cafeteria,1381443,Sep
2023-09-25,Fritanga Momotombo,Invoice,008-01996,Arroz a Granel:Largo Fino 50 LB -Bolsa Dos Hermanos.,,5.0,22.0,110.0,1190768.61,,Lisset Limpio -020,CAFETERIA y RESTAURANTS,1381444,Sep
2023-09-27,Brito Family Corp.,Invoice,008-01997,Arroz a Granel:Parboiled 50 LB -Bolsa Dos Hermanos.,,110.0,25.5,2805.0,1193573.61,,Lisset Limpio -020,CAFETERIA y RESTAURANTS,1381445,Sep
2023-09-27,Fritanga Poneloya,Invoice,008-01998,Arroz a Granel:Largo Fino 50 LB -Bolsa Dos Hermanos.,,5.0,22.0,110.0,1193683.61,,Lisset Limpio -020,CAFETERIA y RESTAURANTS,1381446,Sep
2023-09-27,Food-Star Supermarket,Invoice,008-01999,Arroz Envasado:Largo Fino 1kg (Long grain rice) Dos Hermanos,,10.0,16.5,165.0,1193848.61,,Lisset Limpio -020,RETAIL  DSD,1381447,Sep
2023-09-27,Food-Star Supermarket,Invoice,008-01999,Arroz Envasado:Largo Fino 1kg (Long grain rice) Dos Hermanos,,2.0,0.0,0.0,1193848.61,,Lisset Limpio -020,RETAIL  DSD,1381448,Sep
2023-09-27,Max Food Distributors,Invoice,008-02000,Arroz a Granel:Parboiled 50 LB -Bolsa Dos Hermanos.,,20.0,25.5,510.0,1194358.61,,Lisset Limpio -020,WHOLESALER,1381449,Sep
2023-09-28,Soriano Brothers PB,Invoice,008-02001,Arroz a Granel:Largo Fino 50 LB -Bolsa Dos Hermanos.,,5.0,21.0,105.0,1194463.61,,Lisset Limpio -020,CAFETERIA y RESTAURANTS,1381450,Sep
2023-09-28,Soriano Brothers PB,Invoice,008-02001,Arroz a Granel:Parboiled 50 LB -Bolsa Dos Hermanos.,,5.0,25.5,127.5,1194591.11,,Lisset Limpio -020,CAFETERIA y RESTAURANTS,1381451,Sep
2023-09-28,El Palacio de los jugos / Lita Foods Inc.,Invoice,008-02002,Arroz a Granel:Parboiled 50 LB -Bolsa Dos Hermanos.,,10.0,25.5,255.0,1194846.11,,Lisset Limpio -020,Cafeteria,1381452,Sep
2023-09-28,El Palacio de los jugos / Lita Foods Inc.,Invoice,008-02002,Dry Beans:Dry Beans - Black Beans 50,Dry Black Beans 50 lb,1.0,37.5,37.5,1194883.61,,Lisset Limpio -020,Cafeteria,1381453,Sep
2023-09-28,El Palacio de los jugos / Caribe Tropical,Invoice,008-02003,Arroz a Granel:Parboiled 50 LB -Bolsa Dos Hermanos.,,6.0,25.5,153.0,1195036.61,,Lisset Limpio -020,Cafeteria,1381454,Sep
2023-09-28,El Palacio de los jugos / Caribe Tropical,Invoice,008-02003,Dry Beans:Dry Beans - Black Beans 50,Dry Black Beans 50 lb,2.0,37.5,75.0,1195111.61,,Lisset Limpio -020,Cafeteria,1381455,Sep
2023-09-28,Los Mejores Tamales de Miami,Invoice,008-02004,Arroz a Granel:Largo Fino 50 LB -Bolsa Dos Hermanos.,,2.0,21.0,42.0,1195153.61,,Lisset Limpio -020,CAFETERIA y RESTAURANTS,1381456,Sep
2023-09-28,Sorianos Brothers,Invoice,008-02005,Arroz a Granel:Largo Fino 50 LB -Bolsa Dos Hermanos.,,20.0,21.0,420.0,1195573.61,,Lisset Limpio -020,CAFETERIA y RESTAURANTS,1381457,Sep
2023-09-28,Sorianos Brothers,Invoice,008-02005,Arroz a Granel:Parboiled 50 LB -Bolsa Dos Hermanos.,,20.0,25.5,510.0,1196083.61,,Lisset Limpio -020,CAFETERIA y RESTAURANTS,1381458,Sep
2023-09-28,El Palacio de los jugos / Santa Clara Sabor,Invoice,008-02006,Arroz a Granel:Largo Fino 50 LB -Bolsa Dos Hermanos.,,15.0,21.0,315.0,1196398.61,,Lisset Limpio -020,Cafeteria,1381459,Sep
2023-09-28,El Gallego Supermarket,Invoice,008-02007,Arroz Envasado:Largo Fino 1kg (Long grain rice) Dos Hermanos,,1.0,16.5,16.5,1196415.11,,Lisset Limpio -020,RETAIL  DSD,1381460,Sep
2023-09-28,El Gallego Supermarket,Invoice,008-02007,Arroz Envasado:Parboiled 1kg Bolsa Dos Hermanos.,.,1.0,19.0,19.0,1196434.11,,Lisset Limpio -020,RETAIL  DSD,1381461,Sep
2023-09-28,El Gallego Supermarket,Invoice,008-02007,Arroz a Granel:Parboiled 50 LB -Bolsa Dos Hermanos.,,5.0,25.5,127.5,1196561.61,,Lisset Limpio -020,RETAIL  DSD,1381462,Sep
2023-09-28,El Gallego Supermarket,Invoice,008-02007,Arroz Envasado:Parboiled 1kg Bolsa Dos Hermanos.,.,2.0,0.0,0.0,1196561.61,,Lisset Limpio -020,RETAIL  DSD,1381463,Sep
2023-09-28,El Gallego Supermarket,Invoice,008-02007,Arroz Envasado:Largo Fino 1kg (Long grain rice) Dos Hermanos,,2.0,0.0,0.0,1196561.61,,Lisset Limpio -020,RETAIL  DSD,1381464,Sep
2023-10-01,Soriano Brothers PB,Invoice,008-02008,Arroz a Granel:Largo Fino 50 LB -Bolsa Dos Hermanos.,,5.0,21.0,105.0,1196666.61,,Lisset Limpio -020,CAFETERIA y RESTAURANTS,1381465,Oct
2023-10-01,Soriano Brothers PB,Invoice,008-02008,Arroz a Granel:Parboiled 50 LB -Bolsa Dos Hermanos.,,5.0,25.5,127.5,1196794.11,,Lisset Limpio -020,CAFETERIA y RESTAURANTS,1381466,Oct
2023-10-01,El Palacio de los jugos / Lita Foods Inc.,Invoice,008-02009,Arroz a Granel:Parboiled 50 LB -Bolsa Dos Hermanos.,,10.0,25.5,255.0,1197049.11,,Lisset Limpio -020,Cafeteria,1381467,Oct
2023-10-01,El Palacio de los jugos / Caribe Tropical,Invoice,008-02010,Dry Beans:Dry Beans - Black Beans 50,Dry Black Beans 50 lb,1.0,37.5,37.5,1197086.61,,Lisset Limpio -020,Cafeteria,1381468,Oct
2023-10-01,El Palacio de los jugos / Caribe Tropical,Invoice,008-02010,Arroz a Granel:Parboiled 50 LB -Bolsa Dos Hermanos.,,7.0,25.5,178.5,1197265.11,,Lisset Limpio -020,Cafeteria,1381469,Oct
2023-10-01,El Palacio de los jugos / Caribe Tropical,Invoice,008-02010,Arroz a Granel:Largo Fino 50 LB -Bolsa Dos Hermanos.,,6.0,21.0,126.0,1197391.11,,Lisset Limpio -020,Cafeteria,1381470,Oct
2023-10-01,El Palacio de los jugos / Santa Clara Sabor,Invoice,008-02011,Arroz a Granel:Largo Fino 50 LB -Bolsa Dos Hermanos.,,10.0,21.0,210.0,1197601.11,,Lisset Limpio -020,Cafeteria,1381471,Oct
2023-10-01,El Palacio de los jugos / Sahilys Cafe,Invoice,008-02012,Liquids:AS Marinating Sauce (Mojo),,2.0,17.0,34.0,1197635.11,,Lisset Limpio -020,Cafeteria,1381472,Oct
2023-10-01,El Palacio de los jugos / Sahilys Cafe,Invoice,008-02012,Arroz a Granel:Largo Fino 50 LB -Bolsa Dos Hermanos.,,6.0,21.0,126.0,1197761.11,,Lisset Limpio -020,Cafeteria,1381473,Oct
2023-10-01,Fritanga Momotombo,Invoice,008-02013,Arroz a Granel:Largo Fino 50 LB -Bolsa Dos Hermanos.,,5.0,21.0,105.0,1197866.11,,Lisset Limpio -020,CAFETERIA y RESTAURANTS,1381474,Oct
2023-10-02,Soriano Brothers,Invoice,008-02014,Arroz a Granel:Largo Fino 50 LB -Bolsa Dos Hermanos.,,20.0,21.0,420.0,1198286.11,,Lisset Limpio -020,CAFETERIA y RESTAURANTS,1381475,Oct
2023-10-02,Soriano Brothers,Invoice,008-02014,Arroz a Granel:Parboiled 50 LB -Bolsa Dos Hermanos.,,25.0,25.5,637.5,1198923.61,,Lisset Limpio -020,CAFETERIA y RESTAURANTS,1381476,Oct
2023-10-02,Brito Family Corp.,Invoice,008-02015,Arroz a Granel:Largo Fino 50 LB -Bolsa Dos Hermanos.,,220.0,21.0,4620.0,1203543.61,,Lisset Limpio -020,CAFETERIA y RESTAURANTS,1381477,Oct
2023-10-03,Key Foods  / Ivan,Invoice,008-02016,Arroz a Granel:Largo Fino 50 LB -Bolsa Dos Hermanos.,,25.0,21.5,537.5,1204081.11,,Lisset Limpio -020,RETAIL  DSD,1381478,Oct
2023-10-03,Extra Supermarket,Invoice,008-02017,Arroz Envasado:Parboiled 5KG Dos Hermanos.,6 / 11lbs,10.0,40.5,405.0,1204486.11,,Lisset Limpio -020,RETAIL  DSD,1381479,Oct
2023-10-03,Extra Supermarket,Invoice,008-02017,Arroz Envasado:Parboiled 5KG Dos Hermanos.,6 / 11lbs,2.0,0.0,0.0,1204486.11,,Lisset Limpio -020,RETAIL  DSD,1381480,Oct
2023-10-03,"Criollos Food USA, LLC",Invoice,008-02018,Arroz a Granel:Parboiled 50 LB -Bolsa Dos Hermanos.,,220.0,25.5,5610.0,1210096.11,,Armando Carpio - 017,WHOLESALER,1381481,Oct
2023-10-05,El Palacio de los jugos / Santa Clara Sabor,Invoice,008-02019,Arroz a Granel:Largo Fino 50 LB -Bolsa Dos Hermanos.,,15.0,21.0,315.0,1210411.11,,Lisset Limpio -020,Cafeteria,1381482,Oct
2023-10-05,Miavana & Family,Invoice,008-02020,Arroz a Granel:Parboiled 50 LB -Bolsa Dos Hermanos.,Verbal order,330.0,22.0,7260.0,1217671.11,,Armando Carpio - 017,Distributor,1381483,Oct
2023-10-05,El Palacio de los jugos /  Mires Restaurants,Invoice,008-02021,Arroz a Granel:Largo Fino 50 LB -Bolsa Dos Hermanos.,,6.0,21.0,126.0,1217797.11,,Lisset Limpio -020,Cafeteria,1381484,Oct
2023-10-05,El Palacio de los jugos / Lita Foods Inc.,Invoice,008-02022,Arroz a Granel:Parboiled 50 LB -Bolsa Dos Hermanos.,,8.0,25.5,204.0,1218001.11,,Lisset Limpio -020,Cafeteria,1381485,Oct
2023-10-05,El Palacio de los jugos / Caribe Tropical,Invoice,008-02023,Arroz a Granel:Largo Fino 50 LB -Bolsa Dos Hermanos.,,6.0,21.0,126.0,1218127.11,,Lisset Limpio -020,Cafeteria,1381486,Oct
2023-10-05,El Palacio de los jugos / Caribe Tropical,Invoice,008-02023,Arroz a Granel:Parboiled 50 LB -Bolsa Dos Hermanos.,,9.0,25.5,229.5,1218356.61,,Lisset Limpio -020,Cafeteria,1381487,Oct
2023-10-05,El Palacio de los jugos / Caribe Tropical,Invoice,008-02023,Liquids:AS Marinating Sauce (Mojo),,1.0,17.0,17.0,1218373.61,,Lisset Limpio -020,Cafeteria,1381488,Oct
2023-10-05,El Palacio de los jugos / Sahilys Cafe,Invoice,008-02024,Liquids:AS Marinating Sauce (Mojo),,2.0,17.0,34.0,1218407.61,,Lisset Limpio -020,Cafeteria,1381489,Oct
2023-10-05,El Palacio de los jugos / Sahilys Cafe,Invoice,008-02024,Arroz a Granel:Largo Fino 50 LB -Bolsa Dos Hermanos.,,6.0,21.0,126.0,1218533.61,,Lisset Limpio -020,Cafeteria,1381490,Oct
2023-10-05,Havana Club Cafe and Restaurant,Invoice,008-02025,Arroz a Granel:Parboiled 50 LB -Bolsa Dos Hermanos.,,10.0,25.5,255.0,1218788.61,,Armando Carpio - 017,CAFETERIA y RESTAURANTS,1381491,Oct
2023-10-05,Havana Club Cafe and Restaurant,Invoice,008-02025,Arroz a Granel:Largo Fino 50 LB -Bolsa Dos Hermanos.,,5.0,22.5,112.5,1218901.11,,Armando Carpio - 017,CAFETERIA y RESTAURANTS,1381492,Oct
2023-10-05,Havana Club Cafe and Restaurant,Invoice,008-02025,Liquids:AS Marinating Sauce (Mojo),,2.0,18.5,37.0,1218938.11,,Armando Carpio - 017,CAFETERIA y RESTAURANTS,1381493,Oct
2023-10-05,Havana Club Cafe and Restaurant,Invoice,008-02025,Liquids:AS Bitter Orange,,2.0,15.9,31.8,1218969.91,,Armando Carpio - 017,CAFETERIA y RESTAURANTS,1381494,Oct
2023-10-05,Havana Club Cafe and Restaurant,Invoice,008-02025,Dry Beans:Dry Beans - Black Beans 50,Dry Black Beans 50 lb,1.0,37.5,37.5,1219007.41,,Armando Carpio - 017,CAFETERIA y RESTAURANTS,1381495,Oct
2023-10-09,Fritanga Momotombo,Invoice,008-02026,Arroz a Granel:Largo Fino 50 LB -Bolsa Dos Hermanos.,,5.0,22.0,110.0,1219117.41,,Lisset Limpio -020,CAFETERIA y RESTAURANTS,1381496,Oct
2023-10-09,Soriano Brothers PB,Invoice,008-02027,Arroz a Granel:Largo Fino 50 LB -Bolsa Dos Hermanos.,,5.0,21.0,105.0,1219222.41,,Lisset Limpio -020,CAFETERIA y RESTAURANTS,1381497,Oct
2023-10-09,Soriano Brothers PB,Invoice,008-02027,Arroz a Granel:Parboiled 50 LB -Bolsa Dos Hermanos.,,5.0,25.5,127.5,1219349.91,,Lisset Limpio -020,CAFETERIA y RESTAURANTS,1381498,Oct
2023-10-09,El Palacio de los jugos / Lita Foods Inc.,Invoice,008-02028,Arroz a Granel:Parboiled 50 LB -Bolsa Dos Hermanos.,,8.0,25.5,204.0,1219553.91,,Lisset Limpio -020,Cafeteria,1381499,Oct
2023-10-09,El Palacio de los jugos / Caribe Tropical,Invoice,008-02029,Arroz a Granel:Largo Fino 50 LB -Bolsa Dos Hermanos.,,6.0,21.0,126.0,1219679.91,,Lisset Limpio -020,Cafeteria,1381500,Oct
2023-10-09,El Palacio de los jugos / Caribe Tropical,Invoice,008-02029,Arroz a Granel:Parboiled 50 LB -Bolsa Dos Hermanos.,,7.0,25.5,178.5,1219858.41,,Lisset Limpio -020,Cafeteria,1381501,Oct
2023-10-09,El Palacio de los jugos / Santa Clara Sabor,Invoice,008-02030,Arroz a Granel:Largo Fino 50 LB -Bolsa Dos Hermanos.,,15.0,21.0,315.0,1220173.41,,Lisset Limpio -020,Cafeteria,1381502,Oct
2023-10-09,Los paraditos chinesse,Invoice,008-02031,Arroz a Granel:Largo Fino 50 LB -Bolsa Dos Hermanos.,,10.0,21.0,210.0,1220383.41,,Lisset Limpio -020,CAFETERIA y RESTAURANTS,1381503,Oct
2023-10-09,Los paraditos chinesse,Invoice,008-02031,Arroz a Granel:Parboiled 50 LB -Bolsa Dos Hermanos.,,10.0,25.5,255.0,1220638.41,,Lisset Limpio -020,CAFETERIA y RESTAURANTS,1381504,Oct
2023-10-11,Sorianos Brothers,Invoice,008-02032,Arroz a Granel:Parboiled 50 LB -Bolsa Dos Hermanos.,,20.0,25.5,510.0,1221148.41,,Lisset Limpio -020,CAFETERIA y RESTAURANTS,1381505,Oct
2023-10-11,Bake Mark USA LLC,Credit Memo,008-02033,Varios:Producto vencido/deteriorado (no impacta en inventario),adjunto,-1.0,61.5,-61.5,1221086.91,,Armando Carpio - 017,WHOLESALER MANUFACTURY,1381506,Oct
2023-10-12,Family and Son,Invoice,008-02034,Arroz a Granel:Parboiled 50 LB -Bolsa Dos Hermanos.,,1100.0,21.75,23925.0,1245011.91,,Armando Carpio - 017,WHOLESALER MANUFACTURY,1381507,Oct
2023-10-12,El Palacio de los jugos / Santa Clara Sabor,Credit Memo,008-02035,Varios:Producto vencido/deteriorado (no impacta en inventario),,-1.0,102.0,-102.0,1244909.91,,Lisset Limpio -020,Cafeteria,1381508,Oct
2023-10-12,Soriano Brothers PB,Invoice,008-02036,Arroz a Granel:Largo Fino 50 LB -Bolsa Dos Hermanos.,,5.0,21.0,105.0,1245014.91,,Lisset Limpio -020,CAFETERIA y RESTAURANTS,1381509,Oct
2023-10-12,Soriano Brothers PB,Invoice,008-02036,Arroz a Granel:Parboiled 50 LB -Bolsa Dos Hermanos.,,5.0,25.5,127.5,1245142.41,,Lisset Limpio -020,CAFETERIA y RESTAURANTS,1381510,Oct
2023-10-12,El Palacio de los jugos /  Mires Restaurants,Invoice,008-02037,Arroz a Granel:Largo Fino 50 LB -Bolsa Dos Hermanos.,,3.0,21.0,63.0,1245205.41,,Lisset Limpio -020,Cafeteria,1381511,Oct
2023-10-12,El Palacio de los jugos / Lita Foods Inc.,Invoice,008-02038,Arroz a Granel:Parboiled 50 LB -Bolsa Dos Hermanos.,,10.0,25.5,255.0,1245460.41,,Lisset Limpio -020,Cafeteria,1381512,Oct
2023-10-12,El Palacio de los jugos /  EMMA FOOD CORP,Invoice,008-02039,Arroz a Granel:Largo Fino 50 LB -Bolsa Dos Hermanos.,,8.0,21.0,168.0,1245628.41,,Lisset Limpio -020,Cafeteria,1381513,Oct
2023-10-12,El Palacio de los jugos / Delicias Criollas (DIAGO FOOD_MILLER),Invoice,008-02040,Arroz a Granel:Parboiled 50 LB -Bolsa Dos Hermanos.,,12.0,25.5,306.0,1245934.41,,Lisset Limpio -020,Cafeteria,1381514,Oct
2023-10-12,El Palacio de los jugos / Sahilys Cafe,Invoice,008-02041,Liquids:AS Marinating Sauce (Mojo),,2.0,17.0,34.0,1245968.41,,Lisset Limpio -020,Cafeteria,1381515,Oct
2023-10-12,El Palacio de los jugos / Sahilys Cafe,Invoice,008-02041,Arroz a Granel:Largo Fino 50 LB -Bolsa Dos Hermanos.,,6.0,21.0,126.0,1246094.41,,Lisset Limpio -020,Cafeteria,1381516,Oct
2023-10-12,Fritanga Poneloya,Invoice,008-02042,Arroz a Granel:Largo Fino 50 LB -Bolsa Dos Hermanos.,,4.0,22.0,88.0,1246182.41,,Lisset Limpio -020,CAFETERIA y RESTAURANTS,1381517,Oct
2023-10-12,Pacifico Chinese Restaurant,Invoice,008-02043,Arroz a Granel:Parboiled 50 LB -Bolsa Dos Hermanos.,,10.0,25.5,255.0,1246437.41,,Lisset Limpio -020,CAFETERIA y RESTAURANTS,1381518,Oct
2023-10-12,Los Mejores Tamales de Miami,Invoice,008-02044,Arroz a Granel:Largo Fino 50 LB -Bolsa Dos Hermanos.,,5.0,21.0,105.0,1246542.41,,Lisset Limpio -020,CAFETERIA y RESTAURANTS,1381519,Oct
2023-10-13,El Palacio de los jugos / Santa Clara Sabor,Invoice,008-02045,Arroz a Granel:Largo Fino 50 LB -Bolsa Dos Hermanos.,,20.0,21.0,420.0,1246962.41,,Lisset Limpio -020,Cafeteria,1381520,Oct
2023-10-13,Family and Son,Invoice,008-02046,Arroz a Granel:Parboiled 50 LB -Bolsa Dos Hermanos.,,1100.0,21.75,23925.0,1270887.41,,Armando Carpio - 017,WHOLESALER MANUFACTURY,1381521,Oct
2023-10-13,Family and Son,Invoice,008-02047,Arroz a Granel:Parboiled 50 LB -Bolsa Dos Hermanos.,,1100.0,21.75,23925.0,1294812.41,,Armando Carpio - 017,WHOLESALER MANUFACTURY,1381522,Oct
2023-10-16,El Palacio de Los Jugos / Casa mía Food Restaurant inc,Invoice,008-02048,Arroz a Granel:Parboiled 50 LB -Bolsa Dos Hermanos.,,12.0,25.5,306.0,1295118.41,,Lisset Limpio -020,Cafeteria,1381523,Oct
2023-10-16,Fritanga Momotombo,Invoice,008-02049,Arroz a Granel:Largo Fino 50 LB -Bolsa Dos Hermanos.,,0.0,,0.0,1295118.41,,Lisset Limpio -020,CAFETERIA y RESTAURANTS,1381524,Oct
2023-10-16,El Palacio de los jugos / Sahilys Cafe,Invoice,008-02050,Arroz a Granel:Largo Fino 50 LB -Bolsa Dos Hermanos.,,5.0,21.0,105.0,1295223.41,,Lisset Limpio -020,Cafeteria,1381525,Oct
2023-10-16,El Palacio de los jugos / Sahilys Cafe,Invoice,008-02050,Liquids:AS Marinating Sauce (Mojo),,2.0,17.0,34.0,1295257.41,,Lisset Limpio -020,Cafeteria,1381526,Oct
2023-10-16,El Palacio de los jugos / Lita Foods Inc.,Invoice,008-02051,Arroz a Granel:Parboiled 50 LB -Bolsa Dos Hermanos.,,10.0,25.5,255.0,1295512.41,,Lisset Limpio -020,Cafeteria,1381527,Oct
2023-10-16,El Palacio de los jugos / Caribe Tropical,Invoice,008-02052,Arroz a Granel:Largo Fino 50 LB -Bolsa Dos Hermanos.,,5.0,21.0,105.0,1295617.41,,Lisset Limpio -020,Cafeteria,1381528,Oct
2023-10-16,El Palacio de los jugos / Caribe Tropical,Invoice,008-02052,Dry Beans:Dry Beans - Black Beans 50,Dry Black Beans 50 lb,1.0,37.5,37.5,1295654.91,,Lisset Limpio -020,Cafeteria,1381529,Oct
2023-10-16,El Palacio de los jugos / Caribe Tropical,Invoice,008-02052,Arroz a Granel:Parboiled 50 LB -Bolsa Dos Hermanos.,,9.0,25.5,229.5,1295884.41,,Lisset Limpio -020,Cafeteria,1381530,Oct
2023-10-16,El Palacio de los jugos /  EMMA FOOD CORP,Invoice,008-02053,Arroz a Granel:Largo Fino 50 LB -Bolsa Dos Hermanos.,,6.0,21.0,126.0,1296010.41,,Lisset Limpio -020,Cafeteria,1381531,Oct
2023-10-16,Sorianos Brothers,Invoice,008-02054,Arroz a Granel:Largo Fino 50 LB -Bolsa Dos Hermanos.,,20.0,21.0,420.0,1296430.41,,Lisset Limpio -020,CAFETERIA y RESTAURANTS,1381532,Oct
2023-10-16,Sorianos Brothers,Invoice,008-02054,Arroz a Granel:Parboiled 50 LB -Bolsa Dos Hermanos.,,20.0,25.5,510.0,1296940.41,,Lisset Limpio -020,CAFETERIA y RESTAURANTS,1381533,Oct
2023-10-16,El Palacio de los jugos /  Mires Restaurants,Invoice,008-02055,Arroz a Granel:Largo Fino 50 LB -Bolsa Dos Hermanos.,,3.0,21.0,63.0,1297003.41,,Lisset Limpio -020,Cafeteria,1381534,Oct
2023-10-16,El Palacio de los jugos /  Mires Restaurants,Invoice,008-02055,Arroz a Granel:Parboiled 50 LB -Bolsa Dos Hermanos.,,3.0,25.5,76.5,1297079.91,,Lisset Limpio -020,Cafeteria,1381535,Oct
2023-10-16,"Meat Club Market, LLC.",Invoice,008-02056,Arroz Envasado:Sushi Rice Dos Hermanos 5kg.,,12.0,10.0,120.0,1297199.91,,Lisset Limpio -020,RETAIL  DSD,1381536,Oct
2023-10-16,"Meat Club Market, LLC.",Invoice,008-02056,Arroz Envasado:Sushi Rice Dos Hermanos.,.,1.0,20.0,20.0,1297219.91,,Lisset Limpio -020,RETAIL  DSD,1381537,Oct
2023-10-16,Key Food / Holywood,Invoice,008-02057,Arroz Envasado:Largo Fino 1kg (Long grain rice) Dos Hermanos,,10.0,16.5,165.0,1297384.91,,Lisset Limpio -020,RETAIL  DSD,1381538,Oct
2023-10-16,Key Food / Holywood,Invoice,008-02057,Arroz Envasado:Parboiled 5KG Dos Hermanos.,6 / 11lbs,5.0,40.5,202.5,1297587.41,,Lisset Limpio -020,RETAIL  DSD,1381539,Oct
2023-10-16,Key Food / Holywood,Invoice,008-02057,Arroz Envasado:Largo Fino 1kg (Long grain rice) Dos Hermanos,,2.0,0.0,0.0,1297587.41,,Lisset Limpio -020,RETAIL  DSD,1381540,Oct
2023-10-16,Key Food / Holywood,Invoice,008-02057,Arroz Envasado:Parboiled 5KG Dos Hermanos.,6 / 11lbs,1.0,0.0,0.0,1297587.41,,Lisset Limpio -020,RETAIL  DSD,1381541,Oct
2023-10-16,El Palacio de los jugos / Santa Clara Sabor,Invoice,008-02058,Arroz a Granel:Largo Fino 50 LB -Bolsa Dos Hermanos.,,15.0,21.0,315.0,1297902.41,,Lisset Limpio -020,Cafeteria,1381542,Oct
2023-10-16,Food Fair Plantation Corp,Invoice,008-02059,Arroz Envasado:Parboiled 5KG Dos Hermanos.,6 / 11lbs,21.0,40.5,850.5,1298752.91,,Armando Carpio - 017,RETAIL  DSD,1381543,Oct
2023-10-16,Food Fair Plantation Corp,Invoice,008-02059,Arroz Envasado:Parboiled 5KG Dos Hermanos.,6 / 11lbs,20.0,0.0,0.0,1298752.91,,Armando Carpio - 017,RETAIL  DSD,1381544,Oct
2023-10-16,Food Fair Plantation Corp,Invoice,008-02059,Arroz a Granel:Parboiled 50 LB -Bolsa Dos Hermanos.,,5.0,24.5,122.5,1298875.41,,Armando Carpio - 017,RETAIL  DSD,1381545,Oct
2023-10-16,Ideal Food Basket Davie Cafeteria,Invoice,008-02060,Arroz a Granel:Largo Fino 50 LB -Bolsa Dos Hermanos.,,8.0,23.0,184.0,1299059.41,,Armando Carpio - 017,CAFETERIA y RESTAURANTS,1381546,Oct
2023-10-16,"YummmyCo, Inc",Invoice,008-02061,Arroz a Granel:Parboiled 50 LB -Bolsa Dos Hermanos.,,55.0,24.53,1349.15,1300408.56,,Armando Carpio - 017,WHOLESALER,1381547,Oct
2023-10-18,Soriano Brothers,Invoice,008-02062,Arroz a Granel:Largo Fino 50 LB -Bolsa Dos Hermanos.,,20.0,21.0,420.0,1300828.56,,Lisset Limpio -020,CAFETERIA y RESTAURANTS,1381548,Oct
2023-10-18,Soriano Brothers,Invoice,008-02062,Arroz a Granel:Parboiled 50 LB -Bolsa Dos Hermanos.,,20.0,25.5,510.0,1301338.56,,Lisset Limpio -020,CAFETERIA y RESTAURANTS,1381549,Oct
2023-10-18,El Gallego Supermarket,Invoice,008-02063,Arroz a Granel:Parboiled 50 LB -Bolsa Dos Hermanos.,,5.0,25.5,127.5,1301466.06,,Lisset Limpio -020,RETAIL  DSD,1381550,Oct
2023-10-18,El Gallego Supermarket,Invoice,008-02063,Dry Beans:Dry Beans - Black Beans 50,Dry Black Beans 50 lb,1.0,37.5,37.5,1301503.56,,Lisset Limpio -020,RETAIL  DSD,1381551,Oct
2023-10-20,El Palacio de los jugos /  Mires Restaurants,Invoice,008-02064,Arroz a Granel:Largo Fino 50 LB -Bolsa Dos Hermanos.,,6.0,21.0,126.0,1301629.56,,Lisset Limpio -020,Cafeteria,1381552,Oct
2023-10-20,El Palacio de los jugos /  Mires Restaurants,Invoice,008-02064,Arroz a Granel:Parboiled 50 LB -Bolsa Dos Hermanos.,,6.0,25.5,153.0,1301782.56,,Lisset Limpio -020,Cafeteria,1381553,Oct
2023-10-20,Soriano Brothers PB,Invoice,008-02065,Arroz a Granel:Largo Fino 50 LB -Bolsa Dos Hermanos.,,5.0,21.0,105.0,1301887.56,,Lisset Limpio -020,CAFETERIA y RESTAURANTS,1381554,Oct
2023-10-20,Soriano Brothers PB,Invoice,008-02065,Arroz a Granel:Parboiled 50 LB -Bolsa Dos Hermanos.,,5.0,25.5,127.5,1302015.06,,Lisset Limpio -020,CAFETERIA y RESTAURANTS,1381555,Oct
2023-10-20,El Palacio de Los Jugos / Casa mía Food Restaurant inc,Invoice,008-02066,Arroz a Granel:Parboiled 50 LB -Bolsa Dos Hermanos.,,10.0,25.5,255.0,1302270.06,,Lisset Limpio -020,Cafeteria,1381556,Oct
2023-10-20,El Palacio de los jugos / Lita Foods Inc.,Invoice,008-02067,Arroz a Granel:Parboiled 50 LB -Bolsa Dos Hermanos.,,10.0,25.5,255.0,1302525.06,,Lisset Limpio -020,Cafeteria,1381557,Oct
2023-10-20,Rey Chavez Distributor Corp,Invoice,008-02068,Arroz a Granel:Parboiled 50 LB -Bolsa Dos Hermanos.,,55.0,25.0,1375.0,1303900.06,,Lisset Limpio -020,WHOLESALER,1381558,Oct
2023-10-20,El Palacio de los jugos /  EMMA FOOD CORP,Invoice,008-02069,Arroz a Granel:Largo Fino 50 LB -Bolsa Dos Hermanos.,,6.0,21.0,126.0,1304026.06,,Lisset Limpio -020,Cafeteria,1381559,Oct
2023-10-20,El Palacio de los jugos / Delicias Criollas (DIAGO FOOD_MILLER),Invoice,008-02070,Arroz a Granel:Parboiled 50 LB -Bolsa Dos Hermanos.,,12.0,25.5,306.0,1304332.06,,Lisset Limpio -020,Cafeteria,1381560,Oct
2023-10-20,Fritanga Momotombo,Invoice,008-02071,Arroz a Granel:Largo Fino 50 LB -Bolsa Dos Hermanos.,,5.0,22.0,110.0,1304442.06,,Lisset Limpio -020,CAFETERIA y RESTAURANTS,1381561,Oct
2023-10-20,El Palacio de los jugos / Caribe Tropical,Invoice,008-02072,Arroz a Granel:Largo Fino 50 LB -Bolsa Dos Hermanos.,,6.0,21.0,126.0,1304568.06,,Lisset Limpio -020,Cafeteria,1381562,Oct
2023-10-20,El Palacio de los jugos / Caribe Tropical,Invoice,008-02072,Arroz a Granel:Parboiled 50 LB -Bolsa Dos Hermanos.,,6.0,25.5,153.0,1304721.06,,Lisset Limpio -020,Cafeteria,1381563,Oct
2023-10-20,El Palacio de los jugos / Caribe Tropical,Invoice,008-02072,Dry Beans:Dry Beans - Black Beans 50,Dry Black Beans 50 lb,1.0,37.5,37.5,1304758.56,,Lisset Limpio -020,Cafeteria,1381564,Oct
2023-10-20,El Palacio de los jugos / Santa Clara Sabor,Invoice,008-02073,Arroz a Granel:Largo Fino 50 LB -Bolsa Dos Hermanos.,,15.0,21.0,315.0,1305073.56,,Lisset Limpio -020,Cafeteria,1381565,Oct
2023-10-20,El Palacio de los jugos /  Nanos Latin Foods,Invoice,008-02074,Arroz a Granel:Largo Fino 50 LB -Bolsa Dos Hermanos.,,10.0,21.0,210.0,1305283.56,,Lisset Limpio -020,Cafeteria,1381566,Oct
2023-10-23,China Buffet,Invoice,008-02075,Arroz a Granel:Parboiled 50 LB -Bolsa Dos Hermanos.,,5.0,25.5,127.5,1305411.06,,Lisset Limpio -020,CAFETERIA y RESTAURANTS,1381567,Oct
2023-10-23,Los paraditos chinesse,Invoice,008-02076,Arroz a Granel:Largo Fino 50 LB -Bolsa Dos Hermanos.,,10.0,21.0,210.0,1305621.06,,Lisset Limpio -020,CAFETERIA y RESTAURANTS,1381568,Oct
2023-10-23,Los paraditos chinesse,Invoice,008-02076,Arroz a Granel:Parboiled 50 LB -Bolsa Dos Hermanos.,,2.0,25.5,51.0,1305672.06,,Lisset Limpio -020,CAFETERIA y RESTAURANTS,1381569,Oct
2023-10-23,El Palacio de los jugos / Sahilys Cafe,Invoice,008-02077,Liquids:AS Marinating Sauce (Mojo),,2.0,17.0,34.0,1305706.06,,Lisset Limpio -020,Cafeteria,1381570,Oct
2023-10-23,El Palacio de los jugos / Sahilys Cafe,Invoice,008-02077,Arroz a Granel:Largo Fino 50 LB -Bolsa Dos Hermanos.,,6.0,21.0,126.0,1305832.06,,Lisset Limpio -020,Cafeteria,1381571,Oct
2023-10-23,El Palacio de Los Jugos / Casa mía Food Restaurant inc,Invoice,008-02078,Arroz a Granel:Parboiled 50 LB -Bolsa Dos Hermanos.,,12.0,25.5,306.0,1306138.06,,Lisset Limpio -020,Cafeteria,1381572,Oct
2023-10-23,El Palacio de los jugos / Lita Foods Inc.,Invoice,008-02079,Arroz a Granel:Parboiled 50 LB -Bolsa Dos Hermanos.,,8.0,25.5,204.0,1306342.06,,Lisset Limpio -020,Cafeteria,1381573,Oct
2023-10-23,El Palacio de los jugos / Santa Clara Sabor,Invoice,008-02080,Arroz a Granel:Largo Fino 50 LB -Bolsa Dos Hermanos.,,10.0,21.0,210.0,1306552.06,,Lisset Limpio -020,Cafeteria,1381574,Oct
2023-10-23,El Palacio de los jugos /  Nanos Latin Foods,Invoice,008-02081,Arroz a Granel:Largo Fino 50 LB -Bolsa Dos Hermanos.,,10.0,21.0,210.0,1306762.06,,Lisset Limpio -020,Cafeteria,1381575,Oct
2023-10-23,El Palacio de los jugos /  EMMA FOOD CORP,Invoice,008-02082,Arroz a Granel:Largo Fino 50 LB -Bolsa Dos Hermanos.,,6.0,21.0,126.0,1306888.06,,Lisset Limpio -020,Cafeteria,1381576,Oct
2023-10-23,Festival Supermarket #1,Invoice,008-02083,Arroz Envasado:Parboiled 5KG Dos Hermanos.,6 / 11lbs,10.0,40.5,405.0,1307293.06,,Lisset Limpio -020,RETAIL  DSD,1381577,Oct
2023-10-23,Festival Supermarket #1,Invoice,008-02083,Arroz Envasado:Parboiled 5KG Dos Hermanos.,6 / 11lbs,2.0,0.0,0.0,1307293.06,,Lisset Limpio -020,RETAIL  DSD,1381578,Oct
2023-10-23,Albert Deli #2,Invoice,008-02084,Arroz a Granel:Largo Fino 50 LB -Bolsa Dos Hermanos.,,10.0,23.0,230.0,1307523.06,,Lisset Limpio -020,CAFETERIA y RESTAURANTS,1381579,Oct
2023-10-23,Albert Deli #2,Invoice,008-02084,Dry Beans:Dry Beans - Black Beans 50,Dry Black Beans 50 lb,2.0,37.5,75.0,1307598.06,,Lisset Limpio -020,CAFETERIA y RESTAURANTS,1381580,Oct
2023-10-23,Sedanos Supermarkets #43,Invoice,008-02085,Arroz Envasado:Parboiled 5KG Dos Hermanos.,6 / 11lbs,5.0,40.5,202.5,1307800.56,,Lisset Limpio -020,RETAIL SEDANOS,1381581,Oct
2023-10-23,Sedanos Supermarkets #43,Invoice,008-02085,Arroz Envasado:Parboiled 5KG Dos Hermanos.,6 / 11lbs,5.0,0.0,0.0,1307800.56,,Lisset Limpio -020,RETAIL SEDANOS,1381582,Oct
2023-10-23,Sedanos Supermarkets #43,Invoice,008-02085,,Discount,-202.5,0.02,-4.05,1307796.51,,Lisset Limpio -020,RETAIL SEDANOS,1381583,Oct
2023-10-23,Sedanos Supermarkets #8,Invoice,008-02086,Arroz Envasado:Parboiled 5KG Dos Hermanos.,6 / 11lbs,11.0,40.5,445.5,1308242.01,,Lisset Limpio -020,RETAIL SEDANOS,1381584,Oct
2023-10-23,Sedanos Supermarkets #8,Invoice,008-02086,Arroz Envasado:Parboiled 5KG Dos Hermanos.,6 / 11lbs,11.0,0.0,0.0,1308242.01,,Lisset Limpio -020,RETAIL SEDANOS,1381585,Oct
2023-10-23,Sedanos Supermarkets #8,Invoice,008-02086,,Discount,-445.5,0.02,-8.91,1308233.1,,Lisset Limpio -020,RETAIL SEDANOS,1381586,Oct
2023-10-23,Sedanos Supermarkets #26,Invoice,008-02087,Arroz Envasado:Parboiled 5KG Dos Hermanos.,6 / 11lbs,9.0,40.5,364.5,1308597.6,,Ruta - 019,RETAIL SEDANOS,1381587,Oct
2023-10-23,Sedanos Supermarkets #26,Invoice,008-02087,Arroz Envasado:Parboiled 5KG Dos Hermanos.,6 / 11lbs,9.0,0.0,0.0,1308597.6,,Ruta - 019,RETAIL SEDANOS,1381588,Oct
2023-10-23,Sedanos Supermarkets #26,Invoice,008-02087,,Discount,,,-7.29,1308590.31,,Ruta - 019,RETAIL SEDANOS,1381589,Oct
2023-10-23,Sedanos Supermarkets #22,Invoice,008-02088,Arroz Envasado:Parboiled 5KG Dos Hermanos.,6 / 11lbs,3.0,40.5,121.5,1308711.81,,Lisset Limpio -020,RETAIL SEDANOS,1381590,Oct
2023-10-23,Sedanos Supermarkets #22,Invoice,008-02088,Arroz Envasado:Parboiled 5KG Dos Hermanos.,6 / 11lbs,3.0,0.0,0.0,1308711.81,,Lisset Limpio -020,RETAIL SEDANOS,1381591,Oct
2023-10-23,Sedanos Supermarkets #22,Invoice,008-02088,,Discount,-121.5,0.02,-2.43,1308709.38,,Lisset Limpio -020,RETAIL SEDANOS,1381592,Oct
2023-10-23,Sedanos Supermarkets #16,Invoice,008-02089,Arroz Envasado:Parboiled 5KG Dos Hermanos.,6 / 11lbs,17.0,40.5,688.5,1309397.88,,Lisset Limpio -020,RETAIL SEDANOS,1381593,Oct
2023-10-23,Sedanos Supermarkets #16,Invoice,008-02089,Arroz Envasado:Parboiled 5KG Dos Hermanos.,6 / 11lbs,17.0,0.0,0.0,1309397.88,,Lisset Limpio -020,RETAIL SEDANOS,1381594,Oct
2023-10-23,Sedanos Supermarkets #16,Invoice,008-02089,,Discount,-688.5,0.02,-13.77,1309384.11,,Lisset Limpio -020,RETAIL SEDANOS,1381595,Oct
2023-10-23,Sedanos Supermarkets  #11,Invoice,008-02090,Arroz Envasado:Parboiled 5KG Dos Hermanos.,6 / 11lbs,19.0,40.5,769.5,1310153.61,,Lisset Limpio -020,RETAIL SEDANOS,1381596,Oct
2023-10-23,Sedanos Supermarkets  #11,Invoice,008-02090,Arroz Envasado:Parboiled 5KG Dos Hermanos.,6 / 11lbs,19.0,0.0,0.0,1310153.61,,Lisset Limpio -020,RETAIL SEDANOS,1381597,Oct
2023-10-23,Sedanos Supermarkets  #11,Invoice,008-02090,,Discount,-769.5,,-26.14,1310127.47,,Lisset Limpio -020,RETAIL SEDANOS,1381598,Oct
2023-10-23,Sedanos Supermarkets #10,Invoice,008-02091,Arroz Envasado:Parboiled 5KG Dos Hermanos.,6 / 11lbs,4.0,40.5,162.0,1310289.47,,Lisset Limpio -020,RETAIL SEDANOS,1381599,Oct
2023-10-23,Sedanos Supermarkets #10,Invoice,008-02091,Arroz Envasado:Parboiled 5KG Dos Hermanos.,6 / 11lbs,4.0,0.0,0.0,1310289.47,,Lisset Limpio -020,RETAIL SEDANOS,1381600,Oct
2023-10-23,Sedanos Supermarkets #10,Invoice,008-02091,,Discount,-162.0,0.02,-3.24,1310286.23,,Lisset Limpio -020,RETAIL SEDANOS,1381601,Oct
2023-10-23,Sedanos Supermarkets #9,Invoice,008-02092,Arroz Envasado:Parboiled 5KG Dos Hermanos.,6 / 11lbs,9.0,40.5,364.5,1310650.73,,Lisset Limpio -020,RETAIL SEDANOS,1381602,Oct
2023-10-23,Sedanos Supermarkets #9,Invoice,008-02092,Arroz Envasado:Parboiled 5KG Dos Hermanos.,6 / 11lbs,9.0,0.0,0.0,1310650.73,,Lisset Limpio -020,RETAIL SEDANOS,1381603,Oct
2023-10-23,Sedanos Supermarkets #9,Invoice,008-02092,,Discount,-364.5,,-7.29,1310643.44,,Lisset Limpio -020,RETAIL SEDANOS,1381604,Oct
2023-10-23,Sedanos Supermarkets #1,Invoice,008-02093,Arroz Envasado:Parboiled 5KG Dos Hermanos.,6 / 11lbs,2.0,40.5,81.0,1310724.44,,Lisset Limpio -020,RETAIL SEDANOS,1381605,Oct
2023-10-23,Sedanos Supermarkets #1,Invoice,008-02093,Arroz Envasado:Parboiled 5KG Dos Hermanos.,6 / 11lbs,2.0,0.0,0.0,1310724.44,,Lisset Limpio -020,RETAIL SEDANOS,1381606,Oct
2023-10-23,Sedanos Supermarkets #1,Invoice,008-02093,,Discount,,,-1.62,1310722.82,,Lisset Limpio -020,RETAIL SEDANOS,1381607,Oct
2023-10-23,Sedanos Supermarkets #28,Invoice,008-02094,Arroz Envasado:Parboiled 5KG Dos Hermanos.,6 / 11lbs,19.0,40.5,769.5,1311492.32,,Lisset Limpio -020,RETAIL SEDANOS,1381608,Oct
2023-10-23,Sedanos Supermarkets #28,Invoice,008-02094,Arroz Envasado:Parboiled 5KG Dos Hermanos.,6 / 11lbs,19.0,0.0,0.0,1311492.32,,Lisset Limpio -020,RETAIL SEDANOS,1381609,Oct
2023-10-23,Sedanos Supermarkets #28,Invoice,008-02094,,Discount,-769.5,0.02,-15.39,1311476.93,,Lisset Limpio -020,RETAIL SEDANOS,1381610,Oct
2023-10-24,Family and Son,Invoice,008-02095,Arroz a Granel:Parboiled 50 LB -Bolsa Dos Hermanos.,,1100.0,21.75,23925.0,1335401.93,,Armando Carpio - 017,WHOLESALER MANUFACTURY,1381611,Oct
2023-10-24,Family and Son,Invoice,008-02096,Arroz a Granel:Parboiled 50 LB -Bolsa Dos Hermanos.,,1100.0,21.75,23925.0,1359326.93,,Armando Carpio - 017,WHOLESALER MANUFACTURY,1381612,Oct
2023-10-24,Family and Son,Invoice,008-02097,Arroz a Granel:Parboiled 50 LB -Bolsa Dos Hermanos.,,1100.0,21.75,23925.0,1383251.93,,Armando Carpio - 017,WHOLESALER MANUFACTURY,1381613,Oct
2023-10-24,Brito Family Corp.,Invoice,008-02098,Arroz a Granel:Largo Fino 50 LB -Bolsa Dos Hermanos.,,110.0,21.0,2310.0,1385561.93,,Lisset Limpio -020,CAFETERIA y RESTAURANTS,1381614,Oct
2023-10-24,Brito Family Corp.,Invoice,008-02098,Arroz a Granel:Parboiled 50 LB -Bolsa Dos Hermanos.,,110.0,25.5,2805.0,1388366.93,,Lisset Limpio -020,CAFETERIA y RESTAURANTS,1381615,Oct
2023-10-25,Sedanos Supermarkets #27,Invoice,008-02099,Arroz Envasado:Parboiled 5KG Dos Hermanos.,6 / 11lbs,11.0,40.5,445.5,1388812.43,,Lisset Limpio -020,RETAIL SEDANOS,1381616,Oct
2023-10-25,Sedanos Supermarkets #27,Invoice,008-02099,Arroz Envasado:Parboiled 5KG Dos Hermanos.,6 / 11lbs,11.0,0.0,0.0,1388812.43,,Lisset Limpio -020,RETAIL SEDANOS,1381617,Oct
2023-10-25,Sedanos Supermarkets #27,Invoice,008-02099,,Discount,-445.5,0.02,-8.91,1388803.52,,Lisset Limpio -020,RETAIL SEDANOS,1381618,Oct
2023-10-25,Sedanos Supermarkets #20,Invoice,008-02100,Arroz Envasado:Parboiled 5KG Dos Hermanos.,6 / 11lbs,14.0,40.5,567.0,1389370.52,,Ruta - 019,RETAIL SEDANOS,1381619,Oct
2023-10-25,Sedanos Supermarkets #20,Invoice,008-02100,Arroz Envasado:Parboiled 5KG Dos Hermanos.,6 / 11lbs,14.0,0.0,0.0,1389370.52,,Ruta - 019,RETAIL SEDANOS,1381620,Oct
2023-10-25,Sedanos Supermarkets #20,Invoice,008-02100,,Discount,-567.0,0.02,-11.34,1389359.18,,Ruta - 019,RETAIL SEDANOS,1381621,Oct
2023-10-25,Sedanos Supermarkets #34,Invoice,008-02101,Arroz Envasado:Parboiled 5KG Dos Hermanos.,6 / 11lbs,10.0,40.5,405.0,1389764.18,,Ruta - 019,RETAIL SEDANOS,1381622,Oct
2023-10-25,Sedanos Supermarkets #34,Invoice,008-02101,Arroz Envasado:Parboiled 5KG Dos Hermanos.,6 / 11lbs,10.0,0.0,0.0,1389764.18,,Ruta - 019,RETAIL SEDANOS,1381623,Oct
2023-10-25,Sedanos Supermarkets #34,Invoice,008-02101,,Discount,-405.0,0.02,-8.1,1389756.08,,Ruta - 019,RETAIL SEDANOS,1381624,Oct
2023-10-27,Havana Club Cafe and Restaurant,Invoice,008-02102,Arroz a Granel:Parboiled 50 LB -Bolsa Dos Hermanos.,,10.0,25.5,255.0,1390011.08,,Armando Carpio - 017,CAFETERIA y RESTAURANTS,1381625,Oct
2023-10-27,Havana Club Cafe and Restaurant,Invoice,008-02102,Arroz a Granel:Largo Fino 50 LB -Bolsa Dos Hermanos.,,4.0,21.0,84.0,1390095.08,,Armando Carpio - 017,CAFETERIA y RESTAURANTS,1381626,Oct
2023-10-27,Havana Club Cafe and Restaurant,Invoice,008-02102,Dry Beans:Dry Beans - Black Beans 50,Dry Black Beans 50 lb,5.0,37.5,187.5,1390282.58,,Armando Carpio - 017,CAFETERIA y RESTAURANTS,1381627,Oct
2023-10-27,Havana Club Cafe and Restaurant,Invoice,008-02102,Liquids:AS Marinating Sauce (Mojo),,2.0,18.5,37.0,1390319.58,,Armando Carpio - 017,CAFETERIA y RESTAURANTS,1381628,Oct
2023-10-27,Havana Club Cafe and Restaurant,Invoice,008-02102,Liquids:AS Bitter Orange,,2.0,15.9,31.8,1390351.38,,Armando Carpio - 017,CAFETERIA y RESTAURANTS,1381629,Oct
2023-10-27,Havana Club Cafe and Restaurant,Invoice,008-02102,Liquids:AS Cooking Wine,4/1 Gl.,1.0,127.5,127.5,1390478.88,,Armando Carpio - 017,CAFETERIA y RESTAURANTS,1381630,Oct
2023-10-27,Soriano Brothers PB,Invoice,008-02103,Arroz a Granel:Largo Fino 50 LB -Bolsa Dos Hermanos.,,5.0,21.0,105.0,1390583.88,,Lisset Limpio -020,CAFETERIA y RESTAURANTS,1381631,Oct
2023-10-27,Soriano Brothers PB,Invoice,008-02103,Arroz a Granel:Parboiled 50 LB -Bolsa Dos Hermanos.,,5.0,25.5,127.5,1390711.38,,Lisset Limpio -020,CAFETERIA y RESTAURANTS,1381632,Oct
2023-10-27,El Palacio de los jugos / Sahilys Cafe,Invoice,008-02104,Arroz a Granel:Largo Fino 50 LB -Bolsa Dos Hermanos.,,6.0,21.0,126.0,1390837.38,,Lisset Limpio -020,Cafeteria,1381633,Oct
2023-10-27,El Palacio de los jugos / Caribe Tropical,Invoice,008-02105,Arroz a Granel:Largo Fino 50 LB -Bolsa Dos Hermanos.,,8.0,21.0,168.0,1391005.38,,Lisset Limpio -020,Cafeteria,1381634,Oct
2023-10-27,El Palacio de los jugos / Caribe Tropical,Invoice,008-02105,Dry Beans:Dry Beans - Black Beans 50,Dry Black Beans 50 lb,1.0,37.5,37.5,1391042.88,,Lisset Limpio -020,Cafeteria,1381635,Oct
2023-10-27,El Palacio de los jugos /  Mires Restaurants,Invoice,008-02106,Arroz a Granel:Largo Fino 50 LB -Bolsa Dos Hermanos.,,10.0,21.0,210.0,1391252.88,,Lisset Limpio -020,Cafeteria,1381636,Oct
2023-10-27,El Palacio de los jugos /  Mires Restaurants,Invoice,008-02106,Arroz a Granel:Parboiled 50 LB -Bolsa Dos Hermanos.,,10.0,25.5,255.0,1391507.88,,Lisset Limpio -020,Cafeteria,1381637,Oct
2023-10-27,El Palacio de Los Jugos / Casa mía Food Restaurant inc,Invoice,008-02107,Arroz a Granel:Parboiled 50 LB -Bolsa Dos Hermanos.,,10.0,25.5,255.0,1391762.88,,Lisset Limpio -020,Cafeteria,1381638,Oct
2023-10-27,El Palacio de los jugos / Lita Foods Inc.,Invoice,008-02108,Arroz a Granel:Parboiled 50 LB -Bolsa Dos Hermanos.,,10.0,25.5,255.0,1392017.88,,Lisset Limpio -020,Cafeteria,1381639,Oct
2023-10-27,El Gallego Supermarket,Invoice,008-02109,Arroz a Granel:Parboiled 50 LB -Bolsa Dos Hermanos.,,5.0,25.5,127.5,1392145.38,,Lisset Limpio -020,RETAIL  DSD,1381640,Oct
2023-10-27,El Gallego Supermarket,Invoice,008-02109,Dry Beans:Dry Beans - Black Beans 50,Dry Black Beans 50 lb,1.0,37.5,37.5,1392182.88,,Lisset Limpio -020,RETAIL  DSD,1381641,Oct
2023-10-27,El Palacio de los jugos / Delicias Criollas (DIAGO FOOD_MILLER),Invoice,008-02110,Arroz a Granel:Parboiled 50 LB -Bolsa Dos Hermanos.,,14.0,25.5,357.0,1392539.88,,Lisset Limpio -020,Cafeteria,1381642,Oct
2023-10-27,El Palacio de los jugos / Santa Clara Sabor,Invoice,008-02111,Arroz a Granel:Largo Fino 50 LB -Bolsa Dos Hermanos.,,20.0,21.0,420.0,1392959.88,,Lisset Limpio -020,Cafeteria,1381643,Oct
2023-10-27,Los Mejores Tamales de Miami,Invoice,008-02112,Arroz a Granel:Largo Fino 50 LB -Bolsa Dos Hermanos.,,5.0,21.0,105.0,1393064.88,,Lisset Limpio -020,CAFETERIA y RESTAURANTS,1381644,Oct
2023-10-27,El Palacio de los jugos /  EMMA FOOD CORP,Invoice,008-02113,Arroz a Granel:Parboiled 50 LB -Bolsa Dos Hermanos.,,7.0,25.5,178.5,1393243.38,,Lisset Limpio -020,Cafeteria,1381645,Oct
2023-10-28,El Palacio de los jugos / Caribe Tropical,Invoice,008-02114,Arroz a Granel:Parboiled 50 LB -Bolsa Dos Hermanos.,,10.0,25.5,255.0,1393498.38,,Lisset Limpio -020,Cafeteria,1381646,Oct
2023-10-29,Sorianos Brothers,Invoice,008-02115,Arroz a Granel:Largo Fino 50 LB -Bolsa Dos Hermanos.,,15.0,21.0,315.0,1393813.38,,Lisset Limpio -020,CAFETERIA y RESTAURANTS,1381647,Oct
2023-10-29,Sorianos Brothers,Invoice,008-02115,Arroz a Granel:Parboiled 50 LB -Bolsa Dos Hermanos.,,20.0,25.5,510.0,1394323.38,,Lisset Limpio -020,CAFETERIA y RESTAURANTS,1381648,Oct
2023-10-29,Fritanga Momotombo,Invoice,008-02116,Arroz a Granel:Largo Fino 50 LB -Bolsa Dos Hermanos.,,5.0,22.0,110.0,1394433.38,,Lisset Limpio -020,CAFETERIA y RESTAURANTS,1381649,Oct
2023-10-29,El Palacio de los jugos / Sahilys Cafe,Invoice,008-02117,Arroz a Granel:Largo Fino 50 LB -Bolsa Dos Hermanos.,,6.0,21.0,126.0,1394559.38,,Lisset Limpio -020,Cafeteria,1381650,Oct
2023-10-29,El Palacio de los jugos / Sahilys Cafe,Invoice,008-02117,Liquids:AS Marinating Sauce (Mojo),,1.0,17.0,17.0,1394576.38,,Lisset Limpio -020,Cafeteria,1381651,Oct
2023-10-29,El Palacio de los jugos / Sahilys Cafe,Invoice,008-02117,Liquids:AS Bitter Orange,,1.0,14.0,14.0,1394590.38,,Lisset Limpio -020,Cafeteria,1381652,Oct
2023-10-29,El Palacio de Los Jugos / Casa mía Food Restaurant inc,Invoice,008-02118,Arroz a Granel:Parboiled 50 LB -Bolsa Dos Hermanos.,,5.0,25.5,127.5,1394717.88,,Lisset Limpio -020,Cafeteria,1381653,Oct
2023-10-29,El Palacio de los jugos /  Nanos Latin Foods,Invoice,008-02119,Arroz a Granel:Largo Fino 50 LB -Bolsa Dos Hermanos.,,10.0,21.0,210.0,1394927.88,,Lisset Limpio -020,Cafeteria,1381654,Oct
2023-10-29,El Palacio de los jugos / Lita Foods Inc.,Invoice,008-02120,Arroz a Granel:Parboiled 50 LB -Bolsa Dos Hermanos.,,5.0,25.5,127.5,1395055.38,,Lisset Limpio -020,Cafeteria,1381655,Oct
2023-10-29,El Palacio de los jugos / Santa Clara Sabor,Invoice,008-02121,Arroz a Granel:Largo Fino 50 LB -Bolsa Dos Hermanos.,,15.0,21.0,315.0,1395370.38,,Lisset Limpio -020,Cafeteria,1381656,Oct
2023-10-29,El Palacio de los jugos /  EMMA FOOD CORP,Invoice,008-02122,Arroz a Granel:Largo Fino 50 LB -Bolsa Dos Hermanos.,,8.0,21.0,168.0,1395538.38,,Lisset Limpio -020,Cafeteria,1381657,Oct
2023-10-29,El Palacio de los jugos /  EMMA FOOD CORP,Invoice,008-02122,Arroz a Granel:Parboiled 50 LB -Bolsa Dos Hermanos.,,10.0,25.5,255.0,1395793.38,,Lisset Limpio -020,Cafeteria,1381658,Oct
2023-10-29,Soriano Brothers,Invoice,008-02123,Arroz a Granel:Largo Fino 50 LB -Bolsa Dos Hermanos.,,10.0,21.0,210.0,1396003.38,,Lisset Limpio -020,CAFETERIA y RESTAURANTS,1381659,Oct
2023-10-29,Soriano Brothers,Invoice,008-02123,Arroz a Granel:Parboiled 50 LB -Bolsa Dos Hermanos.,,25.0,25.5,637.5,1396640.88,,Lisset Limpio -020,CAFETERIA y RESTAURANTS,1381660,Oct
2023-10-29,Sabor Tropical Supermarket #4,Invoice,008-02124,Arroz Envasado:Parboiled 5KG Dos Hermanos.,6 / 11lbs,2.0,40.5,81.0,1396721.88,,Lisset Limpio -020,RETAIL  DSD,1381661,Oct
2023-10-29,Sabor Tropical Supermarket #4,Invoice,008-02124,Arroz a Granel:Parboiled 50 LB -Bolsa Dos Hermanos.,,20.0,25.0,500.0,1397221.88,,Lisset Limpio -020,RETAIL  DSD,1381662,Oct
2023-10-30,Sedanos Supermarkets #7,Invoice,008-02125,Arroz Envasado:Parboiled 5KG Dos Hermanos.,6 / 11lbs,11.0,40.5,445.5,1397667.38,,Lisset Limpio -020,RETAIL SEDANOS,1381663,Oct
2023-10-30,Sedanos Supermarkets #7,Invoice,008-02125,Arroz Envasado:Parboiled 5KG Dos Hermanos.,6 / 11lbs,11.0,0.0,0.0,1397667.38,,Lisset Limpio -020,RETAIL SEDANOS,1381664,Oct
2023-10-30,Sedanos Supermarkets #7,Invoice,008-02125,,Discount,-445.5,0.02,-8.91,1397658.47,,Lisset Limpio -020,RETAIL SEDANOS,1381665,Oct
2023-10-30,Sedanos Supermarkets  #37,Invoice,008-02126,Arroz Envasado:Parboiled 5KG Dos Hermanos.,6 / 11lbs,8.0,40.5,324.0,1397982.47,,Lisset Limpio -020,RETAIL SEDANOS,1381666,Oct
2023-10-30,Sedanos Supermarkets  #37,Invoice,008-02126,Arroz Envasado:Parboiled 5KG Dos Hermanos.,6 / 11lbs,8.0,0.0,0.0,1397982.47,,Lisset Limpio -020,RETAIL SEDANOS,1381667,Oct
2023-10-30,Sedanos Supermarkets  #37,Invoice,008-02126,,Discount,-324.0,0.02,-6.48,1397975.99,,Lisset Limpio -020,RETAIL SEDANOS,1381668,Oct
2023-10-30,Sedanos Supermarkets #18,Invoice,008-02127,Arroz Envasado:Parboiled 5KG Dos Hermanos.,6 / 11lbs,17.0,40.5,688.5,1398664.49,,Lisset Limpio -020,RETAIL SEDANOS,1381669,Oct
2023-10-30,Sedanos Supermarkets #18,Invoice,008-02127,Arroz Envasado:Parboiled 5KG Dos Hermanos.,6 / 11lbs,17.0,0.0,0.0,1398664.49,,Lisset Limpio -020,RETAIL SEDANOS,1381670,Oct
2023-10-30,Sedanos Supermarkets #18,Invoice,008-02127,,Discount,-688.5,0.02,-13.77,1398650.72,,Lisset Limpio -020,RETAIL SEDANOS,1381671,Oct
2023-10-30,Sedanos Supermarkets #17,Invoice,008-02128,Arroz Envasado:Parboiled 5KG Dos Hermanos.,6 / 11lbs,6.0,40.5,243.0,1398893.72,,Lisset Limpio -020,RETAIL SEDANOS,1381672,Oct
2023-10-30,Sedanos Supermarkets #17,Invoice,008-02128,Arroz Envasado:Parboiled 5KG Dos Hermanos.,6 / 11lbs,6.0,0.0,0.0,1398893.72,,Lisset Limpio -020,RETAIL SEDANOS,1381673,Oct
2023-10-30,Sedanos Supermarkets #17,Invoice,008-02128,,Discount,-243.0,0.02,-4.86,1398888.86,,Lisset Limpio -020,RETAIL SEDANOS,1381674,Oct
2023-10-30,Sedanos Supermarkets #5,Invoice,008-02129,Arroz Envasado:Parboiled 5KG Dos Hermanos.,6 / 11lbs,11.0,40.5,445.5,1399334.36,,Lisset Limpio -020,RETAIL SEDANOS,1381675,Oct
2023-10-30,Sedanos Supermarkets #5,Invoice,008-02129,Arroz Envasado:Parboiled 5KG Dos Hermanos.,6 / 11lbs,11.0,0.0,0.0,1399334.36,,Lisset Limpio -020,RETAIL SEDANOS,1381676,Oct
2023-10-30,Sedanos Supermarkets #5,Invoice,008-02129,,Discount,-445.5,0.02,-8.91,1399325.45,,Lisset Limpio -020,RETAIL SEDANOS,1381677,Oct
2023-10-30,Sedanos Supermarkets #23,Invoice,008-02130,Arroz Envasado:Parboiled 5KG Dos Hermanos.,6 / 11lbs,12.0,40.5,486.0,1399811.45,,Lisset Limpio -020,RETAIL SEDANOS,1381678,Oct
2023-10-30,Sedanos Supermarkets #23,Invoice,008-02130,Arroz Envasado:Parboiled 5KG Dos Hermanos.,6 / 11lbs,12.0,0.0,0.0,1399811.45,,Lisset Limpio -020,RETAIL SEDANOS,1381679,Oct
2023-10-30,Sedanos Supermarkets #23,Invoice,008-02130,,Discount,-486.0,0.02,-9.72,1399801.73,,Lisset Limpio -020,RETAIL SEDANOS,1381680,Oct
2023-10-30,Sedanos Supermarkets #42,Invoice,008-02131,Arroz Envasado:Parboiled 5KG Dos Hermanos.,6 / 11lbs,17.0,40.5,688.5,1400490.23,,Lisset Limpio -020,RETAIL SEDANOS,1381681,Oct
2023-10-30,Sedanos Supermarkets #42,Invoice,008-02131,Arroz Envasado:Parboiled 5KG Dos Hermanos.,6 / 11lbs,17.0,0.0,0.0,1400490.23,,Lisset Limpio -020,RETAIL SEDANOS,1381682,Oct
2023-10-30,Sedanos Supermarkets #42,Invoice,008-02131,,Discount,-688.5,0.02,-13.77,1400476.46,,Lisset Limpio -020,RETAIL SEDANOS,1381683,Oct
2023-10-30,Sedanos Supermarkets  #4,Invoice,008-02132,Arroz Envasado:Parboiled 5KG Dos Hermanos.,6 / 11lbs,11.0,40.5,445.5,1400921.96,,Lisset Limpio -020,RETAIL SEDANOS,1381684,Oct
2023-10-30,Sedanos Supermarkets  #4,Invoice,008-02132,Arroz Envasado:Parboiled 5KG Dos Hermanos.,6 / 11lbs,11.0,0.0,0.0,1400921.96,,Lisset Limpio -020,RETAIL SEDANOS,1381685,Oct
2023-10-30,Sedanos Supermarkets  #4,Invoice,008-02132,,Discount,-445.5,0.02,-8.91,1400913.05,,Lisset Limpio -020,RETAIL SEDANOS,1381686,Oct
2023-10-31,Miavana & Family,Invoice,008-02133,Arroz a Granel:Parboiled 50 LB -Bolsa Dos Hermanos.,,220.0,21.75,4785.0,1405698.05,,Armando Carpio - 017,Distributor,1381687,Oct
2023-10-31,Sedanos Supermarkets #36,Invoice,008-02134,Arroz Envasado:Parboiled 5KG Dos Hermanos.,6 / 11lbs,14.0,40.5,567.0,1406265.05,,Ruta - 019,RETAIL SEDANOS,1381688,Oct
2023-10-31,Sedanos Supermarkets #36,Invoice,008-02134,Arroz Envasado:Parboiled 5KG Dos Hermanos.,6 / 11lbs,14.0,0.0,0.0,1406265.05,,Ruta - 019,RETAIL SEDANOS,1381689,Oct
2023-10-31,Sedanos Supermarkets #36,Invoice,008-02134,,Discount,-567.0,0.02,-11.34,1406253.71,,Ruta - 019,RETAIL SEDANOS,1381690,Oct
2023-10-31,Sedanos Supermarkets #33,Invoice,008-02135,Arroz Envasado:Parboiled 5KG Dos Hermanos.,6 / 11lbs,17.0,40.5,688.5,1406942.21,,Lisset Limpio -020,RETAIL SEDANOS,1381691,Oct
2023-10-31,Sedanos Supermarkets #33,Invoice,008-02135,Arroz Envasado:Parboiled 5KG Dos Hermanos.,6 / 11lbs,17.0,0.0,0.0,1406942.21,,Lisset Limpio -020,RETAIL SEDANOS,1381692,Oct
2023-10-31,Sedanos Supermarkets #33,Invoice,008-02135,,Discount,-688.5,0.02,-13.77,1406928.44,,Lisset Limpio -020,RETAIL SEDANOS,1381693,Oct
2023-10-31,Sedanos Supermarkets #32,Invoice,008-02136,Arroz Envasado:Parboiled 5KG Dos Hermanos.,6 / 11lbs,12.0,40.5,486.0,1407414.44,,Lisset Limpio -020,RETAIL SEDANOS,1381694,Oct
2023-10-31,Sedanos Supermarkets #32,Invoice,008-02136,Arroz Envasado:Parboiled 5KG Dos Hermanos.,6 / 11lbs,12.0,0.0,0.0,1407414.44,,Lisset Limpio -020,RETAIL SEDANOS,1381695,Oct
2023-10-31,Sedanos Supermarkets #32,Invoice,008-02136,,Discount,-486.0,0.02,-9.72,1407404.72,,Lisset Limpio -020,RETAIL SEDANOS,1381696,Oct
2023-10-31,Sedanos Supermarkets #29,Invoice,008-02137,Arroz Envasado:Parboiled 5KG Dos Hermanos.,6 / 11lbs,10.0,40.5,405.0,1407809.72,,Lisset Limpio -020,RETAIL SEDANOS,1381697,Oct
2023-10-31,Sedanos Supermarkets #29,Invoice,008-02137,Arroz Envasado:Parboiled 5KG Dos Hermanos.,6 / 11lbs,10.0,0.0,0.0,1407809.72,,Lisset Limpio -020,RETAIL SEDANOS,1381698,Oct
2023-10-31,Sedanos Supermarkets #29,Invoice,008-02137,,Discount,-405.0,0.02,-8.1,1407801.62,,Lisset Limpio -020,RETAIL SEDANOS,1381699,Oct
2023-10-31,Sedanos Supermarkets #14,Invoice,008-02138,Arroz Envasado:Parboiled 5KG Dos Hermanos.,6 / 11lbs,19.0,40.5,769.5,1408571.12,,Lisset Limpio -020,RETAIL SEDANOS,1381700,Oct
2023-10-31,Sedanos Supermarkets #14,Invoice,008-02138,Arroz Envasado:Parboiled 5KG Dos Hermanos.,6 / 11lbs,19.0,0.0,0.0,1408571.12,,Lisset Limpio -020,RETAIL SEDANOS,1381701,Oct
2023-10-31,Sedanos Supermarkets #14,Invoice,008-02138,,Discount,-769.5,0.02,-15.39,1408555.73,,Lisset Limpio -020,RETAIL SEDANOS,1381702,Oct
2023-10-31,Sedanos Supermarkets #38,Invoice,008-02139,Arroz Envasado:Parboiled 5KG Dos Hermanos.,6 / 11lbs,22.0,40.5,891.0,1409446.73,,Lisset Limpio -020,RETAIL SEDANOS,1381703,Oct
2023-10-31,Sedanos Supermarkets #38,Invoice,008-02139,Arroz Envasado:Parboiled 5KG Dos Hermanos.,6 / 11lbs,22.0,0.0,0.0,1409446.73,,Lisset Limpio -020,RETAIL SEDANOS,1381704,Oct
2023-10-31,Sedanos Supermarkets #38,Invoice,008-02139,,Discount,-891.0,0.02,-17.82,1409428.91,,Lisset Limpio -020,RETAIL SEDANOS,1381705,Oct
2023-10-31,Ideal Food Basket Davie Cafeteria,Invoice,008-02140,Arroz a Granel:Largo Fino 50 LB -Bolsa Dos Hermanos.,,10.0,23.0,230.0,1409658.91,,Armando Carpio - 017,CAFETERIA y RESTAURANTS,1381706,Oct
2023-10-31,Asian Buffet Sunrise,Invoice,008-02141,Arroz a Granel:Parboiled 50 LB -Bolsa Dos Hermanos.,,5.0,25.5,127.5,1409786.41,,Lisset Limpio -020,CAFETERIA y RESTAURANTS,1381707,Oct
2023-10-31,Festival Supermarket,Invoice,008-02142,Arroz Envasado:Parboiled 5KG Dos Hermanos.,6 / 11lbs,21.0,40.5,850.5,1410636.91,,Ruta - 019,RETAIL  DSD,1381708,Oct
2023-10-31,Festival Supermarket,Invoice,008-02142,Arroz Envasado:Parboiled 5KG Dos Hermanos.,6 / 11lbs,20.0,0.0,0.0,1410636.91,,Ruta - 019,RETAIL  DSD,1381709,Oct
2023-11-02,"El Toro Loco Meat Distribution, LLC",Invoice,008-02143,Arroz a Granel:Largo Fino 50 LB -Bolsa Dos Hermanos.,,55.0,21.5,1182.5,1411819.41,,Lisset Limpio -020,CAFETERIA y RESTAURANTS,1381710,Nov
2023-11-02,Price Choice Food Market # 6,Invoice,008-02144,Arroz a Granel:Largo Fino 50 LB -Bolsa Dos Hermanos.,,15.0,21.5,322.5,1412141.91,,Lisset Limpio -020,RETAIL  DSD,1381711,Nov
2023-11-02,Price Choice Food Market # 6,Invoice,008-02144,Arroz Envasado:Parboiled 5KG Dos Hermanos.,6 / 11lbs,21.0,40.5,850.5,1412992.41,,Lisset Limpio -020,RETAIL  DSD,1381712,Nov
2023-11-02,Price Choice Food Market # 6,Invoice,008-02144,Arroz Envasado:Parboiled 5KG Dos Hermanos.,6 / 11lbs,20.0,0.0,0.0,1412992.41,,Lisset Limpio -020,RETAIL  DSD,1381713,Nov
2023-11-02,Sedanos Supermarkets #31,Invoice,008-02145,Arroz Envasado:Parboiled 5KG Dos Hermanos.,6 / 11lbs,18.0,40.5,729.0,1413721.41,,Lisset Limpio -020,RETAIL SEDANOS,1381714,Nov
2023-11-02,Sedanos Supermarkets #31,Invoice,008-02145,Arroz Envasado:Parboiled 5KG Dos Hermanos.,6 / 11lbs,18.0,0.0,0.0,1413721.41,,Lisset Limpio -020,RETAIL SEDANOS,1381715,Nov
2023-11-02,Sedanos Supermarkets #31,Invoice,008-02145,,Discount,-729.0,0.02,-14.58,1413706.83,,Lisset Limpio -020,RETAIL SEDANOS,1381716,Nov
2023-11-02,Sedanos Supermarkets #21,Invoice,008-02146,Arroz Envasado:Parboiled 5KG Dos Hermanos.,6 / 11lbs,14.0,40.5,567.0,1414273.83,,Lisset Limpio -020,RETAIL SEDANOS,1381717,Nov
2023-11-02,Sedanos Supermarkets #21,Invoice,008-02146,Arroz Envasado:Parboiled 5KG Dos Hermanos.,6 / 11lbs,14.0,0.0,0.0,1414273.83,,Lisset Limpio -020,RETAIL SEDANOS,1381718,Nov
2023-11-02,Sedanos Supermarkets #21,Invoice,008-02146,,Discount,-567.0,0.02,-11.34,1414262.49,,Lisset Limpio -020,RETAIL SEDANOS,1381719,Nov
2023-11-02,Key Foods 40 St,Invoice,008-02147,Arroz Envasado:Parboiled 5KG Dos Hermanos.,6 / 11lbs,0.0,,0.0,1414262.49,,Lisset Limpio -020,RETAIL  DSD,1381720,Nov
2023-11-02,Key Foods 40 St,Invoice,008-02147,Arroz Envasado:Parboiled 5KG Dos Hermanos.,6 / 11lbs,0.0,0.0,0.0,1414262.49,,Lisset Limpio -020,RETAIL  DSD,1381721,Nov
2023-11-03,"Virtue Distributor, Inc",Invoice,008-02148,Arroz a Granel:Largo Fino 50 LB -Bolsa Dos Hermanos.,,55.0,21.5,1182.5,1415444.99,,Armando Carpio - 017,Distributor,1381722,Nov
2023-11-03,El Palacio de los jugos /  Mires Restaurants,Invoice,008-02149,Arroz a Granel:Largo Fino 50 LB -Bolsa Dos Hermanos.,,10.0,21.0,210.0,1415654.99,,Lisset Limpio -020,Cafeteria,1381723,Nov
2023-11-03,El Palacio de los jugos /  Mires Restaurants,Invoice,008-02149,Arroz a Granel:Parboiled 50 LB -Bolsa Dos Hermanos.,,10.0,25.5,255.0,1415909.99,,Lisset Limpio -020,Cafeteria,1381724,Nov
2023-11-03,Soriano Brothers PB,Invoice,008-02150,Arroz a Granel:Largo Fino 50 LB -Bolsa Dos Hermanos.,,5.0,21.0,105.0,1416014.99,,Lisset Limpio -020,CAFETERIA y RESTAURANTS,1381725,Nov
2023-11-03,Soriano Brothers PB,Invoice,008-02150,Arroz a Granel:Parboiled 50 LB -Bolsa Dos Hermanos.,,5.0,25.5,127.5,1416142.49,,Lisset Limpio -020,CAFETERIA y RESTAURANTS,1381726,Nov
2023-11-03,Soriano Brothers PB,Invoice,008-02150,Liquids:AS Bitter Orange,,1.0,14.0,14.0,1416156.49,,Lisset Limpio -020,CAFETERIA y RESTAURANTS,1381727,Nov
2023-11-03,El Palacio de los jugos / Lita Foods Inc.,Invoice,008-02151,Arroz a Granel:Parboiled 50 LB -Bolsa Dos Hermanos.,,10.0,25.5,255.0,1416411.49,,Lisset Limpio -020,Cafeteria,1381728,Nov
2023-11-03,El Palacio de Los Jugos / Casa mía Food Restaurant inc,Invoice,008-02152,Arroz a Granel:Parboiled 50 LB -Bolsa Dos Hermanos.,,10.0,25.5,255.0,1416666.49,,Lisset Limpio -020,Cafeteria,1381729,Nov
2023-11-03,El Palacio de los jugos / Sahilys Cafe,Invoice,008-02153,Arroz a Granel:Largo Fino 50 LB -Bolsa Dos Hermanos.,,5.0,21.0,105.0,1416771.49,,Lisset Limpio -020,Cafeteria,1381730,Nov
2023-11-03,El Palacio de los jugos / Sahilys Cafe,Invoice,008-02153,Liquids:AS Bitter Orange,,1.0,14.0,14.0,1416785.49,,Lisset Limpio -020,Cafeteria,1381731,Nov
2023-11-03,El Palacio de los jugos / Santa Clara Sabor,Invoice,008-02154,Arroz a Granel:Largo Fino 50 LB -Bolsa Dos Hermanos.,,20.0,21.0,420.0,1417205.49,,Lisset Limpio -020,Cafeteria,1381732,Nov
2023-11-03,Pacifico Chinese Restaurant,Invoice,008-02155,Arroz a Granel:Parboiled 50 LB -Bolsa Dos Hermanos.,,10.0,25.5,255.0,1417460.49,,Lisset Limpio -020,CAFETERIA y RESTAURANTS,1381733,Nov
2023-11-03,El Palacio de los jugos / Caribe Tropical,Invoice,008-02156,Liquids:AS Marinating Sauce (Mojo),,1.0,18.5,18.5,1417478.99,,Lisset Limpio -020,Cafeteria,1381734,Nov
2023-11-03,El Palacio de los jugos / Caribe Tropical,Invoice,008-02156,Dry Beans:Dry Beans - Black Beans 50,Dry Black Beans 50 lb,1.0,37.5,37.5,1417516.49,,Lisset Limpio -020,Cafeteria,1381735,Nov
2023-11-03,El Palacio de los jugos / Caribe Tropical,Invoice,008-02156,Arroz a Granel:Parboiled 50 LB -Bolsa Dos Hermanos.,,6.0,25.5,153.0,1417669.49,,Lisset Limpio -020,Cafeteria,1381736,Nov
2023-11-03,El Palacio de los jugos /  EMMA FOOD CORP,Invoice,008-02157,Arroz a Granel:Largo Fino 50 LB -Bolsa Dos Hermanos.,,5.0,21.0,105.0,1417774.49,,Lisset Limpio -020,Cafeteria,1381737,Nov
2023-11-03,El Palacio de los jugos /  EMMA FOOD CORP,Invoice,008-02157,Arroz a Granel:Parboiled 50 LB -Bolsa Dos Hermanos.,,10.0,25.5,255.0,1418029.49,,Lisset Limpio -020,Cafeteria,1381738,Nov
2023-11-03,Fritanga Poneloya,Invoice,008-02158,Arroz a Granel:Largo Fino 50 LB -Bolsa Dos Hermanos.,,5.0,22.0,110.0,1418139.49,,Lisset Limpio -020,CAFETERIA y RESTAURANTS,1381739,Nov
2023-11-06,Family and Son,Invoice,008-02159,Arroz a Granel:Parboiled 50 LB -Bolsa Dos Hermanos.,,1100.0,21.75,23925.0,1442064.49,,Armando Carpio - 017,WHOLESALER MANUFACTURY,1381740,Nov
2023-11-06,Family and Son,Invoice,008-02160,Arroz a Granel:Parboiled 50 LB -Bolsa Dos Hermanos.,,1100.0,21.75,23925.0,1465989.49,,Armando Carpio - 017,WHOLESALER MANUFACTURY,1381741,Nov
2023-11-06,Family and Son,Invoice,008-02161,Arroz a Granel:Parboiled 50 LB -Bolsa Dos Hermanos.,,1100.0,21.75,23925.0,1489914.49,,Armando Carpio - 017,WHOLESALER MANUFACTURY,1381742,Nov
2023-11-06,Soriano Brothers PB,Invoice,008-02162,Arroz a Granel:Largo Fino 50 LB -Bolsa Dos Hermanos.,,5.0,21.0,105.0,1490019.49,,Lisset Limpio -020,CAFETERIA y RESTAURANTS,1381743,Nov
2023-11-06,China Buffet,Invoice,008-02163,Arroz a Granel:Parboiled 50 LB -Bolsa Dos Hermanos.,,5.0,25.5,127.5,1490146.99,,Lisset Limpio -020,CAFETERIA y RESTAURANTS,1381744,Nov
2023-11-06,El Palacio de los jugos / Lita Foods Inc.,Invoice,008-02164,Arroz a Granel:Parboiled 50 LB -Bolsa Dos Hermanos.,,7.0,25.5,178.5,1490325.49,,Lisset Limpio -020,Cafeteria,1381745,Nov
2023-11-06,El Palacio de Los Jugos / Casa mía Food Restaurant inc,Invoice,008-02165,Arroz a Granel:Parboiled 50 LB -Bolsa Dos Hermanos.,,10.0,25.5,255.0,1490580.49,,Lisset Limpio -020,Cafeteria,1381746,Nov
2023-11-06,El Palacio de los jugos / Santa Clara Sabor,Invoice,008-02166,Arroz a Granel:Largo Fino 50 LB -Bolsa Dos Hermanos.,,10.0,21.0,210.0,1490790.49,,Lisset Limpio -020,Cafeteria,1381747,Nov
2023-11-06,El Palacio de los jugos /  EMMA FOOD CORP,Invoice,008-02167,Arroz a Granel:Largo Fino 50 LB -Bolsa Dos Hermanos.,,5.0,21.0,105.0,1490895.49,,Lisset Limpio -020,Cafeteria,1381748,Nov
2023-11-06,El Palacio de los jugos /  EMMA FOOD CORP,Invoice,008-02167,Arroz a Granel:Parboiled 50 LB -Bolsa Dos Hermanos.,,5.0,25.5,127.5,1491022.99,,Lisset Limpio -020,Cafeteria,1381749,Nov
2023-11-06,El Palacio de los jugos / Caribe Tropical,Invoice,008-02168,Dry Beans:Dry Beans - Black Beans 50,Dry Black Beans 50 lb,1.0,37.5,37.5,1491060.49,,Lisset Limpio -020,Cafeteria,1381750,Nov
2023-11-06,El Palacio de los jugos / Caribe Tropical,Invoice,008-02168,Arroz a Granel:Parboiled 50 LB -Bolsa Dos Hermanos.,,8.0,25.5,204.0,1491264.49,,Lisset Limpio -020,Cafeteria,1381751,Nov
2023-11-06,Los Caringas Latin America  Foods,Invoice,008-02169,Arroz a Granel:Largo Fino 50 LB -Bolsa Dos Hermanos.,,3.0,21.5,64.5,1491328.99,,Lisset Limpio -020,CAFETERIA y RESTAURANTS,1381752,Nov
2023-11-06,Los Caringas Latin America  Foods,Invoice,008-02169,Arroz a Granel:Parboiled 50 LB -Bolsa Dos Hermanos.,,3.0,25.5,76.5,1491405.49,,Lisset Limpio -020,CAFETERIA y RESTAURANTS,1381753,Nov
2023-11-06,Los paraditos chinesse,Invoice,008-02170,Arroz a Granel:Parboiled 50 LB -Bolsa Dos Hermanos.,,10.0,25.5,255.0,1491660.49,,Lisset Limpio -020,CAFETERIA y RESTAURANTS,1381754,Nov
2023-11-06,Los paraditos chinesse,Invoice,008-02170,Arroz a Granel:Largo Fino 50 LB -Bolsa Dos Hermanos.,,10.0,21.0,210.0,1491870.49,,Lisset Limpio -020,CAFETERIA y RESTAURANTS,1381755,Nov
2023-11-06,Armando Carpio,Invoice,008-02171,Arroz Envasado:Largo Fino 1kg (Long grain rice) Dos Hermanos,,1.0,0.0,0.0,1491870.49,,,OTHER,1381756,Nov
2023-11-06,Armando Carpio,Invoice,008-02171,Arroz Envasado:Parboiled 1kg Bolsa Dos Hermanos.,.,1.0,0.0,0.0,1491870.49,,,OTHER,1381757,Nov
2023-11-06,Armando Carpio,Invoice,008-02171,Arroz a Granel:Largo Fino 50 LB -Bolsa Dos Hermanos.,,1.0,0.0,0.0,1491870.49,,,OTHER,1381758,Nov
2023-11-06,Soriano Brothers PB,Invoice,008-02172,Arroz a Granel:Parboiled 50 LB -Bolsa Dos Hermanos.,,5.0,25.5,127.5,1491997.99,,Lisset Limpio -020,CAFETERIA y RESTAURANTS,1381759,Nov
2023-11-06,Sedanos Supermarkets #24,Invoice,008-02173,Arroz Envasado:Parboiled 5KG Dos Hermanos.,6 / 11lbs,14.0,40.5,567.0,1492564.99,,Ruta - 019,RETAIL SEDANOS,1381760,Nov
2023-11-06,Sedanos Supermarkets #24,Invoice,008-02173,Arroz Envasado:Parboiled 5KG Dos Hermanos.,6 / 11lbs,14.0,0.0,0.0,1492564.99,,Ruta - 019,RETAIL SEDANOS,1381761,Nov
2023-11-06,Sedanos Supermarkets #24,Invoice,008-02173,,Discount,-567.0,0.02,-11.34,1492553.65,,Ruta - 019,RETAIL SEDANOS,1381762,Nov
2023-11-08,Soriano Brothers PB,Credit Memo,008-02174,Arroz a Granel:Largo Fino 50 LB -Bolsa Dos Hermanos.,,-2.0,21.0,-42.0,1492511.65,,Lisset Limpio -020,CAFETERIA y RESTAURANTS,1381763,Nov
2023-11-09,Rey Chavez Distributor Corp,Invoice,008-02175,Arroz a Granel:Parboiled 50 LB -Bolsa Dos Hermanos.,,55.0,25.0,1375.0,1493886.65,,Lisset Limpio -020,WHOLESALER,1381764,Nov
2023-11-09,Soriano Brothers,Invoice,008-02176,Arroz a Granel:Largo Fino 50 LB -Bolsa Dos Hermanos.,,20.0,21.0,420.0,1494306.65,,Lisset Limpio -020,CAFETERIA y RESTAURANTS,1381765,Nov
2023-11-09,Soriano Brothers,Invoice,008-02176,Arroz a Granel:Parboiled 50 LB -Bolsa Dos Hermanos.,,20.0,25.5,510.0,1494816.65,,Lisset Limpio -020,CAFETERIA y RESTAURANTS,1381766,Nov
2023-11-09,Brito Family Corp.,Invoice,008-02177,Arroz a Granel:Largo Fino 50 LB -Bolsa Dos Hermanos.,,165.0,21.0,3465.0,1498281.65,,Lisset Limpio -020,CAFETERIA y RESTAURANTS,1381767,Nov
2023-11-09,Brito Family Corp.,Invoice,008-02177,Arroz a Granel:Parboiled 50 LB -Bolsa Dos Hermanos.,,55.0,25.5,1402.5,1499684.15,,Lisset Limpio -020,CAFETERIA y RESTAURANTS,1381768,Nov
2023-11-09,Asian Buffet Sunrise,Invoice,008-02178,Arroz a Granel:Parboiled 50 LB -Bolsa Dos Hermanos.,,5.0,25.5,127.5,1499811.65,,Lisset Limpio -020,CAFETERIA y RESTAURANTS,1381769,Nov
2023-11-09,El Palacio de los jugos / Delicias Criollas (DIAGO FOOD_MILLER),Invoice,008-02179,Arroz a Granel:Parboiled 50 LB -Bolsa Dos Hermanos.,,14.0,25.5,357.0,1500168.65,,Lisset Limpio -020,Cafeteria,1381770,Nov
2023-11-09,Extra Supermarket,Invoice,008-02180,Arroz Envasado:Parboiled 5KG Dos Hermanos.,6 / 11lbs,10.0,40.5,405.0,1500573.65,,Lisset Limpio -020,RETAIL  DSD,1381771,Nov
2023-11-09,Extra Supermarket,Invoice,008-02180,Arroz Envasado:Parboiled 5KG Dos Hermanos.,6 / 11lbs,2.0,0.0,0.0,1500573.65,,Lisset Limpio -020,RETAIL  DSD,1381772,Nov
2023-11-09,Family and Son,Invoice,008-02181,Arroz a Granel:Parboiled 50 LB -Bolsa Dos Hermanos.,TEMU 8192116 Pri-Transport,1100.0,21.75,23925.0,1524498.65,,Armando Carpio - 017,WHOLESALER MANUFACTURY,1381773,Nov
2023-11-09,Family and Son,Invoice,008-02182,Arroz a Granel:Parboiled 50 LB -Bolsa Dos Hermanos.,TCLU 1850429 Pro-Transport,1100.0,21.75,23925.0,1548423.65,,Armando Carpio - 017,WHOLESALER MANUFACTURY,1381774,Nov
2023-11-09,El Palacio de los jugos / Sahilys Cafe,Invoice,008-02183,Arroz a Granel:Largo Fino 50 LB -Bolsa Dos Hermanos.,,6.0,21.0,126.0,1548549.65,,Lisset Limpio -020,Cafeteria,1381775,Nov
2023-11-09,El Palacio de los jugos /  Mires Restaurants,Invoice,008-02184,Arroz a Granel:Largo Fino 50 LB -Bolsa Dos Hermanos.,,10.0,21.0,210.0,1548759.65,,Lisset Limpio -020,Cafeteria,1381776,Nov
2023-11-09,El Palacio de los jugos /  Mires Restaurants,Invoice,008-02184,Arroz a Granel:Parboiled 50 LB -Bolsa Dos Hermanos.,,10.0,25.5,255.0,1549014.65,,Lisset Limpio -020,Cafeteria,1381777,Nov
2023-11-09,El Palacio de los jugos / Santa Clara Sabor,Invoice,008-02185,Arroz a Granel:Largo Fino 50 LB -Bolsa Dos Hermanos.,,10.0,21.0,210.0,1549224.65,,Lisset Limpio -020,Cafeteria,1381778,Nov
2023-11-09,El Palacio de Los Jugos / Casa mía Food Restaurant inc,Invoice,008-02186,Arroz a Granel:Parboiled 50 LB -Bolsa Dos Hermanos.,,10.0,25.5,255.0,1549479.65,,Lisset Limpio -020,Cafeteria,1381779,Nov
2023-11-09,El Palacio de los jugos / Lita Foods Inc.,Invoice,008-02187,Arroz a Granel:Parboiled 50 LB -Bolsa Dos Hermanos.,,10.0,25.5,255.0,1549734.65,,Lisset Limpio -020,Cafeteria,1381780,Nov
2023-11-09,Key Foods  / Ivan,Invoice,008-02188,Arroz Envasado:Parboiled 5KG Dos Hermanos.,6 / 11lbs,11.0,40.5,445.5,1550180.15,,Lisset Limpio -020,RETAIL  DSD,1381781,Nov
2023-11-09,Key Foods  / Ivan,Invoice,008-02188,Arroz Envasado:Parboiled 5KG Dos Hermanos.,6 / 11lbs,10.0,0.0,0.0,1550180.15,,Lisset Limpio -020,RETAIL  DSD,1381782,Nov
2023-11-09,El Palacio de los jugos / Caribe Tropical,Invoice,008-02189,Dry Beans:Dry Beans - Black Beans 50,Dry Black Beans 50 lb,1.0,37.5,37.5,1550217.65,,Lisset Limpio -020,Cafeteria,1381783,Nov
2023-11-09,El Palacio de los jugos / Caribe Tropical,Invoice,008-02189,Arroz a Granel:Parboiled 50 LB -Bolsa Dos Hermanos.,,8.0,25.5,204.0,1550421.65,,Lisset Limpio -020,Cafeteria,1381784,Nov
2023-11-09,El Palacio de los jugos / Caribe Tropical,Invoice,008-02189,Liquids:AS Bitter Orange,,1.0,14.0,14.0,1550435.65,,Lisset Limpio -020,Cafeteria,1381785,Nov
2023-11-09,El Palacio de los jugos /  EMMA FOOD CORP,Invoice,008-02190,Arroz a Granel:Largo Fino 50 LB -Bolsa Dos Hermanos.,,5.0,21.0,105.0,1550540.65,,Lisset Limpio -020,Cafeteria,1381786,Nov
2023-11-09,El Palacio de los jugos /  EMMA FOOD CORP,Invoice,008-02190,Arroz a Granel:Parboiled 50 LB -Bolsa Dos Hermanos.,,5.0,25.5,127.5,1550668.15,,Lisset Limpio -020,Cafeteria,1381787,Nov
2023-11-09,El Gallego Supermarket,Invoice,008-02191,Arroz a Granel:Parboiled 50 LB -Bolsa Dos Hermanos.,,5.0,25.5,127.5,1550795.65,,Lisset Limpio -020,RETAIL  DSD,1381788,Nov
2023-11-09,El Gallego Supermarket,Invoice,008-02191,Dry Beans:Dry Beans - Black Beans 50,Dry Black Beans 50 lb,2.0,37.5,75.0,1550870.65,,Lisset Limpio -020,RETAIL  DSD,1381789,Nov
2023-11-09,Fritanga Momotombo,Invoice,008-02192,Arroz a Granel:Largo Fino 50 LB -Bolsa Dos Hermanos.,,5.0,21.0,105.0,1550975.65,,Lisset Limpio -020,CAFETERIA y RESTAURANTS,1381790,Nov
2023-11-10,El Palacio de los jugos /  Nanos Latin Foods,Invoice,008-02193,Arroz a Granel:Largo Fino 50 LB -Bolsa Dos Hermanos.,,10.0,21.0,210.0,1551185.65,,Lisset Limpio -020,Cafeteria,1381791,Nov
2023-11-10,Soriano Brothers PB,Invoice,008-02194,Arroz a Granel:Largo Fino 50 LB -Bolsa Dos Hermanos.,,5.0,21.0,105.0,1551290.65,,Lisset Limpio -020,CAFETERIA y RESTAURANTS,1381792,Nov
2023-11-10,Soriano Brothers PB,Invoice,008-02194,Arroz a Granel:Parboiled 50 LB -Bolsa Dos Hermanos.,,5.0,25.5,127.5,1551418.15,,Lisset Limpio -020,CAFETERIA y RESTAURANTS,1381793,Nov
2023-11-13,El Palacio de los jugos / Sahilys Cafe,Invoice,008-02195,Arroz a Granel:Largo Fino 50 LB -Bolsa Dos Hermanos.,,6.0,21.0,126.0,1551544.15,,Lisset Limpio -020,Cafeteria,1381794,Nov
2023-11-13,Hings Chinese,Invoice,008-02196,Arroz a Granel:Parboiled 50 LB -Bolsa Dos Hermanos.,,5.0,25.5,127.5,1551671.65,,Lisset Limpio -020,CAFETERIA y RESTAURANTS,1381795,Nov
2023-11-13,China Buffet,Invoice,008-02197,Arroz a Granel:Parboiled 50 LB -Bolsa Dos Hermanos.,,5.0,25.5,127.5,1551799.15,,Lisset Limpio -020,CAFETERIA y RESTAURANTS,1381796,Nov
2023-11-13,El Palacio de los jugos /  Mires Restaurants,Invoice,008-02198,Arroz a Granel:Largo Fino 50 LB -Bolsa Dos Hermanos.,,10.0,21.0,210.0,1552009.15,,Lisset Limpio -020,Cafeteria,1381797,Nov
2023-11-13,El Palacio de los jugos /  Mires Restaurants,Invoice,008-02198,Arroz a Granel:Parboiled 50 LB -Bolsa Dos Hermanos.,,10.0,25.5,255.0,1552264.15,,Lisset Limpio -020,Cafeteria,1381798,Nov
2023-11-13,Soriano Brothers PB,Invoice,008-02199,Arroz a Granel:Largo Fino 50 LB -Bolsa Dos Hermanos.,,5.0,21.0,105.0,1552369.15,,Lisset Limpio -020,CAFETERIA y RESTAURANTS,1381799,Nov
2023-11-13,Soriano Brothers PB,Invoice,008-02199,Arroz a Granel:Parboiled 50 LB -Bolsa Dos Hermanos.,,3.0,25.5,76.5,1552445.65,,Lisset Limpio -020,CAFETERIA y RESTAURANTS,1381800,Nov
2023-11-13,Soriano Brothers PB,Invoice,008-02199,Spices:AS Sazon (for all),1 / 30 lb (box or pail),2.0,59.0,118.0,1552563.65,American Spice,Lisset Limpio -020,CAFETERIA y RESTAURANTS,1381801,Nov
2023-11-13,El Palacio de los jugos / Santa Clara Sabor,Invoice,008-02200,Arroz a Granel:Largo Fino 50 LB -Bolsa Dos Hermanos.,,10.0,21.0,210.0,1552773.65,,Lisset Limpio -020,Cafeteria,1381802,Nov
2023-11-13,El Palacio de los jugos / Lita Foods Inc.,Invoice,008-02201,Arroz a Granel:Parboiled 50 LB -Bolsa Dos Hermanos.,,10.0,25.5,255.0,1553028.65,,Lisset Limpio -020,Cafeteria,1381803,Nov
2023-11-13,El Palacio de Los Jugos / Casa mía Food Restaurant inc,Invoice,008-02202,Arroz a Granel:Parboiled 50 LB -Bolsa Dos Hermanos.,,12.0,25.5,306.0,1553334.65,,Lisset Limpio -020,Cafeteria,1381804,Nov
2023-11-13,El Palacio de los jugos /  EMMA FOOD CORP,Invoice,008-02203,Arroz a Granel:Largo Fino 50 LB -Bolsa Dos Hermanos.,,5.0,21.0,105.0,1553439.65,,Lisset Limpio -020,Cafeteria,1381805,Nov
2023-11-13,El Palacio de los jugos /  EMMA FOOD CORP,Invoice,008-02203,Arroz a Granel:Parboiled 50 LB -Bolsa Dos Hermanos.,,5.0,25.5,127.5,1553567.15,,Lisset Limpio -020,Cafeteria,1381806,Nov
2023-11-13,El Palacio de los jugos / Caribe Tropical,Invoice,008-02204,Liquids:AS Marinating Sauce (Mojo),,1.0,17.0,17.0,1553584.15,,Lisset Limpio -020,Cafeteria,1381807,Nov
2023-11-13,El Palacio de los jugos / Caribe Tropical,Invoice,008-02204,,,,,0.0,1553584.15,,Lisset Limpio -020,Cafeteria,1381808,Nov
2023-11-13,El Palacio de los jugos / Caribe Tropical,Invoice,008-02204,Arroz a Granel:Parboiled 50 LB -Bolsa Dos Hermanos.,,9.0,25.5,229.5,1553813.65,,Lisset Limpio -020,Cafeteria,1381809,Nov
2023-11-13,Sorianos Brothers,Invoice,008-02205,Arroz a Granel:Largo Fino 50 LB -Bolsa Dos Hermanos.,,25.0,21.0,525.0,1554338.65,,Lisset Limpio -020,CAFETERIA y RESTAURANTS,1381810,Nov
2023-11-13,Sorianos Brothers,Invoice,008-02205,Arroz a Granel:Parboiled 50 LB -Bolsa Dos Hermanos.,,30.0,25.5,765.0,1555103.65,,Lisset Limpio -020,CAFETERIA y RESTAURANTS,1381811,Nov
2023-11-13,BA Food Imports,Invoice,008-02206,Spices:AS Anise Star (deleted),6 / 5 oz,28.0,33.65,942.2,1556045.85,,Armando Carpio - 017,WHOLESALER,1381812,Nov
2023-11-13,BA Food Imports,Invoice,008-02206,Spices:AS Cinamon Sticks (deleted),6 / 6.5 oz,56.0,22.0,1232.0,1557277.85,,Armando Carpio - 017,WHOLESALER,1381813,Nov
2023-11-13,BA Food Imports,Invoice,008-02206,Spices:AS Garlic Powder (deleted),6 / 14 oz,56.0,24.0,1344.0,1558621.85,,Armando Carpio - 017,WHOLESALER,1381814,Nov
2023-11-13,BA Food Imports,Invoice,008-02206,Spices:AS Black Ground Pepper (deleted),6 / 11.5 oz,28.0,25.3,708.4,1559330.25,,Armando Carpio - 017,WHOLESALER,1381815,Nov
2023-11-13,BA Food Imports,Invoice,008-02206,Spices:AS Turmeric Ground (deleted),6 / 13 oz,17.0,19.0,323.0,1559653.25,,Armando Carpio - 017,WHOLESALER,1381816,Nov
2023-11-13,BA Food Imports,Invoice,008-02206,Spices:AS Bay Leaves Whole (deleted),6 / 1.5 oz,28.0,16.5,462.0,1560115.25,,Armando Carpio - 017,WHOLESALER,1381817,Nov
2023-11-13,BA Food Imports,Invoice,008-02206,Spices:AS Cuming Ground (deleted),4 / 4 lb.,3.0,43.0,129.0,1560244.25,,Armando Carpio - 017,WHOLESALER,1381818,Nov
2023-11-13,BA Food Imports,Invoice,008-02206,Spices:AS Nut Meg Whole (deleted),4 / 4 lb.,3.0,123.2,369.6,1560613.85,,Armando Carpio - 017,WHOLESALER,1381819,Nov
2023-11-13,BA Food Imports,Invoice,008-02206,Spices:AS Paprika Sweet (deleted),4 / 4 lb.,4.0,40.0,160.0,1560773.85,,Armando Carpio - 017,WHOLESALER,1381820,Nov
2023-11-13,BA Food Imports,Invoice,008-02206,Spices:AS Pepper Butcher Black (deleted),4 / 4 lb.,1.0,79.5,79.5,1560853.35,,Armando Carpio - 017,WHOLESALER,1381821,Nov
2023-11-13,BA Food Imports,Invoice,008-02206,Spices:AS Ground Black Pepper (deleted),4/4 lb.,1.0,70.0,70.0,1560923.35,,Armando Carpio - 017,WHOLESALER,1381822,Nov
2023-11-13,BA Food Imports,Invoice,008-02206,Spices:AS Red Xrushed Pepper (deleted),4 / 3.5 oz,1.0,40.0,40.0,1560963.35,,Armando Carpio - 017,WHOLESALER,1381823,Nov
2023-11-13,BA Food Imports,Invoice,008-02206,Spices:AS Whole Oregano (deleted),4 / 24 oz,6.0,21.25,127.5,1561090.85,,Armando Carpio - 017,WHOLESALER,1381824,Nov
2023-11-13,BA Food Imports,Invoice,008-02206,Spices:AS Bay Leaves (whole) (deleted),4 / 12 oz,4.0,25.3,101.2,1561192.05,,Armando Carpio - 017,WHOLESALER,1381825,Nov
2023-11-13,BA Food Imports,Invoice,008-02206,Arroz Envasado:Largo Fino 1kg (Long grain rice) Dos Hermanos,,120.0,13.5,1620.0,1562812.05,,Armando Carpio - 017,WHOLESALER,1381826,Nov
2023-11-14,Ideal Food Basket Davie Cafeteria,Invoice,008-02207,Arroz a Granel:Largo Fino 50 LB -Bolsa Dos Hermanos.,,10.0,23.0,230.0,1563042.05,,Ruta - 019,CAFETERIA y RESTAURANTS,1381827,Nov
2023-11-14,Asian Buffet Sunrise,Invoice,008-02208,Arroz a Granel:Parboiled 50 LB -Bolsa Dos Hermanos.,,10.0,25.5,255.0,1563297.05,,Lisset Limpio -020,CAFETERIA y RESTAURANTS,1381828,Nov
2023-11-14,Bake Mark USA LLC,Invoice,008-02209,Arroz a Granel:Parboiled 50 LB -Bolsa Dos Hermanos.,,880.0,22.5,19800.0,1583097.05,,Armando Carpio - 017,WHOLESALER MANUFACTURY,1381829,Nov
2023-11-16,Sedanos Supermarkets #41,Invoice,008-02210,Arroz Envasado:Parboiled 5KG Dos Hermanos.,6 / 11lbs,14.0,40.5,567.0,1583664.05,,Ruta - 019,RETAIL SEDANOS,1381830,Nov
2023-11-16,Sedanos Supermarkets #41,Invoice,008-02210,Arroz Envasado:Parboiled 5KG Dos Hermanos.,6 / 11lbs,14.0,0.0,0.0,1583664.05,,Ruta - 019,RETAIL SEDANOS,1381831,Nov
2023-11-16,Sedanos Supermarkets #41,Invoice,008-02210,,Discount,-567.0,0.02,-11.34,1583652.71,,Ruta - 019,RETAIL SEDANOS,1381832,Nov
2023-11-16,Sedanos Supermarkets #40,Invoice,008-02211,Arroz Envasado:Parboiled 5KG Dos Hermanos.,6 / 11lbs,14.0,40.5,567.0,1584219.71,,Ruta - 019,RETAIL SEDANOS,1381833,Nov
2023-11-16,Sedanos Supermarkets #40,Invoice,008-02211,Arroz Envasado:Parboiled 5KG Dos Hermanos.,6 / 11lbs,14.0,0.0,0.0,1584219.71,,Ruta - 019,RETAIL SEDANOS,1381834,Nov
2023-11-16,Sedanos Supermarkets #40,Invoice,008-02211,,Discount,-567.0,0.02,-11.34,1584208.37,,Ruta - 019,RETAIL SEDANOS,1381835,Nov
2023-11-16,KISSIMMEE Meat and Produce,Invoice,008-02212,Arroz Envasado:Parboiled 5KG Dos Hermanos.,6 / 11lbs,15.0,40.5,607.5,1584815.87,,Ruta - 019,RETAIL  DSD,1381836,Nov
2023-11-16,KISSIMMEE Meat and Produce,Invoice,008-02212,Arroz Envasado:Parboiled 5KG Dos Hermanos.,6 / 11lbs,15.0,0.0,0.0,1584815.87,,Ruta - 019,RETAIL  DSD,1381837,Nov
2023-11-16,BRAVO KISSIMME,Invoice,008-02213,Arroz Envasado:Parboiled 5KG Dos Hermanos.,6 / 11lbs,11.0,40.5,445.5,1585261.37,,Ruta - 019,RETAIL  DSD,1381838,Nov
2023-11-16,BRAVO KISSIMME,Invoice,008-02213,Arroz Envasado:Parboiled 5KG Dos Hermanos.,6 / 11lbs,10.0,0.0,0.0,1585261.37,,Ruta - 019,RETAIL  DSD,1381839,Nov
2023-11-16,Soriano Brothers PB,Invoice,008-02214,Arroz a Granel:Largo Fino 50 LB -Bolsa Dos Hermanos.,,5.0,21.0,105.0,1585366.37,,Lisset Limpio -020,CAFETERIA y RESTAURANTS,1381840,Nov
2023-11-16,Soriano Brothers PB,Invoice,008-02214,Arroz a Granel:Parboiled 50 LB -Bolsa Dos Hermanos.,,5.0,25.5,127.5,1585493.87,,Lisset Limpio -020,CAFETERIA y RESTAURANTS,1381841,Nov
2023-11-16,El Palacio de los jugos / Sahilys Cafe,Invoice,008-02215,Arroz a Granel:Largo Fino 50 LB -Bolsa Dos Hermanos.,,5.0,21.0,105.0,1585598.87,,Lisset Limpio -020,Cafeteria,1381842,Nov
2023-11-16,El Palacio de los jugos / Santa Clara Sabor,Invoice,008-02216,Arroz a Granel:Largo Fino 50 LB -Bolsa Dos Hermanos.,,10.0,21.0,210.0,1585808.87,,Lisset Limpio -020,Cafeteria,1381843,Nov
2023-11-16,El Palacio de Los Jugos / Casa mía Food Restaurant inc,Invoice,008-02217,Arroz a Granel:Parboiled 50 LB -Bolsa Dos Hermanos.,,12.0,25.5,306.0,1586114.87,,Lisset Limpio -020,Cafeteria,1381844,Nov
2023-11-16,El Palacio de los jugos / Caribe Tropical,Invoice,008-02218,Arroz a Granel:Largo Fino 50 LB -Bolsa Dos Hermanos.,,6.0,21.0,126.0,1586240.87,,Lisset Limpio -020,Cafeteria,1381845,Nov
2023-11-16,El Palacio de los jugos / Caribe Tropical,Invoice,008-02218,Arroz a Granel:Parboiled 50 LB -Bolsa Dos Hermanos.,,6.0,25.5,153.0,1586393.87,,Lisset Limpio -020,Cafeteria,1381846,Nov
2023-11-16,El Palacio de los jugos / Caribe Tropical,Invoice,008-02218,Dry Beans:Dry Beans - Black Beans 50,Dry Black Beans 50 lb,1.0,37.5,37.5,1586431.37,,Lisset Limpio -020,Cafeteria,1381847,Nov
2023-11-16,Key Foods  / Ivan,Invoice,008-02219,Arroz a Granel:Largo Fino 50 LB -Bolsa Dos Hermanos.,,20.0,21.5,430.0,1586861.37,,Lisset Limpio -020,RETAIL  DSD,1381848,Nov
2023-11-16,El Palacio de los jugos /  EMMA FOOD CORP,Invoice,008-02220,Arroz a Granel:Largo Fino 50 LB -Bolsa Dos Hermanos.,,8.0,21.0,168.0,1587029.37,,Lisset Limpio -020,Cafeteria,1381849,Nov
2023-11-16,El Palacio de los jugos /  EMMA FOOD CORP,Invoice,008-02220,Arroz a Granel:Parboiled 50 LB -Bolsa Dos Hermanos.,,10.0,25.5,255.0,1587284.37,,Lisset Limpio -020,Cafeteria,1381850,Nov
2023-11-16,El Palacio de los jugos / Lita Foods Inc.,Invoice,008-02221,Arroz a Granel:Parboiled 50 LB -Bolsa Dos Hermanos.,,10.0,25.5,255.0,1587539.37,,Lisset Limpio -020,Cafeteria,1381851,Nov
2023-11-16,Los Mejores Tamales de Miami,Invoice,008-02222,Arroz a Granel:Largo Fino 50 LB -Bolsa Dos Hermanos.,,5.0,21.5,107.5,1587646.87,,Lisset Limpio -020,CAFETERIA y RESTAURANTS,1381852,Nov
2023-11-16,Albert Deli #2,Invoice,008-02223,Arroz a Granel:Largo Fino 50 LB -Bolsa Dos Hermanos.,,8.0,23.0,184.0,1587830.87,,Lisset Limpio -020,CAFETERIA y RESTAURANTS,1381853,Nov
2023-11-16,Albert Deli #2,Invoice,008-02223,Dry Beans:Dry Beans - Black Beans 50,Dry Black Beans 50 lb,1.0,38.5,38.5,1587869.37,,Lisset Limpio -020,CAFETERIA y RESTAURANTS,1381854,Nov
2023-11-16,Albert Deli #2,Invoice,008-02223,Arroz a Granel:Parboiled 50 LB -Bolsa Dos Hermanos.,,2.0,25.5,51.0,1587920.37,,Lisset Limpio -020,CAFETERIA y RESTAURANTS,1381855,Nov
2023-11-16,Bravo   Francisco Diaz,Invoice,008-02224,Arroz a Granel:Largo Fino 50 LB -Bolsa Dos Hermanos.,,4.0,22.0,88.0,1588008.37,,Lisset Limpio -020,RETAIL  DSD,1381856,Nov
2023-11-16,Bravo   Francisco Diaz,Invoice,008-02224,Liquids:AS Marinating Sauce (Mojo),,3.0,18.5,55.5,1588063.87,,Lisset Limpio -020,RETAIL  DSD,1381857,Nov
2023-11-16,Bravo   Francisco Diaz,Invoice,008-02224,Liquids:AS Cooking Wine,4/1 Gl.,3.0,17.5,52.5,1588116.37,,Lisset Limpio -020,RETAIL  DSD,1381858,Nov
2023-11-16,Bravo   Francisco Diaz,Invoice,008-02224,Liquids:AS White Vinegar,4/1 Gl.,3.0,10.0,30.0,1588146.37,,Lisset Limpio -020,RETAIL  DSD,1381859,Nov
2023-11-17,El Palacio de los jugos /  Nanos Latin Foods,Invoice,008-02225,Arroz a Granel:Largo Fino 50 LB -Bolsa Dos Hermanos.,,10.0,21.0,210.0,1588356.37,,Lisset Limpio -020,Cafeteria,1381860,Nov
2023-11-20,Fritanga Poneloya,Invoice,008-02226,Arroz a Granel:Largo Fino 50 LB -Bolsa Dos Hermanos.,,5.0,22.0,110.0,1588466.37,,Lisset Limpio -020,CAFETERIA y RESTAURANTS,1381861,Nov
2023-11-20,El Gallego Supermarket,Invoice,008-02227,Dry Beans:Dry Beans - Black Beans 50,Dry Black Beans 50 lb,3.0,37.5,112.5,1588578.87,,Lisset Limpio -020,RETAIL  DSD,1381862,Nov
2023-11-20,El Gallego Supermarket,Invoice,008-02227,Arroz a Granel:Parboiled 50 LB -Bolsa Dos Hermanos.,,5.0,25.5,127.5,1588706.37,,Lisset Limpio -020,RETAIL  DSD,1381863,Nov
2023-11-20,Los Caringas Latin America  Foods,Invoice,008-02228,Arroz a Granel:Largo Fino 50 LB -Bolsa Dos Hermanos.,,3.0,21.5,64.5,1588770.87,,Lisset Limpio -020,CAFETERIA y RESTAURANTS,1381864,Nov
2023-11-20,Los Caringas Latin America  Foods,Invoice,008-02228,Arroz a Granel:Parboiled 50 LB -Bolsa Dos Hermanos.,,3.0,25.5,76.5,1588847.37,,Lisset Limpio -020,CAFETERIA y RESTAURANTS,1381865,Nov
2023-11-20,El Palacio de los jugos /  Nanos Latin Foods,Invoice,008-02229,Arroz a Granel:Largo Fino 50 LB -Bolsa Dos Hermanos.,,10.0,21.5,215.0,1589062.37,,Lisset Limpio -020,Cafeteria,1381866,Nov
2023-11-20,Soriano Brothers PB,Invoice,008-02230,Spices:AS Sazon (for all),1 / 30 lb (box or pail),4.0,59.0,236.0,1589298.37,American Spice,Lisset Limpio -020,CAFETERIA y RESTAURANTS,1381867,Nov
2023-11-20,Soriano Brothers PB,Invoice,008-02230,Arroz a Granel:Largo Fino 50 LB -Bolsa Dos Hermanos.,,10.0,21.5,215.0,1589513.37,,Lisset Limpio -020,CAFETERIA y RESTAURANTS,1381868,Nov
2023-11-20,Soriano Brothers PB,Invoice,008-02230,Arroz a Granel:Parboiled 50 LB -Bolsa Dos Hermanos.,,10.0,25.5,255.0,1589768.37,,Lisset Limpio -020,CAFETERIA y RESTAURANTS,1381869,Nov
2023-11-20,El Palacio de los jugos /  Mires Restaurants,Invoice,008-02231,Arroz a Granel:Largo Fino 50 LB -Bolsa Dos Hermanos.,,10.0,21.5,215.0,1589983.37,,Lisset Limpio -020,Cafeteria,1381870,Nov
2023-11-20,El Palacio de los jugos /  Mires Restaurants,Invoice,008-02231,Arroz a Granel:Parboiled 50 LB -Bolsa Dos Hermanos.,,10.0,25.5,255.0,1590238.37,,Lisset Limpio -020,Cafeteria,1381871,Nov
2023-11-20,El Palacio de los jugos / Santa Clara Sabor,Invoice,008-02232,Arroz a Granel:Largo Fino 50 LB -Bolsa Dos Hermanos.,,10.0,21.5,215.0,1590453.37,,Lisset Limpio -020,Cafeteria,1381872,Nov
2023-11-20,El Palacio de los jugos / Lita Foods Inc.,Invoice,008-02233,Arroz a Granel:Parboiled 50 LB -Bolsa Dos Hermanos.,,10.0,25.5,255.0,1590708.37,,Lisset Limpio -020,Cafeteria,1381873,Nov
2023-11-20,El Palacio de Los Jugos / Casa mía Food Restaurant inc,Invoice,008-02234,Arroz a Granel:Parboiled 50 LB -Bolsa Dos Hermanos.,,25.0,25.5,637.5,1591345.87,,Lisset Limpio -020,Cafeteria,1381874,Nov
2023-11-20,El Palacio de los jugos / Sahilys Cafe,Invoice,008-02235,Arroz a Granel:Largo Fino 50 LB -Bolsa Dos Hermanos.,,15.0,21.5,322.5,1591668.37,,Lisset Limpio -020,Cafeteria,1381875,Nov
2023-11-20,El Palacio de los jugos / Caribe Tropical,Invoice,008-02236,Arroz a Granel:Parboiled 50 LB -Bolsa Dos Hermanos.,,10.0,25.5,255.0,1591923.37,,Lisset Limpio -020,Cafeteria,1381876,Nov
2023-11-20,El Palacio de los jugos / Caribe Tropical,Invoice,008-02236,Dry Beans:Dry Beans - Black Beans 50,Dry Black Beans 50 lb,1.0,37.5,37.5,1591960.87,,Lisset Limpio -020,Cafeteria,1381877,Nov
2023-11-20,El Palacio de los jugos /  EMMA FOOD CORP,Invoice,008-02237,Arroz a Granel:Largo Fino 50 LB -Bolsa Dos Hermanos.,,5.0,21.0,105.0,1592065.87,,Lisset Limpio -020,Cafeteria,1381878,Nov
2023-11-20,El Palacio de los jugos /  EMMA FOOD CORP,Invoice,008-02237,Arroz a Granel:Parboiled 50 LB -Bolsa Dos Hermanos.,,8.0,25.5,204.0,1592269.87,,Lisset Limpio -020,Cafeteria,1381879,Nov
2023-11-20,Havana Club Cafe and Restaurant,Invoice,008-02238,Arroz a Granel:Largo Fino 50 LB -Bolsa Dos Hermanos.,,5.0,23.0,115.0,1592384.87,,Armando Carpio - 017,CAFETERIA y RESTAURANTS,1381880,Nov
2023-11-20,Havana Club Cafe and Restaurant,Invoice,008-02238,Arroz a Granel:Parboiled 50 LB -Bolsa Dos Hermanos.,,10.0,25.5,255.0,1592639.87,,Armando Carpio - 017,CAFETERIA y RESTAURANTS,1381881,Nov
2023-11-20,Havana Club Cafe and Restaurant,Invoice,008-02238,Spices:AS Garlic Powder AGG,4/4 lb.,1.0,53.0,53.0,1592692.87,,Armando Carpio - 017,CAFETERIA y RESTAURANTS,1381882,Nov
2023-11-20,Havana Club Cafe and Restaurant,Invoice,008-02238,Dry Beans:Dry Beans - Black Beans 50,Dry Black Beans 50 lb,7.0,38.5,269.5,1592962.37,,Armando Carpio - 017,CAFETERIA y RESTAURANTS,1381883,Nov
2023-11-20,Havana Club Cafe and Restaurant,Invoice,008-02238,Liquids:AS Marinating Sauce (Mojo),,5.0,18.5,92.5,1593054.87,,Armando Carpio - 017,CAFETERIA y RESTAURANTS,1381884,Nov
2023-11-20,Fritanga Momotombo,Invoice,008-02239,Arroz a Granel:Largo Fino 50 LB -Bolsa Dos Hermanos.,,7.0,22.0,154.0,1593208.87,,Lisset Limpio -020,CAFETERIA y RESTAURANTS,1381885,Nov
2023-11-20,Soriano Brothers,Invoice,008-02240,Arroz a Granel:Parboiled 50 LB -Bolsa Dos Hermanos.,,25.0,25.5,637.5,1593846.37,,Lisset Limpio -020,CAFETERIA y RESTAURANTS,1381886,Nov
2023-11-21,Sabor Tropical Supermarket #4,Invoice,008-02241,Arroz a Granel:Parboiled 50 LB -Bolsa Dos Hermanos.,,20.0,25.5,510.0,1594356.37,,Lisset Limpio -020,RETAIL  DSD,1381887,Nov
2023-11-21,Sabor Tropical Supermarket #4,Invoice,008-02241,Spices:AS Chicken Base,1 / 30 lb. (box or pail),2.0,39.5,79.0,1594435.37,,Lisset Limpio -020,RETAIL  DSD,1381888,Nov
2023-11-21,Ideal Food Basket Davie Cafeteria,Invoice,008-02242,Arroz a Granel:Largo Fino 50 LB -Bolsa Dos Hermanos.,,10.0,23.0,230.0,1594665.37,,Armando Carpio - 017,CAFETERIA y RESTAURANTS,1381889,Nov
2023-11-21,Soriano Brothers,Invoice,008-02243,Arroz a Granel:Largo Fino 50 LB -Bolsa Dos Hermanos.,,15.0,21.0,315.0,1594980.37,,Lisset Limpio -020,CAFETERIA y RESTAURANTS,1381890,Nov
2023-11-21,El Palacio de los jugos / Lita Foods Inc.,Invoice,008-02244,Arroz a Granel:Parboiled 50 LB -Bolsa Dos Hermanos.,,20.0,25.5,510.0,1595490.37,,Lisset Limpio -020,Cafeteria,1381891,Nov
2023-11-22,Bravo   Francisco Diaz,Invoice,008-02245,Liquids:AS Cooking Wine,4/1 Gl.,4.0,17.5,70.0,1595560.37,,Lisset Limpio -020,RETAIL  DSD,1381892,Nov
2023-11-22,Bravo   Francisco Diaz,Invoice,008-02245,Arroz a Granel:Largo Fino 50 LB -Bolsa Dos Hermanos.,,2.0,22.0,44.0,1595604.37,,Lisset Limpio -020,RETAIL  DSD,1381893,Nov
2023-11-22,El Palacio de los jugos /  EMMA FOOD CORP,Invoice,008-02246,Arroz a Granel:Largo Fino 50 LB -Bolsa Dos Hermanos.,,8.0,21.5,172.0,1595776.37,,Lisset Limpio -020,Cafeteria,1381894,Nov
2023-11-22,El Palacio de los jugos /  EMMA FOOD CORP,Invoice,008-02246,Arroz a Granel:Parboiled 50 LB -Bolsa Dos Hermanos.,,15.0,25.5,382.5,1596158.87,,Lisset Limpio -020,Cafeteria,1381895,Nov
2023-11-22,El Palacio de los jugos / Caribe Tropical,Invoice,008-02247,Dry Beans:Dry Beans - Black Beans 50,Dry Black Beans 50 lb,2.0,37.5,75.0,1596233.87,,Lisset Limpio -020,Cafeteria,1381896,Nov
2023-11-22,El Palacio de los jugos / Caribe Tropical,Invoice,008-02247,Arroz a Granel:Parboiled 50 LB -Bolsa Dos Hermanos.,,10.0,25.5,255.0,1596488.87,,Lisset Limpio -020,Cafeteria,1381897,Nov
2023-11-22,El Palacio de los jugos / Delicias Criollas (DIAGO FOOD_MILLER),Invoice,008-02248,Arroz a Granel:Parboiled 50 LB -Bolsa Dos Hermanos.,,20.0,25.5,510.0,1596998.87,,Lisset Limpio -020,Cafeteria,1381898,Nov
2023-11-22,Soriano Brothers PB,Invoice,008-02249,Arroz a Granel:Parboiled 50 LB -Bolsa Dos Hermanos.,,10.0,25.5,255.0,1597253.87,,Lisset Limpio -020,CAFETERIA y RESTAURANTS,1381899,Nov
2023-11-22,Soriano Brothers PB,Invoice,008-02249,Dry Beans:Dry Beans - Black Beans 50,Dry Black Beans 50 lb,1.0,37.5,37.5,1597291.37,,Lisset Limpio -020,CAFETERIA y RESTAURANTS,1381900,Nov
2023-11-22,Soriano Brothers PB,Invoice,008-02249,Arroz a Granel:Largo Fino 50 LB -Bolsa Dos Hermanos.,,5.0,21.5,107.5,1597398.87,,Lisset Limpio -020,CAFETERIA y RESTAURANTS,1381901,Nov
2023-11-22,Los paraditos chinesse,Invoice,008-02250,Arroz a Granel:Largo Fino 50 LB -Bolsa Dos Hermanos.,,10.0,21.5,215.0,1597613.87,,Lisset Limpio -020,CAFETERIA y RESTAURANTS,1381902,Nov
2023-11-22,Los paraditos chinesse,Invoice,008-02250,Arroz a Granel:Parboiled 50 LB -Bolsa Dos Hermanos.,,5.0,25.5,127.5,1597741.37,,Lisset Limpio -020,CAFETERIA y RESTAURANTS,1381903,Nov
2023-11-22,Brito Family Corp.,Invoice,008-02251,Arroz a Granel:Largo Fino 50 LB -Bolsa Dos Hermanos.,,110.0,21.0,2310.0,1600051.37,,Lisset Limpio -020,CAFETERIA y RESTAURANTS,1381904,Nov
2023-11-22,Brito Family Corp.,Invoice,008-02251,Arroz a Granel:Parboiled 50 LB -Bolsa Dos Hermanos.,,110.0,25.5,2805.0,1602856.37,,Lisset Limpio -020,CAFETERIA y RESTAURANTS,1381905,Nov
2023-11-27,El Palacio de los jugos / Caribe Tropical,Invoice,008-02252,Arroz a Granel:Parboiled 50 LB -Bolsa Dos Hermanos.,,8.0,25.5,204.0,1603060.37,,Lisset Limpio -020,Cafeteria,1381906,Nov
2023-11-27,El Palacio de los jugos / Caribe Tropical,Invoice,008-02252,Dry Beans:Dry Beans - Black Beans 50,Dry Black Beans 50 lb,1.0,37.5,37.5,1603097.87,,Lisset Limpio -020,Cafeteria,1381907,Nov
2023-11-27,China Buffet,Invoice,008-02253,Arroz a Granel:Parboiled 50 LB -Bolsa Dos Hermanos.,,5.0,25.5,127.5,1603225.37,,Lisset Limpio -020,CAFETERIA y RESTAURANTS,1381908,Nov
2023-11-27,El Palacio de Los Jugos / Casa mía Food Restaurant inc,Invoice,008-02254,Arroz a Granel:Parboiled 50 LB -Bolsa Dos Hermanos.,,10.0,25.5,255.0,1603480.37,,Lisset Limpio -020,Cafeteria,1381909,Nov
2023-11-27,El Palacio de los jugos / Santa Clara Sabor,Invoice,008-02255,Arroz a Granel:Largo Fino 50 LB -Bolsa Dos Hermanos.,,10.0,21.5,215.0,1603695.37,,Lisset Limpio -020,Cafeteria,1381910,Nov
2023-11-27,El Palacio de los jugos / Lita Foods Inc.,Invoice,008-02256,Arroz a Granel:Parboiled 50 LB -Bolsa Dos Hermanos.,,15.0,25.5,382.5,1604077.87,,Lisset Limpio -020,Cafeteria,1381911,Nov
2023-11-27,El Palacio de los jugos /  EMMA FOOD CORP,Invoice,008-02257,Arroz a Granel:Parboiled 50 LB -Bolsa Dos Hermanos.,,8.0,25.5,204.0,1604281.87,,Lisset Limpio -020,Cafeteria,1381912,Nov
2023-11-27,Sorianos Brothers,Invoice,008-02258,Arroz a Granel:Parboiled 50 LB -Bolsa Dos Hermanos.,,25.0,25.5,637.5,1604919.37,,Lisset Limpio -020,CAFETERIA y RESTAURANTS,1381913,Nov
2023-11-27,Soriano Brothers,Invoice,008-02259,Arroz a Granel:Parboiled 50 LB -Bolsa Dos Hermanos.,,25.0,25.5,637.5,1605556.87,,Lisset Limpio -020,CAFETERIA y RESTAURANTS,1381914,Nov
2023-11-27,Fritanga Momotombo,Invoice,008-02260,Arroz a Granel:Largo Fino 50 LB -Bolsa Dos Hermanos.,,5.0,22.0,110.0,1605666.87,,Lisset Limpio -020,CAFETERIA y RESTAURANTS,1381915,Nov
2023-11-28,Pacifico Chinese Restaurant,Invoice,008-02261,Arroz a Granel:Largo Fino 50 LB -Bolsa Dos Hermanos.,,7.0,21.5,150.5,1605817.37,,Lisset Limpio -020,CAFETERIA y RESTAURANTS,1381916,Nov
2023-11-28,Pacifico Chinese Restaurant,Invoice,008-02261,Arroz a Granel:Parboiled 50 LB -Bolsa Dos Hermanos.,,5.0,25.5,127.5,1605944.87,,Lisset Limpio -020,CAFETERIA y RESTAURANTS,1381917,Nov
2023-11-28,Victoria Produce & Meat Market,Invoice,008-02262,Arroz Envasado:Parboiled 5KG Dos Hermanos.,6 / 11lbs,21.0,40.5,850.5,1606795.37,,Ruta - 019,RETAIL  DSD,1381918,Nov
2023-11-28,Victoria Produce & Meat Market,Invoice,008-02262,Arroz Envasado:Parboiled 5KG Dos Hermanos.,6 / 11lbs,20.0,0.0,0.0,1606795.37,,Ruta - 019,RETAIL  DSD,1381919,Nov
2023-11-28,Bake Mark USA LLC,Invoice,008-02263,Arroz a Granel:Parboiled 50 LB -Bolsa Dos Hermanos.,,1100.0,22.5,24750.0,1631545.37,,Armando Carpio - 017,WHOLESALER MANUFACTURY,1381920,Nov
2023-11-28,Bake Mark USA LLC,Invoice,008-02264,Arroz a Granel:Parboiled 50 LB -Bolsa Dos Hermanos.,,1100.0,22.5,24750.0,1656295.37,,Armando Carpio - 017,WHOLESALER MANUFACTURY,1381921,Nov
2023-11-29,Sabor Tropical Supermarket #6,Invoice,008-02265,Arroz Envasado:Parboiled 5KG Dos Hermanos.,6 / 11lbs,21.0,40.5,850.5,1657145.87,,Lisset Limpio -020,RETAIL KEY FOOD,1381922,Nov
2023-11-29,Sabor Tropical Supermarket #6,Invoice,008-02265,Arroz Envasado:Parboiled 5KG Dos Hermanos.,6 / 11lbs,20.0,0.0,0.0,1657145.87,,Lisset Limpio -020,RETAIL KEY FOOD,1381923,Nov
2023-11-29,Hings Chinese,Invoice,008-02266,Arroz a Granel:Largo Fino 50 LB -Bolsa Dos Hermanos.,,3.0,21.5,64.5,1657210.37,,Lisset Limpio -020,CAFETERIA y RESTAURANTS,1381924,Nov
2023-11-29,Hings Chinese,Invoice,008-02266,Arroz a Granel:Parboiled 50 LB -Bolsa Dos Hermanos.,,3.0,25.5,76.5,1657286.87,,Lisset Limpio -020,CAFETERIA y RESTAURANTS,1381925,Nov
2023-11-29,Ideal Food Basket,Invoice,008-02267,Arroz a Granel:Largo Fino 50 LB -Bolsa Dos Hermanos.,,8.0,23.0,184.0,1657470.87,,Armando Carpio - 017,RETAIL  DSD,1381926,Nov
2023-11-30,Rey Chavez Distributor Corp,Invoice,008-02268,Arroz a Granel:Parboiled 50 LB -Bolsa Dos Hermanos.,,55.0,25.0,1375.0,1658845.87,,Lisset Limpio -020,WHOLESALER,1381927,Nov
2023-11-30,El Palacio de los jugos / Caribe Tropical,Invoice,008-02269,Arroz a Granel:Parboiled 50 LB -Bolsa Dos Hermanos.,,8.0,25.5,204.0,1659049.87,,Lisset Limpio -020,Cafeteria,1381928,Nov
2023-11-30,El Palacio de los jugos / Caribe Tropical,Invoice,008-02269,Dry Beans:Dry Beans - Black Beans 50,Dry Black Beans 50 lb,2.0,37.5,75.0,1659124.87,,Lisset Limpio -020,Cafeteria,1381929,Nov
2023-11-30,El Palacio de los jugos / Lita Foods Inc.,Invoice,008-02270,Arroz a Granel:Parboiled 50 LB -Bolsa Dos Hermanos.,,8.0,25.5,204.0,1659328.87,,Lisset Limpio -020,Cafeteria,1381930,Nov
2023-11-30,El Palacio de Los Jugos / Casa mía Food Restaurant inc,Invoice,008-02271,Arroz a Granel:Parboiled 50 LB -Bolsa Dos Hermanos.,,8.0,25.5,204.0,1659532.87,,Lisset Limpio -020,Cafeteria,1381931,Nov
2023-11-30,El Palacio de los jugos /  Nanos Latin Foods,Invoice,008-02272,Arroz a Granel:Largo Fino 50 LB -Bolsa Dos Hermanos.,,10.0,21.5,215.0,1659747.87,,Lisset Limpio -020,Cafeteria,1381932,Nov
2023-11-30,El Palacio de los jugos / Delicias Criollas (DIAGO FOOD_MILLER),Invoice,008-02273,Arroz a Granel:Parboiled 50 LB -Bolsa Dos Hermanos.,,10.0,25.5,255.0,1660002.87,,Lisset Limpio -020,Cafeteria,1381933,Nov
2023-11-30,El Gallego Supermarket,Invoice,008-02274,Arroz a Granel:Parboiled 50 LB -Bolsa Dos Hermanos.,,5.0,25.5,127.5,1660130.37,,Lisset Limpio -020,RETAIL  DSD,1381934,Nov
2023-11-30,El Gallego Supermarket,Invoice,008-02274,Dry Beans:Dry Beans - Black Beans 50,Dry Black Beans 50 lb,2.0,37.5,75.0,1660205.37,,Lisset Limpio -020,RETAIL  DSD,1381935,Nov
2023-11-30,El Palacio de los jugos / Santa Clara Sabor,Invoice,008-02275,Arroz a Granel:Largo Fino 50 LB -Bolsa Dos Hermanos.,,10.0,21.5,215.0,1660420.37,,Lisset Limpio -020,Cafeteria,1381936,Nov
2023-11-30,Havana Club Cafe and Restaurant,Invoice,008-02276,Arroz a Granel:Parboiled 50 LB -Bolsa Dos Hermanos.,,30.0,25.5,765.0,1661185.37,,Armando Carpio - 017,CAFETERIA y RESTAURANTS,1381937,Nov
2023-11-30,Havana Club Cafe and Restaurant,Invoice,008-02276,Arroz a Granel:Largo Fino 50 LB -Bolsa Dos Hermanos.,,10.0,23.0,230.0,1661415.37,,Armando Carpio - 017,CAFETERIA y RESTAURANTS,1381938,Nov
2023-11-30,Havana Club Cafe and Restaurant,Invoice,008-02276,Dry Beans:Dry Beans - Black Beans 50,Dry Black Beans 50 lb,15.0,38.5,577.5,1661992.87,,Armando Carpio - 017,CAFETERIA y RESTAURANTS,1381939,Nov
2023-11-30,Max Food Distributors,Invoice,008-02277,Arroz a Granel:Parboiled 50 LB -Bolsa Dos Hermanos.,,25.0,25.5,637.5,1662630.37,,Lisset Limpio -020,WHOLESALER,1381940,Nov
2023-11-30,Soriano Brothers,Invoice,008-02278,Arroz a Granel:Largo Fino 50 LB -Bolsa Dos Hermanos.,,20.0,21.0,420.0,1663050.37,,Lisset Limpio -020,CAFETERIA y RESTAURANTS,1381941,Nov
2023-11-30,El Palacio de los jugos /  EMMA FOOD CORP,Invoice,008-02279,Arroz a Granel:Parboiled 50 LB -Bolsa Dos Hermanos.,,10.0,25.5,255.0,1663305.37,,Lisset Limpio -020,Cafeteria,1381942,Nov
2023-12-04,Los Caringas Latin America  Foods,Invoice,008-02280,Arroz a Granel:Largo Fino 50 LB -Bolsa Dos Hermanos.,,3.0,21.5,64.5,1663369.87,,Lisset Limpio -020,CAFETERIA y RESTAURANTS,1381943,Dec
2023-12-04,Los Caringas Latin America  Foods,Invoice,008-02280,Arroz a Granel:Parboiled 50 LB -Bolsa Dos Hermanos.,,3.0,25.5,76.5,1663446.37,,Lisset Limpio -020,CAFETERIA y RESTAURANTS,1381944,Dec
2023-12-04,El Palacio de los jugos /  Mires Restaurants,Invoice,008-02281,Arroz a Granel:Parboiled 50 LB -Bolsa Dos Hermanos.,,10.0,25.5,255.0,1663701.37,,Lisset Limpio -020,Cafeteria,1381945,Dec
2023-12-04,El Palacio de los jugos / Santa Clara Sabor,Invoice,008-02282,Arroz a Granel:Largo Fino 50 LB -Bolsa Dos Hermanos.,,10.0,21.5,215.0,1663916.37,,Lisset Limpio -020,Cafeteria,1381946,Dec
2023-12-04,El Palacio de Los Jugos / Casa mía Food Restaurant inc,Invoice,008-02283,Arroz a Granel:Parboiled 50 LB -Bolsa Dos Hermanos.,,10.0,25.5,255.0,1664171.37,,Lisset Limpio -020,Cafeteria,1381947,Dec
2023-12-04,El Palacio de los jugos / Lita Foods Inc.,Invoice,008-02284,Arroz a Granel:Parboiled 50 LB -Bolsa Dos Hermanos.,,10.0,25.5,255.0,1664426.37,,Lisset Limpio -020,Cafeteria,1381948,Dec
2023-12-04,El Palacio de los jugos / Sahilys Cafe,Invoice,008-02285,Arroz a Granel:Largo Fino 50 LB -Bolsa Dos Hermanos.,,5.0,21.5,107.5,1664533.87,,Lisset Limpio -020,Cafeteria,1381949,Dec
2023-12-04,El Palacio de los jugos / Caribe Tropical,Invoice,008-02286,Dry Beans:Dry Beans - Black Beans 50,Dry Black Beans 50 lb,1.0,37.5,37.5,1664571.37,,Lisset Limpio -020,Cafeteria,1381950,Dec
2023-12-04,El Palacio de los jugos / Caribe Tropical,Invoice,008-02286,Arroz a Granel:Parboiled 50 LB -Bolsa Dos Hermanos.,,8.0,25.5,204.0,1664775.37,,Lisset Limpio -020,Cafeteria,1381951,Dec
2023-12-04,El Palacio de los jugos /  EMMA FOOD CORP,Invoice,008-02287,Arroz a Granel:Parboiled 50 LB -Bolsa Dos Hermanos.,,10.0,25.5,255.0,1665030.37,,Lisset Limpio -020,Cafeteria,1381952,Dec
2023-12-05,Bake Mark USA LLC,Invoice,008-02288,Arroz a Granel:Parboiled 50 LB -Bolsa Dos Hermanos.,,1100.0,22.5,24750.0,1689780.37,,Armando Carpio - 017,WHOLESALER MANUFACTURY,1381953,Dec
2023-12-05,Family and Son,Invoice,008-02289,Arroz a Granel:Parboiled 50 LB -Bolsa Dos Hermanos.,,1100.0,21.75,23925.0,1713705.37,,Armando Carpio - 017,WHOLESALER MANUFACTURY,1381954,Dec
2023-12-07,Los paraditos chinesse,Invoice,008-02290,Arroz a Granel:Largo Fino 50 LB -Bolsa Dos Hermanos.,,10.0,21.5,215.0,1713920.37,,Lisset Limpio -020,CAFETERIA y RESTAURANTS,1381955,Dec
2023-12-07,Los paraditos chinesse,Invoice,008-02290,Arroz a Granel:Parboiled 50 LB -Bolsa Dos Hermanos.,,10.0,25.5,255.0,1714175.37,,Lisset Limpio -020,CAFETERIA y RESTAURANTS,1381956,Dec
2023-12-07,Pacifico Chinese Restaurant,Invoice,008-02291,Arroz a Granel:Largo Fino 50 LB -Bolsa Dos Hermanos.,,8.0,21.5,172.0,1714347.37,,Lisset Limpio -020,CAFETERIA y RESTAURANTS,1381957,Dec
2023-12-07,Pacifico Chinese Restaurant,Invoice,008-02291,Arroz a Granel:Parboiled 50 LB -Bolsa Dos Hermanos.,,2.0,25.5,51.0,1714398.37,,Lisset Limpio -020,CAFETERIA y RESTAURANTS,1381958,Dec
2023-12-07,Price Choice Food Market # 6,Invoice,008-02292,Arroz a Granel:Largo Fino 50 LB -Bolsa Dos Hermanos.,,20.0,21.5,430.0,1714828.37,,Lisset Limpio -020,RETAIL  DSD,1381959,Dec
2023-12-07,Festival Supermarket #1,Invoice,008-02293,Arroz Envasado:Parboiled 5KG Dos Hermanos.,6 / 11lbs,10.0,40.5,405.0,1715233.37,,Lisset Limpio -020,RETAIL  DSD,1381960,Dec
2023-12-07,Festival Supermarket #1,Invoice,008-02293,Arroz Envasado:Parboiled 5KG Dos Hermanos.,6 / 11lbs,2.0,0.0,0.0,1715233.37,,Lisset Limpio -020,RETAIL  DSD,1381961,Dec
2023-12-07,Los Mejores Tamales de Miami,Invoice,008-02294,Arroz a Granel:Largo Fino 50 LB -Bolsa Dos Hermanos.,,5.0,21.5,107.5,1715340.87,,Lisset Limpio -020,CAFETERIA y RESTAURANTS,1381962,Dec
2023-12-07,Los Mejores Tamales de Miami,Invoice,008-02294,Arroz a Granel:Parboiled 50 LB -Bolsa Dos Hermanos.,,1.0,25.5,25.5,1715366.37,,Lisset Limpio -020,CAFETERIA y RESTAURANTS,1381963,Dec
2023-12-08,Sedanos Supermarkets #38,Invoice,008-02295,"Rice Snack:Rice Snack, Pizza DH",,1.0,19.9,19.9,1715386.27,,Armando Carpio - 017,RETAIL SEDANOS,1381964,Dec
2023-12-08,Sedanos Supermarkets #38,Invoice,008-02295,Rice Snack:Rice Snack Salami Flavored DOS HERMANOS,,1.0,19.9,19.9,1715406.16999999,,Armando Carpio - 017,RETAIL SEDANOS,1381965,Dec
2023-12-08,Sedanos Supermarkets #38,Invoice,008-02295,Rice Snack:Rice Snack Ham Flavored DOS HERMANOS,,1.0,19.9,19.9,1715426.06999999,,Armando Carpio - 017,RETAIL SEDANOS,1381966,Dec
2023-12-08,Sedanos Supermarkets #38,Invoice,008-02295,"Rice Snack:Rice Snack, Pizza DH",,1.0,0.0,0.0,1715426.06999999,,Armando Carpio - 017,RETAIL SEDANOS,1381967,Dec
2023-12-08,Sedanos Supermarkets #38,Invoice,008-02295,,Discount,-59.7,0.02,-1.19,1715424.87999999,,Armando Carpio - 017,RETAIL SEDANOS,1381968,Dec
2023-12-08,Ideal Food Basket Davie Cafeteria,Invoice,008-02296,Arroz a Granel:Largo Fino 50 LB -Bolsa Dos Hermanos.,,10.0,23.0,230.0,1715654.87999999,,Ruta - 019,CAFETERIA y RESTAURANTS,1381969,Dec
2023-12-08,El Palacio de los jugos / Santa Clara Sabor,Invoice,008-02297,Arroz a Granel:Largo Fino 50 LB -Bolsa Dos Hermanos.,,10.0,21.5,215.0,1715869.87999999,,Lisset Limpio -020,Cafeteria,1381970,Dec
2023-12-08,El Palacio de los jugos / Caribe Tropical,Invoice,008-02298,Arroz a Granel:Parboiled 50 LB -Bolsa Dos Hermanos.,,10.0,25.5,255.0,1716124.87999999,,Lisset Limpio -020,Cafeteria,1381971,Dec
2023-12-08,El Palacio de los jugos / Caribe Tropical,Invoice,008-02298,Liquids:AS Bitter Orange,,1.0,14.0,14.0,1716138.87999999,,Lisset Limpio -020,Cafeteria,1381972,Dec
2023-12-08,El Palacio de los jugos / Caribe Tropical,Invoice,008-02298,Dry Beans:Dry Beans - Black Beans 50,Dry Black Beans 50 lb,1.0,37.5,37.5,1716176.37999999,,Lisset Limpio -020,Cafeteria,1381973,Dec
2023-12-08,El Palacio de los jugos / Sahilys Cafe,Invoice,008-02299,Arroz a Granel:Largo Fino 50 LB -Bolsa Dos Hermanos.,,6.0,21.5,129.0,1716305.37999999,,Lisset Limpio -020,Cafeteria,1381974,Dec
2023-12-08,Bravo   Francisco Diaz,Invoice,008-02300,Liquids:AS White Vinegar,4/1 Gl.,1.0,10.0,10.0,1716315.37999999,,Lisset Limpio -020,RETAIL  DSD,1381975,Dec
2023-12-08,Bravo   Francisco Diaz,Invoice,008-02300,Arroz a Granel:Largo Fino 50 LB -Bolsa Dos Hermanos.,,5.0,22.0,110.0,1716425.37999999,,Lisset Limpio -020,RETAIL  DSD,1381976,Dec
2023-12-08,El Palacio de Los Jugos / Casa mía Food Restaurant inc,Invoice,008-02301,Arroz a Granel:Parboiled 50 LB -Bolsa Dos Hermanos.,,5.0,25.5,127.5,1716552.87999999,,Lisset Limpio -020,Cafeteria,1381977,Dec
2023-12-08,El Palacio de los jugos /  EMMA FOOD CORP,Invoice,008-02302,Arroz a Granel:Parboiled 50 LB -Bolsa Dos Hermanos.,,10.0,25.5,255.0,1716807.87999999,,Lisset Limpio -020,Cafeteria,1381978,Dec
2023-12-08,Soriano Brothers PB,Invoice,008-02303,Arroz a Granel:Largo Fino 50 LB -Bolsa Dos Hermanos.,,7.0,21.5,150.5,1716958.37999999,,Lisset Limpio -020,CAFETERIA y RESTAURANTS,1381979,Dec
2023-12-08,Soriano Brothers PB,Invoice,008-02303,Arroz a Granel:Parboiled 50 LB -Bolsa Dos Hermanos.,,4.0,25.5,102.0,1717060.37999999,,Lisset Limpio -020,CAFETERIA y RESTAURANTS,1381980,Dec
2023-12-08,Soriano Brothers PB,Invoice,008-02303,Spices:AS Sazon (for all),1 / 30 lb (box or pail),1.0,46.59,46.59,1717106.97,American Spice,Lisset Limpio -020,CAFETERIA y RESTAURANTS,1381981,Dec
2023-12-08,El Palacio de los jugos / Delicias Criollas (DIAGO FOOD_MILLER),Invoice,008-02304,Arroz a Granel:Parboiled 50 LB -Bolsa Dos Hermanos.,,15.0,25.5,382.5,1717489.47,,Lisset Limpio -020,Cafeteria,1381982,Dec
2023-12-11,Fritanga Momotombo,Invoice,008-02305,Arroz a Granel:Largo Fino 50 LB -Bolsa Dos Hermanos.,,6.0,22.0,132.0,1717621.47,,Lisset Limpio -020,CAFETERIA y RESTAURANTS,1381983,Dec
2023-12-11,Soriano Brothers PB,Invoice,008-02306,Dry Beans:Dry Beans - Black Beans 50,Dry Black Beans 50 lb,3.0,37.5,112.5,1717733.97,,Lisset Limpio -020,CAFETERIA y RESTAURANTS,1381984,Dec
2023-12-11,Soriano Brothers PB,Invoice,008-02306,Arroz a Granel:Parboiled 50 LB -Bolsa Dos Hermanos.,,10.0,25.5,255.0,1717988.97,,Lisset Limpio -020,CAFETERIA y RESTAURANTS,1381985,Dec
2023-12-11,Los Caringas Latin America  Foods,Invoice,008-02307,Arroz a Granel:Largo Fino 50 LB -Bolsa Dos Hermanos.,,3.0,22.0,66.0,1718054.97,,Lisset Limpio -020,CAFETERIA y RESTAURANTS,1381986,Dec
2023-12-11,Los Caringas Latin America  Foods,Invoice,008-02307,Arroz a Granel:Parboiled 50 LB -Bolsa Dos Hermanos.,,3.0,25.5,76.5,1718131.47,,Lisset Limpio -020,CAFETERIA y RESTAURANTS,1381987,Dec
2023-12-11,Hings Chinese,Invoice,008-02308,Arroz a Granel:Parboiled 50 LB -Bolsa Dos Hermanos.,,5.0,25.5,127.5,1718258.97,,Lisset Limpio -020,CAFETERIA y RESTAURANTS,1381988,Dec
2023-12-11,El Palacio de Los Jugos / Casa mía Food Restaurant inc,Invoice,008-02309,Arroz a Granel:Parboiled 50 LB -Bolsa Dos Hermanos.,,8.0,25.5,204.0,1718462.97,,Lisset Limpio -020,Cafeteria,1381989,Dec
2023-12-11,El Palacio de los jugos /  EMMA FOOD CORP,Invoice,008-02310,Arroz a Granel:Parboiled 50 LB -Bolsa Dos Hermanos.,,12.0,25.5,306.0,1718768.97,,Lisset Limpio -020,Cafeteria,1381990,Dec
2023-12-11,Sorianos Brothers,Invoice,008-02311,Arroz a Granel:Largo Fino 50 LB -Bolsa Dos Hermanos.,,15.0,21.0,315.0,1719083.97,,Lisset Limpio -020,CAFETERIA y RESTAURANTS,1381991,Dec
2023-12-11,Sorianos Brothers,Invoice,008-02311,Arroz a Granel:Parboiled 50 LB -Bolsa Dos Hermanos.,,20.0,25.5,510.0,1719593.97,,Lisset Limpio -020,CAFETERIA y RESTAURANTS,1381992,Dec
2023-12-11,Soriano Brothers,Invoice,008-02312,Arroz a Granel:Largo Fino 50 LB -Bolsa Dos Hermanos.,,15.0,21.0,315.0,1719908.97,,Lisset Limpio -020,CAFETERIA y RESTAURANTS,1381993,Dec
2023-12-11,Soriano Brothers,Invoice,008-02312,Arroz a Granel:Parboiled 50 LB -Bolsa Dos Hermanos.,,30.0,25.5,765.0,1720673.97,,Lisset Limpio -020,CAFETERIA y RESTAURANTS,1381994,Dec
2023-12-11,Sabor Tropical Supermarket #4,Invoice,008-02313,Arroz a Granel:Parboiled 50 LB -Bolsa Dos Hermanos.,,20.0,25.5,510.0,1721183.97,,Lisset Limpio -020,RETAIL  DSD,1381995,Dec
2023-12-11,Sabor Tropical Supermarket #4,Invoice,008-02313,Spices:AS Chicken Base,1 / 30 lb. (box or pail),1.0,39.56,39.56,1721223.53,,Lisset Limpio -020,RETAIL  DSD,1381996,Dec
2023-12-11,Sabor Tropical Supermarket #4,Invoice,008-02313,Dry Beans:Dry Beans - Black Beans 50,Dry Black Beans 50 lb,1.0,37.5,37.5,1721261.03,,Lisset Limpio -020,RETAIL  DSD,1381997,Dec
2023-12-11,Los Mejores Tamales de Miami,Invoice,008-02314,Arroz a Granel:Parboiled 50 LB -Bolsa Dos Hermanos.,,5.0,25.5,127.5,1721388.53,,Lisset Limpio -020,CAFETERIA y RESTAURANTS,1381998,Dec
2023-12-11,El Palacio de los jugos / Lita Foods Inc.,Invoice,008-02315,Arroz a Granel:Parboiled 50 LB -Bolsa Dos Hermanos.,,10.0,25.5,255.0,1721643.53,,Lisset Limpio -020,Cafeteria,1381999,Dec
2023-12-11,Fritanga Poneloya,Invoice,008-02316,Arroz a Granel:Largo Fino 50 LB -Bolsa Dos Hermanos.,,5.0,22.0,110.0,1721753.53,,Lisset Limpio -020,CAFETERIA y RESTAURANTS,1382000,Dec
2023-12-11,"American Spice Trading Co, Inc.",Invoice,008-02317,Arroz a Granel:Parboiled 50 LB -Bolsa Dos Hermanos.,,220.0,22.5,4950.0,1726703.53,,Armando Carpio - 017,WHOLESALER MANUFACTURY,1382001,Dec
2023-12-13,"American Spice Trading Co, Inc.",Invoice,008-02318,Arroz a Granel:Parboiled 50 LB -Bolsa Dos Hermanos.,,330.0,22.5,7425.0,1734128.53,,Armando Carpio - 017,WHOLESALER MANUFACTURY,1382002,Dec
2023-12-13,Panda Depot,Invoice,008-02319,Arroz a Granel:Parboiled 50 LB -Bolsa Dos Hermanos.,,385.0,23.75,9143.75,1743272.28,,Lisset Limpio -020,WHOLESALER,1382003,Dec
2023-12-13,Panda Depot,Invoice,008-02319,Arroz a Granel:Largo Fino 50 LB -Bolsa Dos Hermanos.,,165.0,21.0,3465.0,1746737.28,,Lisset Limpio -020,WHOLESALER,1382004,Dec
2023-12-13,Panda Depot,Invoice,008-02319,Liquids:AS White Vinegar,4/1 Gl.,72.0,9.0,648.0,1747385.28,,Lisset Limpio -020,WHOLESALER,1382005,Dec
2023-12-13,Rey Chavez Distributor Corp,Invoice,008-02320,Arroz a Granel:Parboiled 50 LB -Bolsa Dos Hermanos.,,110.0,25.0,2750.0,1750135.28,,Lisset Limpio -020,WHOLESALER,1382006,Dec
2023-12-13,Bake Mark USA LLC,Invoice,008-02321,Arroz a Granel:Largo Fino 50 LB -Bolsa Dos Hermanos.,,1.0,0.0,0.0,1750135.28,,Armando Carpio - 017,WHOLESALER MANUFACTURY,1382007,Dec
2023-12-14,Panda Depot,Credit Memo,008-02322,Liquids:AS White Vinegar,4/1 Gl.,-66.0,9.0,-594.0,1749541.28,,Lisset Limpio -020,WHOLESALER,1382008,Dec
2023-12-14,Soriano Brothers PB,Invoice,008-02323,Arroz a Granel:Largo Fino 50 LB -Bolsa Dos Hermanos.,,5.0,21.5,107.5,1749648.78,,Lisset Limpio -020,CAFETERIA y RESTAURANTS,1382009,Dec
2023-12-14,Soriano Brothers PB,Invoice,008-02323,Arroz a Granel:Parboiled 50 LB -Bolsa Dos Hermanos.,,5.0,25.5,127.5,1749776.28,,Lisset Limpio -020,CAFETERIA y RESTAURANTS,1382010,Dec
2023-12-14,El Palacio de los jugos /  EMMA FOOD CORP,Invoice,008-02324,Arroz a Granel:Parboiled 50 LB -Bolsa Dos Hermanos.,,10.0,25.5,255.0,1750031.28,,Lisset Limpio -020,Cafeteria,1382011,Dec
2023-12-14,Brito Family Corp.,Invoice,008-02325,Arroz a Granel:Largo Fino 50 LB -Bolsa Dos Hermanos.,,165.0,21.0,3465.0,1753496.28,,Lisset Limpio -020,CAFETERIA y RESTAURANTS,1382012,Dec
2023-12-14,Brito Family Corp.,Invoice,008-02325,Arroz a Granel:Parboiled 50 LB -Bolsa Dos Hermanos.,,55.0,25.5,1402.5,1754898.78,,Lisset Limpio -020,CAFETERIA y RESTAURANTS,1382013,Dec
2023-12-14,El Palacio de los jugos / Caribe Tropical,Invoice,008-02326,Arroz a Granel:Largo Fino 50 LB -Bolsa Dos Hermanos.,,10.0,21.5,215.0,1755113.78,,Lisset Limpio -020,Cafeteria,1382014,Dec
2023-12-14,El Palacio de los jugos / Caribe Tropical,Invoice,008-02326,Arroz a Granel:Parboiled 50 LB -Bolsa Dos Hermanos.,,15.0,25.5,382.5,1755496.28,,Lisset Limpio -020,Cafeteria,1382015,Dec
2023-12-14,El Palacio de los jugos / Caribe Tropical,Invoice,008-02326,Dry Beans:Dry Beans - Black Beans 50,Dry Black Beans 50 lb,1.0,37.5,37.5,1755533.78,,Lisset Limpio -020,Cafeteria,1382016,Dec
2023-12-14,El Palacio de Los Jugos / Casa mía Food Restaurant inc,Invoice,008-02327,Arroz a Granel:Parboiled 50 LB -Bolsa Dos Hermanos.,,10.0,25.5,255.0,1755788.78,,Lisset Limpio -020,Cafeteria,1382017,Dec
2023-12-14,Pacifico Chinese Restaurant,Invoice,008-02328,Arroz a Granel:Largo Fino 50 LB -Bolsa Dos Hermanos.,,8.0,21.5,172.0,1755960.78,,Lisset Limpio -020,CAFETERIA y RESTAURANTS,1382018,Dec
2023-12-14,Pacifico Chinese Restaurant,Invoice,008-02328,Arroz a Granel:Parboiled 50 LB -Bolsa Dos Hermanos.,,2.0,25.5,51.0,1756011.78,,Lisset Limpio -020,CAFETERIA y RESTAURANTS,1382019,Dec
2023-12-14,El Palacio de los jugos / Sahilys Cafe,Invoice,008-02329,Arroz a Granel:Largo Fino 50 LB -Bolsa Dos Hermanos.,,6.0,21.5,129.0,1756140.78,,Lisset Limpio -020,Cafeteria,1382020,Dec
2023-12-14,El Palacio de los jugos / Lita Foods Inc.,Invoice,008-02330,Arroz a Granel:Parboiled 50 LB -Bolsa Dos Hermanos.,,15.0,25.5,382.5,1756523.28,,Lisset Limpio -020,Cafeteria,1382021,Dec
2023-12-14,El Palacio de los jugos / Santa Clara Sabor,Invoice,008-02331,Arroz a Granel:Largo Fino 50 LB -Bolsa Dos Hermanos.,,10.0,21.5,215.0,1756738.28,,Lisset Limpio -020,Cafeteria,1382022,Dec
2023-12-14,El Gallego Supermarket,Invoice,008-02332,Arroz a Granel:Parboiled 50 LB -Bolsa Dos Hermanos.,,5.0,25.5,127.5,1756865.78,,Lisset Limpio -020,RETAIL  DSD,1382023,Dec
2023-12-14,El Gallego Supermarket,Invoice,008-02332,Dry Beans:Dry Beans - Black Beans 50,Dry Black Beans 50 lb,2.0,37.5,75.0,1756940.78,,Lisset Limpio -020,RETAIL  DSD,1382024,Dec
2023-12-14,El Palacio de los jugos / Delicias Criollas (DIAGO FOOD_MILLER),Invoice,008-02333,Arroz a Granel:Parboiled 50 LB -Bolsa Dos Hermanos.,,15.0,25.5,382.5,1757323.28,,Lisset Limpio -020,Cafeteria,1382025,Dec
2023-12-14,El Palacio de los jugos /  Mires Restaurants,Invoice,008-02334,Arroz a Granel:Parboiled 50 LB -Bolsa Dos Hermanos.,,10.0,25.5,255.0,1757578.28,,Lisset Limpio -020,Cafeteria,1382026,Dec
2023-12-18,Soriano Brothers,Invoice,008-02335,Arroz a Granel:Largo Fino 50 LB -Bolsa Dos Hermanos.,,15.0,21.0,315.0,1757893.28,,Lisset Limpio -020,CAFETERIA y RESTAURANTS,1382027,Dec
2023-12-18,Soriano Brothers,Invoice,008-02335,Arroz a Granel:Parboiled 50 LB -Bolsa Dos Hermanos.,,25.0,25.5,637.5,1758530.78,,Lisset Limpio -020,CAFETERIA y RESTAURANTS,1382028,Dec
2023-12-18,Sorianos Brothers,Invoice,008-02336,Arroz a Granel:Largo Fino 50 LB -Bolsa Dos Hermanos.,,10.0,21.0,210.0,1758740.78,,Lisset Limpio -020,CAFETERIA y RESTAURANTS,1382029,Dec
2023-12-18,Sorianos Brothers,Invoice,008-02336,Arroz a Granel:Parboiled 50 LB -Bolsa Dos Hermanos.,,15.0,25.5,382.5,1759123.28,,Lisset Limpio -020,CAFETERIA y RESTAURANTS,1382030,Dec
2023-12-18,Fritanga Momotombo,Invoice,008-02337,Arroz a Granel:Largo Fino 50 LB -Bolsa Dos Hermanos.,,6.0,22.0,132.0,1759255.28,,Lisset Limpio -020,CAFETERIA y RESTAURANTS,1382031,Dec
2023-12-18,El Palacio de los jugos / Lita Foods Inc.,Invoice,008-02338,Arroz a Granel:Parboiled 50 LB -Bolsa Dos Hermanos.,,15.0,25.5,382.5,1759637.78,,Lisset Limpio -020,Cafeteria,1382032,Dec
2023-12-18,El Palacio de los jugos / Sahilys Cafe,Invoice,008-02339,Arroz a Granel:Largo Fino 50 LB -Bolsa Dos Hermanos.,,6.0,21.5,129.0,1759766.78,,Lisset Limpio -020,Cafeteria,1382033,Dec
2023-12-18,El Palacio de Los Jugos / Casa mía Food Restaurant inc,Invoice,008-02340,Arroz a Granel:Parboiled 50 LB -Bolsa Dos Hermanos.,,12.0,25.5,306.0,1760072.78,,Lisset Limpio -020,Cafeteria,1382034,Dec
2023-12-18,El Palacio de los jugos / Santa Clara Sabor,Invoice,008-02341,Arroz a Granel:Largo Fino 50 LB -Bolsa Dos Hermanos.,,10.0,21.5,215.0,1760287.78,,Lisset Limpio -020,Cafeteria,1382035,Dec
2023-12-18,El Palacio de los jugos /  EMMA FOOD CORP,Invoice,008-02342,Arroz a Granel:Largo Fino 50 LB -Bolsa Dos Hermanos.,,8.0,21.5,172.0,1760459.78,,Lisset Limpio -020,Cafeteria,1382036,Dec
2023-12-18,El Palacio de los jugos / Delicias Criollas (DIAGO FOOD_MILLER),Invoice,008-02343,Arroz a Granel:Parboiled 50 LB -Bolsa Dos Hermanos.,,40.0,25.5,1020.0,1761479.78,,Lisset Limpio -020,Cafeteria,1382037,Dec
2023-12-18,Albert Deli #2,Invoice,008-02344,Arroz a Granel:Largo Fino 50 LB -Bolsa Dos Hermanos.,,6.0,23.0,138.0,1761617.78,,Lisset Limpio -020,CAFETERIA y RESTAURANTS,1382038,Dec
2023-12-18,Albert Deli #2,Invoice,008-02344,Arroz a Granel:Parboiled 50 LB -Bolsa Dos Hermanos.,,2.0,25.5,51.0,1761668.78,,Lisset Limpio -020,CAFETERIA y RESTAURANTS,1382039,Dec
2023-12-18,Albert Deli #2,Invoice,008-02344,Dry Beans:Dry Beans - Black Beans 50,Dry Black Beans 50 lb,1.0,38.5,38.5,1761707.28,,Lisset Limpio -020,CAFETERIA y RESTAURANTS,1382040,Dec
2023-12-18,Los Mejores Tamales de Miami,Invoice,008-02345,Arroz a Granel:Parboiled 50 LB -Bolsa Dos Hermanos.,,10.0,25.5,255.0,1761962.28,,Lisset Limpio -020,CAFETERIA y RESTAURANTS,1382041,Dec
2023-12-18,Los Mejores Tamales de Miami,Invoice,008-02345,Arroz a Granel:Largo Fino 50 LB -Bolsa Dos Hermanos.,,10.0,21.5,215.0,1762177.28,,Lisset Limpio -020,CAFETERIA y RESTAURANTS,1382042,Dec
2023-12-18,El Palacio de los jugos / Caribe Tropical,Invoice,008-02346,Arroz a Granel:Largo Fino 50 LB -Bolsa Dos Hermanos.,,10.0,21.5,215.0,1762392.28,,Lisset Limpio -020,Cafeteria,1382043,Dec
2023-12-18,El Palacio de los jugos / Caribe Tropical,Invoice,008-02346,Arroz a Granel:Parboiled 50 LB -Bolsa Dos Hermanos.,,14.0,25.5,357.0,1762749.28,,Lisset Limpio -020,Cafeteria,1382044,Dec
2023-12-18,El Palacio de los jugos / Caribe Tropical,Invoice,008-02346,Dry Beans:Dry Beans - Black Beans 50,Dry Black Beans 50 lb,1.0,37.5,37.5,1762786.78,,Lisset Limpio -020,Cafeteria,1382045,Dec
2023-12-18,Soriano Brothers PB,Invoice,008-02347,Arroz a Granel:Parboiled 50 LB -Bolsa Dos Hermanos.,,7.0,25.5,178.5,1762965.28,,Lisset Limpio -020,CAFETERIA y RESTAURANTS,1382046,Dec
2023-12-19,Havana Club Cafe and Restaurant,Invoice,008-02348,Dry Beans:Dry Beans - Black Beans 50,Dry Black Beans 50 lb,20.0,38.5,770.0,1763735.28,,Armando Carpio - 017,CAFETERIA y RESTAURANTS,1382047,Dec
2023-12-19,Havana Club Cafe and Restaurant,Invoice,008-02348,Arroz a Granel:Parboiled 50 LB -Bolsa Dos Hermanos.,,52.0,25.5,1326.0,1765061.28,,Armando Carpio - 017,CAFETERIA y RESTAURANTS,1382048,Dec
2023-12-19,Havana Club Cafe and Restaurant,Invoice,008-02348,Liquids:AS Marinating Sauce (Mojo),,10.0,18.5,185.0,1765246.28,,Armando Carpio - 017,CAFETERIA y RESTAURANTS,1382049,Dec
2023-12-19,Ideal Food Basket Davie Cafeteria,Invoice,008-02349,Arroz a Granel:Largo Fino 50 LB -Bolsa Dos Hermanos.,,15.0,23.0,345.0,1765591.28,,Ruta - 019,CAFETERIA y RESTAURANTS,1382050,Dec
2023-12-19,La Ranchera Meat Market #3,Invoice,008-02350,Arroz a Granel:Largo Fino 50 LB -Bolsa Dos Hermanos.,,10.0,23.0,230.0,1765821.28,,Ruta - 019,CAFETERIA y RESTAURANTS,1382051,Dec
2023-12-19,Sabor Tropical Supermarket #4,Invoice,008-02351,Spices:AS Chicken Base,1 / 30 lb. (box or pail),7.0,39.0,273.0,1766094.28,,Lisset Limpio -020,RETAIL  DSD,1382052,Dec
2023-12-19,Sabor Tropical Supermarket #4,Invoice,008-02351,Arroz a Granel:Parboiled 50 LB -Bolsa Dos Hermanos.,,5.0,25.85,129.25,1766223.53,,Lisset Limpio -020,RETAIL  DSD,1382053,Dec
2023-12-19,Sabor Tropical Supermarket #4,Invoice,008-02351,Dry Beans:Dry Beans - Black Beans 50,Dry Black Beans 50 lb,2.0,38.5,77.0,1766300.53,,Lisset Limpio -020,RETAIL  DSD,1382054,Dec
2023-12-19,Max Food Distributors,Invoice,008-02352,Arroz a Granel:Parboiled 50 LB -Bolsa Dos Hermanos.,,20.0,25.5,510.0,1766810.53,,Lisset Limpio -020,WHOLESALER,1382055,Dec
2023-12-19,Bravo | Mainor Guevara,Invoice,008-02353,Arroz Envasado:Parboiled 5KG Dos Hermanos.,6 / 11lbs,11.0,40.5,445.5,1767256.03,,Ruta - 019,RETAIL  DSD,1382056,Dec
2023-12-19,Bravo | Mainor Guevara,Invoice,008-02353,Arroz Envasado:Parboiled 5KG Dos Hermanos.,6 / 11lbs,10.0,0.0,0.0,1767256.03,,Ruta - 019,RETAIL  DSD,1382057,Dec
2023-12-19,Soriano Brothers PB,Credit Memo,008-02354,Arroz a Granel:Parboiled 50 LB -Bolsa Dos Hermanos.,,-6.0,25.5,-153.0,1767103.03,,Lisset Limpio -020,CAFETERIA y RESTAURANTS,1382058,Dec
2023-12-19,Soriano Brothers PB,Credit Memo,008-02354,Varios:Producto vencido/deteriorado (no impacta en inventario),,-1.0,25.5,-25.5,1767077.53,,Lisset Limpio -020,CAFETERIA y RESTAURANTS,1382059,Dec
2023-12-19,Rey Chavez Distributor #2,Invoice,008-02355,Arroz a Granel:Parboiled 50 LB -Bolsa Dos Hermanos.,,55.0,25.0,1375.0,1768452.53,,Lisset Limpio -020,WHOLESALER,1382060,Dec
2023-12-19,Brito Family Corp.,Invoice,008-02356,Arroz a Granel:Parboiled 50 LB -Bolsa Dos Hermanos.,,110.0,25.5,2805.0,1771257.53,,Lisset Limpio -020,CAFETERIA y RESTAURANTS,1382061,Dec
2023-12-19,Extra Supermarket,Invoice,008-02357,Arroz Envasado:Parboiled 5KG Dos Hermanos.,6 / 11lbs,10.0,40.5,405.0,1771662.53,,Lisset Limpio -020,RETAIL  DSD,1382062,Dec
2023-12-19,Extra Supermarket,Invoice,008-02357,Arroz Envasado:Parboiled 5KG Dos Hermanos.,6 / 11lbs,2.0,0.0,0.0,1771662.53,,Lisset Limpio -020,RETAIL  DSD,1382063,Dec
2023-12-19,Bravo   Francisco Diaz,Invoice,008-02358,Arroz a Granel:Largo Fino 50 LB -Bolsa Dos Hermanos.,,4.0,23.5,94.0,1771756.53,,Lisset Limpio -020,RETAIL  DSD,1382064,Dec
2023-12-19,Bravo   Francisco Diaz,Invoice,008-02358,Liquids:AS White Vinegar,4/1 Gl.,2.0,10.0,20.0,1771776.53,,Lisset Limpio -020,RETAIL  DSD,1382065,Dec
2023-12-19,Bravo   Francisco Diaz,Invoice,008-02358,Liquids:AS Cooking Wine,4/1 Gl.,3.0,17.5,52.5,1771829.03,,Lisset Limpio -020,RETAIL  DSD,1382066,Dec
2023-12-19,Bravo   Francisco Diaz,Invoice,008-02358,Liquids:AS Marinating Sauce (Mojo),,2.0,18.5,37.0,1771866.03,,Lisset Limpio -020,RETAIL  DSD,1382067,Dec
2023-12-19,El Palacio de los jugos / Caribe Tropical,Invoice,008-02359,Arroz a Granel:Parboiled 50 LB -Bolsa Dos Hermanos.,,6.0,25.5,153.0,1772019.03,,Lisset Limpio -020,Cafeteria,1382068,Dec
2023-12-19,"American Spice Trading Co, Inc.",Invoice,008-02360,Arroz a Granel:Parboiled 50 LB -Bolsa Dos Hermanos.,,55.0,22.5,1237.5,1773256.53,,Armando Carpio - 017,WHOLESALER MANUFACTURY,1382069,Dec
2023-12-21,El Palacio de los jugos /  Nanos Latin Foods,Invoice,008-02361,Arroz a Granel:Largo Fino 50 LB -Bolsa Dos Hermanos.,,15.0,21.5,322.5,1773579.03,,Lisset Limpio -020,Cafeteria,1382070,Dec
2023-12-21,Fritanga Momotombo,Invoice,008-02362,Arroz a Granel:Largo Fino 50 LB -Bolsa Dos Hermanos.,,5.0,22.0,110.0,1773689.03,,Lisset Limpio -020,CAFETERIA y RESTAURANTS,1382071,Dec
2023-12-21,Los paraditos chinesse,Invoice,008-02363,Arroz a Granel:Largo Fino 50 LB -Bolsa Dos Hermanos.,,10.0,22.0,220.0,1773909.03,,Lisset Limpio -020,CAFETERIA y RESTAURANTS,1382072,Dec
2023-12-21,Los paraditos chinesse,Invoice,008-02363,Arroz a Granel:Parboiled 50 LB -Bolsa Dos Hermanos.,,4.0,25.5,102.0,1774011.03,,Lisset Limpio -020,CAFETERIA y RESTAURANTS,1382073,Dec
2023-12-21,El Palacio de los jugos / Santa Clara Sabor,Invoice,008-02364,Arroz a Granel:Largo Fino 50 LB -Bolsa Dos Hermanos.,,15.0,21.5,322.5,1774333.53,,Lisset Limpio -020,Cafeteria,1382074,Dec
2023-12-21,Soriano Brothers PB,Invoice,008-02365,Arroz a Granel:Parboiled 50 LB -Bolsa Dos Hermanos.,,25.0,25.5,637.5,1774971.03,,Lisset Limpio -020,CAFETERIA y RESTAURANTS,1382075,Dec
2023-12-21,Soriano Brothers PB,Invoice,008-02365,Arroz a Granel:Largo Fino 50 LB -Bolsa Dos Hermanos.,,12.0,21.5,258.0,1775229.03,,Lisset Limpio -020,CAFETERIA y RESTAURANTS,1382076,Dec
2023-12-21,Soriano Brothers PB,Invoice,008-02365,Dry Beans:Dry Beans - Black Beans 50,Dry Black Beans 50 lb,3.0,38.5,115.5,1775344.53,,Lisset Limpio -020,CAFETERIA y RESTAURANTS,1382077,Dec
2023-12-21,Soriano Brothers PB,Invoice,008-02365,Spices:AS Sazon (for all),1 / 30 lb (box or pail),2.0,59.0,118.0,1775462.53,American Spice,Lisset Limpio -020,CAFETERIA y RESTAURANTS,1382078,Dec
2023-12-21,El Palacio de los jugos / Caribe Tropical,Invoice,008-02366,Arroz a Granel:Largo Fino 50 LB -Bolsa Dos Hermanos.,,20.0,21.5,430.0,1775892.53,,Lisset Limpio -020,Cafeteria,1382079,Dec
2023-12-21,El Palacio de los jugos / Caribe Tropical,Invoice,008-02366,Arroz a Granel:Parboiled 50 LB -Bolsa Dos Hermanos.,,34.0,25.5,867.0,1776759.53,,Lisset Limpio -020,Cafeteria,1382080,Dec
2023-12-21,Food-Star Supermarket,Invoice,008-02367,Arroz Envasado:Parboiled 5KG Dos Hermanos.,6 / 11lbs,10.0,40.5,405.0,1777164.53,,Lisset Limpio -020,RETAIL  DSD,1382081,Dec
2023-12-21,Food-Star Supermarket,Invoice,008-02367,Arroz Envasado:Parboiled 5KG Dos Hermanos.,6 / 11lbs,2.0,0.0,0.0,1777164.53,,Lisset Limpio -020,RETAIL  DSD,1382082,Dec
2023-12-21,El Palacio de los jugos / Delicias Criollas (DIAGO FOOD_MILLER),Invoice,008-02368,Arroz a Granel:Parboiled 50 LB -Bolsa Dos Hermanos.,,15.0,25.5,382.5,1777547.03,,Lisset Limpio -020,Cafeteria,1382083,Dec
2023-12-21,El Palacio de los jugos /  EMMA FOOD CORP,Invoice,008-02369,Arroz a Granel:Largo Fino 50 LB -Bolsa Dos Hermanos.,,15.0,21.5,322.5,1777869.53,,Lisset Limpio -020,Cafeteria,1382084,Dec
2023-12-21,El Palacio de los jugos /  EMMA FOOD CORP,Invoice,008-02369,Arroz a Granel:Parboiled 50 LB -Bolsa Dos Hermanos.,,25.0,25.5,637.5,1778507.03,,Lisset Limpio -020,Cafeteria,1382085,Dec
2023-12-21,El Palacio de los jugos /  Nanos Latin Foods,Invoice,008-02370,Arroz a Granel:Parboiled 50 LB -Bolsa Dos Hermanos.,,10.0,25.5,255.0,1778762.03,,Lisset Limpio -020,Cafeteria,1382086,Dec
2023-12-21,El Palacio de los jugos / Sahilys Cafe,Invoice,008-02371,Arroz a Granel:Largo Fino 50 LB -Bolsa Dos Hermanos.,,10.0,21.5,215.0,1778977.03,,Lisset Limpio -020,Cafeteria,1382087,Dec
2023-12-21,El Gallego Supermarket,Invoice,008-02372,Dry Beans:Dry Beans - Black Beans 50,Dry Black Beans 50 lb,3.0,38.5,115.5,1779092.53,,Lisset Limpio -020,RETAIL  DSD,1382088,Dec
2023-12-21,El Gallego Supermarket,Invoice,008-02372,Arroz a Granel:Parboiled 50 LB -Bolsa Dos Hermanos.,,5.0,25.5,127.5,1779220.03,,Lisset Limpio -020,RETAIL  DSD,1382089,Dec
2023-12-21,El Gallego Supermarket,Invoice,008-02372,,,,,0.0,1779220.03,,Lisset Limpio -020,RETAIL  DSD,1382090,Dec
2023-12-21,El Gallego Supermarket,Invoice,008-02372,,,,,0.0,1779220.03,,Lisset Limpio -020,RETAIL  DSD,1382091,Dec
2023-12-21,Price Choice Food Market # 6,Invoice,008-02373,Arroz Envasado:Parboiled 5KG Dos Hermanos.,6 / 11lbs,21.0,40.5,850.5,1780070.53,,Lisset Limpio -020,RETAIL  DSD,1382092,Dec
2023-12-21,Price Choice Food Market # 6,Invoice,008-02373,Arroz Envasado:Parboiled 5KG Dos Hermanos.,6 / 11lbs,20.0,0.0,0.0,1780070.53,,Lisset Limpio -020,RETAIL  DSD,1382093,Dec
2023-12-21,El Palacio de los jugos /  Mires Restaurants,Invoice,008-02374,Arroz a Granel:Largo Fino 50 LB -Bolsa Dos Hermanos.,,15.0,21.5,322.5,1780393.03,,Lisset Limpio -020,Cafeteria,1382094,Dec
2023-12-21,Pacifico Chinese Restaurant,Invoice,008-02375,Arroz a Granel:Parboiled 50 LB -Bolsa Dos Hermanos.,,2.0,25.5,51.0,1780444.03,,Lisset Limpio -020,CAFETERIA y RESTAURANTS,1382095,Dec
2023-12-21,Pacifico Chinese Restaurant,Invoice,008-02375,Arroz a Granel:Largo Fino 50 LB -Bolsa Dos Hermanos.,,8.0,22.0,176.0,1780620.03,,Lisset Limpio -020,CAFETERIA y RESTAURANTS,1382096,Dec
2023-12-22,Sedanos Supermarkets #38,Invoice,008-02376,Arroz Envasado:Parboiled 5KG Dos Hermanos.,6 / 11lbs,20.0,40.5,810.0,1781430.03,,Lisset Limpio -020,RETAIL SEDANOS,1382097,Dec
2023-12-22,Sedanos Supermarkets #38,Invoice,008-02376,Arroz Envasado:Parboiled 5KG Dos Hermanos.,6 / 11lbs,20.0,0.0,0.0,1781430.03,,Lisset Limpio -020,RETAIL SEDANOS,1382098,Dec
2023-12-22,Sedanos Supermarkets #38,Invoice,008-02376,,Discount,-810.0,0.02,-16.2,1781413.83,,Lisset Limpio -020,RETAIL SEDANOS,1382099,Dec
2023-12-22,Hings Chinese,Invoice,008-02377,Arroz Envasado:Parboiled 5KG Dos Hermanos.,6 / 11lbs,2.0,33.66,67.32,1781481.15,,Lisset Limpio -020,CAFETERIA y RESTAURANTS,1382100,Dec
2023-12-23,Soriano Brothers PB,Invoice,008-02378,Arroz Envasado:Parboiled 5KG Dos Hermanos.,6 / 11lbs,0.0,0.0,0.0,1781481.15,,Lisset Limpio -020,CAFETERIA y RESTAURANTS,1382101,Dec
2023-12-23,El Palacio de los jugos /  EMMA FOOD CORP,Invoice,008-02379,Arroz Envasado:Parboiled 5KG Dos Hermanos.,6 / 11lbs,20.0,33.66,673.2,1782154.35,,Lisset Limpio -020,Cafeteria,1382102,Dec
2023-12-23,El Palacio de los jugos / Caribe Tropical,Invoice,008-02380,Arroz Envasado:Parboiled 5KG Dos Hermanos.,6 / 11lbs,20.0,33.66,673.2,1782827.55,,Lisset Limpio -020,Cafeteria,1382103,Dec
2023-12-24,El Palacio de los jugos /  Nanos Latin Foods,Invoice,008-02381,Arroz Envasado:Parboiled 5KG Dos Hermanos.,6 / 11lbs,4.0,33.66,134.64,1782962.18999999,,Lisset Limpio -020,Cafeteria,1382104,Dec
2023-12-25,El Palacio de los jugos /  Nanos Latin Foods,Invoice,008-02382,Arroz Envasado:Parboiled 5KG Dos Hermanos.,6 / 11lbs,4.0,33.66,134.64,1783096.82999999,,Lisset Limpio -020,Cafeteria,1382105,Dec
2023-12-25,El Palacio de los jugos /  Nanos Latin Foods,Invoice,008-02382,,,,,0.0,1783096.82999999,,Lisset Limpio -020,Cafeteria,1382106,Dec
2023-12-25,Soriano Brothers,Invoice,008-02383,Arroz Envasado:Parboiled 5KG Dos Hermanos.,6 / 11lbs,8.0,33.66,269.28,1783366.10999999,,Lisset Limpio -020,CAFETERIA y RESTAURANTS,1382107,Dec
2023-12-25,El Palacio de los jugos / Santa Clara Sabor,Invoice,008-02384,Arroz a Granel:Largo Fino 50 LB -Bolsa Dos Hermanos.,,10.0,21.5,215.0,1783581.10999999,,Lisset Limpio -020,Cafeteria,1382108,Dec
2023-12-25,El Palacio de los jugos /  EMMA FOOD CORP,Invoice,008-02385,Arroz a Granel:Largo Fino 50 LB -Bolsa Dos Hermanos.,,5.0,21.5,107.5,1783688.60999999,,Lisset Limpio -020,Cafeteria,1382109,Dec
2023-12-25,El Palacio de los jugos /  EMMA FOOD CORP,Invoice,008-02385,Arroz Envasado:Parboiled 5KG Dos Hermanos.,6 / 11lbs,4.0,33.66,134.64,1783823.24999999,,Lisset Limpio -020,Cafeteria,1382110,Dec
2023-12-27,Ideal Food Basket Davie Cafeteria,Invoice,008-02386,Arroz a Granel:Largo Fino 50 LB -Bolsa Dos Hermanos.,,10.0,23.0,230.0,1784053.24999999,,Ruta - 019,CAFETERIA y RESTAURANTS,1382111,Dec
2023-12-27,Ideal Food Basket Davie Cafeteria,Invoice,008-02386,,,,,0.0,1784053.24999999,,Ruta - 019,CAFETERIA y RESTAURANTS,1382112,Dec
2023-12-27,Arias Supermarket,Invoice,008-02387,Arroz Envasado:Parboiled 5KG Dos Hermanos.,6 / 11lbs,21.0,40.5,850.5,1784903.74999999,,Lisset Limpio -020,CAFETERIA y RESTAURANTS,1382113,Dec
2023-12-27,Arias Supermarket,Invoice,008-02387,Arroz Envasado:Parboiled 5KG Dos Hermanos.,6 / 11lbs,20.0,0.0,0.0,1784903.74999999,,Lisset Limpio -020,CAFETERIA y RESTAURANTS,1382114,Dec
2023-12-27,Soriano Brothers PB,Credit Memo,008-02388,Arroz a Granel:Parboiled 50 LB -Bolsa Dos Hermanos.,,-25.0,25.5,-637.5,1784266.24999999,,Lisset Limpio -020,CAFETERIA y RESTAURANTS,1382115,Dec
2023-12-28,"American Spice Trading Co, Inc.",Invoice,008-02389,Arroz a Granel:Parboiled 50 LB -Bolsa Dos Hermanos.,,1100.0,22.5,24750.0,1809016.24999999,,Armando Carpio - 017,WHOLESALER MANUFACTURY,1382116,Dec
2023-12-28,Bake Mark USA LLC,Invoice,008-02390,Arroz a Granel:Parboiled 50 LB -Bolsa Dos Hermanos.,,1100.0,22.5,24750.0,1833766.24999999,,Armando Carpio - 017,WHOLESALER MANUFACTURY,1382117,Dec
2023-12-28,El Palacio de los jugos / Sahilys Cafe,Invoice,008-02391,Arroz a Granel:Largo Fino 50 LB -Bolsa Dos Hermanos.,,10.0,21.5,215.0,1833981.24999999,,Lisset Limpio -020,Cafeteria,1382118,Dec
2023-12-28,El Palacio de Los Jugos / Casa mía Food Restaurant inc,Invoice,008-02392,Arroz a Granel:Parboiled 50 LB -Bolsa Dos Hermanos.,,6.0,25.5,153.0,1834134.24999999,,Lisset Limpio -020,Cafeteria,1382119,Dec
2023-12-28,El Palacio de Los Jugos / Casa mía Food Restaurant inc,Credit Memo,008-02393,Arroz a Granel:Parboiled 50 LB -Bolsa Dos Hermanos.,,-6.0,25.5,-153.0,1833981.24999999,,Lisset Limpio -020,Cafeteria,1382120,Dec
2023-12-28,El Palacio de los jugos / Delicias Criollas (DIAGO FOOD_MILLER),Invoice,008-02394,Arroz a Granel:Parboiled 50 LB -Bolsa Dos Hermanos.,,13.0,25.5,331.5,1834312.74999999,,Lisset Limpio -020,Cafeteria,1382121,Dec
2023-12-28,El Palacio de los jugos / Caribe Tropical,Invoice,008-02395,Arroz a Granel:Parboiled 50 LB -Bolsa Dos Hermanos.,,20.0,25.5,510.0,1834822.74999999,,Lisset Limpio -020,Cafeteria,1382122,Dec
2023-12-28,El Palacio de los jugos /  EMMA FOOD CORP,Invoice,008-02396,Arroz a Granel:Largo Fino 50 LB -Bolsa Dos Hermanos.,,5.0,21.5,107.5,1834930.24999999,,Lisset Limpio -020,Cafeteria,1382123,Dec
2023-12-28,El Palacio de los jugos /  EMMA FOOD CORP,Invoice,008-02396,Arroz a Granel:Parboiled 50 LB -Bolsa Dos Hermanos.,,5.0,25.5,127.5,1835057.74999999,,Lisset Limpio -020,Cafeteria,1382124,Dec
2023-12-28,Rey Chavez Distributor Corp,Invoice,008-02397,Arroz a Granel:Parboiled 50 LB -Bolsa Dos Hermanos.,,55.0,25.0,1375.0,1836432.74999999,,Lisset Limpio -020,WHOLESALER,1382125,Dec
2023-12-28,El Palacio de los jugos / Santa Clara Sabor,Invoice,008-02398,Arroz a Granel:Largo Fino 50 LB -Bolsa Dos Hermanos.,,10.0,21.5,215.0,1836647.74999999,,Lisset Limpio -020,Cafeteria,1382126,Dec
2023-12-28,El Palacio de los jugos /  Mires Restaurants,Invoice,008-02399,Arroz a Granel:Largo Fino 50 LB -Bolsa Dos Hermanos.,,10.0,21.5,215.0,1836862.74999999,,Lisset Limpio -020,Cafeteria,1382127,Dec
2023-12-28,Brito Family Corp.,Invoice,008-02400,Arroz a Granel:Largo Fino 50 LB -Bolsa Dos Hermanos.,,110.0,21.0,2310.0,1839172.74999999,,Lisset Limpio -020,CAFETERIA y RESTAURANTS,1382128,Dec
2023-12-28,Brito Family Corp.,Invoice,008-02400,Arroz a Granel:Parboiled 50 LB -Bolsa Dos Hermanos.,,110.0,24.5,2695.0,1841867.74999999,,Lisset Limpio -020,CAFETERIA y RESTAURANTS,1382129,Dec
2023-12-28,El Gallego Supermarket,Invoice,008-02401,Arroz a Granel:Parboiled 50 LB -Bolsa Dos Hermanos.,,5.0,25.5,127.5,1841995.24999999,,Lisset Limpio -020,RETAIL  DSD,1382130,Dec
2023-12-28,El Gallego Supermarket,Invoice,008-02401,Dry Beans:Dry Beans - Black Beans 50,Dry Black Beans 50 lb,3.0,38.5,115.5,1842110.74999999,,Lisset Limpio -020,RETAIL  DSD,1382131,Dec
2023-12-28,Bravo   Francisco Diaz,Invoice,008-02402,Arroz a Granel:Largo Fino 50 LB -Bolsa Dos Hermanos.,,5.0,23.5,117.5,1842228.24999999,,Lisset Limpio -020,RETAIL  DSD,1382132,Dec
2023-12-28,Bravo   Francisco Diaz,Invoice,008-02402,Dry Beans:Dry Beans - Black Beans 50,Dry Black Beans 50 lb,2.0,38.5,77.0,1842305.24999999,,Lisset Limpio -020,RETAIL  DSD,1382133,Dec
2023-12-28,Bravo   Francisco Diaz,Invoice,008-02402,Liquids:AS Cooking Wine,4/1 Gl.,4.0,17.5,70.0,1842375.24999999,,Lisset Limpio -020,RETAIL  DSD,1382134,Dec
2023-12-28,Havana Club Cafe and Restaurant,Invoice,008-02403,Arroz a Granel:Parboiled 50 LB -Bolsa Dos Hermanos.,,10.0,25.5,255.0,1842630.24999999,,Armando Carpio - 017,CAFETERIA y RESTAURANTS,1382135,Dec
2023-12-28,Havana Club Cafe and Restaurant,Invoice,008-02403,Arroz a Granel:Largo Fino 50 LB -Bolsa Dos Hermanos.,,10.0,23.0,230.0,1842860.24999999,,Armando Carpio - 017,CAFETERIA y RESTAURANTS,1382136,Dec
2023-12-28,Havana Club Cafe and Restaurant,Invoice,008-02403,Dry Beans:Dry Beans - Black Beans 50,Dry Black Beans 50 lb,5.0,38.5,192.5,1843052.74999999,,Armando Carpio - 017,CAFETERIA y RESTAURANTS,1382137,Dec
2023-12-28,Soriano Brothers,Invoice,008-02404,Arroz a Granel:Largo Fino 50 LB -Bolsa Dos Hermanos.,,10.0,21.0,210.0,1843262.74999999,,Lisset Limpio -020,CAFETERIA y RESTAURANTS,1382138,Dec
2023-12-28,Soriano Brothers,Invoice,008-02404,Arroz a Granel:Parboiled 50 LB -Bolsa Dos Hermanos.,,15.0,25.5,382.5,1843645.24999999,,Lisset Limpio -020,CAFETERIA y RESTAURANTS,1382139,Dec
2023-12-28,Sorianos Brothers,Invoice,008-02405,Arroz a Granel:Largo Fino 50 LB -Bolsa Dos Hermanos.,,10.0,21.0,210.0,1843855.24999999,,Lisset Limpio -020,CAFETERIA y RESTAURANTS,1382140,Dec
2023-12-28,Sorianos Brothers,Invoice,008-02405,Arroz a Granel:Parboiled 50 LB -Bolsa Dos Hermanos.,,20.0,25.5,510.0,1844365.24999999,,Lisset Limpio -020,CAFETERIA y RESTAURANTS,1382141,Dec
2024-01-02,El Palacio de los jugos /  Nanos Latin Foods,Invoice,008-02406,Arroz a Granel:Largo Fino 50 LB -Bolsa Dos Hermanos.,,6.0,21.5,129.0,1844494.24999999,Bulk Rice,Lisset Limpio -020,Cafeteria,1382142,Jan
2024-01-02,"Meat Club Market, LLC.",Invoice,008-02407,Arroz Envasado:Sushi Rice Dos Hermanos 5kg.,,12.0,10.0,120.0,1844614.24999999,Branded Rice,Lisset Limpio -020,RETAIL  DSD,1382143,Jan
2024-01-02,"Meat Club Market, LLC.",Invoice,008-02407,Arroz Envasado:Largo Fino 1kg (Long grain rice) Dos Hermanos,,3.0,16.5,49.5,1844663.74999999,Branded Rice,Lisset Limpio -020,RETAIL  DSD,1382144,Jan
2024-01-02,"Meat Club Market, LLC.",Invoice,008-02407,Arroz Envasado:Parboiled 1kg Bolsa Dos Hermanos.,.,2.0,19.0,38.0,1844701.74999999,Branded Rice,Lisset Limpio -020,RETAIL  DSD,1382145,Jan
2024-01-02,"Meat Club Market, LLC.",Invoice,008-02407,Arroz Envasado:Largo Fino 1kg (Long grain rice) Dos Hermanos,,1.0,0.0,0.0,1844701.74999999,Branded Rice,Lisset Limpio -020,RETAIL  DSD,1382146,Jan
2024-01-02,El Palacio de los jugos / Delicias Criollas (DIAGO FOOD_MILLER),Invoice,008-02408,Arroz a Granel:Parboiled 50 LB -Bolsa Dos Hermanos.,,10.0,25.5,255.0,1844956.74999999,Bulk Rice,Lisset Limpio -020,Cafeteria,1382147,Jan
2024-01-02,Los Caringas Latin America  Foods,Invoice,008-02409,Arroz a Granel:Largo Fino 50 LB -Bolsa Dos Hermanos.,,3.0,21.5,64.5,1845021.24999999,Bulk Rice,Lisset Limpio -020,CAFETERIA y RESTAURANTS,1382148,Jan
2024-01-02,Los Caringas Latin America  Foods,Invoice,008-02409,Arroz a Granel:Parboiled 50 LB -Bolsa Dos Hermanos.,,3.0,25.5,76.5,1845097.74999999,Bulk Rice,Lisset Limpio -020,CAFETERIA y RESTAURANTS,1382149,Jan
2024-01-02,El Palacio de los jugos /  EMMA FOOD CORP,Invoice,008-02410,Arroz a Granel:Largo Fino 50 LB -Bolsa Dos Hermanos.,,5.0,21.0,105.0,1845202.74999999,Bulk Rice,Lisset Limpio -020,Cafeteria,1382150,Jan
2024-01-02,El Palacio de los jugos /  EMMA FOOD CORP,Invoice,008-02410,Arroz a Granel:Parboiled 50 LB -Bolsa Dos Hermanos.,,8.0,25.5,204.0,1845406.74999999,Bulk Rice,Lisset Limpio -020,Cafeteria,1382151,Jan
2024-01-02,El Palacio de los jugos / Caribe Tropical,Invoice,008-02411,Arroz a Granel:Parboiled 50 LB -Bolsa Dos Hermanos.,,15.0,25.5,382.5,1845789.24999999,Bulk Rice,Lisset Limpio -020,Cafeteria,1382152,Jan
2024-01-02,El Palacio de los jugos / Caribe Tropical,Invoice,008-02411,Dry Beans:Dry Beans - Black Beans 50,Dry Black Beans 50 lb,1.0,38.5,38.5,1845827.74999999,Dry Beans,Lisset Limpio -020,Cafeteria,1382153,Jan
2024-01-02,Los Mejores Tamales de Miami,Invoice,008-02412,Arroz a Granel:Parboiled 50 LB -Bolsa Dos Hermanos.,,8.0,25.5,204.0,1846031.74999999,Bulk Rice,Lisset Limpio -020,CAFETERIA y RESTAURANTS,1382154,Jan
2024-01-02,Hings Chinese,Invoice,008-02413,Arroz a Granel:Parboiled 50 LB -Bolsa Dos Hermanos.,,5.0,25.5,127.5,1846159.24999999,Bulk Rice,Lisset Limpio -020,CAFETERIA y RESTAURANTS,1382155,Jan
2024-01-05,Festival Supermarket #1,Invoice,008-02414,Arroz Envasado:Parboiled 5KG Dos Hermanos.,6 / 11lbs,10.0,40.5,405.0,1846564.24999999,Branded Rice,Lisset Limpio -020,RETAIL  DSD,1382156,Jan
2024-01-05,Festival Supermarket #1,Invoice,008-02414,Arroz Envasado:Parboiled 5KG Dos Hermanos.,6 / 11lbs,2.0,40.5,81.0,1846645.24999999,Branded Rice,Lisset Limpio -020,RETAIL  DSD,1382157,Jan
2024-01-05,Bravo   Francisco Diaz,Invoice,008-02415,Liquids:AS Marinating Sauce (Mojo),,2.0,18.5,37.0,1846682.24999999,American Spice,Lisset Limpio -020,RETAIL  DSD,1382158,Jan
2024-01-05,Bravo   Francisco Diaz,Invoice,008-02415,Liquids:AS Cooking Wine,4/1 Gl.,2.0,17.5,35.0,1846717.24999999,American Spice,Lisset Limpio -020,RETAIL  DSD,1382159,Jan
2024-01-05,Bravo   Francisco Diaz,Invoice,008-02415,Liquids:AS White Vinegar,4/1 Gl.,2.0,10.0,20.0,1846737.24999999,American Spice,Lisset Limpio -020,RETAIL  DSD,1382160,Jan
2024-01-05,Bravo   Francisco Diaz,Invoice,008-02415,Arroz a Granel:Largo Fino 50 LB -Bolsa Dos Hermanos.,,5.0,22.0,110.0,1846847.24999999,Bulk Rice,Lisset Limpio -020,RETAIL  DSD,1382161,Jan
2024-01-05,El Palacio de los jugos / Santa Clara Sabor,Invoice,008-02416,Arroz a Granel:Largo Fino 50 LB -Bolsa Dos Hermanos.,,10.0,21.5,215.0,1847062.24999999,Bulk Rice,Lisset Limpio -020,Cafeteria,1382162,Jan
2024-01-05,Albert Deli #2,Invoice,008-02417,Arroz a Granel:Largo Fino 50 LB -Bolsa Dos Hermanos.,,6.0,23.5,141.0,1847203.24999999,Bulk Rice,Lisset Limpio -020,CAFETERIA y RESTAURANTS,1382163,Jan
2024-01-05,Albert Deli #2,Invoice,008-02417,Arroz a Granel:Parboiled 50 LB -Bolsa Dos Hermanos.,,2.0,25.5,51.0,1847254.24999999,Bulk Rice,Lisset Limpio -020,CAFETERIA y RESTAURANTS,1382164,Jan
2024-01-05,Albert Deli #2,Invoice,008-02417,Dry Beans:Dry Beans - Black Beans 50,Dry Black Beans 50 lb,1.0,39.5,39.5,1847293.74999999,Dry Beans,Lisset Limpio -020,CAFETERIA y RESTAURANTS,1382165,Jan
2024-01-05,Los paraditos chinesse,Invoice,008-02418,Arroz a Granel:Largo Fino 50 LB -Bolsa Dos Hermanos.,,10.0,21.5,215.0,1847508.74999999,Bulk Rice,Lisset Limpio -020,CAFETERIA y RESTAURANTS,1382166,Jan
2024-01-05,Los paraditos chinesse,Invoice,008-02418,Arroz a Granel:Parboiled 50 LB -Bolsa Dos Hermanos.,,5.0,25.5,127.5,1847636.24999999,Bulk Rice,Lisset Limpio -020,CAFETERIA y RESTAURANTS,1382167,Jan
2024-01-05,El Gallego Supermarket,Invoice,008-02419,Arroz a Granel:Parboiled 50 LB -Bolsa Dos Hermanos.,,5.0,25.5,127.5,1847763.74999999,Bulk Rice,Lisset Limpio -020,RETAIL  DSD,1382168,Jan
2024-01-05,El Gallego Supermarket,Invoice,008-02419,Dry Beans:Dry Beans - Black Beans 50,Dry Black Beans 50 lb,2.0,39.5,79.0,1847842.74999999,Dry Beans,Lisset Limpio -020,RETAIL  DSD,1382169,Jan
2024-01-05,El Palacio de los jugos / Sahilys Cafe,Invoice,008-02420,Arroz a Granel:Largo Fino 50 LB -Bolsa Dos Hermanos.,,5.0,21.5,107.5,1847950.24999999,Bulk Rice,Lisset Limpio -020,Cafeteria,1382170,Jan
2024-01-05,Hings Chinese,Invoice,008-02421,Arroz a Granel:Largo Fino 50 LB -Bolsa Dos Hermanos.,,10.0,21.5,215.0,1848165.24999999,Bulk Rice,Lisset Limpio -020,CAFETERIA y RESTAURANTS,1382171,Jan
2024-01-05,Pacifico Chinese Restaurant,Invoice,008-02422,Arroz a Granel:Parboiled 50 LB -Bolsa Dos Hermanos.,,2.0,25.5,51.0,1848216.24999999,Bulk Rice,Lisset Limpio -020,CAFETERIA y RESTAURANTS,1382172,Jan
2024-01-05,Pacifico Chinese Restaurant,Invoice,008-02422,Arroz a Granel:Largo Fino 50 LB -Bolsa Dos Hermanos.,,7.0,22.0,154.0,1848370.24999999,Bulk Rice,Lisset Limpio -020,CAFETERIA y RESTAURANTS,1382173,Jan
2024-01-05,Festival Supermarket #1,Credit Memo,008-02613,Varios:Promotional Allowance,Arroz Envasado:Parboiled 5KG Dos Hermanos.,-2.0,40.5,-81.0,1848289.24999999,Branded Rice,Lisset Limpio -020,RETAIL  DSD,1382174,Jan
2024-01-08,Hings Chinese,Invoice,008-02423,Arroz a Granel:Largo Fino 50 LB -Bolsa Dos Hermanos.,,5.0,21.5,107.5,1848396.74999999,Bulk Rice,Lisset Limpio -020,CAFETERIA y RESTAURANTS,1382175,Jan
2024-01-08,El Palacio de los jugos / Caribe Tropical,Invoice,008-02424,Arroz a Granel:Largo Fino 50 LB -Bolsa Dos Hermanos.,,6.0,21.5,129.0,1848525.74999999,Bulk Rice,Lisset Limpio -020,Cafeteria,1382176,Jan
2024-01-08,El Palacio de los jugos / Caribe Tropical,Invoice,008-02424,Arroz a Granel:Parboiled 50 LB -Bolsa Dos Hermanos.,,8.0,25.5,204.0,1848729.74999999,Bulk Rice,Lisset Limpio -020,Cafeteria,1382177,Jan
2024-01-08,El Palacio de los jugos / Lita Foods Inc.,Invoice,008-02425,Arroz a Granel:Parboiled 50 LB -Bolsa Dos Hermanos.,,2.0,25.5,51.0,1848780.74999999,Bulk Rice,Lisset Limpio -020,Cafeteria,1382178,Jan
2024-01-08,El Palacio de los jugos /  Nanos Latin Foods,Invoice,008-02426,Arroz a Granel:Largo Fino 50 LB -Bolsa Dos Hermanos.,,8.0,21.5,172.0,1848952.74999999,Bulk Rice,Lisset Limpio -020,Cafeteria,1382179,Jan
2024-01-08,El Palacio de los jugos / Delicias Criollas (DIAGO FOOD_MILLER),Invoice,008-02427,Arroz a Granel:Parboiled 50 LB -Bolsa Dos Hermanos.,,12.0,25.5,306.0,1849258.74999999,Bulk Rice,Lisset Limpio -020,Cafeteria,1382180,Jan
2024-01-08,Soriano Brothers,Invoice,008-02428,Arroz a Granel:Parboiled 50 LB -Bolsa Dos Hermanos.,,20.0,25.5,510.0,1849768.74999999,Bulk Rice,Lisset Limpio -020,CAFETERIA y RESTAURANTS,1382181,Jan
2024-01-08,Sorianos Brothers,Invoice,008-02429,Arroz a Granel:Parboiled 50 LB -Bolsa Dos Hermanos.,,18.0,25.5,459.0,1850227.74999999,Bulk Rice,Lisset Limpio -020,CAFETERIA y RESTAURANTS,1382182,Jan
2024-01-08,Fritanga Momotombo,Invoice,008-02430,Arroz a Granel:Largo Fino 50 LB -Bolsa Dos Hermanos.,,5.0,22.0,110.0,1850337.74999999,Bulk Rice,Lisset Limpio -020,CAFETERIA y RESTAURANTS,1382183,Jan
2024-01-08,Aries Supermarket & Cafeteria,Invoice,008-02431,Dry Beans:Dry Beans - Black Beans 50,Dry Black Beans 50 lb,10.0,38.0,380.0,1850717.74999999,Dry Beans,Armando Carpio - 017,CAFETERIA y RESTAURANTS,1382184,Jan
2024-01-09,Family and Son,Invoice,008-02432,Arroz a Granel:Parboiled 50 LB -Bolsa Dos Hermanos.,,1100.0,21.75,23925.0,1874642.74999999,Bulk Rice,Armando Carpio - 017,WHOLESALER MANUFACTURY,1382185,Jan
2024-01-09,Bake Mark USA LLC,Invoice,008-02433,Arroz a Granel:Largo Fino 50 LB -Bolsa Dos Hermanos.,Pick-up,880.0,20.8,18304.0,1892946.74999999,Bulk Rice,Armando Carpio - 017,WHOLESALER MANUFACTURY,1382186,Jan
2024-01-09,Sedanos Supermarkets #38,Invoice,008-02434,Arroz a Granel:Largo Fino 50 LB -Bolsa Dos Hermanos.,Peoduct Sample,1.0,23.5,23.5,1892970.24999999,Bulk Rice,Lisset Limpio -020,RETAIL SEDANOS,1382187,Jan
2024-01-10,Family and Son,Invoice,008-02435,Arroz a Granel:Parboiled 50 LB -Bolsa Dos Hermanos.,FANU 331689 5,1100.0,21.75,23925.0,1916895.24999999,Bulk Rice,Armando Carpio - 017,WHOLESALER MANUFACTURY,1382188,Jan
2024-01-10,Sedanos Supermarkets #38,Invoice,008-02436,Arroz a Granel:Largo Fino 50 LB -Bolsa Dos Hermanos.,,5.0,23.5,117.5,1917012.74999999,Bulk Rice,Lisset Limpio -020,RETAIL SEDANOS,1382189,Jan
2024-01-10,Sedanos Supermarkets #38,Invoice,008-02436,,Discount,-117.5,,-2.35,1917010.39999999,,Lisset Limpio -020,RETAIL SEDANOS,1382190,Jan
2024-01-10,"El Toro Loco Meat Distribution, LLC",Invoice,008-02437,Arroz a Granel:Largo Fino 50 LB -Bolsa Dos Hermanos.,,55.0,22.0,1210.0,1918220.39999999,Bulk Rice,Lisset Limpio -020,CAFETERIA y RESTAURANTS,1382191,Jan
2024-01-10,Ideal Food Basket Davie Cafeteria,Invoice,008-02438,Arroz a Granel:Largo Fino 50 LB -Bolsa Dos Hermanos.,,15.0,23.5,352.5,1918572.89999999,Bulk Rice,Ruta - 019,CAFETERIA y RESTAURANTS,1382192,Jan
2024-01-10,Sabor Tropical Supermarket #4,Invoice,008-02439,Arroz a Granel:Parboiled 50 LB -Bolsa Dos Hermanos.,,20.0,25.5,510.0,1919082.89999999,Bulk Rice,Lisset Limpio -020,RETAIL  DSD,1382193,Jan
2024-01-10,Price Choice Food Market # 6,Invoice,008-02440,Arroz a Granel:Largo Fino 50 LB -Bolsa Dos Hermanos.,,15.0,21.5,322.5,1919405.39999999,Bulk Rice,Lisset Limpio -020,RETAIL  DSD,1382194,Jan
2024-01-10,El Palacio de los jugos /  EMMA FOOD CORP,Credit Memo,008-02441,Arroz a Granel:Parboiled 50 LB -Bolsa Dos Hermanos.,,-24.0,25.5,-612.0,1918793.39999999,Bulk Rice,Lisset Limpio -020,Cafeteria,1382195,Jan
2024-01-10,El Palacio de los jugos /  Nanos Latin Foods,Credit Memo,008-02442,Arroz a Granel:Parboiled 50 LB -Bolsa Dos Hermanos.,,-5.0,25.5,-127.5,1918665.89999999,Bulk Rice,Lisset Limpio -020,Cafeteria,1382196,Jan
2024-01-10,Sedanos Supermarkets #38,Credit Memo,008-02614,Varios:Promotional Allowance,Arroz a Granel:Largo Fino 50 LB -Bolsa Dos Hermanos.,-1.0,23.5,-23.5,1918642.39999999,Bulk Rice,Lisset Limpio -020,RETAIL SEDANOS,1382197,Jan
2024-01-11,Soriano Brothers PB,Invoice,008-02443,Spices:AS Sazon (for all),1 / 30 lb (box or pail),2.0,59.0,118.0,1918760.39999999,American Spice,Lisset Limpio -020,CAFETERIA y RESTAURANTS,1382198,Jan
2024-01-11,Soriano Brothers PB,Invoice,008-02443,Arroz a Granel:Largo Fino 50 LB -Bolsa Dos Hermanos.,,8.0,22.0,176.0,1918936.39999999,Bulk Rice,Lisset Limpio -020,CAFETERIA y RESTAURANTS,1382199,Jan
2024-01-11,Soriano Brothers PB,Invoice,008-02443,Arroz a Granel:Parboiled 50 LB -Bolsa Dos Hermanos.,,1.0,27.5,27.5,1918963.89999999,Bulk Rice,Lisset Limpio -020,CAFETERIA y RESTAURANTS,1382200,Jan
2024-01-11,Soriano Brothers PB,Credit Memo,008-02615,Varios:Promotional Allowance,Arroz a Granel:Largo Fino 50 LB -Bolsa Dos Hermanos.,-1.0,27.5,-27.5,1918936.39999999,Bulk Rice,Lisset Limpio -020,CAFETERIA y RESTAURANTS,1382201,Jan
2024-01-12,El Palacio de Los Jugos / Casa mía Food Restaurant inc,Invoice,008-02444,Arroz a Granel:Parboiled 50 LB -Bolsa Dos Hermanos.,,10.0,25.5,255.0,1919191.39999999,Bulk Rice,Lisset Limpio -020,Cafeteria,1382202,Jan
2024-01-12,Hings Chinese,Invoice,008-02445,Arroz a Granel:Largo Fino 50 LB -Bolsa Dos Hermanos.,,10.0,21.5,215.0,1919406.39999999,Bulk Rice,Lisset Limpio -020,CAFETERIA y RESTAURANTS,1382203,Jan
2024-01-12,El Palacio de los jugos /  EMMA FOOD CORP,Invoice,008-02446,Arroz a Granel:Largo Fino 50 LB -Bolsa Dos Hermanos.,,8.0,21.5,172.0,1919578.39999999,Bulk Rice,Lisset Limpio -020,Cafeteria,1382204,Jan
2024-01-12,El Palacio de los jugos /  EMMA FOOD CORP,Invoice,008-02446,Arroz a Granel:Parboiled 50 LB -Bolsa Dos Hermanos.,,10.0,25.5,255.0,1919833.39999999,Bulk Rice,Lisset Limpio -020,Cafeteria,1382205,Jan
2024-01-12,El Palacio de los jugos / Santa Clara Sabor,Invoice,008-02447,Arroz a Granel:Largo Fino 50 LB -Bolsa Dos Hermanos.,,10.0,21.5,215.0,1920048.39999999,Bulk Rice,Lisset Limpio -020,Cafeteria,1382206,Jan
2024-01-12,El Palacio de los jugos / Sahilys Cafe,Invoice,008-02448,Arroz a Granel:Largo Fino 50 LB -Bolsa Dos Hermanos.,,5.0,21.5,107.5,1920155.89999999,Bulk Rice,Lisset Limpio -020,Cafeteria,1382207,Jan
2024-01-12,El Palacio de los jugos / Caribe Tropical,Invoice,008-02449,Dry Beans:Dry Beans - Black Beans 50,Dry Black Beans 50 lb,1.0,39.5,39.5,1920195.39999999,Dry Beans,Lisset Limpio -020,Cafeteria,1382208,Jan
2024-01-12,El Palacio de los jugos / Caribe Tropical,Invoice,008-02449,Arroz a Granel:Largo Fino 50 LB -Bolsa Dos Hermanos.,,6.0,21.5,129.0,1920324.39999999,Bulk Rice,Lisset Limpio -020,Cafeteria,1382209,Jan
2024-01-12,El Palacio de los jugos / Caribe Tropical,Invoice,008-02449,Arroz a Granel:Parboiled 50 LB -Bolsa Dos Hermanos.,,8.0,25.5,204.0,1920528.39999999,Bulk Rice,Lisset Limpio -020,Cafeteria,1382210,Jan
2024-01-12,Soriano Brothers,Invoice,008-02450,Arroz a Granel:Largo Fino 50 LB -Bolsa Dos Hermanos.,,20.0,21.5,430.0,1920958.39999999,Bulk Rice,Lisset Limpio -020,CAFETERIA y RESTAURANTS,1382211,Jan
2024-01-12,Pacifico Chinese Restaurant,Invoice,008-02451,Arroz a Granel:Largo Fino 50 LB -Bolsa Dos Hermanos.,,6.0,21.5,129.0,1921087.39999999,Bulk Rice,Lisset Limpio -020,CAFETERIA y RESTAURANTS,1382212,Jan
2024-01-12,Pacifico Chinese Restaurant,Invoice,008-02451,Arroz a Granel:Parboiled 50 LB -Bolsa Dos Hermanos.,,4.0,25.5,102.0,1921189.39999999,Bulk Rice,Lisset Limpio -020,CAFETERIA y RESTAURANTS,1382213,Jan
2024-01-12,El Palacio de los jugos / Lita Foods Inc.,Invoice,008-02452,Arroz a Granel:Parboiled 50 LB -Bolsa Dos Hermanos.,,2.0,25.5,51.0,1921240.39999999,Bulk Rice,Lisset Limpio -020,Cafeteria,1382214,Jan
2024-01-15,Soriano Brothers PB,Invoice,008-02453,Arroz a Granel:Largo Fino 50 LB -Bolsa Dos Hermanos.,,5.0,22.0,110.0,1921350.39999999,Bulk Rice,Lisset Limpio -020,CAFETERIA y RESTAURANTS,1382215,Jan
2024-01-15,Soriano Brothers PB,Invoice,008-02453,Arroz a Granel:Parboiled 50 LB -Bolsa Dos Hermanos.,,7.0,25.5,178.5,1921528.89999999,Bulk Rice,Lisset Limpio -020,CAFETERIA y RESTAURANTS,1382216,Jan
2024-01-15,Hings Chinese,Invoice,008-02454,Arroz a Granel:Largo Fino 50 LB -Bolsa Dos Hermanos.,,4.0,22.0,88.0,1921616.89999999,Bulk Rice,Lisset Limpio -020,CAFETERIA y RESTAURANTS,1382217,Jan
2024-01-15,Hings Chinese,Invoice,008-02454,Arroz a Granel:Parboiled 50 LB -Bolsa Dos Hermanos.,,2.0,25.5,51.0,1921667.89999999,Bulk Rice,Lisset Limpio -020,CAFETERIA y RESTAURANTS,1382218,Jan
2024-01-15,"Virtue Distributor, Inc",Invoice,008-02455,Arroz a Granel:Parboiled 50 LB -Bolsa Dos Hermanos.,,55.0,23.3,1281.5,1922949.39999999,Bulk Rice,Armando Carpio - 017,Distributor,1382219,Jan
2024-01-15,El Palacio de los jugos / Caribe Tropical,Invoice,008-02456,Arroz a Granel:Largo Fino 50 LB -Bolsa Dos Hermanos.,,5.0,22.0,110.0,1923059.39999999,Bulk Rice,Lisset Limpio -020,Cafeteria,1382220,Jan
2024-01-15,El Palacio de los jugos / Caribe Tropical,Invoice,008-02456,Arroz a Granel:Parboiled 50 LB -Bolsa Dos Hermanos.,,8.0,25.5,204.0,1923263.39999999,Bulk Rice,Lisset Limpio -020,Cafeteria,1382221,Jan
2024-01-15,El Palacio de los jugos / Caribe Tropical,Invoice,008-02456,Dry Beans:Dry Beans - Black Beans 50,Dry Black Beans 50 lb,1.0,39.5,39.5,1923302.89999999,Dry Beans,Lisset Limpio -020,Cafeteria,1382222,Jan
2024-01-15,El Palacio de los jugos / Lita Foods Inc.,Invoice,008-02457,Arroz a Granel:Parboiled 50 LB -Bolsa Dos Hermanos.,,15.0,25.5,382.5,1923685.39999999,Bulk Rice,Lisset Limpio -020,Cafeteria,1382223,Jan
2024-01-15,El Palacio de los jugos /  EMMA FOOD CORP,Invoice,008-02458,Arroz a Granel:Largo Fino 50 LB -Bolsa Dos Hermanos.,,7.0,22.0,154.0,1923839.39999999,Bulk Rice,Lisset Limpio -020,Cafeteria,1382224,Jan
2024-01-15,El Palacio de los jugos /  EMMA FOOD CORP,Invoice,008-02458,Arroz a Granel:Parboiled 50 LB -Bolsa Dos Hermanos.,,8.0,25.5,204.0,1924043.39999999,Bulk Rice,Lisset Limpio -020,Cafeteria,1382225,Jan
2024-01-15,Bravo   Francisco Diaz,Invoice,008-02459,Liquids:AS Marinating Sauce (Mojo),,2.0,18.5,37.0,1924080.39999999,American Spice,Lisset Limpio -020,RETAIL  DSD,1382226,Jan
2024-01-15,Bravo   Francisco Diaz,Invoice,008-02459,Arroz a Granel:Largo Fino 50 LB -Bolsa Dos Hermanos.,,5.0,22.0,110.0,1924190.39999999,Bulk Rice,Lisset Limpio -020,RETAIL  DSD,1382227,Jan
2024-01-15,El Palacio de los jugos /  Nanos Latin Foods,Invoice,008-02460,Arroz a Granel:Largo Fino 50 LB -Bolsa Dos Hermanos.,,8.0,22.0,176.0,1924366.39999999,Bulk Rice,Lisset Limpio -020,Cafeteria,1382228,Jan
2024-01-15,El Palacio de los jugos / Delicias Criollas (DIAGO FOOD_MILLER),Invoice,008-02461,Arroz a Granel:Parboiled 50 LB -Bolsa Dos Hermanos.,,15.0,25.5,382.5,1924748.89999999,Bulk Rice,Lisset Limpio -020,Cafeteria,1382229,Jan
2024-01-15,El Palacio de los jugos / Santa Clara Sabor,Invoice,008-02462,Arroz a Granel:Largo Fino 50 LB -Bolsa Dos Hermanos.,,10.0,22.0,220.0,1924968.89999999,Bulk Rice,Lisset Limpio -020,Cafeteria,1382230,Jan
2024-01-15,El Palacio de los jugos / Santa Clara Sabor,Invoice,008-02462,Arroz a Granel:Parboiled 50 LB -Bolsa Dos Hermanos.,,1.0,25.5,25.5,1924994.39999999,Bulk Rice,Lisset Limpio -020,Cafeteria,1382231,Jan
2024-01-15,Los Caringas Latin America  Foods,Invoice,008-02463,Arroz a Granel:Largo Fino 50 LB -Bolsa Dos Hermanos.,,3.0,22.0,66.0,1925060.39999999,Bulk Rice,Lisset Limpio -020,CAFETERIA y RESTAURANTS,1382232,Jan
2024-01-15,Los Caringas Latin America  Foods,Invoice,008-02463,Arroz a Granel:Parboiled 50 LB -Bolsa Dos Hermanos.,,3.0,25.5,76.5,1925136.89999999,Bulk Rice,Lisset Limpio -020,CAFETERIA y RESTAURANTS,1382233,Jan
2024-01-15,"Soriano Brothers Diaz Food Service,Inc",Invoice,008-02464,Arroz a Granel:Largo Fino 50 LB -Bolsa Dos Hermanos.,,50.0,22.0,1100.0,1926236.89999999,Bulk Rice,Lisset Limpio -020,CAFETERIA y RESTAURANTS,1382234,Jan
2024-01-15,"Soriano Brothers Diaz Food Service,Inc",Invoice,008-02464,Arroz a Granel:Parboiled 50 LB -Bolsa Dos Hermanos.,,50.0,25.5,1275.0,1927511.89999999,Bulk Rice,Lisset Limpio -020,CAFETERIA y RESTAURANTS,1382235,Jan
2024-01-16,Sorianos Brothers,Invoice,008-02465,Arroz a Granel:Largo Fino 50 LB -Bolsa Dos Hermanos.,,20.0,21.5,430.0,1927941.89999999,Bulk Rice,Lisset Limpio -020,CAFETERIA y RESTAURANTS,1382236,Jan
2024-01-17,Family and Son,Invoice,008-02466,Arroz a Granel:Parboiled 50 LB -Bolsa Dos Hermanos.,,1100.0,22.75,25025.0,1952966.89999999,Bulk Rice,Armando Carpio - 017,WHOLESALER MANUFACTURY,1382237,Jan
2024-01-17,El Palacio de los jugos / Caribe Tropical,Credit Memo,008-02467,Arroz a Granel:Parboiled 50 LB -Bolsa Dos Hermanos.,,-26.0,25.5,-663.0,1952303.89999999,Bulk Rice,Lisset Limpio -020,Cafeteria,1382238,Jan
2024-01-17,El Palacio de los jugos / Caribe Tropical,Credit Memo,008-02467,Varios:Producto vencido/deteriorado (no impacta en inventario),,-1.0,10.2,-10.2,1952293.69999999,Bulk Rice,Lisset Limpio -020,Cafeteria,1382239,Jan
2024-01-17,El Palacio de los jugos / Caribe Tropical,Credit Memo,008-02468,Arroz a Granel:Parboiled 50 LB -Bolsa Dos Hermanos.,,-2.0,25.5,-51.0,1952242.69999999,Bulk Rice,Lisset Limpio -020,Cafeteria,1382240,Jan
2024-01-18,Family and Son,Invoice,008-02469,Arroz a Granel:Parboiled 50 LB -Bolsa Dos Hermanos.,,1100.0,22.75,25025.0,1977267.69999999,Bulk Rice,Armando Carpio - 017,WHOLESALER MANUFACTURY,1382241,Jan
2024-01-18,Pacifico Chinese Restaurant,Invoice,008-02470,Arroz a Granel:Largo Fino 50 LB -Bolsa Dos Hermanos.,,7.0,22.0,154.0,1977421.69999999,Bulk Rice,Lisset Limpio -020,CAFETERIA y RESTAURANTS,1382242,Jan
2024-01-18,Pacifico Chinese Restaurant,Invoice,008-02470,Arroz a Granel:Parboiled 50 LB -Bolsa Dos Hermanos.,,3.0,25.5,76.5,1977498.19999999,Bulk Rice,Lisset Limpio -020,CAFETERIA y RESTAURANTS,1382243,Jan
2024-01-18,Key Foods  / Ivan,Invoice,008-02471,Arroz a Granel:Largo Fino 50 LB -Bolsa Dos Hermanos.,,15.0,22.5,337.5,1977835.69999999,Bulk Rice,Lisset Limpio -020,RETAIL  DSD,1382244,Jan
2024-01-18,Sedanos Supermarkets #7,Invoice,008-02472,Rice Snack:Rice Snack Ham Flavored DOS HERMANOS,,3.0,19.9,59.7,1977895.39999999,Puffed Products,Lisset Limpio -020,RETAIL SEDANOS,1382245,Jan
2024-01-18,Sedanos Supermarkets #7,Invoice,008-02472,Rice Snack:Rice Snack Salami Flavored DOS HERMANOS,,3.0,19.9,59.7,1977955.09999999,Puffed Products,Lisset Limpio -020,RETAIL SEDANOS,1382246,Jan
2024-01-18,Sedanos Supermarkets #7,Invoice,008-02472,"Rice Snack:Rice Snack, Pizza DH",,3.0,19.9,59.7,1978014.79999999,Puffed Products,Lisset Limpio -020,RETAIL SEDANOS,1382247,Jan
2024-01-18,Sedanos Supermarkets #7,Invoice,008-02472,Rice Snack:Rice Snack Ham Flavored DOS HERMANOS,,1.0,19.9,19.9,1978034.69999999,Puffed Products,Lisset Limpio -020,RETAIL SEDANOS,1382248,Jan
2024-01-18,Sedanos Supermarkets #7,Invoice,008-02472,"Rice Snack:Rice Snack, Pizza DH",,1.0,19.9,19.9,1978054.59999999,Puffed Products,Lisset Limpio -020,RETAIL SEDANOS,1382249,Jan
2024-01-18,Sedanos Supermarkets #7,Invoice,008-02472,Rice Snack:Rice Snack Salami Flavored DOS HERMANOS,,1.0,19.9,19.9,1978074.49999999,Puffed Products,Lisset Limpio -020,RETAIL SEDANOS,1382250,Jan
2024-01-18,Sedanos Supermarkets #7,Invoice,008-02472,,Discount,-179.1,,-3.58,1978070.91999999,,Lisset Limpio -020,RETAIL SEDANOS,1382251,Jan
2024-01-18,Sedanos Supermarkets #38,Invoice,008-02473,Arroz a Granel:Largo Fino 50 LB -Bolsa Dos Hermanos.,,4.0,23.5,94.0,1978164.91999999,Bulk Rice,Lisset Limpio -020,RETAIL SEDANOS,1382252,Jan
2024-01-18,Sedanos Supermarkets #38,Invoice,008-02473,Dry Beans:Dry Beans - Black Beans 50,Dry Black Beans 50 lb,4.0,39.5,158.0,1978322.91999999,Dry Beans,Lisset Limpio -020,RETAIL SEDANOS,1382253,Jan
2024-01-18,Sedanos Supermarkets #38,Invoice,008-02473,,Discount,-252.0,0.02,-5.04,1978317.87999999,,Lisset Limpio -020,RETAIL SEDANOS,1382254,Jan
2024-01-18,El Palacio de los jugos / Sahilys Cafe,Invoice,008-02474,Arroz a Granel:Largo Fino 50 LB -Bolsa Dos Hermanos.,,6.0,22.0,132.0,1978449.87999999,Bulk Rice,Lisset Limpio -020,Cafeteria,1382255,Jan
2024-01-18,El Palacio de los jugos / Sahilys Cafe,Invoice,008-02474,Arroz a Granel:Parboiled 50 LB -Bolsa Dos Hermanos.,,1.0,25.5,25.5,1978475.37999999,Bulk Rice,Lisset Limpio -020,Cafeteria,1382256,Jan
2024-01-18,Soriano Brothers,Invoice,008-02475,Arroz a Granel:Parboiled 50 LB -Bolsa Dos Hermanos.,,20.0,25.5,510.0,1978985.37999999,Bulk Rice,Lisset Limpio -020,CAFETERIA y RESTAURANTS,1382257,Jan
2024-01-18,Max Food Distributors,Invoice,008-02476,Arroz a Granel:Parboiled 50 LB -Bolsa Dos Hermanos.,,30.0,25.5,765.0,1979750.37999999,Bulk Rice,Lisset Limpio -020,WHOLESALER,1382258,Jan
2024-01-18,El Gallego Supermarket,Invoice,008-02477,Arroz a Granel:Parboiled 50 LB -Bolsa Dos Hermanos.,,5.0,25.5,127.5,1979877.87999999,Bulk Rice,Lisset Limpio -020,RETAIL  DSD,1382259,Jan
2024-01-18,El Gallego Supermarket,Invoice,008-02477,Dry Beans:Dry Beans - Black Beans 50,Dry Black Beans 50 lb,2.0,39.5,79.0,1979956.87999999,Dry Beans,Lisset Limpio -020,RETAIL  DSD,1382260,Jan
2024-01-18,Soriano Brothers PB,Invoice,008-02478,Dry Beans:Dry Beans - Black Beans 50,Dry Black Beans 50 lb,2.0,39.5,79.0,1980035.87999999,Dry Beans,Lisset Limpio -020,CAFETERIA y RESTAURANTS,1382261,Jan
2024-01-18,Soriano Brothers PB,Invoice,008-02478,Arroz a Granel:Largo Fino 50 LB -Bolsa Dos Hermanos.,,3.0,22.0,66.0,1980101.87999999,Bulk Rice,Lisset Limpio -020,CAFETERIA y RESTAURANTS,1382262,Jan
2024-01-18,Soriano Brothers PB,Invoice,008-02478,Arroz a Granel:Parboiled 50 LB -Bolsa Dos Hermanos.,,5.0,25.5,127.5,1980229.37999999,Bulk Rice,Lisset Limpio -020,CAFETERIA y RESTAURANTS,1382263,Jan
2024-01-18,Rey Chavez Distributor Corp,Invoice,008-02479,Arroz a Granel:Parboiled 50 LB -Bolsa Dos Hermanos.,,55.0,25.5,1402.5,1981631.87999999,Bulk Rice,Lisset Limpio -020,WHOLESALER,1382264,Jan
2024-01-18,El Palacio de los jugos /  EMMA FOOD CORP,Invoice,008-02480,Arroz a Granel:Largo Fino 50 LB -Bolsa Dos Hermanos.,,7.0,22.0,154.0,1981785.87999999,Bulk Rice,Lisset Limpio -020,Cafeteria,1382265,Jan
2024-01-18,El Palacio de los jugos /  EMMA FOOD CORP,Invoice,008-02480,Arroz a Granel:Parboiled 50 LB -Bolsa Dos Hermanos.,,6.0,25.5,153.0,1981938.87999999,Bulk Rice,Lisset Limpio -020,Cafeteria,1382266,Jan
2024-01-18,El Palacio de los jugos / Lita Foods Inc.,Invoice,008-02481,Arroz a Granel:Parboiled 50 LB -Bolsa Dos Hermanos.,,10.0,25.5,255.0,1982193.87999999,Bulk Rice,Lisset Limpio -020,Cafeteria,1382267,Jan
2024-01-18,Fritanga Momotombo,Invoice,008-02482,Arroz a Granel:Largo Fino 50 LB -Bolsa Dos Hermanos.,,5.0,22.0,110.0,1982303.87999999,Bulk Rice,Lisset Limpio -020,CAFETERIA y RESTAURANTS,1382268,Jan
2024-01-18,El Palacio de los jugos / Caribe Tropical,Invoice,008-02483,Dry Beans:Dry Beans - Black Beans 50,Dry Black Beans 50 lb,1.0,37.5,37.5,1982341.37999999,Dry Beans,Lisset Limpio -020,Cafeteria,1382269,Jan
2024-01-18,El Palacio de los jugos / Caribe Tropical,Invoice,008-02483,Arroz a Granel:Largo Fino 50 LB -Bolsa Dos Hermanos.,,6.0,21.5,129.0,1982470.37999999,Bulk Rice,Lisset Limpio -020,Cafeteria,1382270,Jan
2024-01-18,El Palacio de los jugos / Caribe Tropical,Invoice,008-02483,Arroz a Granel:Parboiled 50 LB -Bolsa Dos Hermanos.,,8.0,25.5,204.0,1982674.37999999,Bulk Rice,Lisset Limpio -020,Cafeteria,1382271,Jan
2024-01-18,El Palacio de los jugos / Santa Clara Sabor,Invoice,008-02484,Arroz a Granel:Largo Fino 50 LB -Bolsa Dos Hermanos.,,10.0,22.0,220.0,1982894.37999999,Bulk Rice,Lisset Limpio -020,Cafeteria,1382272,Jan
2024-01-18,Hings Chinese,Invoice,008-02485,Arroz a Granel:Largo Fino 50 LB -Bolsa Dos Hermanos.,,5.0,22.0,110.0,1983004.37999999,Bulk Rice,Lisset Limpio -020,CAFETERIA y RESTAURANTS,1382273,Jan
2024-01-18,Ideal Food Basket Davie Cafeteria,Invoice,008-02486,Arroz a Granel:Largo Fino 50 LB -Bolsa Dos Hermanos.,,15.0,23.5,352.5,1983356.87999999,Bulk Rice,Ruta - 019,CAFETERIA y RESTAURANTS,1382274,Jan
2024-01-18,Sedanos Supermarkets #7,Credit Memo,008-02616,Varios:Promotional Allowance,Rice Snack:Rice Snack Ham Flavored DOS HERMANOS,-1.0,19.9,-19.9,1983336.97999999,Puffed Products,Lisset Limpio -020,RETAIL SEDANOS,1382275,Jan
2024-01-18,Sedanos Supermarkets #7,Credit Memo,008-02616,Varios:Promotional Allowance,"Rice Snack:Rice Snack, Pizza DH",-1.0,19.9,-19.9,1983317.07999999,Puffed Products,Lisset Limpio -020,RETAIL SEDANOS,1382276,Jan
2024-01-18,Sedanos Supermarkets #7,Credit Memo,008-02616,Varios:Promotional Allowance,Rice Snack:Rice Snack Salami Flavored DOS HERMANOS,-1.0,19.9,-19.9,1983297.17999999,Puffed Products,Lisset Limpio -020,RETAIL SEDANOS,1382277,Jan
2024-01-22,El Palacio de los jugos /  Nanos Latin Foods,Invoice,008-02487,Arroz a Granel:Largo Fino 50 LB -Bolsa Dos Hermanos.,,8.0,22.0,176.0,1983473.17999999,Bulk Rice,Lisset Limpio -020,Cafeteria,1382278,Jan
2024-01-22,Soriano Brothers PB,Invoice,008-02488,Spices:AS Sazon (for all),1 / 30 lb (box or pail),1.0,59.0,59.0,1983532.17999999,American Spice,Lisset Limpio -020,CAFETERIA y RESTAURANTS,1382279,Jan
2024-01-22,Soriano Brothers PB,Invoice,008-02488,Dry Beans:Dry Beans - Black Beans 50,Dry Black Beans 50 lb,2.0,39.5,79.0,1983611.17999999,Dry Beans,Lisset Limpio -020,CAFETERIA y RESTAURANTS,1382280,Jan
2024-01-22,Soriano Brothers PB,Invoice,008-02488,Arroz a Granel:Largo Fino 50 LB -Bolsa Dos Hermanos.,,4.0,22.0,88.0,1983699.17999999,Bulk Rice,Lisset Limpio -020,CAFETERIA y RESTAURANTS,1382281,Jan
2024-01-22,Soriano Brothers PB,Invoice,008-02488,Arroz a Granel:Parboiled 50 LB -Bolsa Dos Hermanos.,,5.0,25.5,127.5,1983826.67999999,Bulk Rice,Lisset Limpio -020,CAFETERIA y RESTAURANTS,1382282,Jan
2024-01-22,Hings Chinese,Invoice,008-02489,Arroz a Granel:Largo Fino 50 LB -Bolsa Dos Hermanos.,,5.0,22.0,110.0,1983936.67999999,Bulk Rice,Lisset Limpio -020,CAFETERIA y RESTAURANTS,1382283,Jan
2024-01-22,Hings Chinese,Invoice,008-02489,Arroz a Granel:Parboiled 50 LB -Bolsa Dos Hermanos.,,2.0,25.5,51.0,1983987.67999999,Bulk Rice,Lisset Limpio -020,CAFETERIA y RESTAURANTS,1382284,Jan
2024-01-22,El Palacio de los jugos / Delicias Criollas (DIAGO FOOD_MILLER),Invoice,008-02490,Arroz a Granel:Parboiled 50 LB -Bolsa Dos Hermanos.,,10.0,25.5,255.0,1984242.67999999,Bulk Rice,Lisset Limpio -020,Cafeteria,1382285,Jan
2024-01-22,El Palacio de los jugos / Lita Foods Inc.,Invoice,008-02491,Arroz a Granel:Parboiled 50 LB -Bolsa Dos Hermanos.,,10.0,25.5,255.0,1984497.67999999,Bulk Rice,Lisset Limpio -020,Cafeteria,1382286,Jan
2024-01-22,Soriano Brothers,Invoice,008-02492,Arroz a Granel:Largo Fino 50 LB -Bolsa Dos Hermanos.,,15.0,22.0,330.0,1984827.67999999,Bulk Rice,Lisset Limpio -020,CAFETERIA y RESTAURANTS,1382287,Jan
2024-01-22,El Palacio de los jugos /  Mires Restaurants,Invoice,008-02493,Arroz a Granel:Largo Fino 50 LB -Bolsa Dos Hermanos.,,4.0,22.5,90.0,1984917.67999999,Bulk Rice,Lisset Limpio -020,Cafeteria,1382288,Jan
2024-01-22,El Palacio de los jugos /  Mires Restaurants,Invoice,008-02493,Arroz a Granel:Parboiled 50 LB -Bolsa Dos Hermanos.,,6.0,25.5,153.0,1985070.67999999,Bulk Rice,Lisset Limpio -020,Cafeteria,1382289,Jan
2024-01-22,El Palacio de los jugos /  EMMA FOOD CORP,Invoice,008-02494,Arroz a Granel:Largo Fino 50 LB -Bolsa Dos Hermanos.,,6.0,22.0,132.0,1985202.67999999,Bulk Rice,Lisset Limpio -020,Cafeteria,1382290,Jan
2024-01-22,El Palacio de los jugos /  EMMA FOOD CORP,Invoice,008-02494,Arroz a Granel:Parboiled 50 LB -Bolsa Dos Hermanos.,,6.0,25.5,153.0,1985355.67999999,Bulk Rice,Lisset Limpio -020,Cafeteria,1382291,Jan
2024-01-22,El Palacio de los jugos / Caribe Tropical,Invoice,008-02495,Arroz a Granel:Largo Fino 50 LB -Bolsa Dos Hermanos.,,6.0,22.0,132.0,1985487.67999999,Bulk Rice,Lisset Limpio -020,Cafeteria,1382292,Jan
2024-01-22,El Palacio de los jugos / Caribe Tropical,Invoice,008-02495,Arroz a Granel:Parboiled 50 LB -Bolsa Dos Hermanos.,,6.0,25.5,153.0,1985640.67999999,Bulk Rice,Lisset Limpio -020,Cafeteria,1382293,Jan
2024-01-22,El Palacio de los jugos / Santa Clara Sabor,Invoice,008-02496,Arroz a Granel:Largo Fino 50 LB -Bolsa Dos Hermanos.,,10.0,22.0,220.0,1985860.67999999,Bulk Rice,Lisset Limpio -020,Cafeteria,1382294,Jan
2024-01-22,Los Mejores Tamales de Miami,Invoice,008-02497,Arroz a Granel:Largo Fino 50 LB -Bolsa Dos Hermanos.,,5.0,22.0,110.0,1985970.67999999,Bulk Rice,Lisset Limpio -020,CAFETERIA y RESTAURANTS,1382295,Jan
2024-01-22,Los Mejores Tamales de Miami,Invoice,008-02497,Arroz a Granel:Parboiled 50 LB -Bolsa Dos Hermanos.,,5.0,25.5,127.5,1986098.17999999,Bulk Rice,Lisset Limpio -020,CAFETERIA y RESTAURANTS,1382296,Jan
2024-01-22,Los paraditos chinesse,Invoice,008-02498,Arroz a Granel:Largo Fino 50 LB -Bolsa Dos Hermanos.,,10.0,22.0,220.0,1986318.17999999,Bulk Rice,Lisset Limpio -020,CAFETERIA y RESTAURANTS,1382297,Jan
2024-01-22,Los paraditos chinesse,Invoice,008-02498,Arroz a Granel:Parboiled 50 LB -Bolsa Dos Hermanos.,,10.0,25.5,255.0,1986573.17999999,Bulk Rice,Lisset Limpio -020,CAFETERIA y RESTAURANTS,1382298,Jan
2024-01-22,El Palacio de los jugos / Sahilys Cafe,Invoice,008-02499,Arroz a Granel:Largo Fino 50 LB -Bolsa Dos Hermanos.,,6.0,22.0,132.0,1986705.17999999,Bulk Rice,Lisset Limpio -020,Cafeteria,1382299,Jan
2024-01-22,Sedanos Supermarkets  #4,Invoice,008-02500,Arroz Envasado:Parboiled 5KG Dos Hermanos.,6 / 11lbs,10.0,40.5,405.0,1987110.17999999,Branded Rice,Lisset Limpio -020,RETAIL SEDANOS,1382300,Jan
2024-01-22,Sedanos Supermarkets  #4,Invoice,008-02500,Rice Snack:Rice Snack Ham Flavored DOS HERMANOS,,2.0,19.9,39.8,1987149.97999999,Puffed Products,Lisset Limpio -020,RETAIL SEDANOS,1382301,Jan
2024-01-22,Sedanos Supermarkets  #4,Invoice,008-02500,Rice Snack:Rice Snack Salami Flavored DOS HERMANOS,,1.0,19.9,19.9,1987169.87999999,Puffed Products,Lisset Limpio -020,RETAIL SEDANOS,1382302,Jan
2024-01-22,Sedanos Supermarkets  #4,Invoice,008-02500,"Rice Snack:Rice Snack, Pizza DH",,1.0,19.9,19.9,1987189.77999999,Puffed Products,Lisset Limpio -020,RETAIL SEDANOS,1382303,Jan
2024-01-22,Sedanos Supermarkets  #4,Invoice,008-02500,Arroz Envasado:Parboiled 5KG Dos Hermanos.,6 / 11lbs,10.0,40.5,405.0,1987594.77999999,Branded Rice,Lisset Limpio -020,RETAIL SEDANOS,1382304,Jan
2024-01-22,Sedanos Supermarkets  #4,Invoice,008-02500,,Discount,-889.6,,-9.29,1987585.48999999,,Lisset Limpio -020,RETAIL SEDANOS,1382305,Jan
2024-01-22,Festival Supermarket #35- Southgate,Invoice,008-02501,Arroz Envasado:Parboiled 5KG Dos Hermanos.,6 / 11lbs,41.0,40.5,1660.5,1989245.98999999,Branded Rice,Ruta - 019,RETAIL  DSD,1382306,Jan
2024-01-22,Festival Supermarket #35- Southgate,Invoice,008-02501,Arroz Envasado:Parboiled 5KG Dos Hermanos.,6 / 11lbs,40.0,40.5,1620.0,1990865.98999999,Branded Rice,Ruta - 019,RETAIL  DSD,1382307,Jan
2024-01-22,House Of Meats,Invoice,008-02502,Arroz Envasado:Parboiled 5KG Dos Hermanos.,6 / 11lbs,21.0,40.5,850.5,1991716.48999999,Branded Rice,Ruta - 019,RETAIL  DSD,1382308,Jan
2024-01-22,House Of Meats,Invoice,008-02502,Rice Snack:Rice Snack Salami Flavored DOS HERMANOS,,1.0,19.9,19.9,1991736.38999999,Puffed Products,Ruta - 019,RETAIL  DSD,1382309,Jan
2024-01-22,House Of Meats,Invoice,008-02502,Rice Snack:Rice Snack Ham Flavored DOS HERMANOS,,1.0,19.9,19.9,1991756.28999999,Puffed Products,Ruta - 019,RETAIL  DSD,1382310,Jan
2024-01-22,House Of Meats,Invoice,008-02502,"Rice Snack:Rice Snack, Pizza DH",,1.0,19.9,19.9,1991776.18999999,Puffed Products,Ruta - 019,RETAIL  DSD,1382311,Jan
2024-01-22,House Of Meats,Invoice,008-02502,Rice Snack:Rice Snack Salami Flavored DOS HERMANOS,,1.0,19.9,19.9,1991796.08999999,Puffed Products,Ruta - 019,RETAIL  DSD,1382312,Jan
2024-01-22,House Of Meats,Invoice,008-02502,Arroz Envasado:Parboiled 5KG Dos Hermanos.,6 / 11lbs,20.0,40.5,810.0,1992606.08999999,Branded Rice,Ruta - 019,RETAIL  DSD,1382313,Jan
2024-01-22,BRAVO - Port St Lucie,Invoice,008-02503,Arroz Envasado:Parboiled 5KG Dos Hermanos.,6 / 11lbs,11.0,40.5,445.5,1993051.58999999,Branded Rice,Ruta - 019,RETAIL  DSD,1382314,Jan
2024-01-22,BRAVO - Port St Lucie,Invoice,008-02503,Arroz Envasado:Parboiled 5KG Dos Hermanos.,6 / 11lbs,10.0,40.5,405.0,1993456.58999999,Branded Rice,Ruta - 019,RETAIL  DSD,1382315,Jan
2024-01-22,Sedanos Supermarkets  #4,Credit Memo,008-02617,Varios:Promotional Allowance,"Rice Snack:Rice Snack, Pizza DH",-1.0,19.9,-19.9,1993436.68999999,Puffed Products,Lisset Limpio -020,RETAIL SEDANOS,1382316,Jan
2024-01-22,Sedanos Supermarkets  #4,Credit Memo,008-02617,Varios:Promotional Allowance,Arroz Envasado:Parboiled 5KG Dos Hermanos.,-10.0,40.5,-405.0,1993031.68999999,Branded Rice,Lisset Limpio -020,RETAIL SEDANOS,1382317,Jan
2024-01-22,House Of Meats,Credit Memo,008-02618,Varios:Promotional Allowance,Rice Snack:Rice Snack Salami Flavored DOS HERMANOS,-1.0,19.9,-19.9,1993011.78999999,Puffed Products,Ruta - 019,RETAIL  DSD,1382318,Jan
2024-01-22,House Of Meats,Credit Memo,008-02618,Varios:Promotional Allowance,Arroz Envasado:Parboiled 5KG Dos Hermanos.,-20.0,40.5,-810.0,1992201.78999999,Branded Rice,Ruta - 019,RETAIL  DSD,1382319,Jan
2024-01-22,BRAVO - Port St Lucie,Credit Memo,008-02619,Varios:Promotional Allowance,Arroz Envasado:Parboiled 5KG Dos Hermanos.,-10.0,40.5,-405.0,1991796.78999999,Branded Rice,Ruta - 019,RETAIL  DSD,1382320,Jan
2024-01-22,Festival Supermarket #35- Southgate,Credit Memo,008-02627,Varios:Promotional Allowance,Arroz Envasado:Parboiled 5KG Dos Hermanos.,-40.0,40.5,-1620.0,1990176.78999999,Branded Rice,Ruta - 019,RETAIL  DSD,1382321,Jan
2024-01-23,Family and Son,Invoice,008-02504,Arroz a Granel:Parboiled 50 LB -Bolsa Dos Hermanos.,,1100.0,23.0,25300.0,2015476.78999999,Bulk Rice,Armando Carpio - 017,WHOLESALER MANUFACTURY,1382322,Jan
2024-01-23,Bake Mark USA LLC,Invoice,008-02505,Arroz a Granel:Parboiled 50 LB -Bolsa Dos Hermanos.,,1100.0,23.0,25300.0,2040776.78999999,Bulk Rice,Armando Carpio - 017,WHOLESALER MANUFACTURY,1382323,Jan
2024-01-25,"American Spice Trading Co, Inc.",Invoice,008-02506,Arroz a Granel:Parboiled 50 LB -Bolsa Dos Hermanos.,,165.0,22.5,3712.5,2044489.28999999,Bulk Rice,Armando Carpio - 017,WHOLESALER MANUFACTURY,1382324,Jan
2024-01-25,Sorianos Brothers,Invoice,008-02507,Arroz a Granel:Parboiled 50 LB -Bolsa Dos Hermanos.,,20.0,25.5,510.0,2044999.28999999,Bulk Rice,Lisset Limpio -020,CAFETERIA y RESTAURANTS,1382325,Jan
2024-01-25,Sedanos Supermarkets #31,Invoice,008-02508,Arroz Envasado:Parboiled 5KG Dos Hermanos.,6 / 11lbs,10.0,40.5,405.0,2045404.28999999,Branded Rice,Lisset Limpio -020,RETAIL SEDANOS,1382326,Jan
2024-01-25,Sedanos Supermarkets #31,Invoice,008-02508,Rice Snack:Rice Snack Ham Flavored DOS HERMANOS,,2.0,19.9,39.8,2045444.08999999,Puffed Products,Lisset Limpio -020,RETAIL SEDANOS,1382327,Jan
2024-01-25,Sedanos Supermarkets #31,Invoice,008-02508,Rice Snack:Rice Snack Salami Flavored DOS HERMANOS,,1.0,19.9,19.9,2045463.98999999,Puffed Products,Lisset Limpio -020,RETAIL SEDANOS,1382328,Jan
2024-01-25,Sedanos Supermarkets #31,Invoice,008-02508,"Rice Snack:Rice Snack, Pizza DH",,1.0,19.9,19.9,2045483.88999999,Puffed Products,Lisset Limpio -020,RETAIL SEDANOS,1382329,Jan
2024-01-25,Sedanos Supermarkets #31,Invoice,008-02508,Arroz Envasado:Parboiled 5KG Dos Hermanos.,6 / 11lbs,10.0,40.5,405.0,2045888.88999999,Branded Rice,Lisset Limpio -020,RETAIL SEDANOS,1382330,Jan
2024-01-25,Sedanos Supermarkets #31,Invoice,008-02508,,Discount,-464.7,,-9.29,2045879.59999999,,Lisset Limpio -020,RETAIL SEDANOS,1382331,Jan
2024-01-25,El Palacio de los jugos /  EMMA FOOD CORP,Invoice,008-02509,Arroz a Granel:Largo Fino 50 LB -Bolsa Dos Hermanos.,,5.0,22.0,110.0,2045989.59999999,Bulk Rice,Lisset Limpio -020,Cafeteria,1382332,Jan
2024-01-25,El Palacio de los jugos /  EMMA FOOD CORP,Invoice,008-02509,Arroz a Granel:Parboiled 50 LB -Bolsa Dos Hermanos.,,5.0,25.5,127.5,2046117.09999999,Bulk Rice,Lisset Limpio -020,Cafeteria,1382333,Jan
2024-01-25,Hings Chinese,Invoice,008-02510,Arroz a Granel:Largo Fino 50 LB -Bolsa Dos Hermanos.,,3.0,22.0,66.0,2046183.09999999,Bulk Rice,Lisset Limpio -020,CAFETERIA y RESTAURANTS,1382334,Jan
2024-01-25,Hings Chinese,Invoice,008-02510,Arroz a Granel:Parboiled 50 LB -Bolsa Dos Hermanos.,,3.0,25.5,76.5,2046259.59999999,Bulk Rice,Lisset Limpio -020,CAFETERIA y RESTAURANTS,1382335,Jan
2024-01-25,El Palacio de los jugos / Santa Clara Sabor,Invoice,008-02511,Arroz a Granel:Largo Fino 50 LB -Bolsa Dos Hermanos.,,10.0,22.0,220.0,2046479.59999999,Bulk Rice,Lisset Limpio -020,Cafeteria,1382336,Jan
2024-01-25,El Palacio de los jugos / Caribe Tropical,Invoice,008-02512,Arroz a Granel:Largo Fino 50 LB -Bolsa Dos Hermanos.,,4.0,22.0,88.0,2046567.59999999,Bulk Rice,Lisset Limpio -020,Cafeteria,1382337,Jan
2024-01-25,El Palacio de los jugos / Caribe Tropical,Invoice,008-02512,Arroz a Granel:Parboiled 50 LB -Bolsa Dos Hermanos.,,6.0,25.5,153.0,2046720.59999999,Bulk Rice,Lisset Limpio -020,Cafeteria,1382338,Jan
2024-01-25,El Palacio de los jugos / Sahilys Cafe,Invoice,008-02513,Arroz a Granel:Largo Fino 50 LB -Bolsa Dos Hermanos.,,6.0,22.0,132.0,2046852.59999999,Bulk Rice,Lisset Limpio -020,Cafeteria,1382339,Jan
2024-01-25,Pacifico Chinese Restaurant,Invoice,008-02514,Arroz a Granel:Largo Fino 50 LB -Bolsa Dos Hermanos.,,7.0,22.0,154.0,2047006.59999999,Bulk Rice,Lisset Limpio -020,CAFETERIA y RESTAURANTS,1382340,Jan
2024-01-25,Pacifico Chinese Restaurant,Invoice,008-02514,Arroz a Granel:Parboiled 50 LB -Bolsa Dos Hermanos.,,3.0,25.5,76.5,2047083.09999999,Bulk Rice,Lisset Limpio -020,CAFETERIA y RESTAURANTS,1382341,Jan
2024-01-25,Sedanos Supermarkets #31,Credit Memo,008-02620,Varios:Promotional Allowance,"Rice Snack:Rice Snack, Pizza DH",-1.0,19.9,-19.9,2047063.19999999,Puffed Products,Lisset Limpio -020,RETAIL SEDANOS,1382342,Jan
2024-01-25,Sedanos Supermarkets #31,Credit Memo,008-02620,Varios:Promotional Allowance,Arroz Envasado:Parboiled 5KG Dos Hermanos.,-10.0,40.5,-405.0,2046658.19999999,Branded Rice,Lisset Limpio -020,RETAIL SEDANOS,1382343,Jan
2024-01-29,"El Toro Loco Meat Distribution, LLC",Invoice,008-02515,Dry Beans:Dry Beans - Black Beans 50,Dry Black Beans 50 lb,6.0,39.5,237.0,2046895.19999999,Dry Beans,Lisset Limpio -020,CAFETERIA y RESTAURANTS,1382344,Jan
2024-01-29,Aries Supermarket & Cafeteria,Invoice,008-02516,Dry Beans:Dry Beans - Black Beans 50,Dry Black Beans 50 lb,10.0,38.0,380.0,2047275.19999999,Dry Beans,Armando Carpio - 017,CAFETERIA y RESTAURANTS,1382345,Jan
2024-01-29,Hings Chinese,Invoice,008-02517,Arroz a Granel:Largo Fino 50 LB -Bolsa Dos Hermanos.,,10.0,22.0,220.0,2047495.19999999,Bulk Rice,Lisset Limpio -020,CAFETERIA y RESTAURANTS,1382346,Jan
2024-01-29,Fritanga Momotombo,Invoice,008-02518,Arroz a Granel:Largo Fino 50 LB -Bolsa Dos Hermanos.,,5.0,22.0,110.0,2047605.19999999,Bulk Rice,Lisset Limpio -020,CAFETERIA y RESTAURANTS,1382347,Jan
2024-01-29,El Palacio de los jugos /  Mires Restaurants,Invoice,008-02519,Arroz a Granel:Largo Fino 50 LB -Bolsa Dos Hermanos.,,2.0,22.0,44.0,2047649.19999999,Bulk Rice,Lisset Limpio -020,Cafeteria,1382348,Jan
2024-01-29,El Palacio de los jugos /  Mires Restaurants,Invoice,008-02519,Arroz a Granel:Parboiled 50 LB -Bolsa Dos Hermanos.,,7.0,26.75,187.25,2047836.44999999,Bulk Rice,Lisset Limpio -020,Cafeteria,1382349,Jan
2024-01-29,Soriano Brothers,Invoice,008-02520,Arroz a Granel:Largo Fino 50 LB -Bolsa Dos Hermanos.,,10.0,22.0,220.0,2048056.44999999,Bulk Rice,Lisset Limpio -020,CAFETERIA y RESTAURANTS,1382350,Jan
2024-01-29,Soriano Brothers,Invoice,008-02520,Arroz a Granel:Parboiled 50 LB -Bolsa Dos Hermanos.,,20.0,26.75,535.0,2048591.44999999,Bulk Rice,Lisset Limpio -020,CAFETERIA y RESTAURANTS,1382351,Jan
2024-01-29,Soriano Brothers PB,Invoice,008-02521,Arroz a Granel:Largo Fino 50 LB -Bolsa Dos Hermanos.,,5.0,22.0,110.0,2048701.44999999,Bulk Rice,Lisset Limpio -020,CAFETERIA y RESTAURANTS,1382352,Jan
2024-01-29,Soriano Brothers PB,Invoice,008-02521,Arroz a Granel:Parboiled 50 LB -Bolsa Dos Hermanos.,,5.0,26.75,133.75,2048835.19999999,Bulk Rice,Lisset Limpio -020,CAFETERIA y RESTAURANTS,1382353,Jan
2024-01-29,El Palacio de los jugos /  EMMA FOOD CORP,Invoice,008-02522,Arroz a Granel:Largo Fino 50 LB -Bolsa Dos Hermanos.,,6.0,22.0,132.0,2048967.19999999,Bulk Rice,Lisset Limpio -020,Cafeteria,1382354,Jan
2024-01-29,El Palacio de los jugos /  EMMA FOOD CORP,Invoice,008-02522,Arroz a Granel:Parboiled 50 LB -Bolsa Dos Hermanos.,,7.0,26.75,187.25,2049154.44999999,Bulk Rice,Lisset Limpio -020,Cafeteria,1382355,Jan
2024-01-29,Los Caringas Latin America  Foods,Invoice,008-02523,Arroz a Granel:Largo Fino 50 LB -Bolsa Dos Hermanos.,,3.0,22.0,66.0,2049220.44999999,Bulk Rice,Lisset Limpio -020,CAFETERIA y RESTAURANTS,1382356,Jan
2024-01-29,Los Caringas Latin America  Foods,Invoice,008-02523,Arroz a Granel:Parboiled 50 LB -Bolsa Dos Hermanos.,,3.0,26.75,80.25,2049300.69999999,Bulk Rice,Lisset Limpio -020,CAFETERIA y RESTAURANTS,1382357,Jan
2024-01-29,El Palacio de los jugos / Delicias Criollas (DIAGO FOOD_MILLER),Invoice,008-02524,Arroz a Granel:Parboiled 50 LB -Bolsa Dos Hermanos.,,15.0,26.75,401.25,2049701.94999999,Bulk Rice,Lisset Limpio -020,Cafeteria,1382358,Jan
2024-01-29,El Palacio de los jugos / Caribe Tropical,Invoice,008-02525,Arroz a Granel:Largo Fino 50 LB -Bolsa Dos Hermanos.,,6.0,22.0,132.0,2049833.94999999,Bulk Rice,Lisset Limpio -020,Cafeteria,1382359,Jan
2024-01-29,El Palacio de los jugos / Caribe Tropical,Invoice,008-02525,Arroz a Granel:Parboiled 50 LB -Bolsa Dos Hermanos.,,10.0,26.75,267.5,2050101.44999999,Bulk Rice,Lisset Limpio -020,Cafeteria,1382360,Jan
2024-01-29,El Palacio de los jugos / Sahilys Cafe,Invoice,008-02526,Arroz a Granel:Largo Fino 50 LB -Bolsa Dos Hermanos.,,6.0,22.0,132.0,2050233.44999999,Bulk Rice,Lisset Limpio -020,Cafeteria,1382361,Jan
2024-01-31,Ideal Food Basket Davie Cafeteria,Invoice,008-02527,Arroz a Granel:Largo Fino 50 LB -Bolsa Dos Hermanos.,,10.0,24.5,245.0,2050478.44999999,Bulk Rice,Ruta - 019,CAFETERIA y RESTAURANTS,1382362,Jan
2024-01-31,Sedanos Supermarkets #29,Invoice,008-02528,"Rice Snack:Rice Snack, Pizza DH",,1.0,19.9,19.9,2050498.34999999,Puffed Products,Lisset Limpio -020,RETAIL SEDANOS,1382363,Jan
2024-01-31,Sedanos Supermarkets #29,Invoice,008-02528,Rice Snack:Rice Snack Salami Flavored DOS HERMANOS,,1.0,19.9,19.9,2050518.24999999,Puffed Products,Lisset Limpio -020,RETAIL SEDANOS,1382364,Jan
2024-01-31,Sedanos Supermarkets #29,Invoice,008-02528,Rice Snack:Rice Snack Ham Flavored DOS HERMANOS,,1.0,19.9,19.9,2050538.14999999,Puffed Products,Lisset Limpio -020,RETAIL SEDANOS,1382365,Jan
2024-01-31,Sedanos Supermarkets #29,Invoice,008-02528,Rice Snack:Rice Snack Ham Flavored DOS HERMANOS,,1.0,19.9,19.9,2050558.04999999,Puffed Products,Lisset Limpio -020,RETAIL SEDANOS,1382366,Jan
2024-01-31,Sedanos Supermarkets #29,Invoice,008-02528,,Discount,,,-1.19,2050556.85999999,,Lisset Limpio -020,RETAIL SEDANOS,1382367,Jan
2024-01-31,Bravo   Francisco Diaz,Invoice,008-02529,Arroz a Granel:Largo Fino 50 LB -Bolsa Dos Hermanos.,,5.0,24.5,122.5,2050679.35999999,Bulk Rice,Lisset Limpio -020,RETAIL  DSD,1382368,Jan
2024-01-31,Bravo   Francisco Diaz,Invoice,008-02529,Liquids:AS Cooking Wine,4/1 Gl.,4.0,17.5,70.0,2050749.35999999,American Spice,Lisset Limpio -020,RETAIL  DSD,1382369,Jan
2024-01-31,Bravo   Francisco Diaz,Invoice,008-02529,Liquids:AS White Vinegar,4/1 Gl.,1.0,10.0,10.0,2050759.35999999,American Spice,Lisset Limpio -020,RETAIL  DSD,1382370,Jan
2024-01-31,Sedanos Supermarkets #23,Invoice,008-02530,Rice Snack:Rice Snack Ham Flavored DOS HERMANOS,,2.0,19.9,39.8,2050799.15999999,Puffed Products,Lisset Limpio -020,RETAIL SEDANOS,1382371,Jan
2024-01-31,Sedanos Supermarkets #23,Invoice,008-02530,Rice Snack:Rice Snack Salami Flavored DOS HERMANOS,,1.0,19.9,19.9,2050819.05999999,Puffed Products,Lisset Limpio -020,RETAIL SEDANOS,1382372,Jan
2024-01-31,Sedanos Supermarkets #23,Invoice,008-02530,"Rice Snack:Rice Snack, Pizza DH",,1.0,19.9,19.9,2050838.95999999,Puffed Products,Lisset Limpio -020,RETAIL SEDANOS,1382373,Jan
2024-01-31,Sedanos Supermarkets #23,Invoice,008-02530,,Discount,,,-1.19,2050837.76999999,,Lisset Limpio -020,RETAIL SEDANOS,1382374,Jan
2024-01-31,Sedanos Supermarkets  #37,Invoice,008-02531,Rice Snack:Rice Snack Salami Flavored DOS HERMANOS,,1.0,19.9,19.9,2050857.66999999,Puffed Products,Lisset Limpio -020,RETAIL SEDANOS,1382375,Jan
2024-01-31,Sedanos Supermarkets  #37,Invoice,008-02531,Rice Snack:Rice Snack Ham Flavored DOS HERMANOS,,2.0,19.9,39.8,2050897.46999999,Puffed Products,Lisset Limpio -020,RETAIL SEDANOS,1382376,Jan
2024-01-31,Sedanos Supermarkets  #37,Invoice,008-02531,Arroz Envasado:Parboiled 5KG Dos Hermanos.,6 / 11lbs,4.0,40.5,162.0,2051059.46999999,Branded Rice,Lisset Limpio -020,RETAIL SEDANOS,1382377,Jan
2024-01-31,Sedanos Supermarkets  #37,Invoice,008-02531,Arroz Envasado:Parboiled 5KG Dos Hermanos.,6 / 11lbs,4.0,40.5,162.0,2051221.46999999,Branded Rice,Lisset Limpio -020,RETAIL SEDANOS,1382378,Jan
2024-01-31,Sedanos Supermarkets  #37,Invoice,008-02531,Rice Snack:Rice Snack Ham Flavored DOS HERMANOS,,1.0,19.9,19.9,2051241.36999999,Puffed Products,Lisset Limpio -020,RETAIL SEDANOS,1382379,Jan
2024-01-31,Sedanos Supermarkets  #37,Invoice,008-02531,,Discount,,,-4.43,2051236.93999999,,Lisset Limpio -020,RETAIL SEDANOS,1382380,Jan
2024-01-31,El Palacio de los jugos /  Nanos Latin Foods,Invoice,008-02532,Arroz a Granel:Largo Fino 50 LB -Bolsa Dos Hermanos.,,8.0,22.0,176.0,2051412.93999999,Bulk Rice,Lisset Limpio -020,Cafeteria,1382381,Jan
2024-01-31,Sedanos Supermarkets #38,Invoice,008-02533,Dry Beans:Dry Beans - Black Beans 50,Dry Black Beans 50 lb,4.0,39.5,158.0,2051570.93999999,Dry Beans,Lisset Limpio -020,RETAIL SEDANOS,1382382,Jan
2024-01-31,Sedanos Supermarkets #38,Invoice,008-02533,Arroz a Granel:Largo Fino 50 LB -Bolsa Dos Hermanos.,,4.0,23.5,94.0,2051664.93999999,Bulk Rice,Lisset Limpio -020,RETAIL SEDANOS,1382383,Jan
2024-01-31,Sedanos Supermarkets #38,Invoice,008-02533,,Discount,,,-5.04,2051659.89999999,,Lisset Limpio -020,RETAIL SEDANOS,1382384,Jan
2024-01-31,Sedanos Supermarkets #38,Invoice,008-02534,"Rice Snack:Rice Snack, Pizza DH",,1.0,19.9,19.9,2051679.79999999,Puffed Products,Lisset Limpio -020,RETAIL SEDANOS,1382385,Jan
2024-01-31,Sedanos Supermarkets #38,Invoice,008-02534,Rice Snack:Rice Snack Salami Flavored DOS HERMANOS,,1.0,19.9,19.9,2051699.69999999,Puffed Products,Lisset Limpio -020,RETAIL SEDANOS,1382386,Jan
2024-01-31,Sedanos Supermarkets #38,Invoice,008-02534,Rice Snack:Rice Snack Ham Flavored DOS HERMANOS,,1.0,19.9,19.9,2051719.59999999,Puffed Products,Lisset Limpio -020,RETAIL SEDANOS,1382387,Jan
2024-01-31,Sedanos Supermarkets #38,Invoice,008-02534,Arroz Envasado:Parboiled 5KG Dos Hermanos.,6 / 11lbs,20.0,40.5,810.0,2052529.59999999,Branded Rice,Lisset Limpio -020,RETAIL SEDANOS,1382388,Jan
2024-01-31,Sedanos Supermarkets #38,Invoice,008-02534,Arroz Envasado:Parboiled 5KG Dos Hermanos.,6 / 11lbs,20.0,40.5,810.0,2053339.59999999,Branded Rice,Lisset Limpio -020,RETAIL SEDANOS,1382389,Jan
2024-01-31,Sedanos Supermarkets #38,Invoice,008-02534,Rice Snack:Rice Snack Ham Flavored DOS HERMANOS,,1.0,19.9,19.9,2053359.49999999,Puffed Products,Lisset Limpio -020,RETAIL SEDANOS,1382390,Jan
2024-01-31,Sedanos Supermarkets #38,Invoice,008-02534,,Discount,,,-17.39,2053342.10999999,,Lisset Limpio -020,RETAIL SEDANOS,1382391,Jan
2024-01-31,Brito Family Corp.,Invoice,008-02535,Arroz a Granel:Largo Fino 50 LB -Bolsa Dos Hermanos.,,55.0,22.5,1237.5,2054579.60999999,Bulk Rice,Lisset Limpio -020,CAFETERIA y RESTAURANTS,1382392,Jan
2024-01-31,Brito Family Corp.,Invoice,008-02535,Arroz a Granel:Parboiled 50 LB -Bolsa Dos Hermanos.,,110.0,26.75,2942.5,2057522.10999999,Bulk Rice,Lisset Limpio -020,CAFETERIA y RESTAURANTS,1382393,Jan
2024-01-31,Sedanos Supermarkets #5,Invoice,008-02536,"Rice Snack:Rice Snack, Pizza DH",,1.0,19.9,19.9,2057542.00999999,Puffed Products,Lisset Limpio -020,RETAIL SEDANOS,1382394,Jan
2024-01-31,Sedanos Supermarkets #5,Invoice,008-02536,Rice Snack:Rice Snack Salami Flavored DOS HERMANOS,,1.0,19.9,19.9,2057561.90999999,Puffed Products,Lisset Limpio -020,RETAIL SEDANOS,1382395,Jan
2024-01-31,Sedanos Supermarkets #5,Invoice,008-02536,Rice Snack:Rice Snack Ham Flavored DOS HERMANOS,,2.0,19.9,39.8,2057601.70999999,Puffed Products,Lisset Limpio -020,RETAIL SEDANOS,1382396,Jan
2024-01-31,Sedanos Supermarkets #5,Invoice,008-02536,,Discount,,,-1.19,2057600.51999999,,Lisset Limpio -020,RETAIL SEDANOS,1382397,Jan
2024-01-31,Sedanos Supermarkets #21,Invoice,008-02537,Rice Snack:Rice Snack Ham Flavored DOS HERMANOS,,2.0,19.9,39.8,2057640.31999999,Puffed Products,Lisset Limpio -020,RETAIL SEDANOS,1382398,Jan
2024-01-31,Sedanos Supermarkets #21,Invoice,008-02537,Rice Snack:Rice Snack Salami Flavored DOS HERMANOS,,1.0,19.9,19.9,2057660.21999999,Puffed Products,Lisset Limpio -020,RETAIL SEDANOS,1382399,Jan
2024-01-31,Sedanos Supermarkets #21,Invoice,008-02537,"Rice Snack:Rice Snack, Pizza DH",,1.0,19.9,19.9,2057680.11999999,Puffed Products,Lisset Limpio -020,RETAIL SEDANOS,1382400,Jan
2024-01-31,Sedanos Supermarkets #21,Invoice,008-02537,,Discount,,,-1.19,2057678.92999999,,Lisset Limpio -020,RETAIL SEDANOS,1382401,Jan
2024-01-31,Sedanos Supermarkets #23,Credit Memo,008-02621,Varios:Promotional Allowance,"Rice Snack:Rice Snack, Pizza DH",-1.0,19.9,-19.9,2057659.02999999,Puffed Products,Lisset Limpio -020,RETAIL SEDANOS,1382402,Jan
2024-01-31,Sedanos Supermarkets  #37,Credit Memo,008-02622,Varios:Promotional Allowance,Arroz Envasado:Parboiled 5KG Dos Hermanos.,-4.0,40.5,-162.0,2057497.02999999,Branded Rice,Lisset Limpio -020,RETAIL SEDANOS,1382403,Jan
2024-01-31,Sedanos Supermarkets  #37,Credit Memo,008-02622,Varios:Promotional Allowance,Rice Snack:Rice Snack Ham Flavored DOS HERMANOS,-1.0,19.9,-19.9,2057477.12999999,Puffed Products,Lisset Limpio -020,RETAIL SEDANOS,1382404,Jan
2024-01-31,Sedanos Supermarkets #29,Credit Memo,008-02623,Varios:Promotional Allowance,Rice Snack:Rice Snack Ham Flavored DOS HERMANOS,-1.0,19.9,-19.9,2057457.22999999,Puffed Products,Lisset Limpio -020,RETAIL SEDANOS,1382405,Jan
2024-01-31,Sedanos Supermarkets #21,Credit Memo,008-02624,Varios:Promotional Allowance,"Rice Snack:Rice Snack, Pizza DH",-1.0,19.9,-19.9,2057437.32999999,Puffed Products,Lisset Limpio -020,RETAIL SEDANOS,1382406,Jan
2024-01-31,Sedanos Supermarkets #38,Credit Memo,008-02625,Varios:Promotional Allowance,Arroz Envasado:Parboiled 5KG Dos Hermanos.,-20.0,40.5,-810.0,2056627.32999999,Branded Rice,Lisset Limpio -020,RETAIL SEDANOS,1382407,Jan
2024-01-31,Sedanos Supermarkets #38,Credit Memo,008-02625,Varios:Promotional Allowance,Rice Snack:Rice Snack Ham Flavored DOS HERMANOS,-1.0,19.9,-19.9,2056607.42999999,Puffed Products,Lisset Limpio -020,RETAIL SEDANOS,1382408,Jan
2024-01-31,Sedanos Supermarkets #5,Credit Memo,008-02626,Varios:Promotional Allowance,"Rice Snack:Rice Snack, Pizza DH",-1.0,19.9,-19.9,2056587.52999999,Puffed Products,Lisset Limpio -020,RETAIL SEDANOS,1382409,Jan
2024-02-02,Soriano Brothers PB,Invoice,008-02538,Arroz a Granel:Largo Fino 50 LB -Bolsa Dos Hermanos.,,5.0,22.0,110.0,2056697.52999999,Bulk Rice,Lisset Limpio -020,CAFETERIA y RESTAURANTS,1382410,Feb
2024-02-02,Soriano Brothers PB,Invoice,008-02538,Arroz a Granel:Parboiled 50 LB -Bolsa Dos Hermanos.,,7.0,26.75,187.25,2056884.77999999,Bulk Rice,Lisset Limpio -020,CAFETERIA y RESTAURANTS,1382411,Feb
2024-02-02,Soriano Brothers PB,Invoice,008-02538,Spices:AS Sazon (for all),1 / 30 lb (box or pail),1.0,59.0,59.0,2056943.77999999,American Spice,Lisset Limpio -020,CAFETERIA y RESTAURANTS,1382412,Feb
2024-02-02,El Palacio de los jugos / Lita Foods Inc.,Invoice,008-02539,Arroz a Granel:Parboiled 50 LB -Bolsa Dos Hermanos.,,10.0,26.75,267.5,2057211.27999999,Bulk Rice,Lisset Limpio -020,Cafeteria,1382413,Feb
2024-02-02,El Gallego Supermarket,Invoice,008-02540,Dry Beans:Dry Beans - Black Beans 50,Dry Black Beans 50 lb,2.0,39.5,79.0,2057290.27999999,Dry Beans,Lisset Limpio -020,RETAIL  DSD,1382414,Feb
2024-02-02,El Gallego Supermarket,Invoice,008-02540,Arroz a Granel:Parboiled 50 LB -Bolsa Dos Hermanos.,,5.0,26.75,133.75,2057424.02999999,Bulk Rice,Lisset Limpio -020,RETAIL  DSD,1382415,Feb
2024-02-02,Pacifico Chinese Restaurant,Invoice,008-02541,Arroz a Granel:Parboiled 50 LB -Bolsa Dos Hermanos.,,4.0,27.5,110.0,2057534.02999999,Bulk Rice,Lisset Limpio -020,CAFETERIA y RESTAURANTS,1382416,Feb
2024-02-02,Pacifico Chinese Restaurant,Invoice,008-02541,Arroz a Granel:Largo Fino 50 LB -Bolsa Dos Hermanos.,,7.0,22.0,154.0,2057688.02999999,Bulk Rice,Lisset Limpio -020,CAFETERIA y RESTAURANTS,1382417,Feb
2024-02-02,El Palacio de los jugos /  EMMA FOOD CORP,Invoice,008-02542,Arroz a Granel:Largo Fino 50 LB -Bolsa Dos Hermanos.,,9.0,22.0,198.0,2057886.02999999,Bulk Rice,Lisset Limpio -020,Cafeteria,1382418,Feb
2024-02-02,El Palacio de los jugos /  EMMA FOOD CORP,Invoice,008-02542,Arroz a Granel:Parboiled 50 LB -Bolsa Dos Hermanos.,,6.0,26.75,160.5,2058046.52999999,Bulk Rice,Lisset Limpio -020,Cafeteria,1382419,Feb
2024-02-02,Sedanos Supermarkets #42,Invoice,008-02543,"Rice Snack:Rice Snack, Pizza DH",,1.0,19.9,19.9,2058066.42999999,Puffed Products,Lisset Limpio -020,RETAIL SEDANOS,1382420,Feb
2024-02-02,Sedanos Supermarkets #42,Invoice,008-02543,Rice Snack:Rice Snack Salami Flavored DOS HERMANOS,,1.0,19.9,19.9,2058086.32999999,Puffed Products,Lisset Limpio -020,RETAIL SEDANOS,1382421,Feb
2024-02-02,Sedanos Supermarkets #42,Invoice,008-02543,Rice Snack:Rice Snack Ham Flavored DOS HERMANOS,,1.0,19.9,19.9,2058106.22999999,Puffed Products,Lisset Limpio -020,RETAIL SEDANOS,1382422,Feb
2024-02-02,Sedanos Supermarkets #42,Invoice,008-02543,Rice Snack:Rice Snack Ham Flavored DOS HERMANOS,,1.0,19.9,19.9,2058126.12999999,Puffed Products,Lisset Limpio -020,RETAIL SEDANOS,1382423,Feb
2024-02-02,Sedanos Supermarkets #42,Invoice,008-02543,,Discount,,,-1.19,2058124.93999999,,Lisset Limpio -020,RETAIL SEDANOS,1382424,Feb
2024-02-02,El Palacio de los jugos / Caribe Tropical,Invoice,008-02544,Arroz a Granel:Largo Fino 50 LB -Bolsa Dos Hermanos.,,5.0,22.0,110.0,2058234.93999999,Bulk Rice,Lisset Limpio -020,Cafeteria,1382425,Feb
2024-02-02,El Palacio de los jugos / Caribe Tropical,Invoice,008-02544,Arroz a Granel:Parboiled 50 LB -Bolsa Dos Hermanos.,,8.0,26.5,212.0,2058446.93999999,Bulk Rice,Lisset Limpio -020,Cafeteria,1382426,Feb
2024-02-02,Albert Deli #2,Invoice,008-02545,Arroz a Granel:Largo Fino 50 LB -Bolsa Dos Hermanos.,,6.0,24.5,147.0,2058593.93999999,Bulk Rice,Lisset Limpio -020,CAFETERIA y RESTAURANTS,1382427,Feb
2024-02-02,Albert Deli #2,Invoice,008-02545,Arroz a Granel:Parboiled 50 LB -Bolsa Dos Hermanos.,,3.0,26.75,80.25,2058674.18999999,Bulk Rice,Lisset Limpio -020,CAFETERIA y RESTAURANTS,1382428,Feb
2024-02-02,Albert Deli #2,Invoice,008-02545,Dry Beans:Dry Beans - Black Beans 50,Dry Black Beans 50 lb,1.0,39.5,39.5,2058713.68999999,Dry Beans,Lisset Limpio -020,CAFETERIA y RESTAURANTS,1382429,Feb
2024-02-04,Hings Chinese,Invoice,008-02546,Arroz a Granel:Largo Fino 50 LB -Bolsa Dos Hermanos.,,6.0,22.0,132.0,2058845.68999999,Bulk Rice,Lisset Limpio -020,CAFETERIA y RESTAURANTS,1382430,Feb
2024-02-04,El Palacio de los jugos / Delicias Criollas (DIAGO FOOD_MILLER),Invoice,008-02547,Arroz a Granel:Parboiled 50 LB -Bolsa Dos Hermanos.,,10.0,26.75,267.5,2059113.18999999,Bulk Rice,Lisset Limpio -020,Cafeteria,1382431,Feb
2024-02-04,El Palacio de los jugos /  Mires Restaurants,Invoice,008-02548,Arroz a Granel:Largo Fino 50 LB -Bolsa Dos Hermanos.,,5.0,22.0,110.0,2059223.18999999,Bulk Rice,Lisset Limpio -020,Cafeteria,1382432,Feb
2024-02-04,El Palacio de los jugos /  Mires Restaurants,Invoice,008-02548,Arroz a Granel:Parboiled 50 LB -Bolsa Dos Hermanos.,,5.0,26.75,133.75,2059356.93999999,Bulk Rice,Lisset Limpio -020,Cafeteria,1382433,Feb
2024-02-04,El Palacio de los jugos /  EMMA FOOD CORP,Invoice,008-02549,Arroz a Granel:Largo Fino 50 LB -Bolsa Dos Hermanos.,,8.0,22.0,176.0,2059532.93999999,Bulk Rice,Lisset Limpio -020,Cafeteria,1382434,Feb
2024-02-04,El Palacio de los jugos /  EMMA FOOD CORP,Invoice,008-02549,Arroz a Granel:Parboiled 50 LB -Bolsa Dos Hermanos.,,2.0,26.75,53.5,2059586.43999999,Bulk Rice,Lisset Limpio -020,Cafeteria,1382435,Feb
2024-02-04,El Palacio de los jugos / Sahilys Cafe,Invoice,008-02550,Arroz a Granel:Largo Fino 50 LB -Bolsa Dos Hermanos.,,6.0,22.0,132.0,2059718.43999999,Bulk Rice,Lisset Limpio -020,Cafeteria,1382436,Feb
2024-02-04,Sorianos Brothers,Invoice,008-02551,Arroz a Granel:Largo Fino 50 LB -Bolsa Dos Hermanos.,,15.0,22.0,330.0,2060048.43999999,Bulk Rice,Lisset Limpio -020,CAFETERIA y RESTAURANTS,1382437,Feb
2024-02-04,Sorianos Brothers,Invoice,008-02551,Arroz a Granel:Parboiled 50 LB -Bolsa Dos Hermanos.,,20.0,26.75,535.0,2060583.43999999,Bulk Rice,Lisset Limpio -020,CAFETERIA y RESTAURANTS,1382438,Feb
2024-02-04,Los paraditos chinesse,Invoice,008-02552,Arroz a Granel:Largo Fino 50 LB -Bolsa Dos Hermanos.,,10.0,22.0,220.0,2060803.43999999,Bulk Rice,Lisset Limpio -020,CAFETERIA y RESTAURANTS,1382439,Feb
2024-02-04,Los paraditos chinesse,Invoice,008-02552,Arroz a Granel:Parboiled 50 LB -Bolsa Dos Hermanos.,,5.0,26.75,133.75,2060937.18999999,Bulk Rice,Lisset Limpio -020,CAFETERIA y RESTAURANTS,1382440,Feb
2024-02-04,Rey Chavez Distributor #2,Invoice,008-02553,Arroz a Granel:Parboiled 50 LB -Bolsa Dos Hermanos.,,55.0,25.5,1402.5,2062339.68999999,Bulk Rice,Lisset Limpio -020,WHOLESALER,1382441,Feb
2024-02-04,El Palacio de los jugos / Lita Foods Inc.,Invoice,008-02554,Arroz a Granel:Parboiled 50 LB -Bolsa Dos Hermanos.,,10.0,26.75,267.5,2062607.18999999,Bulk Rice,Lisset Limpio -020,Cafeteria,1382442,Feb
2024-02-04,El Palacio de los jugos / Caribe Tropical,Invoice,008-02555,Arroz a Granel:Largo Fino 50 LB -Bolsa Dos Hermanos.,,6.0,22.0,132.0,2062739.18999999,Bulk Rice,Lisset Limpio -020,Cafeteria,1382443,Feb
2024-02-04,El Palacio de los jugos / Caribe Tropical,Invoice,008-02555,Arroz a Granel:Parboiled 50 LB -Bolsa Dos Hermanos.,,10.0,26.75,267.5,2063006.68999999,Bulk Rice,Lisset Limpio -020,Cafeteria,1382444,Feb
2024-02-06,Key Food / Holywood,Invoice,008-02556,Arroz Envasado:Largo Fino 1kg (Long grain rice) Dos Hermanos,,10.0,17.5,175.0,2063181.68999999,Branded Rice,Lisset Limpio -020,RETAIL  DSD,1382445,Feb
2024-02-06,Key Food / Holywood,Invoice,008-02556,Arroz Envasado:Largo Fino 1kg (Long grain rice) Dos Hermanos,,2.0,17.5,35.0,2063216.68999999,Branded Rice,Lisset Limpio -020,RETAIL  DSD,1382446,Feb
2024-02-06,Bravo 5851 Lake Worth Road,Invoice,008-02557,Arroz Envasado:Parboiled 5KG Dos Hermanos.,6 / 11lbs,21.0,40.5,850.5,2064067.18999999,Branded Rice,Ruta - 019,RETAIL  DSD,1382447,Feb
2024-02-06,Bravo 5851 Lake Worth Road,Invoice,008-02557,Arroz Envasado:Parboiled 5KG Dos Hermanos.,6 / 11lbs,20.0,40.5,810.0,2064877.18999999,Branded Rice,Ruta - 019,RETAIL  DSD,1382448,Feb
2024-02-06,Ideal Food Basket Davie Cafeteria,Invoice,008-02558,Arroz a Granel:Largo Fino 50 LB -Bolsa Dos Hermanos.,,10.0,24.5,245.0,2065122.18999999,Bulk Rice,Ruta - 019,CAFETERIA y RESTAURANTS,1382449,Feb
2024-02-06,El Palacio de los jugos / J Mena Corp.,Invoice,008-02559,Arroz a Granel:Largo Fino 50 LB -Bolsa Dos Hermanos.,,10.0,22.0,220.0,2065342.18999999,Bulk Rice,Lisset Limpio -020,Cafeteria,1382450,Feb
2024-02-07,"American Spice Trading Co, Inc.",Invoice,008-02560,Arroz a Granel:Parboiled 50 LB -Bolsa Dos Hermanos.,,275.0,27.5,7562.5,2072904.68999999,Bulk Rice,Armando Carpio - 017,WHOLESALER MANUFACTURY,1382451,Feb
2024-02-07,Sedanos Supermarkets #9,Invoice,008-02561,Rice Snack:Rice Snack Ham Flavored DOS HERMANOS,,1.0,19.9,19.9,2072924.58999999,Puffed Products,Lisset Limpio -020,RETAIL SEDANOS,1382452,Feb
2024-02-07,Sedanos Supermarkets #9,Invoice,008-02561,Rice Snack:Rice Snack Salami Flavored DOS HERMANOS,,2.0,19.9,39.8,2072964.38999999,Puffed Products,Lisset Limpio -020,RETAIL SEDANOS,1382453,Feb
2024-02-07,Sedanos Supermarkets #9,Invoice,008-02561,"Rice Snack:Rice Snack, Pizza DH",,1.0,19.9,19.9,2072984.28999999,Puffed Products,Lisset Limpio -020,RETAIL SEDANOS,1382454,Feb
2024-02-07,Sedanos Supermarkets #9,Invoice,008-02561,Arroz Envasado:Parboiled 5KG Dos Hermanos.,6 / 11lbs,20.0,40.5,810.0,2073794.28999999,Branded Rice,Lisset Limpio -020,RETAIL SEDANOS,1382455,Feb
2024-02-07,Sedanos Supermarkets #9,Invoice,008-02561,Arroz Envasado:Parboiled 5KG Dos Hermanos.,6 / 11lbs,20.0,40.5,810.0,2074604.28999999,Branded Rice,Lisset Limpio -020,RETAIL SEDANOS,1382456,Feb
2024-02-07,Sedanos Supermarkets #9,Invoice,008-02561,,Discount,,,-17.39,2074586.89999999,,Lisset Limpio -020,RETAIL SEDANOS,1382457,Feb
2024-02-07,Sedanos Supermarkets #26,Invoice,008-02562,Arroz Envasado:Parboiled 5KG Dos Hermanos.,6 / 11lbs,20.0,40.5,810.0,2075396.89999999,Branded Rice,Lisset Limpio -020,RETAIL SEDANOS,1382458,Feb
2024-02-07,Sedanos Supermarkets #26,Invoice,008-02562,Rice Snack:Rice Snack Ham Flavored DOS HERMANOS,,2.0,19.9,39.8,2075436.69999999,Puffed Products,Lisset Limpio -020,RETAIL SEDANOS,1382459,Feb
2024-02-07,Sedanos Supermarkets #26,Invoice,008-02562,Rice Snack:Rice Snack Salami Flavored DOS HERMANOS,,1.0,19.9,19.9,2075456.59999999,Puffed Products,Lisset Limpio -020,RETAIL SEDANOS,1382460,Feb
2024-02-07,Sedanos Supermarkets #26,Invoice,008-02562,"Rice Snack:Rice Snack, Pizza DH",,1.0,19.9,19.9,2075476.49999999,Puffed Products,Lisset Limpio -020,RETAIL SEDANOS,1382461,Feb
2024-02-07,Sedanos Supermarkets #26,Invoice,008-02562,Arroz Envasado:Parboiled 5KG Dos Hermanos.,6 / 11lbs,20.0,40.5,810.0,2076286.49999999,Branded Rice,Lisset Limpio -020,RETAIL SEDANOS,1382462,Feb
2024-02-07,Sedanos Supermarkets #26,Invoice,008-02562,,Discount,,,-17.39,2076269.10999999,,Lisset Limpio -020,RETAIL SEDANOS,1382463,Feb
2024-02-07,Sedanos Supermarkets #1,Invoice,008-02563,Arroz Envasado:Parboiled 5KG Dos Hermanos.,6 / 11lbs,5.0,40.5,202.5,2076471.60999999,Branded Rice,Lisset Limpio -020,RETAIL SEDANOS,1382464,Feb
2024-02-07,Sedanos Supermarkets #1,Invoice,008-02563,Rice Snack:Rice Snack Ham Flavored DOS HERMANOS,,1.0,19.9,19.9,2076491.50999999,Puffed Products,Lisset Limpio -020,RETAIL SEDANOS,1382465,Feb
2024-02-07,Sedanos Supermarkets #1,Invoice,008-02563,Rice Snack:Rice Snack Salami Flavored DOS HERMANOS,,1.0,19.9,19.9,2076511.40999999,Puffed Products,Lisset Limpio -020,RETAIL SEDANOS,1382466,Feb
2024-02-07,Sedanos Supermarkets #1,Invoice,008-02563,Arroz Envasado:Parboiled 5KG Dos Hermanos.,6 / 11lbs,5.0,40.5,202.5,2076713.90999999,Branded Rice,Lisset Limpio -020,RETAIL SEDANOS,1382467,Feb
2024-02-07,Sedanos Supermarkets #1,Invoice,008-02563,,Discount,,,-4.45,2076709.45999999,,Lisset Limpio -020,RETAIL SEDANOS,1382468,Feb
2024-02-07,Sedanos Supermarkets #43,Invoice,008-02564,"Rice Snack:Rice Snack, Pizza DH",,1.0,19.9,19.9,2076729.35999999,Puffed Products,Lisset Limpio -020,RETAIL SEDANOS,1382469,Feb
2024-02-07,Sedanos Supermarkets #43,Invoice,008-02564,Rice Snack:Rice Snack Salami Flavored DOS HERMANOS,,2.0,19.9,39.8,2076769.15999999,Puffed Products,Lisset Limpio -020,RETAIL SEDANOS,1382470,Feb
2024-02-07,Sedanos Supermarkets #43,Invoice,008-02564,Rice Snack:Rice Snack Ham Flavored DOS HERMANOS,,1.0,19.9,19.9,2076789.05999999,Puffed Products,Lisset Limpio -020,RETAIL SEDANOS,1382471,Feb
2024-02-07,Sedanos Supermarkets #43,Invoice,008-02564,Arroz Envasado:Parboiled 5KG Dos Hermanos.,6 / 11lbs,20.0,40.5,810.0,2077599.05999999,Branded Rice,Lisset Limpio -020,RETAIL SEDANOS,1382472,Feb
2024-02-07,Sedanos Supermarkets #43,Invoice,008-02564,Arroz Envasado:Parboiled 5KG Dos Hermanos.,6 / 11lbs,20.0,40.5,810.0,2078409.05999999,Branded Rice,Lisset Limpio -020,RETAIL SEDANOS,1382473,Feb
2024-02-07,Sedanos Supermarkets #43,Invoice,008-02564,,Discount,,,-17.39,2078391.66999999,,Lisset Limpio -020,RETAIL SEDANOS,1382474,Feb
2024-02-07,Sedanos Supermarkets #10,Invoice,008-02565,"Rice Snack:Rice Snack, Pizza DH",,1.0,19.9,19.9,2078411.56999999,Puffed Products,Lisset Limpio -020,RETAIL SEDANOS,1382475,Feb
2024-02-07,Sedanos Supermarkets #10,Invoice,008-02565,Rice Snack:Rice Snack Salami Flavored DOS HERMANOS,,2.0,19.9,39.8,2078451.36999999,Puffed Products,Lisset Limpio -020,RETAIL SEDANOS,1382476,Feb
2024-02-07,Sedanos Supermarkets #10,Invoice,008-02565,Rice Snack:Rice Snack Ham Flavored DOS HERMANOS,,1.0,19.9,19.9,2078471.26999999,Puffed Products,Lisset Limpio -020,RETAIL SEDANOS,1382477,Feb
2024-02-07,Sedanos Supermarkets #10,Invoice,008-02565,Arroz Envasado:Parboiled 5KG Dos Hermanos.,6 / 11lbs,20.0,40.5,810.0,2079281.26999999,Branded Rice,Lisset Limpio -020,RETAIL SEDANOS,1382478,Feb
2024-02-07,Sedanos Supermarkets #10,Invoice,008-02565,Arroz Envasado:Parboiled 5KG Dos Hermanos.,6 / 11lbs,20.0,40.5,810.0,2080091.26999999,Branded Rice,Lisset Limpio -020,RETAIL SEDANOS,1382479,Feb
2024-02-07,Sedanos Supermarkets #10,Invoice,008-02565,,Discount,,,-17.39,2080073.87999999,,Lisset Limpio -020,RETAIL SEDANOS,1382480,Feb
2024-02-07,Sedanos Supermarkets #22,Invoice,008-02566,,,,0.0,0.0,2080073.87999999,,Lisset Limpio -020,RETAIL SEDANOS,1382481,Feb
2024-02-07,Sedanos Supermarkets #22,Invoice,008-02566,"Rice Snack:Rice Snack, Pizza DH",,1.0,19.9,19.9,2080093.77999999,Puffed Products,Lisset Limpio -020,RETAIL SEDANOS,1382482,Feb
2024-02-07,Sedanos Supermarkets #22,Invoice,008-02566,Rice Snack:Rice Snack Salami Flavored DOS HERMANOS,,1.0,19.9,19.9,2080113.67999999,Puffed Products,Lisset Limpio -020,RETAIL SEDANOS,1382483,Feb
2024-02-07,Sedanos Supermarkets #22,Invoice,008-02566,Rice Snack:Rice Snack Ham Flavored DOS HERMANOS,,2.0,19.9,39.8,2080153.47999999,Puffed Products,Lisset Limpio -020,RETAIL SEDANOS,1382484,Feb
2024-02-07,Sedanos Supermarkets #22,Invoice,008-02566,Arroz Envasado:Parboiled 5KG Dos Hermanos.,6 / 11lbs,20.0,40.5,810.0,2080963.47999999,Branded Rice,Lisset Limpio -020,RETAIL SEDANOS,1382485,Feb
2024-02-07,Sedanos Supermarkets #22,Invoice,008-02566,Arroz Envasado:Parboiled 5KG Dos Hermanos.,6 / 11lbs,20.0,40.5,810.0,2081773.47999999,Branded Rice,Lisset Limpio -020,RETAIL SEDANOS,1382486,Feb
2024-02-07,Sedanos Supermarkets #22,Invoice,008-02566,,Discount,,,-17.39,2081756.08999999,,Lisset Limpio -020,RETAIL SEDANOS,1382487,Feb
2024-02-07,Sedanos Supermarkets #8,Invoice,008-02567,"Rice Snack:Rice Snack, Pizza DH",,1.0,19.9,19.9,2081775.98999999,Puffed Products,Lisset Limpio -020,RETAIL SEDANOS,1382488,Feb
2024-02-07,Sedanos Supermarkets #8,Invoice,008-02567,Rice Snack:Rice Snack Salami Flavored DOS HERMANOS,,1.0,19.9,19.9,2081795.88999999,Puffed Products,Lisset Limpio -020,RETAIL SEDANOS,1382489,Feb
2024-02-07,Sedanos Supermarkets #8,Invoice,008-02567,Rice Snack:Rice Snack Ham Flavored DOS HERMANOS,,2.0,19.9,39.8,2081835.68999999,Puffed Products,Lisset Limpio -020,RETAIL SEDANOS,1382490,Feb
2024-02-07,Sedanos Supermarkets #8,Invoice,008-02567,Arroz Envasado:Parboiled 5KG Dos Hermanos.,6 / 11lbs,20.0,40.5,810.0,2082645.68999999,Branded Rice,Lisset Limpio -020,RETAIL SEDANOS,1382491,Feb
2024-02-07,Sedanos Supermarkets #8,Invoice,008-02567,Arroz Envasado:Parboiled 5KG Dos Hermanos.,6 / 11lbs,20.0,40.5,810.0,2083455.68999999,Branded Rice,Lisset Limpio -020,RETAIL SEDANOS,1382492,Feb
2024-02-07,Sedanos Supermarkets #8,Invoice,008-02567,,Discount,,,-17.39,2083438.29999999,,Lisset Limpio -020,RETAIL SEDANOS,1382493,Feb
2024-02-08,"F.Garcia Wholesale & Export, Inc.",Invoice,008-02568,Arroz a Granel:Parboiled 50 LB -Bolsa Dos Hermanos.,,1.0,21.5,21.5,2083459.79999999,Bulk Rice,Armando Carpio - 017,WHOLESALER,1382494,Feb
2024-02-09,El Palacio de los jugos / Sahilys Cafe,Invoice,008-02569,Arroz a Granel:Largo Fino 50 LB -Bolsa Dos Hermanos.,,6.0,22.0,132.0,2083591.79999999,Bulk Rice,Lisset Limpio -020,Cafeteria,1382495,Feb
2024-02-09,Pacifico Chinese Restaurant,Invoice,008-02570,Arroz a Granel:Largo Fino 50 LB -Bolsa Dos Hermanos.,,7.0,22.0,154.0,2083745.79999999,Bulk Rice,Lisset Limpio -020,CAFETERIA y RESTAURANTS,1382496,Feb
2024-02-09,Pacifico Chinese Restaurant,Invoice,008-02570,Arroz a Granel:Parboiled 50 LB -Bolsa Dos Hermanos.,,3.0,26.75,80.25,2083826.04999999,Bulk Rice,Lisset Limpio -020,CAFETERIA y RESTAURANTS,1382497,Feb
2024-02-09,Hings Chinese,Invoice,008-02571,Arroz a Granel:Largo Fino 50 LB -Bolsa Dos Hermanos.,,7.0,22.0,154.0,2083980.04999999,Bulk Rice,Lisset Limpio -020,CAFETERIA y RESTAURANTS,1382498,Feb
2024-02-09,Soriano Brothers PB,Invoice,008-02572,Spices:AS Sazon (for all),1 / 30 lb (box or pail),2.0,59.0,118.0,2084098.04999999,American Spice,Lisset Limpio -020,CAFETERIA y RESTAURANTS,1382499,Feb
2024-02-09,Soriano Brothers PB,Invoice,008-02572,Arroz a Granel:Largo Fino 50 LB -Bolsa Dos Hermanos.,,3.0,22.0,66.0,2084164.04999999,Bulk Rice,Lisset Limpio -020,CAFETERIA y RESTAURANTS,1382500,Feb
2024-02-09,Soriano Brothers PB,Invoice,008-02572,Arroz a Granel:Parboiled 50 LB -Bolsa Dos Hermanos.,,5.0,26.75,133.75,2084297.79999999,Bulk Rice,Lisset Limpio -020,CAFETERIA y RESTAURANTS,1382501,Feb
2024-02-09,Soriano Brothers PB,Invoice,008-02572,Dry Beans:Dry Beans - Black Beans 50,Dry Black Beans 50 lb,3.0,39.5,118.5,2084416.29999999,Dry Beans,Lisset Limpio -020,CAFETERIA y RESTAURANTS,1382502,Feb
2024-02-09,El Palacio de los jugos / Lita Foods Inc.,Invoice,008-02573,Arroz a Granel:Largo Fino 50 LB -Bolsa Dos Hermanos.,,5.0,22.0,110.0,2084526.29999999,Bulk Rice,Lisset Limpio -020,Cafeteria,1382503,Feb
2024-02-09,El Palacio de los jugos / Lita Foods Inc.,Invoice,008-02573,Arroz a Granel:Parboiled 50 LB -Bolsa Dos Hermanos.,,10.0,26.75,267.5,2084793.79999999,Bulk Rice,Lisset Limpio -020,Cafeteria,1382504,Feb
2024-02-09,El Palacio de los jugos /  EMMA FOOD CORP,Invoice,008-02574,Arroz a Granel:Largo Fino 50 LB -Bolsa Dos Hermanos.,,10.0,22.0,220.0,2085013.79999999,Bulk Rice,Lisset Limpio -020,Cafeteria,1382505,Feb
2024-02-09,El Palacio de los jugos /  EMMA FOOD CORP,Invoice,008-02574,Arroz a Granel:Parboiled 50 LB -Bolsa Dos Hermanos.,,3.0,26.75,80.25,2085094.04999999,Bulk Rice,Lisset Limpio -020,Cafeteria,1382506,Feb
2024-02-09,El Palacio de los jugos / Caribe Tropical,Invoice,008-02575,Arroz a Granel:Largo Fino 50 LB -Bolsa Dos Hermanos.,,5.0,22.0,110.0,2085204.04999999,Bulk Rice,Lisset Limpio -020,Cafeteria,1382507,Feb
2024-02-09,El Palacio de los jugos / Caribe Tropical,Invoice,008-02575,Arroz a Granel:Parboiled 50 LB -Bolsa Dos Hermanos.,,6.0,26.75,160.5,2085364.54999999,Bulk Rice,Lisset Limpio -020,Cafeteria,1382508,Feb
2024-02-09,Soriano Brothers,Invoice,008-02576,Arroz a Granel:Largo Fino 50 LB -Bolsa Dos Hermanos.,,15.0,22.0,330.0,2085694.54999999,Bulk Rice,Lisset Limpio -020,CAFETERIA y RESTAURANTS,1382509,Feb
2024-02-09,Soriano Brothers,Invoice,008-02576,Arroz a Granel:Parboiled 50 LB -Bolsa Dos Hermanos.,,20.0,26.75,535.0,2086229.54999999,Bulk Rice,Lisset Limpio -020,CAFETERIA y RESTAURANTS,1382510,Feb
2024-02-09,Fritanga Momotombo,Invoice,008-02577,Arroz a Granel:Largo Fino 50 LB -Bolsa Dos Hermanos.,,6.0,22.0,132.0,2086361.54999999,Bulk Rice,Lisset Limpio -020,CAFETERIA y RESTAURANTS,1382511,Feb
2024-02-09,Fritanga Poneloya,Invoice,008-02578,Arroz a Granel:Largo Fino 50 LB -Bolsa Dos Hermanos.,,5.0,22.0,110.0,2086471.54999999,Bulk Rice,Lisset Limpio -020,CAFETERIA y RESTAURANTS,1382512,Feb
2024-02-09,"Soriano Brothers Diaz Food Service,Inc",Invoice,008-02579,Dry Beans:Dry Beans - Black Beans 50,Dry Black Beans 50 lb,8.0,39.5,316.0,2086787.54999999,Dry Beans,Lisset Limpio -020,CAFETERIA y RESTAURANTS,1382513,Feb
2024-02-09,El Palacio de Los Jugos / Casa mía Food Restaurant inc,Invoice,008-02580,Arroz a Granel:Largo Fino 50 LB -Bolsa Dos Hermanos.,,8.0,22.0,176.0,2086963.54999999,Bulk Rice,Lisset Limpio -020,Cafeteria,1382514,Feb
2024-02-09,Los Mejores Tamales de Miami,Invoice,008-02581,Arroz a Granel:Largo Fino 50 LB -Bolsa Dos Hermanos.,,3.0,22.0,66.0,2087029.54999999,Bulk Rice,Lisset Limpio -020,CAFETERIA y RESTAURANTS,1382515,Feb
2024-02-09,Los Mejores Tamales de Miami,Invoice,008-02581,Arroz a Granel:Parboiled 50 LB -Bolsa Dos Hermanos.,,4.0,26.75,107.0,2087136.54999999,Bulk Rice,Lisset Limpio -020,CAFETERIA y RESTAURANTS,1382516,Feb
2024-02-12,Hings Chinese,Invoice,008-02582,Arroz a Granel:Largo Fino 50 LB -Bolsa Dos Hermanos.,,5.0,22.0,110.0,2087246.54999999,Bulk Rice,Lisset Limpio -020,CAFETERIA y RESTAURANTS,1382517,Feb
2024-02-12,El Palacio de los jugos / J Mena Corp.,Invoice,008-02583,Arroz a Granel:Largo Fino 50 LB -Bolsa Dos Hermanos.,,10.0,22.0,220.0,2087466.54999999,Bulk Rice,Lisset Limpio -020,Cafeteria,1382518,Feb
2024-02-12,El Palacio de los jugos / Delicias Criollas (DIAGO FOOD_MILLER),Invoice,008-02584,Arroz a Granel:Parboiled 50 LB -Bolsa Dos Hermanos.,,15.0,26.75,401.25,2087867.79999999,Bulk Rice,Lisset Limpio -020,Cafeteria,1382519,Feb
2024-02-12,El Palacio de los jugos / Lita Foods Inc.,Invoice,008-02585,Arroz a Granel:Largo Fino 50 LB -Bolsa Dos Hermanos.,,6.0,22.0,132.0,2087999.79999999,Bulk Rice,Lisset Limpio -020,Cafeteria,1382520,Feb
2024-02-12,El Palacio de los jugos / Lita Foods Inc.,Invoice,008-02585,Arroz a Granel:Parboiled 50 LB -Bolsa Dos Hermanos.,,10.0,26.75,267.5,2088267.29999999,Bulk Rice,Lisset Limpio -020,Cafeteria,1382521,Feb
2024-02-12,El Palacio de los jugos /  EMMA FOOD CORP,Invoice,008-02586,Arroz a Granel:Largo Fino 50 LB -Bolsa Dos Hermanos.,,9.0,22.0,198.0,2088465.29999999,Bulk Rice,Lisset Limpio -020,Cafeteria,1382522,Feb
2024-02-12,El Palacio de los jugos /  EMMA FOOD CORP,Invoice,008-02586,Arroz a Granel:Parboiled 50 LB -Bolsa Dos Hermanos.,,5.0,26.75,133.75,2088599.04999999,Bulk Rice,Lisset Limpio -020,Cafeteria,1382523,Feb
2024-02-12,El Palacio de los jugos / Sahilys Cafe,Invoice,008-02587,Arroz a Granel:Largo Fino 50 LB -Bolsa Dos Hermanos.,,6.0,22.0,132.0,2088731.04999999,Bulk Rice,Lisset Limpio -020,Cafeteria,1382524,Feb
2024-02-12,El Palacio de Los Jugos / Casa mía Food Restaurant inc,Invoice,008-02589,Arroz a Granel:Largo Fino 50 LB -Bolsa Dos Hermanos.,,12.0,22.0,264.0,2088995.04999999,Bulk Rice,Lisset Limpio -020,Cafeteria,1382525,Feb
2024-02-12,El Palacio de los jugos /  Mires Restaurants,Invoice,008-02590,Arroz a Granel:Largo Fino 50 LB -Bolsa Dos Hermanos.,,4.0,22.0,88.0,2089083.04999999,Bulk Rice,Lisset Limpio -020,Cafeteria,1382526,Feb
2024-02-12,El Palacio de los jugos /  Mires Restaurants,Invoice,008-02590,Arroz a Granel:Parboiled 50 LB -Bolsa Dos Hermanos.,,6.0,26.75,160.5,2089243.54999999,Bulk Rice,Lisset Limpio -020,Cafeteria,1382527,Feb
2024-02-12,Price Choice Food Market # 6,Invoice,008-02591,Arroz Envasado:Parboiled 5KG Dos Hermanos.,6 / 11lbs,21.0,40.5,850.5,2090094.04999999,Branded Rice,Lisset Limpio -020,RETAIL  DSD,1382528,Feb
2024-02-12,Price Choice Food Market # 6,Invoice,008-02591,Arroz a Granel:Largo Fino 50 LB -Bolsa Dos Hermanos.,,20.0,22.0,440.0,2090534.04999999,Bulk Rice,Lisset Limpio -020,RETAIL  DSD,1382529,Feb
2024-02-12,Price Choice Food Market # 6,Invoice,008-02591,Arroz Envasado:Parboiled 5KG Dos Hermanos.,6 / 11lbs,20.0,40.5,810.0,2091344.04999999,Branded Rice,Lisset Limpio -020,RETAIL  DSD,1382530,Feb
2024-02-12,Brito Family Corp.,Invoice,008-02592,Arroz a Granel:Parboiled 50 LB -Bolsa Dos Hermanos.,,110.0,25.5,2805.0,2094149.04999999,Bulk Rice,Lisset Limpio -020,CAFETERIA y RESTAURANTS,1382531,Feb
2024-02-12,Soriano Brothers PB,Invoice,008-02593,Arroz a Granel:Largo Fino 50 LB -Bolsa Dos Hermanos.,,5.0,22.0,110.0,2094259.04999999,Bulk Rice,Lisset Limpio -020,CAFETERIA y RESTAURANTS,1382532,Feb
2024-02-12,Soriano Brothers PB,Invoice,008-02593,Arroz a Granel:Parboiled 50 LB -Bolsa Dos Hermanos.,,4.0,26.75,107.0,2094366.04999999,Bulk Rice,Lisset Limpio -020,CAFETERIA y RESTAURANTS,1382533,Feb
2024-02-12,Soriano Brothers PB,Invoice,008-02593,Dry Beans:Dry Beans - Black Beans 50,Dry Black Beans 50 lb,2.0,39.5,79.0,2094445.04999999,Dry Beans,Lisset Limpio -020,CAFETERIA y RESTAURANTS,1382534,Feb
2024-02-12,El Palacio de los jugos / Caribe Tropical,Invoice,008-02594,Arroz a Granel:Largo Fino 50 LB -Bolsa Dos Hermanos.,,6.0,22.0,132.0,2094577.04999999,Bulk Rice,Lisset Limpio -020,Cafeteria,1382535,Feb
2024-02-12,El Palacio de los jugos / Caribe Tropical,Invoice,008-02594,Arroz a Granel:Parboiled 50 LB -Bolsa Dos Hermanos.,,10.0,26.75,267.5,2094844.54999999,Bulk Rice,Lisset Limpio -020,Cafeteria,1382536,Feb
2024-02-12,Rey Chavez Distributor Corp,Invoice,008-02595,Arroz a Granel:Parboiled 50 LB -Bolsa Dos Hermanos.,,220.0,25.5,5610.0,2100454.54999999,Bulk Rice,Lisset Limpio -020,WHOLESALER,1382537,Feb
2024-02-12,El Gallego Supermarket,Invoice,008-02596,Arroz Envasado:Largo Fino 1kg (Long grain rice) Dos Hermanos,,1.0,16.5,16.5,2100471.04999999,Branded Rice,Lisset Limpio -020,RETAIL  DSD,1382538,Feb
2024-02-12,El Gallego Supermarket,Invoice,008-02596,Arroz Envasado:Parboiled 1kg Bolsa Dos Hermanos.,.,1.0,19.9,19.9,2100490.94999999,Branded Rice,Lisset Limpio -020,RETAIL  DSD,1382539,Feb
2024-02-12,El Gallego Supermarket,Invoice,008-02596,Arroz a Granel:Parboiled 50 LB -Bolsa Dos Hermanos.,,5.0,26.75,133.75,2100624.69999999,Bulk Rice,Lisset Limpio -020,RETAIL  DSD,1382540,Feb
2024-02-12,El Gallego Supermarket,Invoice,008-02596,Arroz Envasado:Parboiled 5KG Dos Hermanos.,6 / 11lbs,1.0,40.5,40.5,2100665.19999999,Branded Rice,Lisset Limpio -020,RETAIL  DSD,1382541,Feb
2024-02-12,Los Caringas Latin America  Foods,Invoice,008-02597,Arroz a Granel:Largo Fino 50 LB -Bolsa Dos Hermanos.,,3.0,22.0,66.0,2100731.19999999,Bulk Rice,Lisset Limpio -020,CAFETERIA y RESTAURANTS,1382542,Feb
2024-02-12,Los Caringas Latin America  Foods,Invoice,008-02597,Arroz a Granel:Parboiled 50 LB -Bolsa Dos Hermanos.,,3.0,26.75,80.25,2100811.44999999,Bulk Rice,Lisset Limpio -020,CAFETERIA y RESTAURANTS,1382543,Feb
2024-02-12,Panda Depot,Invoice,008-02598,Arroz a Granel:Parboiled 50 LB -Bolsa Dos Hermanos.,,275.0,26.5,7287.5,2108098.94999999,Bulk Rice,Lisset Limpio -020,WHOLESALER,1382544,Feb
2024-02-15,Ideal Food Basket Davie Cafeteria,Invoice,008-02599,Arroz a Granel:Largo Fino 50 LB -Bolsa Dos Hermanos.,,10.0,24.5,245.0,2108343.94999999,Bulk Rice,Armando Carpio - 017,CAFETERIA y RESTAURANTS,1382545,Feb
2024-02-15,Sedanos Supermarkets #42,Credit Memo,008-02600,Varios:Promotional Allowance,Rice Snack:Rice Snack Ham Flavored DOS HERMANOS,-1.0,19.9,-19.9,2108324.04999999,Puffed Products,Lisset Limpio -020,RETAIL SEDANOS,1382546,Feb
2024-02-15,Bravo 5851 Lake Worth Road,Credit Memo,008-02601,Varios:Promotional Allowance,Arroz Envasado:Parboiled 5KG Dos Hermanos.,-20.0,40.5,-810.0,2107514.04999999,Branded Rice,Ruta - 019,RETAIL  DSD,1382547,Feb
2024-02-15,Key Food / Holywood,Credit Memo,008-02602,Varios:Promotional Allowance,Arroz Envasado:Largo Fino 1kg (Long grain rice) Dos Hermanos,-2.0,17.5,-35.0,2107479.04999999,Branded Rice,Lisset Limpio -020,RETAIL  DSD,1382548,Feb
2024-02-15,Sedanos Supermarkets #43,Credit Memo,008-02603,Varios:Promotional Allowance,Arroz Envasado:Parboiled 5KG Dos Hermanos.,-20.0,40.5,-810.0,2106669.04999999,Branded Rice,Lisset Limpio -020,RETAIL SEDANOS,1382549,Feb
2024-02-15,Sedanos Supermarkets #43,Credit Memo,008-02603,Varios:Promotional Allowance,"Rice Snack:Rice Snack, Pizza DH",-1.0,19.9,-19.9,2106649.14999999,Puffed Products,Lisset Limpio -020,RETAIL SEDANOS,1382550,Feb
2024-02-15,Sedanos Supermarkets #26,Credit Memo,008-02604,Varios:Promotional Allowance,"Rice Snack:Rice Snack, Pizza DH",-1.0,19.9,-19.9,2106629.24999999,Puffed Products,Lisset Limpio -020,RETAIL SEDANOS,1382551,Feb
2024-02-15,Sedanos Supermarkets #26,Credit Memo,008-02604,Varios:Promotional Allowance,Arroz Envasado:Parboiled 5KG Dos Hermanos.,-20.0,40.5,-810.0,2105819.24999999,Branded Rice,Lisset Limpio -020,RETAIL SEDANOS,1382552,Feb
2024-02-15,Sedanos Supermarkets #1,Credit Memo,008-02605,Varios:Promotional Allowance,Rice Snack:Rice Snack Salami Flavored DOS HERMANOS,-1.0,19.9,-19.9,2105799.34999999,Puffed Products,Lisset Limpio -020,RETAIL SEDANOS,1382553,Feb
2024-02-15,Sedanos Supermarkets #1,Credit Memo,008-02605,Varios:Promotional Allowance,Arroz Envasado:Parboiled 5KG Dos Hermanos.,-5.0,40.5,-202.5,2105596.84999999,Branded Rice,Lisset Limpio -020,RETAIL SEDANOS,1382554,Feb
2024-02-15,Sedanos Supermarkets #22,Credit Memo,008-02606,Varios:Promotional Allowance,"Rice Snack:Rice Snack, Pizza DH",-1.0,19.9,-19.9,2105576.94999999,Puffed Products,Lisset Limpio -020,RETAIL SEDANOS,1382555,Feb
2024-02-15,Sedanos Supermarkets #22,Credit Memo,008-02606,Varios:Promotional Allowance,Arroz Envasado:Parboiled 5KG Dos Hermanos.,-20.0,40.5,-810.0,2104766.94999999,Branded Rice,Lisset Limpio -020,RETAIL SEDANOS,1382556,Feb
2024-02-15,Sedanos Supermarkets #8,Credit Memo,008-02607,Varios:Promotional Allowance,"Rice Snack:Rice Snack, Pizza DH",-1.0,19.9,-19.9,2104747.04999999,Puffed Products,Lisset Limpio -020,RETAIL SEDANOS,1382557,Feb
2024-02-15,Sedanos Supermarkets #8,Credit Memo,008-02607,Varios:Promotional Allowance,Arroz Envasado:Parboiled 5KG Dos Hermanos.,-20.0,40.5,-810.0,2103937.04999999,Branded Rice,Lisset Limpio -020,RETAIL SEDANOS,1382558,Feb
2024-02-15,Sedanos Supermarkets #9,Credit Memo,008-02608,Varios:Promotional Allowance,"Rice Snack:Rice Snack, Pizza DH",-1.0,19.9,-19.9,2103917.14999999,Puffed Products,Lisset Limpio -020,RETAIL SEDANOS,1382559,Feb
2024-02-15,Sedanos Supermarkets #9,Credit Memo,008-02608,Varios:Promotional Allowance,Arroz Envasado:Parboiled 5KG Dos Hermanos.,-20.0,40.5,-810.0,2103107.14999999,Branded Rice,Lisset Limpio -020,RETAIL SEDANOS,1382560,Feb
2024-02-15,Sedanos Supermarkets #10,Credit Memo,008-02609,Varios:Promotional Allowance,"Rice Snack:Rice Snack, Pizza DH",-1.0,19.9,-19.9,2103087.24999999,Puffed Products,Lisset Limpio -020,RETAIL SEDANOS,1382561,Feb
2024-02-15,Sedanos Supermarkets #10,Credit Memo,008-02609,Varios:Promotional Allowance,Arroz Envasado:Parboiled 5KG Dos Hermanos.,-20.0,40.5,-810.0,2102277.24999999,Branded Rice,Lisset Limpio -020,RETAIL SEDANOS,1382562,Feb
2024-02-15,"F.Garcia Wholesale & Export, Inc.",Credit Memo,008-02610,Varios:Promotional Allowance,Arroz a Granel:Parboiled 50 LB -Bolsa Dos Hermanos.,-1.0,21.5,-21.5,2102255.74999999,Bulk Rice,Armando Carpio - 017,WHOLESALER,1382563,Feb
2024-02-15,Price Choice Food Market # 6,Credit Memo,008-02611,Varios:Promotional Allowance,Arroz Envasado:Parboiled 5KG Dos Hermanos.,-20.0,40.5,-810.0,2101445.74999999,Branded Rice,Lisset Limpio -020,RETAIL  DSD,1382564,Feb
2024-02-15,"American Spice Trading Co, Inc.",Invoice,008-02612,Arroz a Granel:Parboiled 50 LB -Bolsa Dos Hermanos.,,110.0,27.5,3025.0,2104470.74999999,Bulk Rice,Armando Carpio - 017,WHOLESALER MANUFACTURY,1382565,Feb
2024-02-16,Bravo   Francisco Diaz,Invoice,008-02628,Liquids:AS White Vinegar,4/1 Gl.,2.0,10.0,20.0,2104490.74999999,American Spice,Lisset Limpio -020,RETAIL  DSD,1382566,Feb
2024-02-16,Bravo   Francisco Diaz,Invoice,008-02628,Arroz a Granel:Largo Fino 50 LB -Bolsa Dos Hermanos.,,5.0,24.5,122.5,2104613.24999999,Bulk Rice,Lisset Limpio -020,RETAIL  DSD,1382567,Feb
2024-02-16,Bravo   Francisco Diaz,Invoice,008-02628,Liquids:AS Cooking Wine,4/1 Gl.,3.0,17.5,52.5,2104665.74999999,American Spice,Lisset Limpio -020,RETAIL  DSD,1382568,Feb
2024-02-16,Soriano Brothers PB,Invoice,008-02629,Arroz a Granel:Parboiled 50 LB -Bolsa Dos Hermanos.,,5.0,26.75,133.75,2104799.49999999,Bulk Rice,Lisset Limpio -020,CAFETERIA y RESTAURANTS,1382569,Feb
2024-02-16,El Palacio de los jugos / Lita Foods Inc.,Invoice,008-02630,Arroz a Granel:Largo Fino 50 LB -Bolsa Dos Hermanos.,,5.0,22.0,110.0,2104909.49999999,Bulk Rice,Lisset Limpio -020,Cafeteria,1382570,Feb
2024-02-16,El Palacio de los jugos / Lita Foods Inc.,Invoice,008-02630,Arroz a Granel:Parboiled 50 LB -Bolsa Dos Hermanos.,,10.0,26.75,267.5,2105176.99999999,Bulk Rice,Lisset Limpio -020,Cafeteria,1382571,Feb
2024-02-16,El Palacio de los jugos / Sahilys Cafe,Invoice,008-02631,Arroz a Granel:Largo Fino 50 LB -Bolsa Dos Hermanos.,,6.0,21.5,129.0,2105305.99999999,Bulk Rice,Lisset Limpio -020,Cafeteria,1382572,Feb
2024-02-16,Sorianos Brothers,Invoice,008-02632,Arroz a Granel:Largo Fino 50 LB -Bolsa Dos Hermanos.,,15.0,22.0,330.0,2105635.99999999,Bulk Rice,Lisset Limpio -020,CAFETERIA y RESTAURANTS,1382573,Feb
2024-02-16,El Palacio de los jugos /  EMMA FOOD CORP,Invoice,008-02633,Arroz a Granel:Largo Fino 50 LB -Bolsa Dos Hermanos.,,6.0,22.0,132.0,2105767.99999999,Bulk Rice,Lisset Limpio -020,Cafeteria,1382574,Feb
2024-02-16,El Palacio de los jugos /  EMMA FOOD CORP,Invoice,008-02633,Arroz a Granel:Parboiled 50 LB -Bolsa Dos Hermanos.,,8.0,26.75,214.0,2105981.99999999,Bulk Rice,Lisset Limpio -020,Cafeteria,1382575,Feb
2024-02-16,El Palacio de los jugos / Caribe Tropical,Invoice,008-02634,Arroz a Granel:Largo Fino 50 LB -Bolsa Dos Hermanos.,,4.0,22.0,88.0,2106069.99999999,Bulk Rice,Lisset Limpio -020,Cafeteria,1382576,Feb
2024-02-16,El Palacio de los jugos / Caribe Tropical,Invoice,008-02634,Arroz a Granel:Parboiled 50 LB -Bolsa Dos Hermanos.,,6.0,26.75,160.5,2106230.49999999,Bulk Rice,Lisset Limpio -020,Cafeteria,1382577,Feb
2024-02-16,Pacifico Chinese Restaurant,Invoice,008-02635,Arroz a Granel:Largo Fino 50 LB -Bolsa Dos Hermanos.,,7.0,22.0,154.0,2106384.49999999,Bulk Rice,Lisset Limpio -020,CAFETERIA y RESTAURANTS,1382578,Feb
2024-02-16,Pacifico Chinese Restaurant,Invoice,008-02635,Arroz a Granel:Parboiled 50 LB -Bolsa Dos Hermanos.,,3.0,26.75,80.25,2106464.74999999,Bulk Rice,Lisset Limpio -020,CAFETERIA y RESTAURANTS,1382579,Feb
2024-02-16,Hings Chinese,Invoice,008-02636,Arroz a Granel:Largo Fino 50 LB -Bolsa Dos Hermanos.,,5.0,22.0,110.0,2106574.74999999,Bulk Rice,Lisset Limpio -020,CAFETERIA y RESTAURANTS,1382580,Feb
2024-02-16,El Palacio de los jugos /  Nanos Latin Foods,Invoice,008-02637,Arroz a Granel:Parboiled 50 LB -Bolsa Dos Hermanos.,,6.0,26.75,160.5,2106735.24999999,Bulk Rice,Lisset Limpio -020,Cafeteria,1382581,Feb
2024-02-16,Los paraditos chinesse,Invoice,008-02638,Arroz a Granel:Largo Fino 50 LB -Bolsa Dos Hermanos.,,10.0,22.0,220.0,2106955.24999999,Bulk Rice,Lisset Limpio -020,CAFETERIA y RESTAURANTS,1382582,Feb
2024-02-16,Los paraditos chinesse,Invoice,008-02638,Arroz a Granel:Parboiled 50 LB -Bolsa Dos Hermanos.,,5.0,26.75,133.75,2107088.99999999,Bulk Rice,Lisset Limpio -020,CAFETERIA y RESTAURANTS,1382583,Feb
2024-02-16,Soriano Brothers PB,Credit Memo,008-02639,Arroz a Granel:Largo Fino 50 LB -Bolsa Dos Hermanos.,,-5.0,22.0,-110.0,2106978.99999999,Bulk Rice,Lisset Limpio -020,CAFETERIA y RESTAURANTS,1382584,Feb
2024-02-19,El Palacio de los jugos / Sahilys Cafe,Invoice,008-02640,Arroz a Granel:Largo Fino 50 LB -Bolsa Dos Hermanos.,,6.0,22.0,132.0,2107110.99999999,Bulk Rice,Lisset Limpio -020,Cafeteria,1382585,Feb
2024-02-19,El Palacio de los jugos /  Nanos Latin Foods,Invoice,008-02641,Arroz a Granel:Parboiled 50 LB -Bolsa Dos Hermanos.,,10.0,26.75,267.5,2107378.49999999,Bulk Rice,Lisset Limpio -020,Cafeteria,1382586,Feb
2024-02-19,Hings Chinese,Invoice,008-02642,Arroz a Granel:Largo Fino 50 LB -Bolsa Dos Hermanos.,,5.0,22.0,110.0,2107488.49999999,Bulk Rice,Lisset Limpio -020,CAFETERIA y RESTAURANTS,1382587,Feb
2024-02-19,El Palacio de los jugos / Lita Foods Inc.,Invoice,008-02643,Arroz a Granel:Largo Fino 50 LB -Bolsa Dos Hermanos.,,5.0,22.0,110.0,2107598.49999999,Bulk Rice,Lisset Limpio -020,Cafeteria,1382588,Feb
2024-02-19,El Palacio de los jugos / Lita Foods Inc.,Invoice,008-02643,Arroz a Granel:Parboiled 50 LB -Bolsa Dos Hermanos.,,7.0,26.75,187.25,2107785.74999999,Bulk Rice,Lisset Limpio -020,Cafeteria,1382589,Feb
2024-02-19,Fritanga Momotombo,Invoice,008-02644,Arroz a Granel:Largo Fino 50 LB -Bolsa Dos Hermanos.,,5.0,22.0,110.0,2107895.74999999,Bulk Rice,Lisset Limpio -020,CAFETERIA y RESTAURANTS,1382590,Feb
2024-02-19,El Palacio de Los Jugos / Casa mía Food Restaurant inc,Invoice,008-02645,Arroz a Granel:Largo Fino 50 LB -Bolsa Dos Hermanos.,,15.0,22.0,330.0,2108225.74999999,Bulk Rice,Lisset Limpio -020,Cafeteria,1382591,Feb
2024-02-19,El Palacio de los jugos /  Mires Restaurants,Invoice,008-02646,Arroz a Granel:Largo Fino 50 LB -Bolsa Dos Hermanos.,,6.0,22.0,132.0,2108357.74999999,Bulk Rice,Lisset Limpio -020,Cafeteria,1382592,Feb
2024-02-19,El Palacio de los jugos /  Mires Restaurants,Invoice,008-02646,Arroz a Granel:Parboiled 50 LB -Bolsa Dos Hermanos.,,6.0,26.75,160.5,2108518.24999999,Bulk Rice,Lisset Limpio -020,Cafeteria,1382593,Feb
2024-02-19,El Palacio de los jugos / Caribe Tropical,Invoice,008-02647,Arroz a Granel:Largo Fino 50 LB -Bolsa Dos Hermanos.,,8.0,22.0,176.0,2108694.24999999,Bulk Rice,Lisset Limpio -020,Cafeteria,1382594,Feb
2024-02-19,El Palacio de los jugos / Caribe Tropical,Invoice,008-02647,Arroz a Granel:Parboiled 50 LB -Bolsa Dos Hermanos.,,10.0,26.75,267.5,2108961.74999999,Bulk Rice,Lisset Limpio -020,Cafeteria,1382595,Feb
2024-02-19,El Palacio de los jugos /  EMMA FOOD CORP,Invoice,008-02648,Arroz a Granel:Parboiled 50 LB -Bolsa Dos Hermanos.,,6.0,26.75,160.5,2109122.24999999,Bulk Rice,Lisset Limpio -020,Cafeteria,1382596,Feb
2024-02-19,El Palacio de los jugos /  EMMA FOOD CORP,Invoice,008-02648,Arroz a Granel:Largo Fino 50 LB -Bolsa Dos Hermanos.,,7.0,22.0,154.0,2109276.24999999,Bulk Rice,Lisset Limpio -020,Cafeteria,1382597,Feb
2024-02-19,El Palacio de los jugos / J Mena Corp.,Invoice,008-02649,Arroz a Granel:Largo Fino 50 LB -Bolsa Dos Hermanos.,,10.0,22.0,220.0,2109496.24999999,Bulk Rice,Lisset Limpio -020,Cafeteria,1382598,Feb
2024-02-19,Ideal Food Basket Davie Cafeteria,Invoice,008-02650,Arroz a Granel:Largo Fino 50 LB -Bolsa Dos Hermanos.,,10.0,25.5,255.0,2109751.24999999,Bulk Rice,Lisset Limpio -020,CAFETERIA y RESTAURANTS,1382599,Feb
2024-02-19,Sedanos Supermarkets #36,Invoice,008-02651,Arroz Envasado:Parboiled 5KG Dos Hermanos.,6 / 11lbs,4.0,40.5,162.0,2109913.24999999,Branded Rice,Lisset Limpio -020,RETAIL SEDANOS,1382600,Feb
2024-02-19,Sedanos Supermarkets #36,Invoice,008-02651,Rice Snack:Rice Snack Salami Flavored DOS HERMANOS,,2.0,19.9,39.8,2109953.04999999,Puffed Products,Lisset Limpio -020,RETAIL SEDANOS,1382601,Feb
2024-02-19,Sedanos Supermarkets #36,Invoice,008-02651,Rice Snack:Rice Snack Ham Flavored DOS HERMANOS,,1.0,19.9,19.9,2109972.94999999,Puffed Products,Lisset Limpio -020,RETAIL SEDANOS,1382602,Feb
2024-02-19,Sedanos Supermarkets #36,Invoice,008-02651,"Rice Snack:Rice Snack, Pizza DH",,1.0,19.9,19.9,2109992.84999999,Puffed Products,Lisset Limpio -020,RETAIL SEDANOS,1382603,Feb
2024-02-19,Sedanos Supermarkets #36,Invoice,008-02651,Arroz Envasado:Parboiled 5KG Dos Hermanos.,6 / 11lbs,4.0,40.5,162.0,2110154.84999999,Branded Rice,Lisset Limpio -020,RETAIL SEDANOS,1382604,Feb
2024-02-19,Sedanos Supermarkets #36,Invoice,008-02651,,Discount,,,-4.43,2110150.41999999,,Lisset Limpio -020,RETAIL SEDANOS,1382605,Feb
2024-02-19,Sedanos Supermarkets #28,Invoice,008-02652,Arroz Envasado:Parboiled 5KG Dos Hermanos.,6 / 11lbs,5.0,40.5,202.5,2110352.91999999,Branded Rice,Lisset Limpio -020,RETAIL SEDANOS,1382606,Feb
2024-02-19,Sedanos Supermarkets #28,Invoice,008-02652,Arroz Envasado:Parboiled 5KG Dos Hermanos.,6 / 11lbs,5.0,40.5,202.5,2110555.41999999,Branded Rice,Lisset Limpio -020,RETAIL SEDANOS,1382607,Feb
2024-02-19,Sedanos Supermarkets #28,Invoice,008-02652,,Discount,,,-4.05,2110551.36999999,,Lisset Limpio -020,RETAIL SEDANOS,1382608,Feb
2024-02-19,Sedanos Supermarkets #32,Invoice,008-02653,Rice Snack:Rice Snack Salami Flavored DOS HERMANOS,,2.0,19.9,39.8,2110591.16999999,Puffed Products,Lisset Limpio -020,RETAIL SEDANOS,1382609,Feb
2024-02-19,Sedanos Supermarkets #32,Invoice,008-02653,Rice Snack:Rice Snack Ham Flavored DOS HERMANOS,,1.0,19.9,19.9,2110611.06999999,Puffed Products,Lisset Limpio -020,RETAIL SEDANOS,1382610,Feb
2024-02-19,Sedanos Supermarkets #32,Invoice,008-02653,"Rice Snack:Rice Snack, Pizza DH",,1.0,19.9,19.9,2110630.96999999,Puffed Products,Lisset Limpio -020,RETAIL SEDANOS,1382611,Feb
2024-02-19,Sedanos Supermarkets #32,Invoice,008-02653,,Discount,,,-1.19,2110629.77999999,,Lisset Limpio -020,RETAIL SEDANOS,1382612,Feb
2024-02-19,Sedanos Supermarkets #38,Invoice,008-02654,Dry Beans:Dry Beans - Black Beans 50,Dry Black Beans 50 lb,2.0,39.5,79.0,2110708.77999999,Dry Beans,Lisset Limpio -020,RETAIL SEDANOS,1382613,Feb
2024-02-19,Sedanos Supermarkets #38,Invoice,008-02654,,Discount,,,-1.58,2110707.19999999,,Lisset Limpio -020,RETAIL SEDANOS,1382614,Feb
2024-02-19,Sedanos Supermarkets #36,Credit Memo,008-02714,Varios:Promotional Allowance,Arroz Envasado:Parboiled 5KG Dos Hermanos.,-4.0,40.5,-162.0,2110545.19999999,Branded Rice,Keila Alfaro-Visvikis,RETAIL SEDANOS,1382615,Feb
2024-02-19,Sedanos Supermarkets #36,Credit Memo,008-02714,Varios:Promotional Allowance,"Rice Snack:Rice Snack, Pizza DH",-1.0,19.9,-19.9,2110525.29999999,Puffed Products,Keila Alfaro-Visvikis,RETAIL SEDANOS,1382616,Feb
2024-02-19,Sedanos Supermarkets #28,Credit Memo,008-02716,Varios:Promotional Allowance,Arroz Envasado:Parboiled 5KG Dos Hermanos.,-5.0,40.5,-202.5,2110322.79999999,Branded Rice,Lisset Limpio -020,RETAIL SEDANOS,1382617,Feb
2024-02-20,Soriano Brothers,Invoice,008-02655,Arroz a Granel:Parboiled 50 LB -Bolsa Dos Hermanos.,,20.0,26.75,535.0,2110857.79999999,Bulk Rice,Lisset Limpio -020,CAFETERIA y RESTAURANTS,1382618,Feb
2024-02-20,"American Spice Trading Co, Inc.",Invoice,008-02656,Arroz a Granel:Parboiled 50 LB -Bolsa Dos Hermanos.,,55.0,27.5,1512.5,2112370.29999999,Bulk Rice,Armando Carpio - 017,WHOLESALER MANUFACTURY,1382619,Feb
2024-02-20,Max Food Distributors,Invoice,008-02657,Arroz a Granel:Parboiled 50 LB -Bolsa Dos Hermanos.,,30.0,26.75,802.5,2113172.79999999,Bulk Rice,Lisset Limpio -020,WHOLESALER,1382620,Feb
2024-02-20,"American Spice Trading Co, Inc.",Invoice,008-02658,Arroz a Granel:Parboiled 50 LB -Bolsa Dos Hermanos.,,1100.0,27.5,30250.0,2143422.79999999,Bulk Rice,Armando Carpio - 017,WHOLESALER MANUFACTURY,1382621,Feb
2024-02-20,Family and Son,Invoice,008-02659,Arroz a Granel:Parboiled 50 LB -Bolsa Dos Hermanos.,,1100.0,27.5,30250.0,2173672.79999999,Bulk Rice,Armando Carpio - 017,WHOLESALER MANUFACTURY,1382622,Feb
2024-02-20,Sedanos Supermarkets #32,Credit Memo,008-02715,Varios:Promotional Allowance,"Rice Snack:Rice Snack, Pizza DH",-1.0,19.9,-19.9,2173652.89999999,Puffed Products,Lisset Limpio -020,RETAIL SEDANOS,1382623,Feb
2024-02-23,El Palacio de los jugos / Lita Foods Inc.,Invoice,008-02660,Arroz a Granel:Parboiled 50 LB -Bolsa Dos Hermanos.,,8.0,27.75,222.0,2173874.89999999,Bulk Rice,Lisset Limpio -020,Cafeteria,1382624,Feb
2024-02-23,El Palacio de los jugos /  EMMA FOOD CORP,Invoice,008-02661,Arroz a Granel:Parboiled 50 LB -Bolsa Dos Hermanos.,,8.0,27.75,222.0,2174096.89999999,Bulk Rice,Lisset Limpio -020,Cafeteria,1382625,Feb
2024-02-23,Los Caringas Latin America  Foods,Invoice,008-02662,Arroz a Granel:Parboiled 50 LB -Bolsa Dos Hermanos.,,4.0,27.75,111.0,2174207.89999999,Bulk Rice,Lisset Limpio -020,CAFETERIA y RESTAURANTS,1382626,Feb
2024-02-23,Los Caringas Latin America  Foods,Invoice,008-02662,Arroz a Granel:Largo Fino 50 LB -Bolsa Dos Hermanos.,,3.0,26.0,78.0,2174285.89999999,Bulk Rice,Lisset Limpio -020,CAFETERIA y RESTAURANTS,1382627,Feb
2024-02-23,El Palacio de los jugos / Caribe Tropical,Invoice,008-02663,Arroz a Granel:Largo Fino 50 LB -Bolsa Dos Hermanos.,,5.0,26.0,130.0,2174415.89999999,Bulk Rice,Lisset Limpio -020,Cafeteria,1382628,Feb
2024-02-23,El Palacio de los jugos / Caribe Tropical,Invoice,008-02663,Arroz a Granel:Parboiled 50 LB -Bolsa Dos Hermanos.,,8.0,27.75,222.0,2174637.89999999,Bulk Rice,Lisset Limpio -020,Cafeteria,1382629,Feb
2024-02-23,Los Mejores Tamales de Miami,Invoice,008-02664,Arroz a Granel:Largo Fino 50 LB -Bolsa Dos Hermanos.,,5.0,26.0,130.0,2174767.89999999,Bulk Rice,Lisset Limpio -020,CAFETERIA y RESTAURANTS,1382630,Feb
2024-02-23,Los Mejores Tamales de Miami,Invoice,008-02664,Arroz a Granel:Parboiled 50 LB -Bolsa Dos Hermanos.,,5.0,27.75,138.75,2174906.64999999,Bulk Rice,Lisset Limpio -020,CAFETERIA y RESTAURANTS,1382631,Feb
2024-02-23,Max Food Distributors,Invoice,008-02665,Arroz a Granel:Parboiled 50 LB -Bolsa Dos Hermanos.,,25.0,25.5,637.5,2175544.14999999,Bulk Rice,Lisset Limpio -020,WHOLESALER,1382632,Feb
2024-02-23,Soriano Brothers PB,Invoice,008-02666,Arroz a Granel:Parboiled 50 LB -Bolsa Dos Hermanos.,,10.0,27.75,277.5,2175821.64999999,Bulk Rice,Lisset Limpio -020,CAFETERIA y RESTAURANTS,1382633,Feb
2024-02-23,Soriano Brothers PB,Invoice,008-02666,Spices:AS Sazon (for all),1 / 30 lb (box or pail),1.0,59.0,59.0,2175880.64999999,American Spice,Lisset Limpio -020,CAFETERIA y RESTAURANTS,1382634,Feb
2024-02-23,Soriano Brothers PB,Invoice,008-02666,Dry Beans:Dry Beans - Black Beans 50,Dry Black Beans 50 lb,2.0,41.5,83.0,2175963.64999999,Dry Beans,Lisset Limpio -020,CAFETERIA y RESTAURANTS,1382635,Feb
2024-02-23,El Palacio de los jugos /  Nanos Latin Foods,Invoice,008-02667,Arroz a Granel:Parboiled 50 LB -Bolsa Dos Hermanos.,,12.0,27.75,333.0,2176296.64999999,Bulk Rice,Lisset Limpio -020,Cafeteria,1382636,Feb
2024-02-26,El Palacio de los jugos /  EMMA FOOD CORP,Invoice,008-02668,Arroz a Granel:Parboiled 50 LB -Bolsa Dos Hermanos.,,7.0,27.75,194.25,2176490.89999999,Bulk Rice,Lisset Limpio -020,Cafeteria,1382637,Feb
2024-02-26,El Palacio de los jugos /  Mires Restaurants,Invoice,008-02669,Arroz a Granel:Parboiled 50 LB -Bolsa Dos Hermanos.,,4.0,27.75,111.0,2176601.89999999,Bulk Rice,Lisset Limpio -020,Cafeteria,1382638,Feb
2024-02-26,El Palacio de los jugos /  Mires Restaurants,Invoice,008-02669,Arroz a Granel:Largo Fino 50 LB -Bolsa Dos Hermanos.,,4.0,26.5,106.0,2176707.89999999,Bulk Rice,Lisset Limpio -020,Cafeteria,1382639,Feb
2024-02-26,El Palacio de los jugos /  Nanos Latin Foods,Invoice,008-02670,Arroz a Granel:Parboiled 50 LB -Bolsa Dos Hermanos.,,6.0,27.75,166.5,2176874.39999999,Bulk Rice,Lisset Limpio -020,Cafeteria,1382640,Feb
2024-02-26,El Palacio de los jugos / Caribe Tropical,Invoice,008-02671,Arroz a Granel:Parboiled 50 LB -Bolsa Dos Hermanos.,,10.0,27.75,277.5,2177151.89999999,Bulk Rice,Lisset Limpio -020,Cafeteria,1382641,Feb
2024-02-26,El Palacio de los jugos / Lita Foods Inc.,Invoice,008-02672,Arroz a Granel:Parboiled 50 LB -Bolsa Dos Hermanos.,,6.0,27.75,166.5,2177318.39999999,Bulk Rice,Lisset Limpio -020,Cafeteria,1382642,Feb
2024-02-26,"YummmyCo, Inc",Invoice,008-02673,Arroz a Granel:Parboiled 50 LB -Bolsa Dos Hermanos.,,55.0,27.5,1512.5,2178830.89999999,Bulk Rice,Armando Carpio - 017,WHOLESALER,1382643,Feb
2024-02-26,"American Spice Trading Co, Inc.",Invoice,008-02674,Arroz a Granel:Parboiled 50 LB -Bolsa Dos Hermanos.,,550.0,27.5,15125.0,2193955.89999999,Bulk Rice,Armando Carpio - 017,WHOLESALER MANUFACTURY,1382644,Feb
2024-02-27,Ideal Food Basket Davie Cafeteria,Invoice,008-02675,Arroz a Granel:Largo Fino 50 LB -Bolsa Dos Hermanos.,,10.0,26.5,265.0,2194220.89999999,Bulk Rice,Armando Carpio - 017,CAFETERIA y RESTAURANTS,1382645,Feb
2024-02-27,La Ranchera Meat Market #3,Invoice,008-02676,Arroz a Granel:Largo Fino 50 LB -Bolsa Dos Hermanos.,,10.0,26.5,265.0,2194485.89999999,Bulk Rice,Armando Carpio - 017,CAFETERIA y RESTAURANTS,1382646,Feb
2024-02-27,Sedanos Supermarkets #38,Invoice,008-02677,Arroz a Granel:Largo Fino 50 LB -Bolsa Dos Hermanos.,,4.0,26.5,106.0,2194591.89999999,Bulk Rice,Lisset Limpio -020,RETAIL SEDANOS,1382647,Feb
2024-02-27,Sedanos Supermarkets #38,Invoice,008-02677,Dry Beans:Dry Beans - Black Beans 50,Dry Black Beans 50 lb,4.0,41.5,166.0,2194757.89999999,Dry Beans,Lisset Limpio -020,RETAIL SEDANOS,1382648,Feb
2024-02-27,Sedanos Supermarkets #38,Invoice,008-02677,,Discount,,,-5.44,2194752.45999999,,Lisset Limpio -020,RETAIL SEDANOS,1382649,Feb
2024-02-27,BRAVO - Port St Lucie,Invoice,008-02678,Arroz Envasado:Parboiled 5KG Dos Hermanos.,6 / 11lbs,10.0,45.6,456.0,2195208.45999999,Branded Rice,Ruta - 019,RETAIL  DSD,1382650,Feb
2024-02-27,BRAVO - Port St Lucie,Invoice,008-02678,Arroz Envasado:Parboiled 5KG Dos Hermanos.,6 / 11lbs,3.0,45.6,136.8,2195345.25999999,Branded Rice,Ruta - 019,RETAIL  DSD,1382651,Feb
2024-02-27,Sedanos Supermarkets #16,Invoice,008-02679,Arroz Envasado:Parboiled 5KG Dos Hermanos.,6 / 11lbs,20.0,40.5,810.0,2196155.25999999,Branded Rice,Lisset Limpio -020,RETAIL SEDANOS,1382652,Feb
2024-02-27,Sedanos Supermarkets #16,Invoice,008-02679,Rice Snack:Rice Snack Ham Flavored DOS HERMANOS,,1.0,19.9,19.9,2196175.15999999,Puffed Products,Lisset Limpio -020,RETAIL SEDANOS,1382653,Feb
2024-02-27,Sedanos Supermarkets #16,Invoice,008-02679,Rice Snack:Rice Snack Salami Flavored DOS HERMANOS,,2.0,19.9,39.8,2196214.95999999,Puffed Products,Lisset Limpio -020,RETAIL SEDANOS,1382654,Feb
2024-02-27,Sedanos Supermarkets #16,Invoice,008-02679,"Rice Snack:Rice Snack, Pizza DH",,1.0,19.9,19.9,2196234.85999999,Puffed Products,Lisset Limpio -020,RETAIL SEDANOS,1382655,Feb
2024-02-27,Sedanos Supermarkets #16,Invoice,008-02679,Arroz Envasado:Parboiled 5KG Dos Hermanos.,6 / 11lbs,20.0,0.0,0.0,2196234.85999999,Branded Rice,Lisset Limpio -020,RETAIL SEDANOS,1382656,Feb
2024-02-27,Sedanos Supermarkets #16,Invoice,008-02679,,Discount,,,-17.79,2196217.06999999,,Lisset Limpio -020,RETAIL SEDANOS,1382657,Feb
2024-02-27,BRAVO - Port St Lucie,Credit Memo,008-02717,Varios:Promotional Allowance,Arroz Envasado:Parboiled 5KG Dos Hermanos.,-3.0,45.6,-136.8,2196080.26999999,Branded Rice,Ruta - 019,RETAIL  DSD,1382658,Feb
2024-02-29,Soriano Brothers PB,Invoice,008-02680,Arroz a Granel:Parboiled 50 LB -Bolsa Dos Hermanos.,,5.0,27.75,138.75,2196219.01999999,Bulk Rice,Lisset Limpio -020,CAFETERIA y RESTAURANTS,1382659,Feb
2024-02-29,Soriano Brothers PB,Invoice,008-02680,Spices:AS Sazon (for all),1 / 30 lb (box or pail),1.0,59.0,59.0,2196278.01999999,American Spice,Lisset Limpio -020,CAFETERIA y RESTAURANTS,1382660,Feb
2024-02-29,Sedanos Supermarkets #38,Invoice,008-02681,Arroz Envasado:Parboiled 5KG Dos Hermanos.,6 / 11lbs,20.0,40.5,810.0,2197088.01999999,Branded Rice,Lisset Limpio -020,RETAIL SEDANOS,1382661,Feb
2024-02-29,Sedanos Supermarkets #38,Invoice,008-02681,Arroz Envasado:Parboiled 5KG Dos Hermanos.,6 / 11lbs,20.0,0.0,0.0,2197088.01999999,Branded Rice,Lisset Limpio -020,RETAIL SEDANOS,1382662,Feb
2024-02-29,Sedanos Supermarkets #38,Invoice,008-02681,,Discount,,,-16.2,2197071.81999999,,Lisset Limpio -020,RETAIL SEDANOS,1382663,Feb
2024-02-29,El Palacio de los jugos / Lita Foods Inc.,Invoice,008-02682,Arroz a Granel:Parboiled 50 LB -Bolsa Dos Hermanos.,,8.0,27.75,222.0,2197293.81999999,Bulk Rice,Lisset Limpio -020,Cafeteria,1382664,Feb
2024-02-29,El Palacio de los jugos /  EMMA FOOD CORP,Invoice,008-02683,Arroz a Granel:Parboiled 50 LB -Bolsa Dos Hermanos.,,8.0,27.75,222.0,2197515.81999999,Bulk Rice,Lisset Limpio -020,Cafeteria,1382665,Feb
2024-02-29,Hings Chinese,Invoice,008-02684,Arroz a Granel:Parboiled 50 LB -Bolsa Dos Hermanos.,,5.0,27.75,138.75,2197654.56999999,Bulk Rice,Lisset Limpio -020,CAFETERIA y RESTAURANTS,1382666,Feb
2024-02-29,Sedanos Supermarkets  #37,Invoice,008-02685,"Rice Snack:Rice Snack, Pizza DH",,1.0,19.9,19.9,2197674.46999999,Puffed Products,Lisset Limpio -020,RETAIL SEDANOS,1382667,Feb
2024-02-29,Sedanos Supermarkets  #37,Invoice,008-02685,Rice Snack:Rice Snack Salami Flavored DOS HERMANOS,,2.0,19.9,39.8,2197714.26999999,Puffed Products,Lisset Limpio -020,RETAIL SEDANOS,1382668,Feb
2024-02-29,Sedanos Supermarkets  #37,Invoice,008-02685,Rice Snack:Rice Snack Ham Flavored DOS HERMANOS,,1.0,19.9,19.9,2197734.16999999,Puffed Products,Lisset Limpio -020,RETAIL SEDANOS,1382669,Feb
2024-02-29,Sedanos Supermarkets  #37,Invoice,008-02685,,Discount,,,-1.19,2197732.97999999,,Lisset Limpio -020,RETAIL SEDANOS,1382670,Feb
2024-02-29,Sedanos Supermarkets #14,Invoice,008-02686,"Rice Snack:Rice Snack, Pizza DH",,1.0,19.9,19.9,2197752.87999999,Puffed Products,Lisset Limpio -020,RETAIL SEDANOS,1382671,Feb
2024-02-29,Sedanos Supermarkets #14,Invoice,008-02686,Rice Snack:Rice Snack Salami Flavored DOS HERMANOS,,2.0,19.9,39.8,2197792.67999999,Puffed Products,Lisset Limpio -020,RETAIL SEDANOS,1382672,Feb
2024-02-29,Sedanos Supermarkets #14,Invoice,008-02686,Rice Snack:Rice Snack Ham Flavored DOS HERMANOS,,1.0,19.9,19.9,2197812.57999999,Puffed Products,Lisset Limpio -020,RETAIL SEDANOS,1382673,Feb
2024-02-29,Sedanos Supermarkets #14,Invoice,008-02686,,Discount,,,-1.19,2197811.38999999,,Lisset Limpio -020,RETAIL SEDANOS,1382674,Feb
2024-02-29,El Palacio de los jugos / Caribe Tropical,Invoice,008-02687,Arroz a Granel:Parboiled 50 LB -Bolsa Dos Hermanos.,,8.0,27.75,222.0,2198033.38999999,Bulk Rice,Lisset Limpio -020,Cafeteria,1382675,Feb
2024-02-29,Albert Deli #2,Invoice,008-02688,Arroz a Granel:Largo Fino 50 LB -Bolsa Dos Hermanos.,,5.0,26.5,132.5,2198165.88999999,Bulk Rice,Lisset Limpio -020,CAFETERIA y RESTAURANTS,1382676,Feb
2024-02-29,Albert Deli #2,Invoice,008-02688,Arroz a Granel:Parboiled 50 LB -Bolsa Dos Hermanos.,,5.0,27.75,138.75,2198304.63999999,Bulk Rice,Lisset Limpio -020,CAFETERIA y RESTAURANTS,1382677,Feb
2024-02-29,Fritanga Momotombo,Invoice,008-02689,Arroz a Granel:Largo Fino 50 LB -Bolsa Dos Hermanos.,,5.0,26.5,132.5,2198437.13999999,Bulk Rice,Lisset Limpio -020,CAFETERIA y RESTAURANTS,1382678,Feb
2024-02-29,Pacifico Chinese Restaurant,Invoice,008-02690,Arroz a Granel:Parboiled 50 LB -Bolsa Dos Hermanos.,,10.0,27.5,275.0,2198712.13999999,Bulk Rice,Lisset Limpio -020,CAFETERIA y RESTAURANTS,1382679,Feb
2024-02-29,Los paraditos chinesse,Invoice,008-02691,Arroz a Granel:Largo Fino 50 LB -Bolsa Dos Hermanos.,,10.0,26.5,265.0,2198977.13999999,Bulk Rice,Lisset Limpio -020,CAFETERIA y RESTAURANTS,1382680,Feb
2024-02-29,Los paraditos chinesse,Invoice,008-02691,Arroz a Granel:Parboiled 50 LB -Bolsa Dos Hermanos.,,10.0,27.75,277.5,2199254.63999999,Bulk Rice,Lisset Limpio -020,CAFETERIA y RESTAURANTS,1382681,Feb
2024-02-29,Sedanos Supermarkets  #37,Credit Memo,008-02718,Varios:Promotional Allowance,Rice Snack:Rice Snack Ham Flavored DOS HERMANOS,-1.0,19.9,-19.9,2199234.73999999,Puffed Products,Lisset Limpio -020,RETAIL SEDANOS,1382682,Feb
2024-02-29,Sedanos Supermarkets #14,Credit Memo,008-02719,Varios:Promotional Allowance,Rice Snack:Rice Snack Ham Flavored DOS HERMANOS,-1.0,19.9,-19.9,2199214.83999999,Puffed Products,Lisset Limpio -020,RETAIL SEDANOS,1382683,Feb
2024-02-29,Sedanos,Invoice,008-02720,Arroz Envasado:Parboiled 5KG Dos Hermanos.,6 / 11lbs,25.0,40.5,1012.5,2200227.33999999,Branded Rice,Lisset Limpio -020,RETAIL SEDANOS,1382684,Feb
2024-02-29,Sedanos,Credit Memo,008-02721,Varios:Promotional Allowance,Arroz Envasado:Parboiled 5KG Dos Hermanos.,-25.0,40.5,-1012.5,2199214.83999999,Branded Rice,Lisset Limpio -020,RETAIL SEDANOS,1382685,Feb
2024-03-01,El Palacio de los jugos /  Nanos Latin Foods,Invoice,008-02692,Arroz a Granel:Parboiled 50 LB -Bolsa Dos Hermanos.,,10.0,27.75,277.5,2199492.33999999,Bulk Rice,Lisset Limpio -020,Cafeteria,1382686,Mar
2024-03-03,Soriano Brothers PB,Invoice,008-02693,Arroz a Granel:Largo Fino 50 LB -Bolsa Dos Hermanos.,,5.0,26.5,132.5,2199624.83999999,Bulk Rice,Lisset Limpio -020,CAFETERIA y RESTAURANTS,1382687,Mar
2024-03-03,Soriano Brothers PB,Invoice,008-02693,Arroz a Granel:Parboiled 50 LB -Bolsa Dos Hermanos.,,5.0,27.75,138.75,2199763.58999999,Bulk Rice,Lisset Limpio -020,CAFETERIA y RESTAURANTS,1382688,Mar
2024-03-03,Soriano Brothers PB,Invoice,008-02693,Dry Beans:Dry Beans - Black Beans 50,Dry Black Beans 50 lb,2.0,41.5,83.0,2199846.58999999,Dry Beans,Lisset Limpio -020,CAFETERIA y RESTAURANTS,1382689,Mar
2024-03-03,Soriano Brothers PB,Invoice,008-02693,Spices:AS Sazon (for all),1 / 30 lb (box or pail),1.0,59.0,59.0,2199905.58999999,American Spice,Lisset Limpio -020,CAFETERIA y RESTAURANTS,1382690,Mar
2024-03-03,Hings Chinese,Invoice,008-02694,Arroz a Granel:Parboiled 50 LB -Bolsa Dos Hermanos.,,5.0,27.75,138.75,2200044.33999999,Bulk Rice,Lisset Limpio -020,CAFETERIA y RESTAURANTS,1382691,Mar
2024-03-03,El Palacio de los jugos /  Mires Restaurants,Invoice,008-02695,Arroz a Granel:Largo Fino 50 LB -Bolsa Dos Hermanos.,,4.0,26.5,106.0,2200150.33999999,Bulk Rice,Lisset Limpio -020,Cafeteria,1382692,Mar
2024-03-03,El Palacio de los jugos /  Mires Restaurants,Invoice,008-02695,Arroz a Granel:Parboiled 50 LB -Bolsa Dos Hermanos.,,6.0,27.75,166.5,2200316.83999999,Bulk Rice,Lisset Limpio -020,Cafeteria,1382693,Mar
2024-03-03,El Palacio de los jugos /  EMMA FOOD CORP,Invoice,008-02696,Arroz a Granel:Parboiled 50 LB -Bolsa Dos Hermanos.,,8.0,27.75,222.0,2200538.83999999,Bulk Rice,Lisset Limpio -020,Cafeteria,1382694,Mar
2024-03-03,El Palacio de los jugos /  EMMA FOOD CORP,Invoice,008-02696,Arroz a Granel:Largo Fino 50 LB -Bolsa Dos Hermanos.,,8.0,26.5,212.0,2200750.83999999,Bulk Rice,Lisset Limpio -020,Cafeteria,1382695,Mar
2024-03-03,El Palacio de los jugos / Lita Foods Inc.,Invoice,008-02697,Arroz a Granel:Parboiled 50 LB -Bolsa Dos Hermanos.,,10.0,27.75,277.5,2201028.33999999,Bulk Rice,Lisset Limpio -020,Cafeteria,1382696,Mar
2024-03-03,El Palacio de los jugos / Caribe Tropical,Invoice,008-02698,Arroz a Granel:Parboiled 50 LB -Bolsa Dos Hermanos.,,8.0,27.75,222.0,2201250.33999999,Bulk Rice,Lisset Limpio -020,Cafeteria,1382697,Mar
2024-03-03,El Palacio de los jugos /  Nanos Latin Foods,Invoice,008-02699,Arroz a Granel:Parboiled 50 LB -Bolsa Dos Hermanos.,,15.0,27.75,416.25,2201666.58999999,Bulk Rice,Lisset Limpio -020,Cafeteria,1382698,Mar
2024-03-03,Sedanos Supermarkets #33,Invoice,008-02700,"Rice Snack:Rice Snack, Pizza DH",,1.0,19.9,19.9,2201686.48999999,Puffed Products,Lisset Limpio -020,RETAIL SEDANOS,1382699,Mar
2024-03-03,Sedanos Supermarkets #33,Invoice,008-02700,Rice Snack:Rice Snack Salami Flavored DOS HERMANOS,,2.0,19.9,39.8,2201726.28999999,Puffed Products,Lisset Limpio -020,RETAIL SEDANOS,1382700,Mar
2024-03-03,Sedanos Supermarkets #33,Invoice,008-02700,,Discount,,,-1.19,2201725.09999999,,Lisset Limpio -020,RETAIL SEDANOS,1382701,Mar
2024-03-04,El Gallego Supermarket,Invoice,008-02701,Arroz a Granel:Parboiled 50 LB -Bolsa Dos Hermanos.,,5.0,27.75,138.75,2201863.84999999,Bulk Rice,Lisset Limpio -020,RETAIL  DSD,1382702,Mar
2024-03-04,El Gallego Supermarket,Invoice,008-02701,Dry Beans:Dry Beans - Black Beans 50,Dry Black Beans 50 lb,2.0,41.5,83.0,2201946.84999999,Dry Beans,Lisset Limpio -020,RETAIL  DSD,1382703,Mar
2024-03-05,Aries Supermarket & Cafeteria,Invoice,008-02702,Arroz a Granel:Parboiled 50 LB -Bolsa Dos Hermanos.,,10.0,28.8,288.0,2202234.84999999,Bulk Rice,Armando Carpio - 017,CAFETERIA y RESTAURANTS,1382704,Mar
2024-03-05,Brito Family Corp.,Invoice,008-02703,Arroz a Granel:Parboiled 50 LB -Bolsa Dos Hermanos.,,110.0,27.75,3052.5,2205287.34999999,Bulk Rice,Lisset Limpio -020,CAFETERIA y RESTAURANTS,1382705,Mar
2024-03-05,Ideal Food Basket Davie Cafeteria,Invoice,008-02704,Arroz a Granel:Largo Fino 50 LB -Bolsa Dos Hermanos.,,10.0,26.5,265.0,2205552.34999999,Bulk Rice,Lisset Limpio -020,CAFETERIA y RESTAURANTS,1382706,Mar
2024-03-07,El Palacio de los jugos / Lita Foods Inc.,Invoice,008-02705,Arroz a Granel:Parboiled 50 LB -Bolsa Dos Hermanos.,,10.0,27.75,277.5,2205829.84999999,Bulk Rice,Lisset Limpio -020,Cafeteria,1382707,Mar
2024-03-07,El Palacio de los jugos /  EMMA FOOD CORP,Invoice,008-02706,Arroz a Granel:Largo Fino 50 LB -Bolsa Dos Hermanos.,,5.0,26.5,132.5,2205962.34999999,Bulk Rice,Lisset Limpio -020,Cafeteria,1382708,Mar
2024-03-07,El Palacio de los jugos /  EMMA FOOD CORP,Invoice,008-02706,Arroz a Granel:Parboiled 50 LB -Bolsa Dos Hermanos.,,6.0,27.75,166.5,2206128.84999999,Bulk Rice,Lisset Limpio -020,Cafeteria,1382709,Mar
2024-03-07,El Palacio de los jugos /  Nanos Latin Foods,Invoice,008-02707,Arroz a Granel:Parboiled 50 LB -Bolsa Dos Hermanos.,,12.0,27.75,333.0,2206461.84999999,Bulk Rice,Lisset Limpio -020,Cafeteria,1382710,Mar
2024-03-07,Los Caringas Latin America  Foods,Invoice,008-02708,Arroz a Granel:Largo Fino 50 LB -Bolsa Dos Hermanos.,,3.0,26.5,79.5,2206541.34999999,Bulk Rice,Lisset Limpio -020,CAFETERIA y RESTAURANTS,1382711,Mar
2024-03-07,Los Caringas Latin America  Foods,Invoice,008-02708,Arroz a Granel:Parboiled 50 LB -Bolsa Dos Hermanos.,,3.0,27.75,83.25,2206624.59999999,Bulk Rice,Lisset Limpio -020,CAFETERIA y RESTAURANTS,1382712,Mar
2024-03-07,Los Caringas Latin America  Foods,Invoice,008-02708,,Discount,,,-0.6,2206623.99999999,,Lisset Limpio -020,CAFETERIA y RESTAURANTS,1382713,Mar
2024-03-07,Bravo   Francisco Diaz,Invoice,008-02709,Arroz a Granel:Largo Fino 50 LB -Bolsa Dos Hermanos.,,4.0,26.5,106.0,2206729.99999999,Bulk Rice,Lisset Limpio -020,RETAIL  DSD,1382714,Mar
2024-03-07,Soriano Brothers PB,Invoice,008-02710,Arroz a Granel:Largo Fino 50 LB -Bolsa Dos Hermanos.,,5.0,26.5,132.5,2206862.49999999,Bulk Rice,Lisset Limpio -020,CAFETERIA y RESTAURANTS,1382715,Mar
2024-03-07,Soriano Brothers PB,Invoice,008-02710,Arroz a Granel:Parboiled 50 LB -Bolsa Dos Hermanos.,,3.0,27.75,83.25,2206945.74999999,Bulk Rice,Lisset Limpio -020,CAFETERIA y RESTAURANTS,1382716,Mar
2024-03-07,El Palacio de los jugos / Caribe Tropical,Invoice,008-02711,Arroz a Granel:Parboiled 50 LB -Bolsa Dos Hermanos.,,10.0,27.75,277.5,2207223.24999999,Bulk Rice,Lisset Limpio -020,Cafeteria,1382717,Mar
2024-03-07,"El Toro Loco Meat Distribution, LLC",Invoice,008-02712,Dry Beans:Dry Beans - Black Beans 50,Dry Black Beans 50 lb,6.0,41.5,249.0,2207472.24999999,Dry Beans,Lisset Limpio -020,CAFETERIA y RESTAURANTS,1382718,Mar
2024-03-07,"El Toro Loco Meat Distribution, LLC",Invoice,008-02712,Arroz a Granel:Largo Fino 50 LB -Bolsa Dos Hermanos.,,55.0,26.5,1457.5,2208929.74999999,Bulk Rice,Lisset Limpio -020,CAFETERIA y RESTAURANTS,1382719,Mar
2024-03-07,Price Choice Food Market # 6,Invoice,008-02713,Arroz a Granel:Largo Fino 50 LB -Bolsa Dos Hermanos.,,0.0,,0.0,2208929.74999999,Bulk Rice,Lisset Limpio -020,RETAIL  DSD,1382720,Mar
2024-03-11,El Palacio de los jugos / Caribe Tropical,Invoice,008-02722,Arroz a Granel:Parboiled 50 LB -Bolsa Dos Hermanos.,,8.0,27.75,222.0,2209151.74999999,Bulk Rice,Lisset Limpio -020,Cafeteria,1382721,Mar
2024-03-11,El Palacio de los jugos /  Mires Restaurants,Invoice,008-02723,Arroz a Granel:Largo Fino 50 LB -Bolsa Dos Hermanos.,,8.0,26.5,212.0,2209363.74999999,Bulk Rice,Lisset Limpio -020,Cafeteria,1382722,Mar
2024-03-11,El Palacio de los jugos /  Mires Restaurants,Invoice,008-02723,Arroz a Granel:Parboiled 50 LB -Bolsa Dos Hermanos.,,8.0,27.75,222.0,2209585.74999999,Bulk Rice,Lisset Limpio -020,Cafeteria,1382723,Mar
2024-03-11,El Palacio de los jugos / Lita Foods Inc.,Invoice,008-02724,Arroz a Granel:Parboiled 50 LB -Bolsa Dos Hermanos.,,10.0,27.75,277.5,2209863.24999999,Bulk Rice,Lisset Limpio -020,Cafeteria,1382724,Mar
2024-03-11,El Palacio de los jugos /  EMMA FOOD CORP,Invoice,008-02725,Arroz a Granel:Largo Fino 50 LB -Bolsa Dos Hermanos.,,6.0,26.5,159.0,2210022.24999999,Bulk Rice,Lisset Limpio -020,Cafeteria,1382725,Mar
2024-03-11,El Palacio de los jugos /  EMMA FOOD CORP,Invoice,008-02725,Arroz a Granel:Parboiled 50 LB -Bolsa Dos Hermanos.,,9.0,27.75,249.75,2210271.99999999,Bulk Rice,Lisset Limpio -020,Cafeteria,1382726,Mar
2024-03-11,El Palacio de los jugos /  Nanos Latin Foods,Invoice,008-02726,Arroz a Granel:Parboiled 50 LB -Bolsa Dos Hermanos.,,5.0,27.75,138.75,2210410.74999999,Bulk Rice,Lisset Limpio -020,Cafeteria,1382727,Mar
2024-03-11,El Palacio de los jugos /  Nanos Latin Foods,Invoice,008-02726,Arroz a Granel:Largo Fino 50 LB -Bolsa Dos Hermanos.,,5.0,26.5,132.5,2210543.24999999,Bulk Rice,Lisset Limpio -020,Cafeteria,1382728,Mar
2024-03-11,Hings Chinese,Invoice,008-02727,Arroz a Granel:Parboiled 50 LB -Bolsa Dos Hermanos.,,6.0,27.75,166.5,2210709.74999999,Bulk Rice,Lisset Limpio -020,CAFETERIA y RESTAURANTS,1382729,Mar
2024-03-14,Ideal Food Basket Davie Cafeteria,Invoice,008-02728,Arroz a Granel:Largo Fino 50 LB -Bolsa Dos Hermanos.,,8.0,26.5,212.0,2210921.74999999,Bulk Rice,Armando Carpio - 017,CAFETERIA y RESTAURANTS,1382730,Mar
2024-03-14,Los paraditos chinesse,Invoice,008-02729,Arroz a Granel:Largo Fino 50 LB -Bolsa Dos Hermanos.,,10.0,26.5,265.0,2211186.74999999,Bulk Rice,Lisset Limpio -020,CAFETERIA y RESTAURANTS,1382731,Mar
2024-03-14,Los paraditos chinesse,Invoice,008-02729,Arroz a Granel:Parboiled 50 LB -Bolsa Dos Hermanos.,,5.0,27.75,138.75,2211325.49999999,Bulk Rice,Lisset Limpio -020,CAFETERIA y RESTAURANTS,1382732,Mar
2024-03-14,Sedanos Supermarkets #17,Invoice,008-02730,Rice Snack:Rice Snack Ham Flavored DOS HERMANOS,,2.0,19.9,39.8,2211365.29999999,Puffed Products,Lisset Limpio -020,RETAIL SEDANOS,1382733,Mar
2024-03-14,Sedanos Supermarkets #17,Invoice,008-02730,Rice Snack:Rice Snack Salami Flavored DOS HERMANOS,,1.0,19.9,19.9,2211385.19999999,Puffed Products,Lisset Limpio -020,RETAIL SEDANOS,1382734,Mar
2024-03-14,Sedanos Supermarkets #17,Invoice,008-02730,"Rice Snack:Rice Snack, Pizza DH",,1.0,19.9,19.9,2211405.09999999,Puffed Products,Lisset Limpio -020,RETAIL SEDANOS,1382735,Mar
2024-03-14,Sedanos Supermarkets #17,Invoice,008-02730,,Discount,,,-1.19,2211403.90999999,,Lisset Limpio -020,RETAIL SEDANOS,1382736,Mar
2024-03-14,Key Foods  / Ivan,Invoice,008-02731,Arroz a Granel:Parboiled 50 LB -Bolsa Dos Hermanos.,,25.0,27.75,693.75,2212097.65999999,Bulk Rice,Lisset Limpio -020,RETAIL  DSD,1382737,Mar
2024-03-14,"Soriano Brothers Diaz Food Service,Inc",Invoice,008-02732,Dry Beans:Dry Beans - Black Beans 50,Dry Black Beans 50 lb,8.0,41.5,332.0,2212429.65999999,Dry Beans,Lisset Limpio -020,CAFETERIA y RESTAURANTS,1382738,Mar
2024-03-14,"Soriano Brothers Diaz Food Service,Inc",Invoice,008-02732,Arroz a Granel:Parboiled 50 LB -Bolsa Dos Hermanos.,,8.0,27.75,222.0,2212651.65999999,Bulk Rice,Lisset Limpio -020,CAFETERIA y RESTAURANTS,1382739,Mar
2024-03-14,Sedanos Supermarkets #38,Invoice,008-02733,Arroz a Granel:Largo Fino 50 LB -Bolsa Dos Hermanos.,,4.0,26.5,106.0,2212757.65999999,Bulk Rice,Lisset Limpio -020,RETAIL SEDANOS,1382740,Mar
2024-03-14,Sedanos Supermarkets #38,Invoice,008-02733,,Discount,,,-2.12,2212755.53999999,,Lisset Limpio -020,RETAIL SEDANOS,1382741,Mar
2024-03-14,Sedanos Supermarkets #18,Invoice,008-02734,Arroz Envasado:Parboiled 5KG Dos Hermanos.,6 / 11lbs,10.0,40.5,405.0,2213160.53999999,Branded Rice,Lisset Limpio -020,RETAIL SEDANOS,1382742,Mar
2024-03-14,Sedanos Supermarkets #18,Invoice,008-02734,Arroz Envasado:Parboiled 5KG Dos Hermanos.,6 / 11lbs,10.0,40.5,405.0,2213565.53999999,Branded Rice,Lisset Limpio -020,RETAIL SEDANOS,1382743,Mar
2024-03-14,Sedanos Supermarkets #18,Invoice,008-02734,,Discount,,,-8.1,2213557.43999999,,Lisset Limpio -020,RETAIL SEDANOS,1382744,Mar
2024-03-15,El Palacio de los jugos /  EMMA FOOD CORP,Invoice,008-02735,,,,,0.0,2213557.43999999,,Lisset Limpio -020,Cafeteria,1382745,Mar
2024-03-15,El Palacio de los jugos /  EMMA FOOD CORP,Invoice,008-02735,Arroz a Granel:Parboiled 50 LB -Bolsa Dos Hermanos.,,7.0,27.75,194.25,2213751.68999999,Bulk Rice,Lisset Limpio -020,Cafeteria,1382746,Mar
2024-03-15,Bravo   Francisco Diaz,Invoice,008-02736,Liquids:AS Marinating Sauce (Mojo),,3.0,18.5,55.5,2213807.18999999,American Spice,Lisset Limpio -020,RETAIL  DSD,1382747,Mar
2024-03-15,Bravo   Francisco Diaz,Invoice,008-02736,Liquids:AS Cooking Wine,4/1 Gl.,4.0,17.5,70.0,2213877.18999999,American Spice,Lisset Limpio -020,RETAIL  DSD,1382748,Mar
2024-03-15,Bravo   Francisco Diaz,Invoice,008-02736,Arroz a Granel:Largo Fino 50 LB -Bolsa Dos Hermanos.,,2.0,26.5,53.0,2213930.18999999,Bulk Rice,Lisset Limpio -020,RETAIL  DSD,1382749,Mar
2024-03-15,Sedanos Supermarkets #20,Invoice,008-02737,"Rice Snack:Rice Snack, Pizza DH",,1.0,19.9,19.9,2213950.08999999,Puffed Products,Lisset Limpio -020,RETAIL SEDANOS,1382750,Mar
2024-03-15,Sedanos Supermarkets #20,Invoice,008-02737,Rice Snack:Rice Snack Salami Flavored DOS HERMANOS,,1.0,19.9,19.9,2213969.98999999,Puffed Products,Lisset Limpio -020,RETAIL SEDANOS,1382751,Mar
2024-03-15,Sedanos Supermarkets #20,Invoice,008-02737,Rice Snack:Rice Snack Ham Flavored DOS HERMANOS,,2.0,19.9,39.8,2214009.78999999,Puffed Products,Lisset Limpio -020,RETAIL SEDANOS,1382752,Mar
2024-03-15,Sedanos Supermarkets #20,Invoice,008-02737,,Discount,,,-1.47,2214008.31999999,,Lisset Limpio -020,RETAIL SEDANOS,1382753,Mar
2024-03-15,El Palacio de los jugos /  Nanos Latin Foods,Invoice,008-02738,,,,,0.0,2214008.31999999,,Lisset Limpio -020,Cafeteria,1382754,Mar
2024-03-15,El Palacio de los jugos /  Nanos Latin Foods,Invoice,008-02738,Arroz a Granel:Parboiled 50 LB -Bolsa Dos Hermanos.,,10.0,27.75,277.5,2214285.81999999,Bulk Rice,Lisset Limpio -020,Cafeteria,1382755,Mar
2024-03-15,El Palacio de los jugos / Lita Foods Inc.,Invoice,008-02739,Arroz a Granel:Parboiled 50 LB -Bolsa Dos Hermanos.,,10.0,27.75,277.5,2214563.31999999,Bulk Rice,Lisset Limpio -020,Cafeteria,1382756,Mar
2024-03-15,El Palacio de los jugos / Caribe Tropical,Invoice,008-02740,Arroz a Granel:Parboiled 50 LB -Bolsa Dos Hermanos.,,5.0,27.75,138.75,2214702.06999999,Bulk Rice,Lisset Limpio -020,Cafeteria,1382757,Mar
2024-03-15,Los Mejores Tamales de Miami,Invoice,008-02741,Arroz a Granel:Parboiled 50 LB -Bolsa Dos Hermanos.,,5.0,27.75,138.75,2214840.81999999,Bulk Rice,Lisset Limpio -020,CAFETERIA y RESTAURANTS,1382758,Mar
2024-03-15,Soriano Brothers PB,Invoice,008-02742,,,,,0.0,2214840.81999999,,Lisset Limpio -020,CAFETERIA y RESTAURANTS,1382759,Mar
2024-03-15,Soriano Brothers PB,Invoice,008-02742,Arroz a Granel:Parboiled 50 LB -Bolsa Dos Hermanos.,,10.0,27.75,277.5,2215118.31999999,Bulk Rice,Lisset Limpio -020,CAFETERIA y RESTAURANTS,1382760,Mar
2024-03-18,Hings Chinese,Invoice,008-02743,Arroz a Granel:Parboiled 50 LB -Bolsa Dos Hermanos.,,6.0,27.75,166.5,2215284.81999999,Bulk Rice,Lisset Limpio -020,CAFETERIA y RESTAURANTS,1382761,Mar
2024-03-18,El Palacio de los jugos /  Nanos Latin Foods,Invoice,008-02745,Arroz a Granel:Parboiled 50 LB -Bolsa Dos Hermanos.,,10.0,27.75,277.5,2215562.31999999,Bulk Rice,Lisset Limpio -020,Cafeteria,1382762,Mar
2024-03-18,El Palacio de los jugos / Lita Foods Inc.,Invoice,008-02746,Arroz a Granel:Parboiled 50 LB -Bolsa Dos Hermanos.,,8.0,27.75,222.0,2215784.31999999,Bulk Rice,Lisset Limpio -020,Cafeteria,1382763,Mar
2024-03-18,El Palacio de los jugos /  EMMA FOOD CORP,Invoice,008-02747,Arroz a Granel:Parboiled 50 LB -Bolsa Dos Hermanos.,,8.0,27.75,222.0,2216006.31999999,Bulk Rice,Lisset Limpio -020,Cafeteria,1382764,Mar
2024-03-18,Family and Son,Invoice,008-02748,Arroz a Granel:Parboiled 50 LB -Bolsa Dos Hermanos.,,1100.0,27.25,29975.0,2245981.31999999,Bulk Rice,Armando Carpio - 017,WHOLESALER MANUFACTURY,1382765,Mar
2024-03-18,Aries Supermarket & Cafeteria,Invoice,008-02749,Arroz a Granel:Parboiled 50 LB -Bolsa Dos Hermanos.,,10.0,28.8,288.0,2246269.31999999,Bulk Rice,Armando Carpio - 017,CAFETERIA y RESTAURANTS,1382766,Mar
2024-03-19,Family and Son,Invoice,008-02750,Arroz a Granel:Parboiled 50 LB -Bolsa Dos Hermanos.,,1100.0,22.5,24750.0,2271019.31999999,Bulk Rice,Armando Carpio - 017,WHOLESALER MANUFACTURY,1382767,Mar
2024-03-19,"Meat Club Market, LLC.",Invoice,008-02751,Arroz Envasado:Sushi Rice Dos Hermanos 5kg.,,12.0,10.0,120.0,2271139.31999999,Branded Rice,Lisset Limpio -020,RETAIL  DSD,1382768,Mar
2024-03-19,Soriano Brothers PB,Invoice,008-02752,Arroz a Granel:Largo Fino 50 LB -Bolsa Dos Hermanos.,,10.0,27.25,272.5,2271411.81999999,Bulk Rice,Lisset Limpio -020,CAFETERIA y RESTAURANTS,1382769,Mar
2024-03-19,Soriano Brothers PB,Invoice,008-02752,Spices:AS Sazon (for all),1 / 30 lb (box or pail),1.0,59.0,59.0,2271470.81999999,American Spice,Lisset Limpio -020,CAFETERIA y RESTAURANTS,1382770,Mar
2024-03-19,Fritanga Momotombo,Invoice,008-02753,Arroz a Granel:Largo Fino 50 LB -Bolsa Dos Hermanos.,,6.0,27.25,163.5,2271634.31999999,Bulk Rice,Lisset Limpio -020,CAFETERIA y RESTAURANTS,1382771,Mar
2024-03-19,Bravo   Francisco Diaz,Invoice,008-02754,Arroz a Granel:Largo Fino 50 LB -Bolsa Dos Hermanos.,,3.0,27.25,81.75,2271716.06999999,Bulk Rice,Lisset Limpio -020,RETAIL  DSD,1382772,Mar
2024-03-19,"American Spice Trading Co, Inc.",Invoice,008-02755,Arroz a Granel:Parboiled 50 LB -Bolsa Dos Hermanos.,,330.0,27.5,9075.0,2280791.06999999,Bulk Rice,Armando Carpio - 017,WHOLESALER MANUFACTURY,1382773,Mar
2024-03-20,Sedanos Supermarkets #43,Invoice,008-02756,Arroz a Granel:Parboiled 50 LB -Bolsa Dos Hermanos.,,3.0,28.25,84.75,2280875.81999999,Bulk Rice,Lisset Limpio -020,RETAIL SEDANOS,1382774,Mar
2024-03-20,Sedanos Supermarkets #43,Invoice,008-02756,Dry Beans:Dry Beans - Black Beans 50,Dry Black Beans 50 lb,2.0,39.0,78.0,2280953.81999999,Dry Beans,Lisset Limpio -020,RETAIL SEDANOS,1382775,Mar
2024-03-20,Sedanos Supermarkets #43,Invoice,008-02756,,Discount,,,-3.26,2280950.55999999,,Lisset Limpio -020,RETAIL SEDANOS,1382776,Mar
2024-03-20,Sedanos Supermarkets #36,Invoice,008-02757,Arroz a Granel:Parboiled 50 LB -Bolsa Dos Hermanos.,,3.0,28.25,84.75,2281035.30999999,Bulk Rice,Lisset Limpio -020,RETAIL SEDANOS,1382777,Mar
2024-03-20,Sedanos Supermarkets #36,Invoice,008-02757,Dry Beans:Dry Beans - Black Beans 50,Dry Black Beans 50 lb,2.0,39.0,78.0,2281113.30999999,Dry Beans,Lisset Limpio -020,RETAIL SEDANOS,1382778,Mar
2024-03-20,Sedanos Supermarkets #36,Invoice,008-02757,,Discount,,,-3.26,2281110.04999999,,Lisset Limpio -020,RETAIL SEDANOS,1382779,Mar
2024-03-20,Sedanos Supermarkets #34,Invoice,008-02758,Arroz a Granel:Parboiled 50 LB -Bolsa Dos Hermanos.,,10.0,28.5,285.0,2281395.04999999,Bulk Rice,Lisset Limpio -020,RETAIL SEDANOS,1382780,Mar
2024-03-20,Sedanos Supermarkets #34,Invoice,008-02758,Dry Beans:Dry Beans - Black Beans 50,Dry Black Beans 50 lb,2.0,39.0,78.0,2281473.04999999,Dry Beans,Lisset Limpio -020,RETAIL SEDANOS,1382781,Mar
2024-03-20,Sedanos Supermarkets #34,Invoice,008-02758,,Discount,,,-7.26,2281465.78999999,,Lisset Limpio -020,RETAIL SEDANOS,1382782,Mar
2024-03-20,Sedanos Supermarkets #33,Invoice,008-02759,Arroz a Granel:Parboiled 50 LB -Bolsa Dos Hermanos.,,3.0,28.25,84.75,2281550.53999999,Bulk Rice,Lisset Limpio -020,RETAIL SEDANOS,1382783,Mar
2024-03-20,Sedanos Supermarkets #33,Invoice,008-02759,Dry Beans:Dry Beans - Black Beans 50,Dry Black Beans 50 lb,2.0,39.0,78.0,2281628.53999999,Dry Beans,Lisset Limpio -020,RETAIL SEDANOS,1382784,Mar
2024-03-20,Sedanos Supermarkets #33,Invoice,008-02759,,Discount,,,-3.26,2281625.27999999,,Lisset Limpio -020,RETAIL SEDANOS,1382785,Mar
2024-03-20,Sedanos Supermarkets #28,Invoice,008-02760,Dry Beans:Dry Beans - Black Beans 50,Dry Black Beans 50 lb,5.0,39.0,195.0,2281820.27999999,Dry Beans,Lisset Limpio -020,RETAIL SEDANOS,1382786,Mar
2024-03-20,Sedanos Supermarkets #28,Invoice,008-02760,Arroz a Granel:Parboiled 50 LB -Bolsa Dos Hermanos.,,10.0,25.25,252.5,2282072.77999999,Bulk Rice,Lisset Limpio -020,RETAIL SEDANOS,1382787,Mar
2024-03-20,Sedanos Supermarkets #28,Invoice,008-02760,,Discount,,,-8.95,2282063.82999999,,Lisset Limpio -020,RETAIL SEDANOS,1382788,Mar
2024-03-20,Sedanos Supermarkets #27,Invoice,008-02761,Arroz a Granel:Parboiled 50 LB -Bolsa Dos Hermanos.,,6.0,28.25,169.5,2282233.32999999,Bulk Rice,Lisset Limpio -020,RETAIL SEDANOS,1382789,Mar
2024-03-20,Sedanos Supermarkets #27,Invoice,008-02761,Dry Beans:Dry Beans - Black Beans 50,Dry Black Beans 50 lb,6.0,39.0,234.0,2282467.32999999,Dry Beans,Lisset Limpio -020,RETAIL SEDANOS,1382790,Mar
2024-03-20,Sedanos Supermarkets #27,Invoice,008-02761,,Discount,,,-8.07,2282459.25999999,,Lisset Limpio -020,RETAIL SEDANOS,1382791,Mar
2024-03-20,Sedanos Supermarkets #22,Invoice,008-02762,Arroz a Granel:Parboiled 50 LB -Bolsa Dos Hermanos.,,2.0,28.25,56.5,2282515.75999999,Bulk Rice,Lisset Limpio -020,RETAIL SEDANOS,1382792,Mar
2024-03-20,Sedanos Supermarkets #22,Invoice,008-02762,Dry Beans:Dry Beans - Black Beans 50,Dry Black Beans 50 lb,2.0,39.5,79.0,2282594.75999999,Dry Beans,Lisset Limpio -020,RETAIL SEDANOS,1382793,Mar
2024-03-20,Sedanos Supermarkets #22,Invoice,008-02762,,Discount,,,-2.71,2282592.04999999,,Lisset Limpio -020,RETAIL SEDANOS,1382794,Mar
2024-03-20,Sedanos Supermarkets #24,Invoice,008-02763,Dry Beans:Dry Beans - Black Beans 50,Dry Black Beans 50 lb,2.0,39.5,79.0,2282671.04999999,Dry Beans,Keila Alfaro-Visvikis,RETAIL SEDANOS,1382795,Mar
2024-03-20,Sedanos Supermarkets #24,Invoice,008-02763,Arroz a Granel:Parboiled 50 LB -Bolsa Dos Hermanos.,,3.0,28.5,85.5,2282756.54999999,Bulk Rice,Keila Alfaro-Visvikis,RETAIL SEDANOS,1382796,Mar
2024-03-20,Sedanos Supermarkets #24,Invoice,008-02763,,Discount,,,-3.29,2282753.25999999,,Keila Alfaro-Visvikis,RETAIL SEDANOS,1382797,Mar
2024-03-21,El Palacio de los jugos / Lita Foods Inc.,Invoice,008-02764,Arroz a Granel:Parboiled 50 LB -Bolsa Dos Hermanos.,,10.0,27.75,277.5,2283030.75999999,Bulk Rice,Lisset Limpio -020,Cafeteria,1382798,Mar
2024-03-21,El Palacio de los jugos /  Mires Restaurants,Invoice,008-02765,Arroz a Granel:Parboiled 50 LB -Bolsa Dos Hermanos.,,8.0,27.75,222.0,2283252.75999999,Bulk Rice,Lisset Limpio -020,Cafeteria,1382799,Mar
2024-03-21,Los Caringas Latin America  Foods,Invoice,008-02766,Arroz a Granel:Largo Fino 50 LB -Bolsa Dos Hermanos.,,3.0,27.25,81.75,2283334.50999999,Bulk Rice,Lisset Limpio -020,CAFETERIA y RESTAURANTS,1382800,Mar
2024-03-21,Los Caringas Latin America  Foods,Invoice,008-02766,Arroz a Granel:Parboiled 50 LB -Bolsa Dos Hermanos.,,4.0,27.75,111.0,2283445.50999999,Bulk Rice,Lisset Limpio -020,CAFETERIA y RESTAURANTS,1382801,Mar
2024-03-21,El Palacio de los jugos / Caribe Tropical,Invoice,008-02767,Arroz a Granel:Parboiled 50 LB -Bolsa Dos Hermanos.,,8.0,27.75,222.0,2283667.50999999,Bulk Rice,Lisset Limpio -020,Cafeteria,1382802,Mar
2024-03-21,El Palacio de los jugos /  EMMA FOOD CORP,Invoice,008-02768,Arroz a Granel:Parboiled 50 LB -Bolsa Dos Hermanos.,,7.0,27.75,194.25,2283861.75999999,Bulk Rice,Lisset Limpio -020,Cafeteria,1382803,Mar
2024-03-21,Sedanos Supermarkets  #37,Invoice,008-02769,Arroz Envasado:Parboiled 5KG Dos Hermanos.,6 / 11lbs,5.0,40.5,202.5,2284064.25999999,Branded Rice,Lisset Limpio -020,RETAIL SEDANOS,1382804,Mar
2024-03-21,Sedanos Supermarkets  #37,Invoice,008-02769,Arroz Envasado:Parboiled 5KG Dos Hermanos.,6 / 11lbs,5.0,40.5,202.5,2284266.75999999,Branded Rice,Lisset Limpio -020,RETAIL SEDANOS,1382805,Mar
2024-03-21,Sedanos Supermarkets  #37,Invoice,008-02769,,Discount,,,-4.05,2284262.70999999,,Lisset Limpio -020,RETAIL SEDANOS,1382806,Mar
2024-03-21,Sedanos Supermarkets #18,Invoice,008-02770,Rice Snack:Rice Snack Salami Flavored DOS HERMANOS,,1.0,19.9,19.9,2284282.60999999,Puffed Products,Lisset Limpio -020,RETAIL SEDANOS,1382807,Mar
2024-03-21,Sedanos Supermarkets #18,Invoice,008-02770,"Rice Snack:Rice Snack, Pizza DH",,1.0,19.9,19.9,2284302.50999999,Puffed Products,Lisset Limpio -020,RETAIL SEDANOS,1382808,Mar
2024-03-21,Sedanos Supermarkets #18,Invoice,008-02770,Rice Snack:Rice Snack Ham Flavored DOS HERMANOS,,2.0,19.9,39.8,2284342.30999999,Puffed Products,Lisset Limpio -020,RETAIL SEDANOS,1382809,Mar
2024-03-21,Sedanos Supermarkets #18,Invoice,008-02770,,Discount,,,-1.19,2284341.11999999,,Lisset Limpio -020,RETAIL SEDANOS,1382810,Mar
2024-03-21,El Gallego Supermarket,Invoice,008-02771,Dry Beans:Dry Beans - Black Beans 50,Dry Black Beans 50 lb,2.0,42.5,85.0,2284426.11999999,Dry Beans,Lisset Limpio -020,RETAIL  DSD,1382811,Mar
2024-03-21,El Gallego Supermarket,Invoice,008-02771,Arroz a Granel:Parboiled 50 LB -Bolsa Dos Hermanos.,,5.0,27.75,138.75,2284564.86999999,Bulk Rice,Lisset Limpio -020,RETAIL  DSD,1382812,Mar
2024-03-21,Sedanos Supermarkets  #37,Invoice,008-02772,Arroz a Granel:Parboiled 50 LB -Bolsa Dos Hermanos.,,3.0,28.25,84.75,2284649.61999999,Bulk Rice,Lisset Limpio -020,RETAIL SEDANOS,1382813,Mar
2024-03-21,Sedanos Supermarkets  #37,Invoice,008-02772,Dry Beans:Dry Beans - Black Beans 50,Dry Black Beans 50 lb,2.0,39.0,78.0,2284727.61999999,Dry Beans,Lisset Limpio -020,RETAIL SEDANOS,1382814,Mar
2024-03-21,Sedanos Supermarkets  #37,Invoice,008-02772,,Discount,,,-3.26,2284724.35999999,,Lisset Limpio -020,RETAIL SEDANOS,1382815,Mar
2024-03-21,Sedanos Supermarkets #18,Invoice,008-02773,Arroz a Granel:Parboiled 50 LB -Bolsa Dos Hermanos.,,5.0,28.25,141.25,2284865.60999999,Bulk Rice,Lisset Limpio -020,RETAIL SEDANOS,1382816,Mar
2024-03-21,Sedanos Supermarkets #18,Invoice,008-02773,Dry Beans:Dry Beans - Black Beans 50,Dry Black Beans 50 lb,6.0,39.0,234.0,2285099.60999999,Dry Beans,Lisset Limpio -020,RETAIL SEDANOS,1382817,Mar
2024-03-21,Sedanos Supermarkets #18,Invoice,008-02773,,Discount,,,-7.51,2285092.09999999,,Lisset Limpio -020,RETAIL SEDANOS,1382818,Mar
2024-03-21,Pacifico Chinese Restaurant,Invoice,008-02774,Arroz a Granel:Parboiled 50 LB -Bolsa Dos Hermanos.,,10.0,27.75,277.5,2285369.59999999,Bulk Rice,Lisset Limpio -020,CAFETERIA y RESTAURANTS,1382819,Mar
2024-03-22,El Palacio de los jugos /  Nanos Latin Foods,Invoice,008-02775,Arroz a Granel:Parboiled 50 LB -Bolsa Dos Hermanos.,,10.0,27.75,277.5,2285647.09999999,Bulk Rice,Lisset Limpio -020,Cafeteria,1382820,Mar
2024-03-22,Sedanos Supermarkets #38,Invoice,008-02776,Dry Beans:Dry Beans - Black Beans 50,Dry Black Beans 50 lb,2.0,39.0,78.0,2285725.09999999,Dry Beans,Lisset Limpio -020,RETAIL SEDANOS,1382821,Mar
2024-03-22,Sedanos Supermarkets #38,Invoice,008-02776,Arroz a Granel:Parboiled 50 LB -Bolsa Dos Hermanos.,,3.0,28.25,84.75,2285809.84999999,Bulk Rice,Lisset Limpio -020,RETAIL SEDANOS,1382822,Mar
2024-03-22,Sedanos Supermarkets #38,Invoice,008-02776,,Discount,,,-3.26,2285806.58999999,,Lisset Limpio -020,RETAIL SEDANOS,1382823,Mar
2024-03-25,Soriano Brothers PB,Invoice,008-02777,Arroz a Granel:Parboiled 50 LB -Bolsa Dos Hermanos.,,10.0,27.75,277.5,2286084.08999999,Bulk Rice,Lisset Limpio -020,CAFETERIA y RESTAURANTS,1382824,Mar
2024-03-25,Soriano Brothers PB,Invoice,008-02777,Arroz a Granel:Largo Fino 50 LB -Bolsa Dos Hermanos.,,10.0,27.25,272.5,2286356.58999999,Bulk Rice,Lisset Limpio -020,CAFETERIA y RESTAURANTS,1382825,Mar
2024-03-25,Soriano Brothers PB,Invoice,008-02777,Spices:AS Sazon (for all),1 / 30 lb (box or pail),1.0,59.0,59.0,2286415.58999999,American Spice,Lisset Limpio -020,CAFETERIA y RESTAURANTS,1382826,Mar
2024-03-25,Soriano Brothers PB,Invoice,008-02777,Dry Beans:Dry Beans - Black Beans 50,Dry Black Beans 50 lb,2.0,42.5,85.0,2286500.58999999,Dry Beans,Lisset Limpio -020,CAFETERIA y RESTAURANTS,1382827,Mar
2024-03-25,El Palacio de los jugos /  EMMA FOOD CORP,Invoice,008-02778,Arroz a Granel:Largo Fino 50 LB -Bolsa Dos Hermanos.,,6.0,27.25,163.5,2286664.08999999,Bulk Rice,Lisset Limpio -020,Cafeteria,1382828,Mar
2024-03-25,El Palacio de los jugos /  EMMA FOOD CORP,Invoice,008-02778,Arroz a Granel:Parboiled 50 LB -Bolsa Dos Hermanos.,,6.0,27.75,166.5,2286830.58999999,Bulk Rice,Lisset Limpio -020,Cafeteria,1382829,Mar
2024-03-25,El Palacio de los jugos / Caribe Tropical,Invoice,008-02779,Arroz a Granel:Parboiled 50 LB -Bolsa Dos Hermanos.,,8.0,27.75,222.0,2287052.58999999,Bulk Rice,Lisset Limpio -020,Cafeteria,1382830,Mar
2024-03-25,El Palacio de los jugos /  Nanos Latin Foods,Invoice,008-02780,Arroz a Granel:Parboiled 50 LB -Bolsa Dos Hermanos.,,8.0,27.75,222.0,2287274.58999999,Bulk Rice,Lisset Limpio -020,Cafeteria,1382831,Mar
2024-03-25,Los paraditos chinesse,Invoice,008-02781,Arroz a Granel:Largo Fino 50 LB -Bolsa Dos Hermanos.,,10.0,27.25,272.5,2287547.08999999,Bulk Rice,Lisset Limpio -020,CAFETERIA y RESTAURANTS,1382832,Mar
2024-03-25,Los paraditos chinesse,Invoice,008-02781,Arroz a Granel:Parboiled 50 LB -Bolsa Dos Hermanos.,,10.0,27.75,277.5,2287824.58999999,Bulk Rice,Lisset Limpio -020,CAFETERIA y RESTAURANTS,1382833,Mar
2024-03-25,Sedanos Supermarkets #29,Invoice,008-02782,Arroz a Granel:Parboiled 50 LB -Bolsa Dos Hermanos.,,4.0,28.25,113.0,2287937.58999999,Bulk Rice,Lisset Limpio -020,RETAIL SEDANOS,1382834,Mar
2024-03-25,Sedanos Supermarkets #29,Invoice,008-02782,,Discount,,,-2.26,2287935.32999999,,Lisset Limpio -020,RETAIL SEDANOS,1382835,Mar
2024-03-25,Sedanos Supermarkets #31,Invoice,008-02783,Arroz Envasado:Parboiled 5KG Dos Hermanos.,6 / 11lbs,10.0,40.5,405.0,2288340.32999999,Branded Rice,Lisset Limpio -020,RETAIL SEDANOS,1382836,Mar
2024-03-25,Sedanos Supermarkets #31,Invoice,008-02783,Arroz Envasado:Parboiled 5KG Dos Hermanos.,6 / 11lbs,10.0,40.5,405.0,2288745.32999999,Branded Rice,Lisset Limpio -020,RETAIL SEDANOS,1382837,Mar
2024-03-25,Sedanos Supermarkets #31,Invoice,008-02783,,Discount,,,-8.1,2288737.22999999,,Lisset Limpio -020,RETAIL SEDANOS,1382838,Mar
2024-03-25,Sedanos Supermarkets #16,Invoice,008-02784,Dry Beans:Dry Beans - Black Beans 50,Dry Black Beans 50 lb,2.0,39.0,78.0,2288815.22999999,Dry Beans,Lisset Limpio -020,RETAIL SEDANOS,1382839,Mar
2024-03-25,Sedanos Supermarkets #16,Invoice,008-02784,Arroz a Granel:Parboiled 50 LB -Bolsa Dos Hermanos.,,6.0,28.25,169.5,2288984.72999999,Bulk Rice,Lisset Limpio -020,RETAIL SEDANOS,1382840,Mar
2024-03-25,Sedanos Supermarkets #16,Invoice,008-02784,,Discount,,,-4.95,2288979.77999999,,Lisset Limpio -020,RETAIL SEDANOS,1382841,Mar
2024-03-25,Sedanos Supermarkets #32,Invoice,008-02785,Arroz a Granel:Parboiled 50 LB -Bolsa Dos Hermanos.,,6.0,28.25,169.5,2289149.27999999,Bulk Rice,Lisset Limpio -020,RETAIL SEDANOS,1382842,Mar
2024-03-25,Sedanos Supermarkets #32,Invoice,008-02785,Dry Beans:Dry Beans - Black Beans 50,Dry Black Beans 50 lb,6.0,39.0,234.0,2289383.27999999,Dry Beans,Lisset Limpio -020,RETAIL SEDANOS,1382843,Mar
2024-03-25,Sedanos Supermarkets #32,Invoice,008-02785,,Discount,,,-8.07,2289375.20999999,,Lisset Limpio -020,RETAIL SEDANOS,1382844,Mar
2024-03-25,Sedanos Supermarkets #31,Invoice,008-02786,Arroz a Granel:Parboiled 50 LB -Bolsa Dos Hermanos.,,3.0,28.25,84.75,2289459.95999999,Bulk Rice,Lisset Limpio -020,RETAIL SEDANOS,1382845,Mar
2024-03-25,Sedanos Supermarkets #31,Invoice,008-02786,Dry Beans:Dry Beans - Black Beans 50,Dry Black Beans 50 lb,2.0,39.0,78.0,2289537.95999999,Dry Beans,Lisset Limpio -020,RETAIL SEDANOS,1382846,Mar
2024-03-25,Sedanos Supermarkets #31,Invoice,008-02786,,Discount,,,-3.26,2289534.69999999,,Lisset Limpio -020,RETAIL SEDANOS,1382847,Mar
2024-03-25,Sedanos Supermarkets #31,Credit Memo,008-02858,Varios:Promotional Allowance,Arroz Envasado:Parboiled 5KG Dos Hermanos.,-10.0,40.5,-405.0,2289129.69999999,Branded Rice,Lisset Limpio -020,RETAIL SEDANOS,1382848,Mar
2024-03-25,Sedanos Supermarkets #24,Credit Memo,008-02859,Varios:Promotional Allowance,"Rice Snack:Rice Snack, Pizza DH",-1.0,19.9,-19.9,2289109.79999999,Puffed Products,Ruta - 019,RETAIL SEDANOS,1382849,Mar
2024-03-26,Sedanos Supermarkets #27,Invoice,008-02787,Arroz a Granel:Parboiled 50 LB -Bolsa Dos Hermanos.,,6.0,28.25,169.5,2289279.29999999,Bulk Rice,Lisset Limpio -020,RETAIL SEDANOS,1382850,Mar
2024-03-26,Sedanos Supermarkets #27,Invoice,008-02787,,,,,0.0,2289279.29999999,,Lisset Limpio -020,RETAIL SEDANOS,1382851,Mar
2024-03-26,Sedanos Supermarkets #27,Invoice,008-02787,,Discount,,,-3.39,2289275.90999999,,Lisset Limpio -020,RETAIL SEDANOS,1382852,Mar
2024-03-26,Ideal Food Basket Davie Cafeteria,Invoice,008-02788,Arroz a Granel:Largo Fino 50 LB -Bolsa Dos Hermanos.,,12.0,27.25,327.0,2289602.90999999,Bulk Rice,Armando Carpio - 017,CAFETERIA y RESTAURANTS,1382853,Mar
2024-03-26,El Palacio de los jugos /  Nanos Latin Foods,Invoice,008-02789,Arroz a Granel:Largo Fino 50 LB -Bolsa Dos Hermanos.,,5.0,27.25,136.25,2289739.15999999,Bulk Rice,Lisset Limpio -020,Cafeteria,1382854,Mar
2024-03-26,Sedanos Supermarkets #24,Invoice,008-02790,"Rice Snack:Rice Snack, Pizza DH",,1.0,19.9,19.9,2289759.05999999,Puffed Products,Keila Alfaro-Visvikis,RETAIL SEDANOS,1382855,Mar
2024-03-26,Sedanos Supermarkets #24,Invoice,008-02790,Rice Snack:Rice Snack Salami Flavored DOS HERMANOS,,1.0,19.9,19.9,2289778.95999999,Puffed Products,Keila Alfaro-Visvikis,RETAIL SEDANOS,1382856,Mar
2024-03-26,Sedanos Supermarkets #24,Invoice,008-02790,Rice Snack:Rice Snack Ham Flavored DOS HERMANOS,,2.0,19.9,39.8,2289818.75999999,Puffed Products,Keila Alfaro-Visvikis,RETAIL SEDANOS,1382857,Mar
2024-03-26,Sedanos Supermarkets #24,Invoice,008-02790,,Discount,,,-1.19,2289817.56999999,,Keila Alfaro-Visvikis,RETAIL SEDANOS,1382858,Mar
2024-03-26,La Ranchera Meat Market #3,Invoice,008-02791,Arroz a Granel:Largo Fino 50 LB -Bolsa Dos Hermanos.,,10.0,27.25,272.5,2290090.06999999,Bulk Rice,Ruta - 019,CAFETERIA y RESTAURANTS,1382859,Mar
2024-03-26,La Ranchera Meat Market #3,Invoice,008-02791,Arroz Envasado:Largo Fino 1kg (Long grain rice) Dos Hermanos,,5.0,16.5,82.5,2290172.56999999,Branded Rice,Ruta - 019,CAFETERIA y RESTAURANTS,1382860,Mar
2024-03-26,La Ranchera Meat Market #3,Invoice,008-02791,Arroz Envasado:Largo Fino 1kg (Long grain rice) Dos Hermanos,,1.0,16.5,16.5,2290189.06999999,Branded Rice,Ruta - 019,CAFETERIA y RESTAURANTS,1382861,Mar
2024-03-26,Sabor Tropical Supermarket #4,Invoice,008-02792,Arroz a Granel:Parboiled 50 LB -Bolsa Dos Hermanos.,,20.0,28.25,565.0,2290754.06999999,Bulk Rice,Lisset Limpio -020,RETAIL  DSD,1382862,Mar
2024-03-26,Sedanos Supermarkets #27,Invoice,008-02793,Arroz Envasado:Parboiled 5KG Dos Hermanos.,6 / 11lbs,2.0,40.5,81.0,2290835.06999999,Branded Rice,Lisset Limpio -020,RETAIL SEDANOS,1382863,Mar
2024-03-26,Sedanos Supermarkets #27,Invoice,008-02793,,Discount,,,-1.62,2290833.44999999,,Lisset Limpio -020,RETAIL SEDANOS,1382864,Mar
2024-03-26,La Ranchera Meat Market #3,Credit Memo,008-02860,Varios:Promotional Allowance,Arroz Envasado:Largo Fino 1kg (Long grain rice) Dos Hermanos,-1.0,16.5,-16.5,2290816.94999999,Branded Rice,Keila Alfaro-Visvikis,CAFETERIA y RESTAURANTS,1382865,Mar
2024-03-27,Sedanos Supermarkets #41,Invoice,008-02794,Rice Snack:Rice Snack Salami Flavored DOS HERMANOS,,1.0,19.9,19.9,2290836.84999999,Puffed Products,Armando Carpio - 017,RETAIL SEDANOS,1382866,Mar
2024-03-27,Sedanos Supermarkets #41,Invoice,008-02794,Rice Snack:Rice Snack Ham Flavored DOS HERMANOS,,2.0,19.9,39.8,2290876.64999999,Puffed Products,Armando Carpio - 017,RETAIL SEDANOS,1382867,Mar
2024-03-27,Sedanos Supermarkets #41,Invoice,008-02794,"Rice Snack:Rice Snack, Pizza DH",,1.0,0.0,0.0,2290876.64999999,Puffed Products,Armando Carpio - 017,RETAIL SEDANOS,1382868,Mar
2024-03-27,Sedanos Supermarkets #41,Invoice,008-02794,,Discount,,,-1.19,2290875.45999999,,Armando Carpio - 017,RETAIL SEDANOS,1382869,Mar
2024-03-27,Sedanos Supermarkets #42,Invoice,008-02795,Rice Snack:Rice Snack Ham Flavored DOS HERMANOS,,1.0,19.9,19.9,2290895.35999999,Puffed Products,Lisset Limpio -020,RETAIL SEDANOS,1382870,Mar
2024-03-27,Sedanos Supermarkets #42,Invoice,008-02795,,Discount,,,-0.4,2290894.95999999,,Lisset Limpio -020,RETAIL SEDANOS,1382871,Mar
2024-03-27,Sedanos Supermarkets #40,Invoice,008-02796,"Rice Snack:Rice Snack, Pizza DH",,1.0,19.9,19.9,2290914.85999999,Puffed Products,Armando Carpio - 017,RETAIL SEDANOS,1382872,Mar
2024-03-27,Sedanos Supermarkets #40,Invoice,008-02796,Rice Snack:Rice Snack Salami Flavored DOS HERMANOS,,1.0,19.9,19.9,2290934.75999999,Puffed Products,Armando Carpio - 017,RETAIL SEDANOS,1382873,Mar
2024-03-27,Sedanos Supermarkets #40,Invoice,008-02796,Rice Snack:Rice Snack Ham Flavored DOS HERMANOS,,1.0,19.9,19.9,2290954.65999999,Puffed Products,Armando Carpio - 017,RETAIL SEDANOS,1382874,Mar
2024-03-27,Sedanos Supermarkets #40,Invoice,008-02796,Rice Snack:Rice Snack Salami Flavored DOS HERMANOS,,1.0,0.0,0.0,2290954.65999999,Puffed Products,Armando Carpio - 017,RETAIL SEDANOS,1382875,Mar
2024-03-27,Sedanos Supermarkets #40,Invoice,008-02796,,Discount,,,-1.19,2290953.46999999,,Armando Carpio - 017,RETAIL SEDANOS,1382876,Mar
2024-03-27,Los Mejores Tamales de Miami,Invoice,008-02797,Arroz a Granel:Largo Fino 50 LB -Bolsa Dos Hermanos.,,5.0,27.25,136.25,2291089.71999999,Bulk Rice,Lisset Limpio -020,CAFETERIA y RESTAURANTS,1382877,Mar
2024-03-27,Los Mejores Tamales de Miami,Invoice,008-02797,Arroz a Granel:Parboiled 50 LB -Bolsa Dos Hermanos.,,5.0,27.75,138.75,2291228.46999999,Bulk Rice,Lisset Limpio -020,CAFETERIA y RESTAURANTS,1382878,Mar
2024-03-27,Sedanos Supermarkets #41,Invoice,008-02798,Arroz a Granel:Parboiled 50 LB -Bolsa Dos Hermanos.,,10.0,28.25,282.5,2291510.96999999,Bulk Rice,Armando Carpio - 017,RETAIL SEDANOS,1382879,Mar
2024-03-27,Sedanos Supermarkets #41,Invoice,008-02798,Dry Beans:Dry Beans - Black Beans 50,Dry Black Beans 50 lb,5.0,39.0,195.0,2291705.96999999,Dry Beans,Armando Carpio - 017,RETAIL SEDANOS,1382880,Mar
2024-03-27,Sedanos Supermarkets #41,Invoice,008-02798,,Discount,,,-9.55,2291696.41999999,,Armando Carpio - 017,RETAIL SEDANOS,1382881,Mar
2024-03-27,Sedanos Supermarkets #40,Invoice,008-02799,Arroz a Granel:Parboiled 50 LB -Bolsa Dos Hermanos.,,10.0,28.25,282.5,2291978.91999999,Bulk Rice,Armando Carpio - 017,RETAIL SEDANOS,1382882,Mar
2024-03-27,Sedanos Supermarkets #40,Invoice,008-02799,Dry Beans:Dry Beans - Black Beans 50,Dry Black Beans 50 lb,5.0,39.0,195.0,2292173.91999999,Dry Beans,Armando Carpio - 017,RETAIL SEDANOS,1382883,Mar
2024-03-27,Sedanos Supermarkets #40,Invoice,008-02799,Spices:AS Cumin Ground,4 / 4 lb,2.0,49.0,98.0,2292271.91999999,American Spice,Armando Carpio - 017,RETAIL SEDANOS,1382884,Mar
2024-03-27,Sedanos Supermarkets #40,Invoice,008-02799,Spices:AS Chicken Base 4/5lb,4/5lb,2.0,35.5,71.0,2292342.91999999,American Spice,Armando Carpio - 017,RETAIL SEDANOS,1382885,Mar
2024-03-27,Sedanos Supermarkets #40,Invoice,008-02799,Spices:AS Complete Seasoning,4/6 lb,1.0,48.0,48.0,2292390.91999999,American Spice,Armando Carpio - 017,RETAIL SEDANOS,1382886,Mar
2024-03-27,Sedanos Supermarkets #40,Invoice,008-02799,,Discount,,,-13.89,2292377.02999999,,Armando Carpio - 017,RETAIL SEDANOS,1382887,Mar
2024-03-27,Bravo   Francisco Diaz,Invoice,008-02800,Arroz a Granel:Largo Fino 50 LB -Bolsa Dos Hermanos.,,6.0,23.5,141.0,2292518.02999999,Bulk Rice,Lisset Limpio -020,RETAIL  DSD,1382888,Mar
2024-03-27,Bravo   Francisco Diaz,Invoice,008-02800,Liquids:AS Marinating Sauce (Mojo),,2.0,18.5,37.0,2292555.02999999,American Spice,Lisset Limpio -020,RETAIL  DSD,1382889,Mar
2024-03-27,Bravo   Francisco Diaz,Invoice,008-02800,Liquids:AS Cooking Wine,4/1 Gl.,2.0,17.5,35.0,2292590.02999999,American Spice,Lisset Limpio -020,RETAIL  DSD,1382890,Mar
2024-03-27,Bravo   Francisco Diaz,Invoice,008-02800,Liquids:AS White Vinegar,4/1 Gl.,1.0,10.0,10.0,2292600.02999999,American Spice,Lisset Limpio -020,RETAIL  DSD,1382891,Mar
2024-03-27,Bravo   Francisco Diaz,Invoice,008-02800,Dry Beans:Dry Beans - Black Beans 50,Dry Black Beans 50 lb,2.0,42.5,85.0,2292685.02999999,Dry Beans,Lisset Limpio -020,RETAIL  DSD,1382892,Mar
2024-03-27,"American Spice Trading Co, Inc.",Invoice,008-02801,Arroz a Granel:Parboiled 50 LB -Bolsa Dos Hermanos.,,220.0,27.5,6050.0,2298735.02999999,Bulk Rice,Armando Carpio - 017,WHOLESALER MANUFACTURY,1382893,Mar
2024-03-28,Fritanga Momotombo,Invoice,008-02802,Arroz a Granel:Largo Fino 50 LB -Bolsa Dos Hermanos.,,5.0,27.25,136.25,2298871.27999999,Bulk Rice,Lisset Limpio -020,CAFETERIA y RESTAURANTS,1382894,Mar
2024-03-28,El Palacio de los jugos /  Nanos Latin Foods,Invoice,008-02803,Arroz a Granel:Parboiled 50 LB -Bolsa Dos Hermanos.,,10.0,27.75,277.5,2299148.77999999,Bulk Rice,Lisset Limpio -020,Cafeteria,1382895,Mar
2024-03-28,El Palacio de los jugos / Lita Foods Inc.,Invoice,008-02804,Arroz a Granel:Parboiled 50 LB -Bolsa Dos Hermanos.,,10.0,27.75,277.5,2299426.27999999,Bulk Rice,Lisset Limpio -020,Cafeteria,1382896,Mar
2024-03-28,El Palacio de los jugos / Caribe Tropical,Invoice,008-02805,Arroz a Granel:Parboiled 50 LB -Bolsa Dos Hermanos.,,10.0,27.75,277.5,2299703.77999999,Bulk Rice,Lisset Limpio -020,Cafeteria,1382897,Mar
2024-03-28,El Palacio de Los Jugos / Casa mía Food Restaurant inc,Invoice,008-02806,Arroz a Granel:Parboiled 50 LB -Bolsa Dos Hermanos.,,10.0,27.75,277.5,2299981.27999999,Bulk Rice,Lisset Limpio -020,Cafeteria,1382898,Mar
2024-03-28,El Palacio de los jugos /  EMMA FOOD CORP,Invoice,008-02807,Arroz a Granel:Largo Fino 50 LB -Bolsa Dos Hermanos.,,10.0,27.2,272.0,2300253.27999999,Bulk Rice,Lisset Limpio -020,Cafeteria,1382899,Mar
2024-03-28,El Palacio de los jugos /  EMMA FOOD CORP,Invoice,008-02807,Arroz a Granel:Parboiled 50 LB -Bolsa Dos Hermanos.,,8.0,27.75,222.0,2300475.27999999,Bulk Rice,Lisset Limpio -020,Cafeteria,1382900,Mar
2024-03-28,Mei Chang,Invoice,008-02808,Arroz a Granel:Parboiled 50 LB -Bolsa Dos Hermanos.,,10.0,27.75,277.5,2300752.77999999,Bulk Rice,Lisset Limpio -020,CAFETERIA y RESTAURANTS,1382901,Mar
2024-03-28,Sedanos Supermarkets  #37,Credit Memo,008-02857,Varios:Promotional Allowance,Arroz Envasado:Parboiled 5KG Dos Hermanos.,-5.0,40.5,-202.5,2300550.27999999,Branded Rice,Lisset Limpio -020,RETAIL SEDANOS,1382902,Mar
2024-03-31,JMN Dely Corp,Credit Memo,008-02833,Varios:Producto vencido/deteriorado (no impacta en inventario),,-1.0,140.0,-140.0,2300410.27999999,,Ruta - 019,CAFETERIA y RESTAURANTS,1382903,Mar
2024-03-31,"Meat Club Market, LLC.",Credit Memo,008-02834,Varios:Producto vencido/deteriorado (no impacta en inventario),,-1.0,0.45,-0.45,2300409.82999999,,Lisset Limpio -020,RETAIL  DSD,1382904,Mar
2024-03-31,Price Choice 5 YNTO Food Corp.,Credit Memo,008-02835,Varios:Producto vencido/deteriorado (no impacta en inventario),,-1.0,20.0,-20.0,2300389.82999999,,Lisset Limpio -020,RETAIL  DSD,1382905,Mar
2024-03-31,Rey Chavez Distributor Corp,Credit Memo,008-02836,Varios:Producto vencido/deteriorado (no impacta en inventario),,-1.0,195.0,-195.0,2300194.82999999,,Lisset Limpio -020,WHOLESALER,1382906,Mar
2024-03-31,Seabra Foods / A&J Supermarkets,Credit Memo,008-02837,Varios:Producto vencido/deteriorado (no impacta en inventario),,-1.0,157.5,-157.5,2300037.32999999,,Ruta - 019,RETAIL  DSD,1382907,Mar
2024-03-31,Sebastian Avila,Credit Memo,008-02838,Varios:Producto vencido/deteriorado (no impacta en inventario),,-1.0,521.3,-521.3,2299516.02999999,,Ruta - 019,RETAIL  DSD,1382908,Mar
2024-03-31,Soriano Brothers PB,Credit Memo,008-02839,Varios:Producto vencido/deteriorado (no impacta en inventario),,-1.0,122.5,-122.5,2299393.52999999,,Lisset Limpio -020,CAFETERIA y RESTAURANTS,1382909,Mar
2024-03-31,Food Fair Plantation Corp,Credit Memo,008-02840,Varios:Producto vencido/deteriorado (no impacta en inventario),,-1.0,385.0,-385.0,2299008.52999999,Branded Rice,Armando Carpio - 017,RETAIL  DSD,1382910,Mar
2024-03-31,Foodtown Supermarket,Credit Memo,008-02841,Varios:Producto vencido/deteriorado (no impacta en inventario),,-1.0,747.5,-747.5,2298261.02999999,,Ruta - 019,CAFETERIA y RESTAURANTS,1382911,Mar
2024-03-31,El Palacio de los jugos /  Mires Restaurants,Credit Memo,008-02842,Varios:Producto vencido/deteriorado (no impacta en inventario),,-1.0,6.92,-6.92,2298254.10999999,,Lisset Limpio -020,Cafeteria,1382912,Mar
2024-03-31,Fritanga Poneloya,Credit Memo,008-02843,Varios:Producto vencido/deteriorado (no impacta en inventario),,-1.0,4.0,-4.0,2298250.10999999,,Lisset Limpio -020,CAFETERIA y RESTAURANTS,1382913,Mar
2024-03-31,El Palacio de los jugos /  Nanos Latin Foods,Credit Memo,008-02844,Varios:Producto vencido/deteriorado (no impacta en inventario),,-1.0,9.22,-9.22,2298240.88999999,,Lisset Limpio -020,Cafeteria,1382914,Mar
2024-03-31,Sedanos Supermarkets #17,Credit Memo,008-02854,Varios:Promotional Allowance,"Rice Snack:Rice Snack, Pizza DH",-1.0,19.9,-19.9,2298220.98999999,Puffed Products,Lisset Limpio -020,RETAIL SEDANOS,1382915,Mar
2024-03-31,Sedanos Supermarkets #18,Credit Memo,008-02855,Varios:Promotional Allowance,Arroz Envasado:Parboiled 5KG Dos Hermanos.,-10.0,40.5,-405.0,2297815.98999999,Branded Rice,Lisset Limpio -020,RETAIL SEDANOS,1382916,Mar
2024-03-31,Sedanos Supermarkets #18,Credit Memo,008-02856,Varios:Promotional Allowance,Rice Snack:Rice Snack Salami Flavored DOS HERMANOS,-1.0,19.9,-19.9,2297796.08999999,Puffed Products,Lisset Limpio -020,RETAIL SEDANOS,1382917,Mar
2024-04-01,Soriano Brothers PB,Invoice,008-02809,Arroz a Granel:Largo Fino 50 LB -Bolsa Dos Hermanos.,,10.0,27.25,272.5,2298068.58999999,Bulk Rice,Lisset Limpio -020,CAFETERIA y RESTAURANTS,1382918,Apr
2024-04-01,Soriano Brothers PB,Invoice,008-02809,Arroz a Granel:Parboiled 50 LB -Bolsa Dos Hermanos.,,10.0,27.75,277.5,2298346.08999999,Bulk Rice,Lisset Limpio -020,CAFETERIA y RESTAURANTS,1382919,Apr
2024-04-01,Soriano Brothers PB,Invoice,008-02809,Dry Beans:Dry Beans - Black Beans 50,Dry Black Beans 50 lb,1.0,42.5,42.5,2298388.58999999,Dry Beans,Lisset Limpio -020,CAFETERIA y RESTAURANTS,1382920,Apr
2024-04-01,Hings Chinese,Invoice,008-02810,Arroz a Granel:Parboiled 50 LB -Bolsa Dos Hermanos.,,6.0,27.75,166.5,2298555.08999999,Bulk Rice,Lisset Limpio -020,CAFETERIA y RESTAURANTS,1382921,Apr
2024-04-01,El Palacio de los jugos /  Mires Restaurants,Invoice,008-02811,Arroz a Granel:Parboiled 50 LB -Bolsa Dos Hermanos.,,6.0,27.75,166.5,2298721.58999999,Bulk Rice,Lisset Limpio -020,Cafeteria,1382922,Apr
2024-04-01,El Palacio de los jugos / Lita Foods Inc.,Invoice,008-02812,Arroz a Granel:Parboiled 50 LB -Bolsa Dos Hermanos.,,5.0,27.75,138.75,2298860.33999999,Bulk Rice,Lisset Limpio -020,Cafeteria,1382923,Apr
2024-04-01,El Palacio de los jugos / Caribe Tropical,Invoice,008-02813,Arroz a Granel:Largo Fino 50 LB -Bolsa Dos Hermanos.,,8.0,27.25,218.0,2299078.33999999,Bulk Rice,Lisset Limpio -020,Cafeteria,1382924,Apr
2024-04-01,Festival Supermarket #1,Invoice,008-02814,Arroz Envasado:Parboiled 5KG Dos Hermanos.,6 / 11lbs,10.0,45.6,456.0,2299534.33999999,Branded Rice,Lisset Limpio -020,RETAIL  DSD,1382925,Apr
2024-04-01,Festival Supermarket #1,Invoice,008-02814,Arroz Envasado:Parboiled 5KG Dos Hermanos.,6 / 11lbs,2.0,45.6,91.2,2299625.53999999,Branded Rice,Lisset Limpio -020,RETAIL  DSD,1382926,Apr
2024-04-01,Aries Supermarket & Cafeteria,Invoice,008-02815,Arroz a Granel:Parboiled 50 LB -Bolsa Dos Hermanos.,,10.0,28.8,288.0,2299913.53999999,Bulk Rice,Lisset Limpio -020,CAFETERIA y RESTAURANTS,1382927,Apr
2024-04-01,El Palacio de los jugos /  Nanos Latin Foods,Invoice,008-02816,Arroz a Granel:Largo Fino 50 LB -Bolsa Dos Hermanos.,,10.0,27.25,272.5,2300186.03999999,Bulk Rice,Lisset Limpio -020,Cafeteria,1382928,Apr
2024-04-01,El Palacio de los jugos /  EMMA FOOD CORP,Invoice,008-02817,Arroz a Granel:Largo Fino 50 LB -Bolsa Dos Hermanos.,,8.0,27.25,218.0,2300404.03999999,Bulk Rice,Lisset Limpio -020,Cafeteria,1382929,Apr
2024-04-01,El Palacio de los jugos /  EMMA FOOD CORP,Invoice,008-02817,Arroz a Granel:Parboiled 50 LB -Bolsa Dos Hermanos.,,8.0,27.75,222.0,2300626.03999999,Bulk Rice,Lisset Limpio -020,Cafeteria,1382930,Apr
2024-04-01,El Palacio de los jugos /  EMMA FOOD CORP,Invoice,008-02817,Spices:AS Chicken Base,1 / 30 lb. (box or pail),1.0,39.0,39.0,2300665.03999999,American Spice,Lisset Limpio -020,Cafeteria,1382931,Apr
2024-04-01,Festival Supermarket #1,Credit Memo,008-03016,Varios:Promotional Allowance,Arroz Envasado:Parboiled 5KG Dos Hermanos.,-2.0,45.6,-91.2,2300573.83999999,Branded Rice,Keila Alfaro-Visvikis,RETAIL  DSD,1382932,Apr
2024-04-01,Brito Family Corp.,Credit Memo,008-03088,Arroz a Granel:Largo Fino 50 LB -Bolsa Dos Hermanos.,,-55.0,22.5,-1237.5,2299336.33999999,Bulk Rice,Lisset Limpio -020,CAFETERIA y RESTAURANTS,1382933,Apr
2024-04-01,Brito Family Corp.,Credit Memo,008-03088,Arroz a Granel:Parboiled 50 LB -Bolsa Dos Hermanos.,,-110.0,26.75,-2942.5,2296393.83999999,Bulk Rice,Lisset Limpio -020,CAFETERIA y RESTAURANTS,1382934,Apr
2024-04-02,"American Spice Trading Co, Inc.",Invoice,008-02818,Arroz a Granel:Parboiled 50 LB -Bolsa Dos Hermanos.,,1100.0,27.5,30250.0,2326643.83999999,Bulk Rice,Armando Carpio - 017,WHOLESALER MANUFACTURY,1382935,Apr
2024-04-02,Bake Mark USA LLC,Invoice,008-02819,Arroz a Granel:Parboiled 50 LB -Bolsa Dos Hermanos.,,1100.0,23.0,25300.0,2351943.83999999,Bulk Rice,Armando Carpio - 017,WHOLESALER MANUFACTURY,1382936,Apr
2024-04-03,"American Spice Trading Co, Inc.",Invoice,008-02820,Arroz a Granel:Parboiled 50 LB -Bolsa Dos Hermanos.,,1100.0,27.5,30250.0,2382193.83999999,Bulk Rice,Armando Carpio - 017,WHOLESALER MANUFACTURY,1382937,Apr
2024-04-03,El Palacio de los jugos / Lita Foods Inc.,Invoice,008-02821,Arroz a Granel:Parboiled 50 LB -Bolsa Dos Hermanos.,,10.0,27.75,277.5,2382471.33999999,Bulk Rice,Lisset Limpio -020,Cafeteria,1382938,Apr
2024-04-03,Family and Son,Invoice,008-02822,Arroz a Granel:Parboiled 50 LB -Bolsa Dos Hermanos.,,1100.0,27.25,29975.0,2412446.33999999,Bulk Rice,Armando Carpio - 017,WHOLESALER MANUFACTURY,1382939,Apr
2024-04-03,Bake Mark USA LLC,Invoice,008-02823,Arroz a Granel:Parboiled 50 LB -Bolsa Dos Hermanos.,,1100.0,24.0,26400.0,2438846.33999999,Bulk Rice,Armando Carpio - 017,WHOLESALER MANUFACTURY,1382940,Apr
2024-04-03,Sedanos Supermarkets #43,Invoice,008-02825,Arroz a Granel:Parboiled 50 LB -Bolsa Dos Hermanos.,,5.0,28.5,142.5,2438988.83999999,Bulk Rice,Lisset Limpio -020,RETAIL SEDANOS,1382941,Apr
2024-04-03,Sedanos Supermarkets #43,Invoice,008-02825,Dry Beans:Dry Beans - Black Beans 50,Dry Black Beans 50 lb,2.0,42.5,85.0,2439073.83999999,Dry Beans,Lisset Limpio -020,RETAIL SEDANOS,1382942,Apr
2024-04-03,Sedanos Supermarkets #43,Invoice,008-02825,,Discount,,,-4.55,2439069.28999999,,Lisset Limpio -020,RETAIL SEDANOS,1382943,Apr
2024-04-03,Sedanos Supermarkets #22,Invoice,008-02826,Arroz a Granel:Parboiled 50 LB -Bolsa Dos Hermanos.,,10.0,28.5,285.0,2439354.28999999,Bulk Rice,Lisset Limpio -020,RETAIL SEDANOS,1382944,Apr
2024-04-03,Sedanos Supermarkets #22,Invoice,008-02826,Dry Beans:Dry Beans - Black Beans 50,Dry Black Beans 50 lb,3.0,42.5,127.5,2439481.78999999,Dry Beans,Lisset Limpio -020,RETAIL SEDANOS,1382945,Apr
2024-04-03,Sedanos Supermarkets #22,Invoice,008-02826,,Discount,,,-8.25,2439473.53999999,,Lisset Limpio -020,RETAIL SEDANOS,1382946,Apr
2024-04-03,El Palacio de Los Jugos / Casa mía Food Restaurant inc,Invoice,008-02827,Arroz a Granel:Parboiled 50 LB -Bolsa Dos Hermanos.,,15.0,27.75,416.25,2439889.78999999,Bulk Rice,Lisset Limpio -020,Cafeteria,1382947,Apr
2024-04-03,Sedanos Supermarkets #18,Invoice,008-02828,Arroz a Granel:Parboiled 50 LB -Bolsa Dos Hermanos.,,10.0,28.5,285.0,2440174.78999999,Bulk Rice,Lisset Limpio -020,RETAIL SEDANOS,1382948,Apr
2024-04-03,Sedanos Supermarkets #18,Invoice,008-02828,,Discount,,,-5.7,2440169.08999999,,Lisset Limpio -020,RETAIL SEDANOS,1382949,Apr
2024-04-03,Sedanos Supermarkets  #4,Invoice,008-02829,"Rice Snack:Rice Snack, Pizza DH",,1.0,19.9,19.9,2440188.98999999,Puffed Products,Lisset Limpio -020,RETAIL SEDANOS,1382950,Apr
2024-04-03,Sedanos Supermarkets  #4,Invoice,008-02829,Rice Snack:Rice Snack Salami Flavored DOS HERMANOS,,1.0,19.9,19.9,2440208.88999999,Puffed Products,Lisset Limpio -020,RETAIL SEDANOS,1382951,Apr
2024-04-03,Sedanos Supermarkets  #4,Invoice,008-02829,Rice Snack:Rice Snack Ham Flavored DOS HERMANOS,,2.0,19.9,39.8,2440248.68999999,Puffed Products,Lisset Limpio -020,RETAIL SEDANOS,1382952,Apr
2024-04-03,Sedanos Supermarkets  #4,Invoice,008-02829,,Discount,,,-1.19,2440247.49999999,,Lisset Limpio -020,RETAIL SEDANOS,1382953,Apr
2024-04-03,Ideal Food Basket Davie Cafeteria,Invoice,008-02830,Arroz a Granel:Largo Fino 50 LB -Bolsa Dos Hermanos.,,12.0,27.25,327.0,2440574.49999999,Bulk Rice,Keila Alfaro-Visvikis,CAFETERIA y RESTAURANTS,1382954,Apr
2024-04-03,Sedanos Supermarkets #38,Invoice,008-02831,Dry Beans:Dry Beans - Black Beans 50,Dry Black Beans 50 lb,2.0,42.5,85.0,2440659.49999999,Dry Beans,Lisset Limpio -020,RETAIL SEDANOS,1382955,Apr
2024-04-03,Sedanos Supermarkets #38,Invoice,008-02831,Arroz a Granel:Largo Fino 50 LB -Bolsa Dos Hermanos.,,4.0,27.85,111.4,2440770.89999999,Bulk Rice,Lisset Limpio -020,RETAIL SEDANOS,1382956,Apr
2024-04-03,Sedanos Supermarkets #38,Invoice,008-02831,,Discount,,,-3.93,2440766.96999999,,Lisset Limpio -020,RETAIL SEDANOS,1382957,Apr
2024-04-03,Sedanos Supermarkets #38,Invoice,008-02832,Rice Snack:Rice Snack Ham Flavored DOS HERMANOS,,2.0,19.9,39.8,2440806.76999999,Puffed Products,Lisset Limpio -020,RETAIL SEDANOS,1382958,Apr
2024-04-03,Sedanos Supermarkets #38,Invoice,008-02832,"Rice Snack:Rice Snack, Pizza DH",,1.0,19.9,19.9,2440826.66999999,Puffed Products,Lisset Limpio -020,RETAIL SEDANOS,1382959,Apr
2024-04-03,Sedanos Supermarkets #38,Invoice,008-02832,Rice Snack:Rice Snack Salami Flavored DOS HERMANOS,,1.0,19.9,19.9,2440846.56999999,Puffed Products,Lisset Limpio -020,RETAIL SEDANOS,1382960,Apr
2024-04-03,Sedanos Supermarkets #38,Invoice,008-02832,,Discount,,,-1.19,2440845.37999999,,Lisset Limpio -020,RETAIL SEDANOS,1382961,Apr
2024-04-03,Sedanos Supermarkets  #4,Credit Memo,008-03017,Varios:Promotional Allowance,"Rice Snack:Rice Snack, Pizza DH",-1.0,19.9,-19.9,2440825.47999999,Puffed Products,Lisset Limpio -020,RETAIL SEDANOS,1382962,Apr
2024-04-03,Sedanos Supermarkets #38,Credit Memo,008-03018,Varios:Promotional Allowance,Rice Snack:Rice Snack Salami Flavored DOS HERMANOS,-1.0,19.9,-19.9,2440805.57999999,Puffed Products,Lisset Limpio -020,RETAIL SEDANOS,1382963,Apr
2024-04-04,Family and Son,Invoice,008-02824,Arroz a Granel:Parboiled 50 LB -Bolsa Dos Hermanos.,,1100.0,27.25,29975.0,2470780.57999999,Bulk Rice,Armando Carpio - 017,WHOLESALER MANUFACTURY,1382964,Apr
2024-04-04,Soriano Brothers PB,Invoice,008-02845,Spices:AS Sazon (for all),1 / 30 lb (box or pail),1.0,59.0,59.0,2470839.57999999,American Spice,Lisset Limpio -020,CAFETERIA y RESTAURANTS,1382965,Apr
2024-04-04,Soriano Brothers PB,Invoice,008-02845,Dry Beans:Dry Beans - Black Beans 50,Dry Black Beans 50 lb,2.0,42.5,85.0,2470924.57999999,Dry Beans,Lisset Limpio -020,CAFETERIA y RESTAURANTS,1382966,Apr
2024-04-04,Soriano Brothers PB,Invoice,008-02845,Arroz a Granel:Parboiled 50 LB -Bolsa Dos Hermanos.,,7.0,27.75,194.25,2471118.82999999,Bulk Rice,Lisset Limpio -020,CAFETERIA y RESTAURANTS,1382967,Apr
2024-04-04,El Palacio de los jugos / Caribe Tropical,Invoice,008-02846,Arroz a Granel:Largo Fino 50 LB -Bolsa Dos Hermanos.,,8.0,27.25,218.0,2471336.82999999,Bulk Rice,Lisset Limpio -020,Cafeteria,1382968,Apr
2024-04-04,El Palacio de los jugos / Caribe Tropical,Invoice,008-02846,Arroz a Granel:Parboiled 50 LB -Bolsa Dos Hermanos.,,10.0,27.75,277.5,2471614.32999999,Bulk Rice,Lisset Limpio -020,Cafeteria,1382969,Apr
2024-04-04,El Palacio de los jugos / Caribe Tropical,Invoice,008-02846,Spices:AS Chicken Base,1 / 30 lb. (box or pail),1.0,39.0,39.0,2471653.32999999,American Spice,Lisset Limpio -020,Cafeteria,1382970,Apr
2024-04-04,El Palacio de los jugos / Caribe Tropical,Invoice,008-02846,Spices:AS Sazon (for all),1 / 30 lb (box or pail),1.0,59.0,59.0,2471712.32999999,American Spice,Lisset Limpio -020,Cafeteria,1382971,Apr
2024-04-04,El Palacio de los jugos /  Nanos Latin Foods,Invoice,008-02847,Arroz a Granel:Parboiled 50 LB -Bolsa Dos Hermanos.,,10.0,27.75,277.5,2471989.82999999,Bulk Rice,Lisset Limpio -020,Cafeteria,1382972,Apr
2024-04-04,El Palacio de los jugos /  Nanos Latin Foods,Invoice,008-02847,Spices:AS Chicken Base,1 / 30 lb. (box or pail),1.0,39.0,39.0,2472028.82999999,American Spice,Lisset Limpio -020,Cafeteria,1382973,Apr
2024-04-04,El Gallego Supermarket,Invoice,008-02848,Dry Beans:Dry Beans - Black Beans 50,Dry Black Beans 50 lb,2.0,42.5,85.0,2472113.82999999,Dry Beans,Lisset Limpio -020,RETAIL  DSD,1382974,Apr
2024-04-04,El Gallego Supermarket,Invoice,008-02848,Arroz a Granel:Parboiled 50 LB -Bolsa Dos Hermanos.,,5.0,27.75,138.75,2472252.57999999,Bulk Rice,Lisset Limpio -020,RETAIL  DSD,1382975,Apr
2024-04-04,Los Caringas Latin America  Foods,Invoice,008-02849,Arroz a Granel:Largo Fino 50 LB -Bolsa Dos Hermanos.,,3.0,27.25,81.75,2472334.32999999,Bulk Rice,Lisset Limpio -020,CAFETERIA y RESTAURANTS,1382976,Apr
2024-04-04,Los Caringas Latin America  Foods,Invoice,008-02849,Arroz a Granel:Parboiled 50 LB -Bolsa Dos Hermanos.,,3.0,27.75,83.25,2472417.57999999,Bulk Rice,Lisset Limpio -020,CAFETERIA y RESTAURANTS,1382977,Apr
2024-04-04,El Palacio de los jugos /  EMMA FOOD CORP,Invoice,008-02850,Arroz a Granel:Largo Fino 50 LB -Bolsa Dos Hermanos.,,7.0,27.25,190.75,2472608.32999999,Bulk Rice,Lisset Limpio -020,Cafeteria,1382978,Apr
2024-04-04,El Palacio de los jugos /  EMMA FOOD CORP,Invoice,008-02850,Arroz a Granel:Parboiled 50 LB -Bolsa Dos Hermanos.,,7.0,27.75,194.25,2472802.57999999,Bulk Rice,Lisset Limpio -020,Cafeteria,1382979,Apr
2024-04-04,Bravo   Francisco Diaz,Invoice,008-02851,Arroz a Granel:Largo Fino 50 LB -Bolsa Dos Hermanos.,,6.0,27.25,163.5,2472966.07999999,Bulk Rice,Lisset Limpio -020,RETAIL  DSD,1382980,Apr
2024-04-04,Bravo   Francisco Diaz,Invoice,008-02851,Liquids:AS Cooking Wine,4/1 Gl.,2.0,17.5,35.0,2473001.07999999,American Spice,Lisset Limpio -020,RETAIL  DSD,1382981,Apr
2024-04-04,"Soriano Brothers Diaz Food Service,Inc",Invoice,008-02852,Arroz a Granel:Parboiled 50 LB -Bolsa Dos Hermanos.,,20.0,27.75,555.0,2473556.07999999,Bulk Rice,Lisset Limpio -020,CAFETERIA y RESTAURANTS,1382982,Apr
2024-04-04,"Soriano Brothers Diaz Food Service,Inc",Invoice,008-02852,Dry Beans:Dry Beans - Black Beans 50,Dry Black Beans 50 lb,8.0,42.5,340.0,2473896.07999999,Dry Beans,Lisset Limpio -020,CAFETERIA y RESTAURANTS,1382983,Apr
2024-04-04,El Palacio de los jugos / Lita Foods Inc.,Invoice,008-02853,Arroz a Granel:Parboiled 50 LB -Bolsa Dos Hermanos.,,6.0,27.75,166.5,2474062.57999999,Bulk Rice,Lisset Limpio -020,Cafeteria,1382984,Apr
2024-04-07,Fritanga Momotombo,Invoice,008-02861,Arroz a Granel:Largo Fino 50 LB -Bolsa Dos Hermanos.,,5.0,27.25,136.25,2474198.82999999,Bulk Rice,Lisset Limpio -020,CAFETERIA y RESTAURANTS,1382985,Apr
2024-04-07,El Palacio de Los Jugos / Casa mía Food Restaurant inc,Invoice,008-02862,Arroz a Granel:Parboiled 50 LB -Bolsa Dos Hermanos.,,5.0,27.75,138.75,2474337.57999999,Bulk Rice,Lisset Limpio -020,Cafeteria,1382986,Apr
2024-04-07,Soriano Brothers PB,Invoice,008-02863,Arroz a Granel:Largo Fino 50 LB -Bolsa Dos Hermanos.,,0.0,,0.0,2474337.57999999,Bulk Rice,Lisset Limpio -020,CAFETERIA y RESTAURANTS,1382987,Apr
2024-04-07,Soriano Brothers PB,Invoice,008-02863,Arroz a Granel:Parboiled 50 LB -Bolsa Dos Hermanos.,,0.0,,0.0,2474337.57999999,Bulk Rice,Lisset Limpio -020,CAFETERIA y RESTAURANTS,1382988,Apr
2024-04-07,Hings Chinese,Invoice,008-02864,Arroz a Granel:Parboiled 50 LB -Bolsa Dos Hermanos.,,5.0,27.75,138.75,2474476.32999999,Bulk Rice,Lisset Limpio -020,CAFETERIA y RESTAURANTS,1382989,Apr
2024-04-07,El Palacio de los jugos / Caribe Tropical,Invoice,008-02865,Arroz a Granel:Largo Fino 50 LB -Bolsa Dos Hermanos.,,4.0,27.25,109.0,2474585.32999999,Bulk Rice,Lisset Limpio -020,Cafeteria,1382990,Apr
2024-04-07,El Palacio de los jugos / Caribe Tropical,Invoice,008-02865,Arroz a Granel:Parboiled 50 LB -Bolsa Dos Hermanos.,,8.0,27.75,222.0,2474807.32999999,Bulk Rice,Lisset Limpio -020,Cafeteria,1382991,Apr
2024-04-07,El Palacio de los jugos / Lita Foods Inc.,Invoice,008-02866,Arroz a Granel:Parboiled 50 LB -Bolsa Dos Hermanos.,,10.0,27.75,277.5,2475084.82999999,Bulk Rice,Lisset Limpio -020,Cafeteria,1382992,Apr
2024-04-07,El Palacio de los jugos /  EMMA FOOD CORP,Invoice,008-02867,Arroz a Granel:Largo Fino 50 LB -Bolsa Dos Hermanos.,,5.0,27.25,136.25,2475221.07999999,Bulk Rice,Lisset Limpio -020,Cafeteria,1382993,Apr
2024-04-07,El Palacio de los jugos /  EMMA FOOD CORP,Invoice,008-02867,Arroz a Granel:Parboiled 50 LB -Bolsa Dos Hermanos.,,7.0,27.75,194.25,2475415.32999999,Bulk Rice,Lisset Limpio -020,Cafeteria,1382994,Apr
2024-04-07,El Palacio de los jugos /  Nanos Latin Foods,Invoice,008-02868,Arroz a Granel:Largo Fino 50 LB -Bolsa Dos Hermanos.,,10.0,27.25,272.5,2475687.82999999,Bulk Rice,Lisset Limpio -020,Cafeteria,1382995,Apr
2024-04-07,El Palacio de los jugos /  Nanos Latin Foods,Invoice,008-02868,Arroz a Granel:Parboiled 50 LB -Bolsa Dos Hermanos.,,8.0,27.75,222.0,2475909.82999999,Bulk Rice,Lisset Limpio -020,Cafeteria,1382996,Apr
2024-04-07,"El Toro Loco Meat Distribution, LLC",Invoice,008-02869,Arroz a Granel:Largo Fino 50 LB -Bolsa Dos Hermanos.,,55.0,27.25,1498.75,2477408.57999999,Bulk Rice,Lisset Limpio -020,CAFETERIA y RESTAURANTS,1382997,Apr
2024-04-09,Mei Chang,Invoice,008-02870,Arroz a Granel:Parboiled 50 LB -Bolsa Dos Hermanos.,,5.0,27.75,138.75,2477547.32999999,Bulk Rice,Lisset Limpio -020,CAFETERIA y RESTAURANTS,1382998,Apr
2024-04-09,Mei Chang,Invoice,008-02870,Arroz a Granel:Largo Fino 50 LB -Bolsa Dos Hermanos.,,2.0,27.25,54.5,2477601.82999999,Bulk Rice,Lisset Limpio -020,CAFETERIA y RESTAURANTS,1382999,Apr
2024-04-09,Sedanos Supermarkets #36,Invoice,008-02871,,,,0.0,0.0,2477601.82999999,,Keila Alfaro-Visvikis,RETAIL SEDANOS,1383000,Apr
2024-04-09,Sedanos Supermarkets #36,Invoice,008-02871,Rice Snack:Rice Snack Salami Flavored DOS HERMANOS,,2.0,19.9,39.8,2477641.62999999,Puffed Products,Keila Alfaro-Visvikis,RETAIL SEDANOS,1383001,Apr
2024-04-09,Sedanos Supermarkets #36,Invoice,008-02871,"Rice Snack:Rice Snack, Pizza DH",,1.0,19.9,19.9,2477661.52999999,Puffed Products,Keila Alfaro-Visvikis,RETAIL SEDANOS,1383002,Apr
2024-04-09,Sedanos Supermarkets #36,Invoice,008-02871,,Discount,,,-1.19,2477660.33999999,,Keila Alfaro-Visvikis,RETAIL SEDANOS,1383003,Apr
2024-04-09,Sedanos Supermarkets #20,Invoice,008-02872,Rice Snack:Rice Snack Salami Flavored DOS HERMANOS,,2.0,19.9,39.8,2477700.13999999,Puffed Products,Keila Alfaro-Visvikis,RETAIL SEDANOS,1383004,Apr
2024-04-09,Sedanos Supermarkets #20,Invoice,008-02872,"Rice Snack:Rice Snack, Pizza DH",,1.0,19.9,19.9,2477720.03999999,Puffed Products,Keila Alfaro-Visvikis,RETAIL SEDANOS,1383005,Apr
2024-04-09,Sedanos Supermarkets #20,Invoice,008-02872,,Discount,,,-1.19,2477718.84999999,,Keila Alfaro-Visvikis,RETAIL SEDANOS,1383006,Apr
2024-04-09,Sedanos Supermarkets #34,Invoice,008-02873,Rice Snack:Rice Snack Salami Flavored DOS HERMANOS,,1.0,19.9,19.9,2477738.74999999,Puffed Products,Keila Alfaro-Visvikis,RETAIL SEDANOS,1383007,Apr
2024-04-09,Sedanos Supermarkets #34,Invoice,008-02873,"Rice Snack:Rice Snack, Pizza DH",,1.0,19.9,19.9,2477758.64999999,Puffed Products,Keila Alfaro-Visvikis,RETAIL SEDANOS,1383008,Apr
2024-04-09,Sedanos Supermarkets #34,Invoice,008-02873,,Discount,,,-0.8,2477757.84999999,,Keila Alfaro-Visvikis,RETAIL SEDANOS,1383009,Apr
2024-04-09,Sedanos Supermarkets #27,Invoice,008-02874,Dry Beans:Dry Beans - Black Beans 50,Dry Black Beans 50 lb,1.0,42.5,42.5,2477800.34999999,Dry Beans,Keila Alfaro-Visvikis,RETAIL SEDANOS,1383010,Apr
2024-04-09,Sedanos Supermarkets #27,Invoice,008-02874,Arroz a Granel:Parboiled 50 LB -Bolsa Dos Hermanos.,,8.0,28.5,228.0,2478028.34999999,Bulk Rice,Keila Alfaro-Visvikis,RETAIL SEDANOS,1383011,Apr
2024-04-09,Sedanos Supermarkets #27,Invoice,008-02874,,Discount,,,-5.41,2478022.93999999,,Keila Alfaro-Visvikis,RETAIL SEDANOS,1383012,Apr
2024-04-09,Ideal Food Basket Davie Cafeteria,Invoice,008-02875,Arroz a Granel:Largo Fino 50 LB -Bolsa Dos Hermanos.,,8.0,27.25,218.0,2478240.93999999,Bulk Rice,Lisset Limpio -020,CAFETERIA y RESTAURANTS,1383013,Apr
2024-04-09,Los Mejores Tamales de Miami,Invoice,008-02876,Arroz a Granel:Parboiled 50 LB -Bolsa Dos Hermanos.,,5.0,27.75,138.75,2478379.68999999,Bulk Rice,Lisset Limpio -020,CAFETERIA y RESTAURANTS,1383014,Apr
2024-04-09,Los Mejores Tamales de Miami,Invoice,008-02876,Arroz a Granel:Largo Fino 50 LB -Bolsa Dos Hermanos.,,5.0,26.5,132.5,2478512.18999999,Bulk Rice,Lisset Limpio -020,CAFETERIA y RESTAURANTS,1383015,Apr
2024-04-09,Bake Mark USA LLC,Invoice,008-02877,Arroz a Granel:Parboiled 50 LB -Bolsa Dos Hermanos.,,1100.0,23.0,25300.0,2503812.18999999,Bulk Rice,Armando Carpio - 017,WHOLESALER MANUFACTURY,1383016,Apr
2024-04-10,Price Choice Food Market # 2,Invoice,008-02878,Arroz Envasado:Parboiled 5KG Dos Hermanos.,6 / 11lbs,5.0,45.5,227.5,2504039.68999999,Branded Rice,Keila Alfaro-Visvikis,RETAIL  DSD,1383017,Apr
2024-04-10,Price Choice Food Market # 2,Invoice,008-02878,Arroz Envasado:Parboiled 5KG Dos Hermanos.,6 / 11lbs,1.0,45.5,45.5,2504085.18999999,Branded Rice,Keila Alfaro-Visvikis,RETAIL  DSD,1383018,Apr
2024-04-10,Sedanos Supermarkets #33,Invoice,008-02879,Arroz a Granel:Parboiled 50 LB -Bolsa Dos Hermanos.,,3.0,28.5,85.5,2504170.68999999,Bulk Rice,Lisset Limpio -020,RETAIL SEDANOS,1383019,Apr
2024-04-10,Sedanos Supermarkets #33,Invoice,008-02879,Dry Beans:Dry Beans - Black Beans 50,Dry Black Beans 50 lb,2.0,42.5,85.0,2504255.68999999,Dry Beans,Lisset Limpio -020,RETAIL SEDANOS,1383020,Apr
2024-04-10,Sedanos Supermarkets #33,Invoice,008-02879,,Discount,,,-3.41,2504252.27999999,,Lisset Limpio -020,RETAIL SEDANOS,1383021,Apr
2024-04-10,Sedanos Supermarkets #16,Invoice,008-02880,Arroz a Granel:Parboiled 50 LB -Bolsa Dos Hermanos.,,4.0,28.5,114.0,2504366.27999999,Bulk Rice,Lisset Limpio -020,RETAIL SEDANOS,1383022,Apr
2024-04-10,Sedanos Supermarkets #16,Invoice,008-02880,Dry Beans:Dry Beans - Black Beans 50,Dry Black Beans 50 lb,2.0,42.5,85.0,2504451.27999999,Dry Beans,Lisset Limpio -020,RETAIL SEDANOS,1383023,Apr
2024-04-10,Sedanos Supermarkets #16,Invoice,008-02880,,Discount,,,-3.98,2504447.29999999,,Lisset Limpio -020,RETAIL SEDANOS,1383024,Apr
2024-04-10,Food Fair Plantation Corp,Invoice,008-02881,Arroz Envasado:Parboiled 5KG Dos Hermanos.,6 / 11lbs,10.0,45.5,455.0,2504902.29999999,Branded Rice,Keila Alfaro-Visvikis,RETAIL  DSD,1383025,Apr
2024-04-10,Food Fair Plantation Corp,Invoice,008-02881,Arroz a Granel:Parboiled 50 LB -Bolsa Dos Hermanos.,,55.0,27.5,1512.5,2506414.79999999,Bulk Rice,Keila Alfaro-Visvikis,RETAIL  DSD,1383026,Apr
2024-04-10,Food Fair Plantation Corp,Invoice,008-02881,Arroz Envasado:Parboiled 5KG Dos Hermanos.,6 / 11lbs,1.0,45.5,45.5,2506460.29999999,Branded Rice,Keila Alfaro-Visvikis,RETAIL  DSD,1383027,Apr
2024-04-10,Albert Deli #2,Invoice,008-02882,Arroz a Granel:Largo Fino 50 LB -Bolsa Dos Hermanos.,,6.0,27.25,163.5,2506623.79999999,Bulk Rice,Keila Alfaro-Visvikis,CAFETERIA y RESTAURANTS,1383028,Apr
2024-04-10,Albert Deli #2,Invoice,008-02882,Arroz a Granel:Parboiled 50 LB -Bolsa Dos Hermanos.,,5.0,28.5,142.5,2506766.29999999,Bulk Rice,Keila Alfaro-Visvikis,CAFETERIA y RESTAURANTS,1383029,Apr
2024-04-10,Albert Deli #2,Invoice,008-02882,Dry Beans:Dry Beans - Black Beans 50,Dry Black Beans 50 lb,1.0,42.5,42.5,2506808.79999999,Dry Beans,Keila Alfaro-Visvikis,CAFETERIA y RESTAURANTS,1383030,Apr
2024-04-10,Sedanos Supermarkets #14,Invoice,008-02883,Arroz Envasado:Parboiled 5KG Dos Hermanos.,6 / 11lbs,5.0,40.5,202.5,2507011.29999999,Branded Rice,Lisset Limpio -020,RETAIL SEDANOS,1383031,Apr
2024-04-10,Sedanos Supermarkets #14,Invoice,008-02883,Arroz Envasado:Parboiled 5KG Dos Hermanos.,6 / 11lbs,5.0,40.5,202.5,2507213.79999999,Branded Rice,Lisset Limpio -020,RETAIL SEDANOS,1383032,Apr
2024-04-10,Sedanos Supermarkets #14,Invoice,008-02883,,Discount,,,-4.05,2507209.74999999,,Lisset Limpio -020,RETAIL SEDANOS,1383033,Apr
2024-04-10,Food Fair Plantation Corp,Credit Memo,008-03019,Varios:Promotional Allowance,Arroz Envasado:Parboiled 5KG Dos Hermanos.,-1.0,45.5,-45.5,2507164.24999999,Branded Rice,Keila Alfaro-Visvikis,RETAIL  DSD,1383034,Apr
2024-04-10,Sedanos Supermarkets #14,Credit Memo,008-03020,Varios:Promotional Allowance,Arroz Envasado:Parboiled 5KG Dos Hermanos.,-5.0,40.5,-202.5,2506961.74999999,Branded Rice,Lisset Limpio -020,RETAIL SEDANOS,1383035,Apr
2024-04-10,Price Choice Food Market # 2,Credit Memo,008-03021,Varios:Promotional Allowance,Arroz Envasado:Parboiled 5KG Dos Hermanos.,-1.0,45.5,-45.5,2506916.24999999,Branded Rice,Keila Alfaro-Visvikis,RETAIL  DSD,1383036,Apr
2024-04-12,El Palacio de los jugos / J Mena Corp.,Invoice,008-02884,Arroz a Granel:Parboiled 50 LB -Bolsa Dos Hermanos.,,1.0,27.75,27.75,2506943.99999999,Bulk Rice,Lisset Limpio -020,Cafeteria,1383037,Apr
2024-04-12,Los paraditos chinesse,Invoice,008-02885,Arroz a Granel:Largo Fino 50 LB -Bolsa Dos Hermanos.,,10.0,27.25,272.5,2507216.49999999,Bulk Rice,Lisset Limpio -020,CAFETERIA y RESTAURANTS,1383038,Apr
2024-04-12,Los paraditos chinesse,Invoice,008-02885,Arroz a Granel:Parboiled 50 LB -Bolsa Dos Hermanos.,,10.0,27.75,277.5,2507493.99999999,Bulk Rice,Lisset Limpio -020,CAFETERIA y RESTAURANTS,1383039,Apr
2024-04-12,Rey Chavez Distributor Corp,Invoice,008-02886,Arroz a Granel:Parboiled 50 LB -Bolsa Dos Hermanos.,,110.0,27.75,3052.5,2510546.49999999,Bulk Rice,Lisset Limpio -020,WHOLESALER,1383040,Apr
2024-04-12,El Palacio de los jugos / Sahilys Cafe,Invoice,008-02887,Arroz a Granel:Parboiled 50 LB -Bolsa Dos Hermanos.,,1.0,27.75,27.75,2510574.24999999,Bulk Rice,Lisset Limpio -020,Cafeteria,1383041,Apr
2024-04-12,El Palacio de los jugos / Lita Foods Inc.,Invoice,008-02888,Arroz a Granel:Parboiled 50 LB -Bolsa Dos Hermanos.,,10.0,27.75,277.5,2510851.74999999,Bulk Rice,Lisset Limpio -020,Cafeteria,1383042,Apr
2024-04-12,El Palacio de los jugos /  EMMA FOOD CORP,Invoice,008-02889,Arroz a Granel:Parboiled 50 LB -Bolsa Dos Hermanos.,,8.0,27.75,222.0,2511073.74999999,Bulk Rice,Lisset Limpio -020,Cafeteria,1383043,Apr
2024-04-12,El Palacio de los jugos /  EMMA FOOD CORP,Invoice,008-02889,Arroz a Granel:Largo Fino 50 LB -Bolsa Dos Hermanos.,,6.0,27.25,163.5,2511237.24999999,Bulk Rice,Lisset Limpio -020,Cafeteria,1383044,Apr
2024-04-12,El Palacio de los jugos /  Nanos Latin Foods,Invoice,008-02890,Arroz a Granel:Largo Fino 50 LB -Bolsa Dos Hermanos.,,2.0,27.25,54.5,2511291.74999999,Bulk Rice,Lisset Limpio -020,Cafeteria,1383045,Apr
2024-04-12,El Palacio de los jugos /  Nanos Latin Foods,Invoice,008-02890,Arroz a Granel:Parboiled 50 LB -Bolsa Dos Hermanos.,,10.0,27.75,277.5,2511569.24999999,Bulk Rice,Lisset Limpio -020,Cafeteria,1383046,Apr
2024-04-12,El Palacio de Los Jugos / Casa mía Food Restaurant inc,Invoice,008-02891,Arroz a Granel:Parboiled 50 LB -Bolsa Dos Hermanos.,,12.0,27.75,333.0,2511902.24999999,Bulk Rice,Lisset Limpio -020,Cafeteria,1383047,Apr
2024-04-12,El Palacio de los jugos / Caribe Tropical,Invoice,008-02892,Arroz a Granel:Largo Fino 50 LB -Bolsa Dos Hermanos.,,5.0,27.25,136.25,2512038.49999999,Bulk Rice,Lisset Limpio -020,Cafeteria,1383048,Apr
2024-04-12,El Palacio de los jugos / Caribe Tropical,Invoice,008-02892,Arroz a Granel:Parboiled 50 LB -Bolsa Dos Hermanos.,,8.0,27.75,222.0,2512260.49999999,Bulk Rice,Lisset Limpio -020,Cafeteria,1383049,Apr
2024-04-15,El Palacio de Los Jugos / Casa mía Food Restaurant inc,Invoice,008-02893,Arroz a Granel:Parboiled 50 LB -Bolsa Dos Hermanos.,,8.0,27.75,222.0,2512482.49999999,Bulk Rice,Lisset Limpio -020,Cafeteria,1383050,Apr
2024-04-15,El Palacio de los jugos /  EMMA FOOD CORP,Invoice,008-02894,Arroz a Granel:Largo Fino 50 LB -Bolsa Dos Hermanos.,,7.0,27.25,190.75,2512673.24999999,Bulk Rice,Lisset Limpio -020,Cafeteria,1383051,Apr
2024-04-15,El Palacio de los jugos /  EMMA FOOD CORP,Invoice,008-02894,Arroz a Granel:Parboiled 50 LB -Bolsa Dos Hermanos.,,6.0,27.75,166.5,2512839.74999999,Bulk Rice,Lisset Limpio -020,Cafeteria,1383052,Apr
2024-04-15,El Palacio de los jugos / Lita Foods Inc.,Invoice,008-02895,Arroz a Granel:Parboiled 50 LB -Bolsa Dos Hermanos.,,5.0,27.75,138.75,2512978.49999999,Bulk Rice,Lisset Limpio -020,Cafeteria,1383053,Apr
2024-04-15,El Palacio de los jugos /  Nanos Latin Foods,Invoice,008-02896,Arroz a Granel:Parboiled 50 LB -Bolsa Dos Hermanos.,,8.0,27.75,222.0,2513200.49999999,Bulk Rice,Lisset Limpio -020,Cafeteria,1383054,Apr
2024-04-15,El Palacio de los jugos / Caribe Tropical,Invoice,008-02897,Arroz a Granel:Parboiled 50 LB -Bolsa Dos Hermanos.,,8.0,27.75,222.0,2513422.49999999,Bulk Rice,Lisset Limpio -020,Cafeteria,1383055,Apr
2024-04-15,Food-Star Supermarket,Invoice,008-02898,Arroz Envasado:Largo Fino 1kg (Long grain rice) Dos Hermanos,,10.0,17.0,170.0,2513592.49999999,Branded Rice,Lisset Limpio -020,RETAIL  DSD,1383056,Apr
2024-04-15,Food-Star Supermarket,Invoice,008-02898,Arroz Envasado:Largo Fino 1kg (Long grain rice) Dos Hermanos,,2.0,17.0,34.0,2513626.49999999,Branded Rice,Lisset Limpio -020,RETAIL  DSD,1383057,Apr
2024-04-15,Aries Supermarket & Cafeteria,Invoice,008-02899,Arroz a Granel:Parboiled 50 LB -Bolsa Dos Hermanos.,,10.0,28.8,288.0,2513914.49999999,Bulk Rice,Armando Carpio - 017,CAFETERIA y RESTAURANTS,1383058,Apr
2024-04-15,Food-Star Supermarket,Credit Memo,008-03022,Varios:Promotional Allowance,Arroz Envasado:Largo Fino 1kg (Long grain rice) Dos Hermanos,-2.0,17.0,-34.0,2513880.49999999,Branded Rice,Lisset Limpio -020,RETAIL  DSD,1383059,Apr
2024-04-16,"American Spice Trading Co, Inc.",Invoice,008-02900,Arroz a Granel:Parboiled 50 LB -Bolsa Dos Hermanos.,,1100.0,27.5,30250.0,2544130.49999999,Bulk Rice,Armando Carpio - 017,WHOLESALER MANUFACTURY,1383060,Apr
2024-04-16,"American Spice Trading Co, Inc.",Invoice,008-02901,Arroz a Granel:Parboiled 50 LB -Bolsa Dos Hermanos.,,1100.0,27.5,30250.0,2574380.49999999,Bulk Rice,Armando Carpio - 017,WHOLESALER MANUFACTURY,1383061,Apr
2024-04-16,"Soriano Brothers Diaz Food Service,Inc",Invoice,008-02902,Arroz a Granel:Parboiled 50 LB -Bolsa Dos Hermanos.,,30.0,27.75,832.5,2575212.99999999,Bulk Rice,Lisset Limpio -020,CAFETERIA y RESTAURANTS,1383062,Apr
2024-04-16,"Soriano Brothers Diaz Food Service,Inc",Invoice,008-02902,Arroz a Granel:Largo Fino 50 LB -Bolsa Dos Hermanos.,,30.0,26.5,795.0,2576007.99999999,Bulk Rice,Lisset Limpio -020,CAFETERIA y RESTAURANTS,1383063,Apr
2024-04-16,"Soriano Brothers Diaz Food Service,Inc",Invoice,008-02902,Dry Beans:Dry Beans - Small Red Beans 50 lbs.,Small Red Beans 50 lbs,2.0,44.0,88.0,2576095.99999999,Dry Beans,Lisset Limpio -020,CAFETERIA y RESTAURANTS,1383064,Apr
2024-04-16,Sedanos Supermarkets #31,Invoice,008-02903,Spices:AS Chicken Base 4/5lb,4/5lb,1.0,35.5,35.5,2576131.49999999,American Spice,Lisset Limpio -020,RETAIL SEDANOS,1383065,Apr
2024-04-16,Sedanos Supermarkets #31,Invoice,008-02903,Spices:AS Sazon (for all),1 / 30 lb (box or pail),1.0,59.0,59.0,2576190.49999999,American Spice,Lisset Limpio -020,RETAIL SEDANOS,1383066,Apr
2024-04-16,Sedanos Supermarkets #31,Invoice,008-02903,Arroz a Granel:Parboiled 50 LB -Bolsa Dos Hermanos.,,3.0,28.5,85.5,2576275.99999999,Bulk Rice,Lisset Limpio -020,RETAIL SEDANOS,1383067,Apr
2024-04-16,Sedanos Supermarkets #31,Invoice,008-02903,Dry Beans:Dry Beans - Small Red Beans 50 lbs.,Small Red Beans 50 lbs,1.0,46.0,46.0,2576321.99999999,Dry Beans,Lisset Limpio -020,RETAIL SEDANOS,1383068,Apr
2024-04-16,Sedanos Supermarkets #31,Invoice,008-02903,Arroz a Granel:Largo Fino 50 LB -Bolsa Dos Hermanos.,,1.0,26.5,26.5,2576348.49999999,Bulk Rice,Lisset Limpio -020,RETAIL SEDANOS,1383069,Apr
2024-04-16,Sedanos Supermarkets #31,Invoice,008-02903,,Discount,,,-5.05,2576343.44999999,,Lisset Limpio -020,RETAIL SEDANOS,1383070,Apr
2024-04-16,Sedanos Supermarkets #31,Invoice,008-02904,Arroz Envasado:Parboiled 5KG Dos Hermanos.,6 / 11lbs,10.0,40.5,405.0,2576748.44999999,Branded Rice,Lisset Limpio -020,RETAIL SEDANOS,1383071,Apr
2024-04-16,Sedanos Supermarkets #31,Invoice,008-02904,Arroz Envasado:Parboiled 5KG Dos Hermanos.,6 / 11lbs,10.0,,0.0,2576748.44999999,Branded Rice,Lisset Limpio -020,RETAIL SEDANOS,1383072,Apr
2024-04-16,Sedanos Supermarkets #31,Invoice,008-02904,,Discount,,,-8.1,2576740.34999999,,Lisset Limpio -020,RETAIL SEDANOS,1383073,Apr
2024-04-16,Bravo   Francisco Diaz,Invoice,008-02905,Arroz a Granel:Largo Fino 50 LB -Bolsa Dos Hermanos.,,7.0,27.25,190.75,2576931.09999999,Bulk Rice,Lisset Limpio -020,RETAIL  DSD,1383074,Apr
2024-04-16,Bravo   Francisco Diaz,Invoice,008-02905,Liquids:AS Cooking Wine,4/1 Gl.,4.0,17.5,70.0,2577001.09999999,American Spice,Lisset Limpio -020,RETAIL  DSD,1383075,Apr
2024-04-16,Sedanos Supermarkets #29,Invoice,008-02906,Arroz Envasado:Parboiled 5KG Dos Hermanos.,6 / 11lbs,5.0,40.5,202.5,2577203.59999999,Branded Rice,Lisset Limpio -020,RETAIL SEDANOS,1383076,Apr
2024-04-16,Sedanos Supermarkets #29,Invoice,008-02906,Arroz Envasado:Parboiled 5KG Dos Hermanos.,6 / 11lbs,5.0,40.5,202.5,2577406.09999999,Branded Rice,Lisset Limpio -020,RETAIL SEDANOS,1383077,Apr
2024-04-16,Sedanos Supermarkets #29,Invoice,008-02906,,Discount,,,-4.05,2577402.04999999,,Lisset Limpio -020,RETAIL SEDANOS,1383078,Apr
2024-04-16,Sedanos Supermarkets #29,Credit Memo,008-03023,Varios:Promotional Allowance,Arroz Envasado:Parboiled 5KG Dos Hermanos.,-5.0,40.5,-202.5,2577199.54999999,Branded Rice,Lisset Limpio -020,RETAIL SEDANOS,1383079,Apr
2024-04-17,Sabor Tropical Supermarket #7,Invoice,008-02907,Arroz Envasado:Largo Fino 1kg (Long grain rice) Dos Hermanos,,1.0,17.0,17.0,2577216.54999999,Branded Rice,Keila Alfaro-Visvikis,RETAIL  DSD,1383080,Apr
2024-04-17,Sabor Tropical Supermarket #7,Invoice,008-02907,Arroz Envasado:Parboiled 1kg Bolsa Dos Hermanos.,.,1.0,19.9,19.9,2577236.44999999,Branded Rice,Keila Alfaro-Visvikis,RETAIL  DSD,1383081,Apr
2024-04-17,Sabor Tropical Supermarket #7,Invoice,008-02907,Rice Snack:Rice Snack Salami Flavored DOS HERMANOS,,1.0,19.9,19.9,2577256.34999999,Puffed Products,Keila Alfaro-Visvikis,RETAIL  DSD,1383082,Apr
2024-04-17,Sabor Tropical Supermarket #7,Invoice,008-02907,"Rice Snack:Rice Snack, Pizza DH",,1.0,19.9,19.9,2577276.24999999,Puffed Products,Keila Alfaro-Visvikis,RETAIL  DSD,1383083,Apr
2024-04-17,Sabor Tropical Supermarket #7,Invoice,008-02907,Tostadas de Arroz:Tostadas de Arroz Saladas 120gr,iC/ii/iD/i16,1.0,19.9,19.9,2577296.14999999,Puffed Products,Keila Alfaro-Visvikis,RETAIL  DSD,1383084,Apr
2024-04-17,Sabor Tropical Supermarket #7,Invoice,008-02907,Rice Cakes:Rice Cakes salty DH,,2.0,19.9,39.8,2577335.94999999,Puffed Products,Keila Alfaro-Visvikis,RETAIL  DSD,1383085,Apr
2024-04-17,Sabor Tropical Supermarket #7,Invoice,008-02907,Rice Snack:Rice Snack Ham Flavored DOS HERMANOS,,1.0,19.9,19.9,2577355.84999999,Puffed Products,Keila Alfaro-Visvikis,RETAIL  DSD,1383086,Apr
2024-04-17,Sabor Tropical Supermarket #7,Invoice,008-02907,Rice Cakes:Rice Cakes salty DH,,1.0,19.9,19.9,2577375.74999999,Puffed Products,Keila Alfaro-Visvikis,RETAIL  DSD,1383087,Apr
2024-04-17,Ideal Food Basket Davie Cafeteria,Invoice,008-02908,Arroz a Granel:Largo Fino 50 LB -Bolsa Dos Hermanos.,,10.0,27.25,272.5,2577648.24999999,Bulk Rice,Keila Alfaro-Visvikis,CAFETERIA y RESTAURANTS,1383088,Apr
2024-04-17,Sedanos Supermarkets #28,Invoice,008-02909,Arroz a Granel:Parboiled 50 LB -Bolsa Dos Hermanos.,,10.0,28.5,285.0,2577933.24999999,Bulk Rice,Lisset Limpio -020,RETAIL SEDANOS,1383089,Apr
2024-04-17,Sedanos Supermarkets #28,Invoice,008-02909,,Discount,,,-5.7,2577927.54999999,,Lisset Limpio -020,RETAIL SEDANOS,1383090,Apr
2024-04-17,Sedanos Supermarkets #16,Invoice,008-02910,Arroz a Granel:Parboiled 50 LB -Bolsa Dos Hermanos.,,4.0,28.5,114.0,2578041.54999999,Bulk Rice,Lisset Limpio -020,RETAIL SEDANOS,1383091,Apr
2024-04-17,Sedanos Supermarkets #16,Invoice,008-02910,,Discount,,,-2.28,2578039.26999999,,Lisset Limpio -020,RETAIL SEDANOS,1383092,Apr
2024-04-17,Sedanos Supermarkets #43,Invoice,008-02911,Arroz a Granel:Parboiled 50 LB -Bolsa Dos Hermanos.,,5.0,28.5,142.5,2578181.76999999,Bulk Rice,Lisset Limpio -020,RETAIL SEDANOS,1383093,Apr
2024-04-17,Sedanos Supermarkets #43,Invoice,008-02911,Dry Beans:Dry Beans - Black Beans 50,Dry Black Beans 50 lb,2.0,42.5,85.0,2578266.76999999,Dry Beans,Lisset Limpio -020,RETAIL SEDANOS,1383094,Apr
2024-04-17,Sedanos Supermarkets #43,Invoice,008-02911,,Discount,,,-4.55,2578262.21999999,,Lisset Limpio -020,RETAIL SEDANOS,1383095,Apr
2024-04-17,Sedanos Supermarkets #34,Invoice,008-02912,Rice Snack:Rice Snack Ham Flavored DOS HERMANOS,,0.0,,0.0,2578262.21999999,Puffed Products,Keila Alfaro-Visvikis,RETAIL SEDANOS,1383096,Apr
2024-04-17,Festival Supermarket #35- Southgate,Invoice,008-02913,Arroz Envasado:Parboiled 5KG Dos Hermanos.,6 / 11lbs,20.5,45.5,932.75,2579194.96999999,Branded Rice,Keila Alfaro-Visvikis,RETAIL  DSD,1383097,Apr
2024-04-17,Festival Supermarket #35- Southgate,Invoice,008-02913,Rice Snack:Rice Snack Ham Flavored DOS HERMANOS,,1.0,19.9,19.9,2579214.86999999,Puffed Products,Keila Alfaro-Visvikis,RETAIL  DSD,1383098,Apr
2024-04-17,Festival Supermarket #35- Southgate,Invoice,008-02913,Rice Snack:Rice Snack Salami Flavored DOS HERMANOS,,1.0,19.9,19.9,2579234.76999999,Puffed Products,Keila Alfaro-Visvikis,RETAIL  DSD,1383099,Apr
2024-04-17,Festival Supermarket #35- Southgate,Invoice,008-02913,"Rice Snack:Rice Snack, Pizza DH",,1.0,19.9,19.9,2579254.66999999,Puffed Products,Keila Alfaro-Visvikis,RETAIL  DSD,1383100,Apr
2024-04-17,Festival Supermarket #35- Southgate,Invoice,008-02913,Arroz Envasado:Parboiled 1kg Bolsa Dos Hermanos.,.,1.0,19.9,19.9,2579274.56999999,Branded Rice,Keila Alfaro-Visvikis,RETAIL  DSD,1383101,Apr
2024-04-17,Festival Supermarket #35- Southgate,Invoice,008-02913,Arroz Envasado:Parboiled 5KG Dos Hermanos.,6 / 11lbs,20.5,45.5,932.75,2580207.31999999,Branded Rice,Keila Alfaro-Visvikis,RETAIL  DSD,1383102,Apr
2024-04-17,Festival Supermarket #35- Southgate,Invoice,008-02913,,,,0.0,0.0,2580207.31999999,,Keila Alfaro-Visvikis,RETAIL  DSD,1383103,Apr
2024-04-17,Key Food / Holywood,Invoice,008-02914,Arroz Envasado:Largo Fino 1kg (Long grain rice) Dos Hermanos,,10.0,17.0,170.0,2580377.31999999,Branded Rice,Keila Alfaro-Visvikis,RETAIL  DSD,1383104,Apr
2024-04-17,Key Food / Holywood,Invoice,008-02914,Arroz Envasado:Parboiled 5KG Dos Hermanos.,6 / 11lbs,5.0,45.5,227.5,2580604.81999999,Branded Rice,Keila Alfaro-Visvikis,RETAIL  DSD,1383105,Apr
2024-04-17,Key Food / Holywood,Invoice,008-02914,Arroz Envasado:Parboiled 5KG Dos Hermanos.,6 / 11lbs,2.0,45.5,91.0,2580695.81999999,Branded Rice,Keila Alfaro-Visvikis,RETAIL  DSD,1383106,Apr
2024-04-17,Key Food / Holywood,Invoice,008-02914,Arroz Envasado:Parboiled 1kg Bolsa Dos Hermanos.,.,2.0,17.0,34.0,2580729.81999999,Branded Rice,Keila Alfaro-Visvikis,RETAIL  DSD,1383107,Apr
2024-04-17,Key Food / Holywood,Invoice,008-02914,Arroz Envasado:Yamani Integral Dos Hermanos,.,1.0,17.0,17.0,2580746.81999999,Branded Rice,Keila Alfaro-Visvikis,RETAIL  DSD,1383108,Apr
2024-04-17,Sedanos Supermarkets #27,Invoice,008-02915,Arroz a Granel:Parboiled 50 LB -Bolsa Dos Hermanos.,,4.0,28.5,114.0,2580860.81999999,Bulk Rice,Keila Alfaro-Visvikis,RETAIL SEDANOS,1383109,Apr
2024-04-17,Sedanos Supermarkets #27,Invoice,008-02915,Dry Beans:Dry Beans - Black Beans 50,Dry Black Beans 50 lb,4.0,42.5,170.0,2581030.81999999,Dry Beans,Keila Alfaro-Visvikis,RETAIL SEDANOS,1383110,Apr
2024-04-17,Sedanos Supermarkets #27,Invoice,008-02915,,Discount,,,-5.68,2581025.13999999,,Keila Alfaro-Visvikis,RETAIL SEDANOS,1383111,Apr
2024-04-17,Key Food / Holywood,Invoice,008-02916,Arroz a Granel:Largo Fino 50 LB -Bolsa Dos Hermanos.,Cafetería Cutting,1.0,23.5,23.5,2581048.63999999,Bulk Rice,Lisset Limpio -020,RETAIL  DSD,1383112,Apr
2024-04-17,Festival Supermarket #35- Southgate,Credit Memo,008-03024,Varios:Promotional Allowance,Arroz Envasado:Parboiled 5KG Dos Hermanos.,-20.5,45.5,-932.75,2580115.88999999,Branded Rice,Keila Alfaro-Visvikis,RETAIL  DSD,1383113,Apr
2024-04-17,Sabor Tropical Supermarket #7,Credit Memo,008-03025,Varios:Promotional Allowance,Rice Snack:Rice Snack Ham Flavored DOS HERMANOS,-1.0,19.9,-19.9,2580095.98999999,Puffed Products,Keila Alfaro-Visvikis,RETAIL  DSD,1383114,Apr
2024-04-17,Sabor Tropical Supermarket #7,Credit Memo,008-03025,Varios:Promotional Allowance,Rice Cakes:Rice Cakes salty DH,-1.0,19.9,-19.9,2580076.08999999,Puffed Products,Keila Alfaro-Visvikis,RETAIL  DSD,1383115,Apr
2024-04-17,Key Food / Holywood,Credit Memo,008-03026,Varios:Promotional Allowance,Arroz Envasado:Parboiled 5KG Dos Hermanos.,-2.0,45.5,-91.0,2579985.08999999,Branded Rice,Lisset Limpio -020,RETAIL  DSD,1383116,Apr
2024-04-17,Key Food / Holywood,Credit Memo,008-03026,Varios:Promotional Allowance,Arroz Envasado:Parboiled 1kg Bolsa Dos Hermanos.,-2.0,17.0,-34.0,2579951.08999999,Branded Rice,Lisset Limpio -020,RETAIL  DSD,1383117,Apr
2024-04-17,Key Food / Holywood,Credit Memo,008-03026,Varios:Promotional Allowance,Arroz Envasado:Yamani Integral Dos Hermanos,-1.0,17.0,-17.0,2579934.08999999,Branded Rice,Lisset Limpio -020,RETAIL  DSD,1383118,Apr
2024-04-17,Key Food / Holywood,Credit Memo,008-03027,Varios:Promotional Allowance,Arroz a Granel:Largo Fino 50 LB -Bolsa Dos Hermanos.,-1.0,23.5,-23.5,2579910.58999999,Bulk Rice,Lisset Limpio -020,RETAIL  DSD,1383119,Apr
2024-04-18,Festival Supermarket Margate,Invoice,008-02917,Arroz Envasado:Parboiled 5KG Dos Hermanos.,6 / 11lbs,20.5,45.5,932.75,2580843.33999999,Branded Rice,Keila Alfaro-Visvikis,RETAIL  DSD,1383120,Apr
2024-04-18,Festival Supermarket Margate,Invoice,008-02917,Arroz Envasado:Parboiled 1kg Bolsa Dos Hermanos.,.,1.0,19.0,19.0,2580862.33999999,Branded Rice,Keila Alfaro-Visvikis,RETAIL  DSD,1383121,Apr
2024-04-18,Festival Supermarket Margate,Invoice,008-02917,Rice Snack:Rice Snack Ham Flavored DOS HERMANOS,,1.0,19.9,19.9,2580882.23999999,Puffed Products,Keila Alfaro-Visvikis,RETAIL  DSD,1383122,Apr
2024-04-18,Festival Supermarket Margate,Invoice,008-02917,Rice Snack:Rice Snack Salami Flavored DOS HERMANOS,,1.0,19.9,19.9,2580902.13999999,Puffed Products,Keila Alfaro-Visvikis,RETAIL  DSD,1383123,Apr
2024-04-18,Festival Supermarket Margate,Invoice,008-02917,"Rice Snack:Rice Snack, Pizza DH",,1.0,19.9,19.9,2580922.03999999,Puffed Products,Keila Alfaro-Visvikis,RETAIL  DSD,1383124,Apr
2024-04-18,Sedanos Supermarkets #40,Invoice,008-02918,Arroz a Granel:Parboiled 50 LB -Bolsa Dos Hermanos.,Cafetería / Igor,55.0,28.0,1540.0,2582462.03999999,Bulk Rice,Armando Carpio - 017,RETAIL SEDANOS,1383125,Apr
2024-04-18,Sedanos Supermarkets #40,Invoice,008-02918,,Discount,,,-30.8,2582431.23999999,,Armando Carpio - 017,RETAIL SEDANOS,1383126,Apr
2024-04-18,Sedanos Supermarkets #40,Invoice,008-02919,Arroz Envasado:Parboiled 5KG Dos Hermanos.,6 / 11lbs,5.0,40.5,202.5,2582633.73999999,Branded Rice,Armando Carpio - 017,RETAIL SEDANOS,1383127,Apr
2024-04-18,Sedanos Supermarkets #40,Invoice,008-02919,Arroz Envasado:Parboiled 5KG Dos Hermanos.,6 / 11lbs,5.0,40.5,202.5,2582836.23999999,Branded Rice,Armando Carpio - 017,RETAIL SEDANOS,1383128,Apr
2024-04-18,Sedanos Supermarkets #40,Invoice,008-02919,,Discount,,,-4.05,2582832.18999999,,Armando Carpio - 017,RETAIL SEDANOS,1383129,Apr
2024-04-18,Sedanos Supermarkets #41,Invoice,008-02920,Arroz Envasado:Parboiled 5KG Dos Hermanos.,6 / 11lbs,20.0,40.5,810.0,2583642.18999999,Branded Rice,Armando Carpio - 017,RETAIL SEDANOS,1383130,Apr
2024-04-18,Sedanos Supermarkets #41,Invoice,008-02920,Arroz Envasado:Parboiled 5KG Dos Hermanos.,6 / 11lbs,20.0,40.5,810.0,2584452.18999999,Branded Rice,Armando Carpio - 017,RETAIL SEDANOS,1383131,Apr
2024-04-18,Sedanos Supermarkets #41,Invoice,008-02920,,Discount,,,-16.2,2584435.98999999,,Armando Carpio - 017,RETAIL SEDANOS,1383132,Apr
2024-04-18,El Gallego Supermarket,Invoice,008-02922,Arroz Envasado:Largo Fino 1kg (Long grain rice) Dos Hermanos,,1.0,17.0,17.0,2584452.98999999,Branded Rice,Lisset Limpio -020,RETAIL  DSD,1383133,Apr
2024-04-18,El Gallego Supermarket,Invoice,008-02922,Arroz a Granel:Parboiled 50 LB -Bolsa Dos Hermanos.,,5.0,28.5,142.5,2584595.48999999,Bulk Rice,Lisset Limpio -020,RETAIL  DSD,1383134,Apr
2024-04-18,El Gallego Supermarket,Invoice,008-02922,Dry Beans:Dry Beans - Black Beans 50,Dry Black Beans 50 lb,2.0,42.5,85.0,2584680.48999999,Dry Beans,Lisset Limpio -020,RETAIL  DSD,1383135,Apr
2024-04-18,Fritanga Momotombo,Invoice,008-02923,Arroz a Granel:Largo Fino 50 LB -Bolsa Dos Hermanos.,,5.0,27.25,136.25,2584816.73999999,Bulk Rice,Lisset Limpio -020,CAFETERIA y RESTAURANTS,1383136,Apr
2024-04-18,El Palacio de Los Jugos / Casa mía Food Restaurant inc,Invoice,008-02924,Arroz a Granel:Parboiled 50 LB -Bolsa Dos Hermanos.,,10.0,27.75,277.5,2585094.23999999,Bulk Rice,Lisset Limpio -020,Cafeteria,1383137,Apr
2024-04-18,El Palacio de los jugos / Lita Foods Inc.,Invoice,008-02925,Arroz a Granel:Parboiled 50 LB -Bolsa Dos Hermanos.,,10.0,27.75,277.5,2585371.73999999,Bulk Rice,Lisset Limpio -020,Cafeteria,1383138,Apr
2024-04-18,Sedanos Supermarkets #34,Invoice,008-02926,Dry Beans:Dry Beans - Black Beans 50,Dry Black Beans 50 lb,4.0,42.5,170.0,2585541.73999999,Dry Beans,Keila Alfaro-Visvikis,RETAIL SEDANOS,1383139,Apr
2024-04-18,Sedanos Supermarkets #34,Invoice,008-02926,Arroz a Granel:Parboiled 50 LB -Bolsa Dos Hermanos.,,8.0,28.5,228.0,2585769.73999999,Bulk Rice,Keila Alfaro-Visvikis,RETAIL SEDANOS,1383140,Apr
2024-04-18,Sedanos Supermarkets #34,Invoice,008-02926,,Discount,,,-7.96,2585761.77999999,,Keila Alfaro-Visvikis,RETAIL SEDANOS,1383141,Apr
2024-04-18,El Palacio de los jugos /  Nanos Latin Foods,Invoice,008-02927,Arroz a Granel:Largo Fino 50 LB -Bolsa Dos Hermanos.,,6.0,26.5,159.0,2585920.77999999,Bulk Rice,Lisset Limpio -020,Cafeteria,1383142,Apr
2024-04-18,El Palacio de los jugos /  Nanos Latin Foods,Invoice,008-02927,Arroz a Granel:Parboiled 50 LB -Bolsa Dos Hermanos.,,10.0,27.75,277.5,2586198.27999999,Bulk Rice,Lisset Limpio -020,Cafeteria,1383143,Apr
2024-04-18,Hings Chinese,Invoice,008-02928,Arroz a Granel:Parboiled 50 LB -Bolsa Dos Hermanos.,,5.0,27.75,138.75,2586337.02999999,Bulk Rice,Lisset Limpio -020,CAFETERIA y RESTAURANTS,1383144,Apr
2024-04-18,Los Caringas Latin America  Foods,Invoice,008-02929,Arroz a Granel:Largo Fino 50 LB -Bolsa Dos Hermanos.,,3.0,27.25,81.75,2586418.77999999,Bulk Rice,Lisset Limpio -020,CAFETERIA y RESTAURANTS,1383145,Apr
2024-04-18,Los Caringas Latin America  Foods,Invoice,008-02929,Arroz a Granel:Parboiled 50 LB -Bolsa Dos Hermanos.,,3.0,27.75,83.25,2586502.02999999,Bulk Rice,Lisset Limpio -020,CAFETERIA y RESTAURANTS,1383146,Apr
2024-04-18,El Palacio de los jugos /  EMMA FOOD CORP,Invoice,008-02930,Arroz a Granel:Largo Fino 50 LB -Bolsa Dos Hermanos.,,6.0,26.5,159.0,2586661.02999999,Bulk Rice,Lisset Limpio -020,Cafeteria,1383147,Apr
2024-04-18,El Palacio de los jugos /  EMMA FOOD CORP,Invoice,008-02930,Arroz a Granel:Parboiled 50 LB -Bolsa Dos Hermanos.,,8.0,27.75,222.0,2586883.02999999,Bulk Rice,Lisset Limpio -020,Cafeteria,1383148,Apr
2024-04-18,El Palacio de los jugos / Caribe Tropical,Invoice,008-02931,Arroz a Granel:Parboiled 50 LB -Bolsa Dos Hermanos.,,8.0,27.75,222.0,2587105.02999999,Bulk Rice,Lisset Limpio -020,Cafeteria,1383149,Apr
2024-04-18,Pacifico Chinese Restaurant,Invoice,008-02932,Arroz a Granel:Parboiled 50 LB -Bolsa Dos Hermanos.,,10.0,27.75,277.5,2587382.52999999,Bulk Rice,Lisset Limpio -020,CAFETERIA y RESTAURANTS,1383150,Apr
2024-04-18,Sedanos Supermarkets #33,Invoice,008-02933,Arroz a Granel:Parboiled 50 LB -Bolsa Dos Hermanos.,,2.0,28.5,57.0,2587439.52999999,Bulk Rice,Lisset Limpio -020,RETAIL SEDANOS,1383151,Apr
2024-04-18,Sedanos Supermarkets #33,Invoice,008-02933,Dry Beans:Dry Beans - Black Beans 50,Dry Black Beans 50 lb,1.0,42.0,42.0,2587481.52999999,Dry Beans,Lisset Limpio -020,RETAIL SEDANOS,1383152,Apr
2024-04-18,Sedanos Supermarkets #33,Invoice,008-02933,,Discount,,,-1.98,2587479.54999999,,Lisset Limpio -020,RETAIL SEDANOS,1383153,Apr
2024-04-18,Fritanga Momotombo,Invoice,008-02934,Dry Beans:Dry Beans - Small Red Beans 50 lbs.,Small Red Beans 50 lbs,1.0,46.0,46.0,2587525.54999999,Dry Beans,Lisset Limpio -020,CAFETERIA y RESTAURANTS,1383154,Apr
2024-04-18,Sedanos Supermarkets #40,Credit Memo,008-03028,Varios:Promotional Allowance,Arroz Envasado:Parboiled 5KG Dos Hermanos.,-5.0,40.5,-202.5,2587323.04999999,Branded Rice,Armando Carpio - 017,RETAIL SEDANOS,1383155,Apr
2024-04-19,Los Mejores Tamales de Miami,Invoice,008-02921,Arroz a Granel:Parboiled 50 LB -Bolsa Dos Hermanos.,,5.0,28.5,142.5,2587465.54999999,Bulk Rice,Armando Carpio - 017,CAFETERIA y RESTAURANTS,1383156,Apr
2024-04-19,Sedanos Supermarkets #41,Credit Memo,008-03029,Varios:Promotional Allowance,Arroz Envasado:Parboiled 5KG Dos Hermanos.,-20.0,40.5,-810.0,2586655.54999999,Branded Rice,Armando Carpio - 017,RETAIL SEDANOS,1383157,Apr
2024-04-22,El Palacio de Los Jugos / Casa mía Food Restaurant inc,Invoice,008-02935,Arroz a Granel:Parboiled 50 LB -Bolsa Dos Hermanos.,,8.0,27.75,222.0,2586877.54999999,Bulk Rice,Lisset Limpio -020,Cafeteria,1383158,Apr
2024-04-22,"Virtue Distributor, Inc",Invoice,008-02936,Arroz a Granel:Largo Fino 50 LB -Bolsa Dos Hermanos.,,55.0,27.15,1493.25,2588370.79999999,Bulk Rice,Armando Carpio - 017,Distributor,1383159,Apr
2024-04-22,El Palacio de los jugos /  Nanos Latin Foods,Invoice,008-02937,Arroz a Granel:Largo Fino 50 LB -Bolsa Dos Hermanos.,,6.0,27.25,163.5,2588534.29999999,Bulk Rice,Lisset Limpio -020,Cafeteria,1383160,Apr
2024-04-22,El Palacio de los jugos /  Nanos Latin Foods,Invoice,008-02937,Arroz a Granel:Parboiled 50 LB -Bolsa Dos Hermanos.,,6.0,27.75,166.5,2588700.79999999,Bulk Rice,Lisset Limpio -020,Cafeteria,1383161,Apr
2024-04-22,El Palacio de los jugos /  EMMA FOOD CORP,Invoice,008-02938,Arroz a Granel:Largo Fino 50 LB -Bolsa Dos Hermanos.,,4.0,27.25,109.0,2588809.79999999,Bulk Rice,Lisset Limpio -020,Cafeteria,1383162,Apr
2024-04-22,El Palacio de los jugos /  EMMA FOOD CORP,Invoice,008-02938,Arroz a Granel:Parboiled 50 LB -Bolsa Dos Hermanos.,,8.0,27.75,222.0,2589031.79999999,Bulk Rice,Lisset Limpio -020,Cafeteria,1383163,Apr
2024-04-22,El Palacio de los jugos / Caribe Tropical,Invoice,008-02939,Arroz a Granel:Parboiled 50 LB -Bolsa Dos Hermanos.,,10.0,27.75,277.5,2589309.29999999,Bulk Rice,Lisset Limpio -020,Cafeteria,1383164,Apr
2024-04-24,"American Spice Trading Co, Inc.",Invoice,008-02940,Arroz a Granel:Parboiled 50 LB -Bolsa Dos Hermanos.,PO 13458,1100.0,27.5,30250.0,2619559.29999999,Bulk Rice,Armando Carpio - 017,WHOLESALER MANUFACTURY,1383165,Apr
2024-04-24,Sedanos Supermarkets #8,Invoice,008-02941,Arroz Envasado:Parboiled 5KG Dos Hermanos.,6 / 11lbs,20.0,40.5,810.0,2620369.29999999,Branded Rice,Lisset Limpio -020,RETAIL SEDANOS,1383166,Apr
2024-04-24,Sedanos Supermarkets #8,Invoice,008-02941,Arroz Envasado:Parboiled 5KG Dos Hermanos.,6 / 11lbs,20.0,40.5,810.0,2621179.29999999,Branded Rice,Lisset Limpio -020,RETAIL SEDANOS,1383167,Apr
2024-04-24,Sedanos Supermarkets #8,Invoice,008-02941,Rice Snack:Rice Snack Ham Flavored DOS HERMANOS,,1.0,19.9,19.9,2621199.19999999,Puffed Products,Lisset Limpio -020,RETAIL SEDANOS,1383168,Apr
2024-04-24,Sedanos Supermarkets #8,Invoice,008-02941,Rice Snack:Rice Snack Salami Flavored DOS HERMANOS,,1.0,19.9,19.9,2621219.09999999,Puffed Products,Lisset Limpio -020,RETAIL SEDANOS,1383169,Apr
2024-04-24,Sedanos Supermarkets #8,Invoice,008-02941,"Rice Snack:Rice Snack, Pizza DH",,1.0,19.9,19.9,2621238.99999999,Puffed Products,Lisset Limpio -020,RETAIL SEDANOS,1383170,Apr
2024-04-24,Sedanos Supermarkets #8,Invoice,008-02941,Rice Snack:Rice Snack Salami Flavored DOS HERMANOS,,1.0,19.9,19.9,2621258.89999999,Puffed Products,Lisset Limpio -020,RETAIL SEDANOS,1383171,Apr
2024-04-24,Sedanos Supermarkets #8,Invoice,008-02941,,Discount,,,-17.39,2621241.50999999,,Lisset Limpio -020,RETAIL SEDANOS,1383172,Apr
2024-04-24,Sedanos Supermarkets #9,Invoice,008-02942,Arroz Envasado:Parboiled 5KG Dos Hermanos.,6 / 11lbs,10.0,40.5,405.0,2621646.50999999,Branded Rice,Lisset Limpio -020,RETAIL SEDANOS,1383173,Apr
2024-04-24,Sedanos Supermarkets #9,Invoice,008-02942,Arroz Envasado:Parboiled 5KG Dos Hermanos.,6 / 11lbs,10.0,40.5,405.0,2622051.50999999,Branded Rice,Lisset Limpio -020,RETAIL SEDANOS,1383174,Apr
2024-04-24,Sedanos Supermarkets #10,Invoice,008-02943,Arroz Envasado:Parboiled 5KG Dos Hermanos.,6 / 11lbs,10.0,40.5,405.0,2622456.50999999,Branded Rice,Lisset Limpio -020,RETAIL SEDANOS,1383175,Apr
2024-04-24,Sedanos Supermarkets #10,Invoice,008-02943,Arroz Envasado:Parboiled 5KG Dos Hermanos.,6 / 11lbs,10.0,40.5,405.0,2622861.50999999,Branded Rice,Lisset Limpio -020,RETAIL SEDANOS,1383176,Apr
2024-04-24,Sedanos Supermarkets #10,Invoice,008-02943,,Discount,,,-8.1,2622853.40999999,,Lisset Limpio -020,RETAIL SEDANOS,1383177,Apr
2024-04-24,Sedanos Supermarkets #22,Invoice,008-02944,Arroz Envasado:Parboiled 5KG Dos Hermanos.,6 / 11lbs,10.0,40.5,405.0,2623258.40999999,Branded Rice,Lisset Limpio -020,RETAIL SEDANOS,1383178,Apr
2024-04-24,Sedanos Supermarkets #22,Invoice,008-02944,Arroz Envasado:Parboiled 5KG Dos Hermanos.,6 / 11lbs,10.0,40.5,405.0,2623663.40999999,Branded Rice,Lisset Limpio -020,RETAIL SEDANOS,1383179,Apr
2024-04-24,Sedanos Supermarkets #22,Invoice,008-02944,,Discount,,,-8.1,2623655.30999999,,Lisset Limpio -020,RETAIL SEDANOS,1383180,Apr
2024-04-24,Sedanos Supermarkets #26,Invoice,008-02945,Arroz Envasado:Parboiled 5KG Dos Hermanos.,6 / 11lbs,10.0,40.5,405.0,2624060.30999999,Branded Rice,Lisset Limpio -020,RETAIL SEDANOS,1383181,Apr
2024-04-24,Sedanos Supermarkets #26,Invoice,008-02945,Arroz Envasado:Parboiled 5KG Dos Hermanos.,6 / 11lbs,10.0,40.5,405.0,2624465.30999999,Branded Rice,Lisset Limpio -020,RETAIL SEDANOS,1383182,Apr
2024-04-24,Sedanos Supermarkets #26,Invoice,008-02945,,Discount,,,-3.42,2624461.88999999,,Lisset Limpio -020,RETAIL SEDANOS,1383183,Apr
2024-04-24,Sedanos Supermarkets #28,Invoice,008-02946,Arroz Envasado:Parboiled 5KG Dos Hermanos.,6 / 11lbs,20.0,40.5,810.0,2625271.88999999,Branded Rice,Keila Alfaro-Visvikis,RETAIL SEDANOS,1383184,Apr
2024-04-24,Sedanos Supermarkets #28,Invoice,008-02946,Arroz Envasado:Parboiled 5KG Dos Hermanos.,6 / 11lbs,20.0,40.5,810.0,2626081.88999999,Branded Rice,Keila Alfaro-Visvikis,RETAIL SEDANOS,1383185,Apr
2024-04-24,Sedanos Supermarkets #28,Invoice,008-02946,,Discount,,,-16.2,2626065.68999999,,Keila Alfaro-Visvikis,RETAIL SEDANOS,1383186,Apr
2024-04-24,Sedanos Supermarkets #43,Invoice,008-02947,Arroz Envasado:Parboiled 5KG Dos Hermanos.,6 / 11lbs,20.0,40.5,810.0,2626875.68999999,Branded Rice,Lisset Limpio -020,RETAIL SEDANOS,1383187,Apr
2024-04-24,Sedanos Supermarkets #43,Invoice,008-02947,Arroz Envasado:Parboiled 5KG Dos Hermanos.,6 / 11lbs,20.0,40.5,810.0,2627685.68999999,Branded Rice,Lisset Limpio -020,RETAIL SEDANOS,1383188,Apr
2024-04-24,Sedanos Supermarkets #43,Invoice,008-02947,,Discount,,,-16.2,2627669.48999999,,Lisset Limpio -020,RETAIL SEDANOS,1383189,Apr
2024-04-24,Los paraditos chinesse,Invoice,008-02948,Arroz a Granel:Largo Fino 50 LB -Bolsa Dos Hermanos.,,10.0,26.5,265.0,2627934.48999999,Bulk Rice,Lisset Limpio -020,CAFETERIA y RESTAURANTS,1383190,Apr
2024-04-24,Los paraditos chinesse,Invoice,008-02948,Arroz a Granel:Parboiled 50 LB -Bolsa Dos Hermanos.,,5.0,27.75,138.75,2628073.23999999,Bulk Rice,Lisset Limpio -020,CAFETERIA y RESTAURANTS,1383191,Apr
2024-04-24,Sedanos Supermarkets #16,Invoice,008-02949,Arroz a Granel:Parboiled 50 LB -Bolsa Dos Hermanos.,,4.0,28.5,114.0,2628187.23999999,Bulk Rice,Lisset Limpio -020,RETAIL SEDANOS,1383192,Apr
2024-04-24,Sedanos Supermarkets #16,Invoice,008-02949,,Discount,,,-2.28,2628184.95999999,,Lisset Limpio -020,RETAIL SEDANOS,1383193,Apr
2024-04-24,Sabor Tropical Supermarket #4,Invoice,008-02950,Arroz Envasado:Parboiled 5KG Dos Hermanos.,6 / 11lbs,5.0,45.5,227.5,2628412.45999999,Branded Rice,Keila Alfaro-Visvikis,RETAIL  DSD,1383194,Apr
2024-04-24,Sabor Tropical Supermarket #4,Invoice,008-02950,Arroz Envasado:Parboiled 5KG Dos Hermanos.,6 / 11lbs,2.0,45.5,91.0,2628503.45999999,Branded Rice,Keila Alfaro-Visvikis,RETAIL  DSD,1383195,Apr
2024-04-24,Sedanos Supermarkets #8,Credit Memo,008-03030,Varios:Promotional Allowance,Arroz Envasado:Parboiled 5KG Dos Hermanos.,-20.0,40.5,-810.0,2627693.45999999,Branded Rice,Lisset Limpio -020,RETAIL SEDANOS,1383196,Apr
2024-04-24,Sedanos Supermarkets #8,Credit Memo,008-03030,Varios:Promotional Allowance,Rice Snack:Rice Snack Salami Flavored DOS HERMANOS,-1.0,19.9,-19.9,2627673.55999999,Puffed Products,Lisset Limpio -020,RETAIL SEDANOS,1383197,Apr
2024-04-24,Sedanos Supermarkets #28,Credit Memo,008-03031,Varios:Promotional Allowance,Arroz Envasado:Parboiled 5KG Dos Hermanos.,-20.0,40.5,-810.0,2626863.55999999,Branded Rice,Keila Alfaro-Visvikis,RETAIL SEDANOS,1383198,Apr
2024-04-24,Sedanos Supermarkets #43,Credit Memo,008-03032,Varios:Promotional Allowance,Arroz Envasado:Parboiled 5KG Dos Hermanos.,-20.0,40.5,-810.0,2626053.55999999,Branded Rice,Lisset Limpio -020,RETAIL SEDANOS,1383199,Apr
2024-04-24,Sedanos Supermarkets #9,Credit Memo,008-03033,Varios:Promotional Allowance,Arroz Envasado:Parboiled 5KG Dos Hermanos.,-10.0,40.5,-405.0,2625648.55999999,Branded Rice,Lisset Limpio -020,RETAIL SEDANOS,1383200,Apr
2024-04-24,Sedanos Supermarkets #22,Credit Memo,008-03034,Varios:Promotional Allowance,Arroz Envasado:Parboiled 5KG Dos Hermanos.,-10.0,40.5,-405.0,2625243.55999999,Branded Rice,Lisset Limpio -020,RETAIL SEDANOS,1383201,Apr
2024-04-25,Sedanos Supermarkets #31,Invoice,008-02951,Arroz a Granel:Largo Fino 50 LB -Bolsa Dos Hermanos.,,2.0,27.85,55.7,2625299.25999999,Bulk Rice,Lisset Limpio -020,RETAIL SEDANOS,1383202,Apr
2024-04-25,Sedanos Supermarkets #31,Invoice,008-02951,Dry Beans:Dry Beans - Black Beans 50,Dry Black Beans 50 lb,2.0,42.5,85.0,2625384.25999999,Dry Beans,Lisset Limpio -020,RETAIL SEDANOS,1383203,Apr
2024-04-25,Sedanos Supermarkets #31,Invoice,008-02951,Arroz a Granel:Parboiled 50 LB -Bolsa Dos Hermanos.,,5.0,28.5,142.5,2625526.75999999,Bulk Rice,Lisset Limpio -020,RETAIL SEDANOS,1383204,Apr
2024-04-25,Sedanos Supermarkets #31,Invoice,008-02951,,Discount,,,-5.66,2625521.09999999,,Lisset Limpio -020,RETAIL SEDANOS,1383205,Apr
2024-04-25,Sedanos Supermarkets #31,Invoice,008-02952,Arroz Envasado:Parboiled 5KG Dos Hermanos.,6 / 11lbs,20.0,40.5,810.0,2626331.09999999,Branded Rice,Lisset Limpio -020,RETAIL SEDANOS,1383206,Apr
2024-04-25,Sedanos Supermarkets #31,Invoice,008-02952,Arroz Envasado:Parboiled 5KG Dos Hermanos.,6 / 11lbs,20.0,40.5,810.0,2627141.09999999,Branded Rice,Lisset Limpio -020,RETAIL SEDANOS,1383207,Apr
2024-04-25,Sedanos Supermarkets #31,Invoice,008-02952,,Discount,,,-16.2,2627124.89999999,,Lisset Limpio -020,RETAIL SEDANOS,1383208,Apr
2024-04-25,Sedanos Supermarkets #38,Invoice,008-02953,Arroz a Granel:Largo Fino 50 LB -Bolsa Dos Hermanos.,,4.0,27.85,111.4,2627236.29999999,Bulk Rice,Lisset Limpio -020,RETAIL SEDANOS,1383209,Apr
2024-04-25,Sedanos Supermarkets #38,Invoice,008-02953,,Discount,,,-2.23,2627234.06999999,,Lisset Limpio -020,RETAIL SEDANOS,1383210,Apr
2024-04-25,Sedanos Supermarkets #38,Invoice,008-02954,Arroz Envasado:Parboiled 5KG Dos Hermanos.,6 / 11lbs,20.0,40.5,810.0,2628044.06999999,Branded Rice,Lisset Limpio -020,RETAIL SEDANOS,1383211,Apr
2024-04-25,Sedanos Supermarkets #38,Invoice,008-02954,Arroz Envasado:Parboiled 5KG Dos Hermanos.,6 / 11lbs,20.0,40.5,810.0,2628854.06999999,Branded Rice,Lisset Limpio -020,RETAIL SEDANOS,1383212,Apr
2024-04-25,Sedanos Supermarkets #38,Invoice,008-02954,,Discount,,,-16.2,2628837.86999999,,Lisset Limpio -020,RETAIL SEDANOS,1383213,Apr
2024-04-25,Sedanos Supermarkets #32,Invoice,008-02955,Arroz a Granel:Parboiled 50 LB -Bolsa Dos Hermanos.,,6.0,28.5,171.0,2629008.86999999,Bulk Rice,Lisset Limpio -020,RETAIL SEDANOS,1383214,Apr
2024-04-25,Sedanos Supermarkets #32,Invoice,008-02955,,Discount,,,-3.42,2629005.44999999,,Lisset Limpio -020,RETAIL SEDANOS,1383215,Apr
2024-04-25,Sedanos Supermarkets #32,Invoice,008-02956,Arroz Envasado:Parboiled 5KG Dos Hermanos.,6 / 11lbs,10.0,40.5,405.0,2629410.44999999,Branded Rice,Lisset Limpio -020,RETAIL SEDANOS,1383216,Apr
2024-04-25,Sedanos Supermarkets #32,Invoice,008-02956,Arroz Envasado:Parboiled 5KG Dos Hermanos.,6 / 11lbs,10.0,40.5,405.0,2629815.44999999,Branded Rice,Lisset Limpio -020,RETAIL SEDANOS,1383217,Apr
2024-04-25,Sedanos Supermarkets #32,Invoice,008-02956,,Discount,,,-8.1,2629807.34999999,,Lisset Limpio -020,RETAIL SEDANOS,1383218,Apr
2024-04-25,Mei Chang,Invoice,008-02957,Arroz a Granel:Parboiled 50 LB -Bolsa Dos Hermanos.,,5.0,27.75,138.75,2629946.09999999,Bulk Rice,Lisset Limpio -020,CAFETERIA y RESTAURANTS,1383219,Apr
2024-04-25,Mei Chang,Invoice,008-02957,Arroz a Granel:Largo Fino 50 LB -Bolsa Dos Hermanos.,,2.0,27.25,54.5,2630000.59999999,Bulk Rice,Lisset Limpio -020,CAFETERIA y RESTAURANTS,1383220,Apr
2024-04-25,El Palacio de los jugos /  EMMA FOOD CORP,Invoice,008-02958,Arroz a Granel:Parboiled 50 LB -Bolsa Dos Hermanos.,,8.0,27.75,222.0,2630222.59999999,Bulk Rice,Lisset Limpio -020,Cafeteria,1383221,Apr
2024-04-25,El Palacio de los jugos /  Nanos Latin Foods,Invoice,008-02959,Arroz a Granel:Largo Fino 50 LB -Bolsa Dos Hermanos.,,3.0,26.5,79.5,2630302.09999999,Bulk Rice,Lisset Limpio -020,Cafeteria,1383222,Apr
2024-04-25,El Palacio de los jugos /  Nanos Latin Foods,Invoice,008-02959,Arroz a Granel:Parboiled 50 LB -Bolsa Dos Hermanos.,,10.0,27.75,277.5,2630579.59999999,Bulk Rice,Lisset Limpio -020,Cafeteria,1383223,Apr
2024-04-25,El Palacio de los jugos / Caribe Tropical,Invoice,008-02960,Arroz a Granel:Largo Fino 50 LB -Bolsa Dos Hermanos.,,6.0,26.5,159.0,2630738.59999999,Bulk Rice,Lisset Limpio -020,Cafeteria,1383224,Apr
2024-04-25,El Palacio de los jugos / Caribe Tropical,Invoice,008-02960,Arroz a Granel:Parboiled 50 LB -Bolsa Dos Hermanos.,,8.0,27.75,222.0,2630960.59999999,Bulk Rice,Lisset Limpio -020,Cafeteria,1383225,Apr
2024-04-25,El Palacio de Los Jugos / Casa mía Food Restaurant inc,Invoice,008-02961,Arroz a Granel:Parboiled 50 LB -Bolsa Dos Hermanos.,,6.0,27.75,166.5,2631127.09999999,Bulk Rice,Lisset Limpio -020,Cafeteria,1383226,Apr
2024-04-25,Extra Supermarket,Invoice,008-02962,Arroz Envasado:Parboiled 5KG Dos Hermanos.,6 / 11lbs,10.0,45.6,456.0,2631583.09999999,Branded Rice,Lisset Limpio -020,RETAIL  DSD,1383227,Apr
2024-04-25,Extra Supermarket,Invoice,008-02962,Arroz Envasado:Parboiled 5KG Dos Hermanos.,6 / 11lbs,2.0,45.6,91.2,2631674.29999999,Branded Rice,Lisset Limpio -020,RETAIL  DSD,1383228,Apr
2024-04-25,Sedanos Supermarkets #38,Credit Memo,008-03038,Varios:Promotional Allowance,Arroz Envasado:Parboiled 5KG Dos Hermanos.,-20.0,40.5,-810.0,2630864.29999999,Branded Rice,Lisset Limpio -020,RETAIL SEDANOS,1383229,Apr
2024-04-25,Sedanos Supermarkets #32,Credit Memo,008-03040,Varios:Promotional Allowance,Arroz Envasado:Parboiled 5KG Dos Hermanos.,-10.0,40.5,-405.0,2630459.29999999,Branded Rice,Lisset Limpio -020,RETAIL SEDANOS,1383230,Apr
2024-04-25,Extra Supermarket,Credit Memo,008-03041,Varios:Promotional Allowance,Arroz Envasado:Parboiled 5KG Dos Hermanos.,-2.0,45.6,-91.2,2630368.09999999,Branded Rice,Lisset Limpio -020,RETAIL  DSD,1383231,Apr
2024-04-25,Sedanos Supermarkets #31,Credit Memo,008-03042,Varios:Promotional Allowance,Arroz Envasado:Parboiled 5KG Dos Hermanos.,-20.0,40.5,-810.0,2629558.09999999,Branded Rice,Lisset Limpio -020,RETAIL SEDANOS,1383232,Apr
2024-04-25,Sedanos Supermarkets #34,Credit Memo,008-03043,Varios:Promotional Allowance,Arroz Envasado:Parboiled 5KG Dos Hermanos.,-10.0,40.5,-405.0,2629153.09999999,Branded Rice,Keila Alfaro-Visvikis,RETAIL SEDANOS,1383233,Apr
2024-04-25,Sedanos Supermarkets #27,Credit Memo,008-03044,Varios:Promotional Allowance,Arroz Envasado:Parboiled 5KG Dos Hermanos.,-10.0,40.5,-405.0,2628748.09999999,Branded Rice,Keila Alfaro-Visvikis,RETAIL SEDANOS,1383234,Apr
2024-04-25,Sedanos Supermarkets #24,Credit Memo,008-03045,Varios:Promotional Allowance,Arroz Envasado:Parboiled 5KG Dos Hermanos.,-15.0,40.5,-607.5,2628140.59999999,Branded Rice,Keila Alfaro-Visvikis,RETAIL SEDANOS,1383235,Apr
2024-04-25,Sedanos Supermarkets #40,Credit Memo,008-03046,Varios:Promotional Allowance,Arroz Envasado:Parboiled 5KG Dos Hermanos.,-18.0,40.5,-729.0,2627411.59999999,Branded Rice,Armando Carpio - 017,RETAIL SEDANOS,1383236,Apr
2024-04-25,Bay supermarket,Credit Memo,008-03047,Varios:Promotional Allowance,Arroz Envasado:Largo Fino 1kg (Long grain rice) Dos Hermanos,-2.0,17.0,-34.0,2627377.59999999,Branded Rice,Keila Alfaro-Visvikis,RETAIL  DSD,1383237,Apr
2024-04-25,Bay supermarket,Credit Memo,008-03047,Varios:Promotional Allowance,Rice Snack:Rice Snack Ham Flavored DOS HERMANOS,-1.0,19.9,-19.9,2627357.69999999,Puffed Products,Keila Alfaro-Visvikis,RETAIL  DSD,1383238,Apr
2024-04-25,Bay supermarket,Credit Memo,008-03047,Varios:Promotional Allowance,Tostadas de Arroz:Tostadas de Arroz Saladas 120gr,-1.0,19.9,-19.9,2627337.79999999,Puffed Products,Keila Alfaro-Visvikis,RETAIL  DSD,1383239,Apr
2024-04-26,BA Food Imports,Credit Memo,008-02963,Varios:Producto vencido/deteriorado (no impacta en inventario),6X5 PARBOIL,-29.0,34.0,-986.0,2626351.79999999,Branded Rice,Armando Carpio - 017,WHOLESALER,1383240,Apr
2024-04-29,Fritanga Momotombo,Invoice,008-02964,Arroz a Granel:Largo Fino 50 LB -Bolsa Dos Hermanos.,,5.0,27.25,136.25,2626488.04999999,Bulk Rice,Lisset Limpio -020,CAFETERIA y RESTAURANTS,1383241,Apr
2024-04-29,Fritanga Momotombo,Invoice,008-02964,Dry Beans:Dry Beans - Small Red Beans 50 lbs.,Small Red Beans 50 lbs,1.0,46.0,46.0,2626534.04999999,Dry Beans,Lisset Limpio -020,CAFETERIA y RESTAURANTS,1383242,Apr
2024-04-29,Hings Chinese,Invoice,008-02965,Arroz a Granel:Parboiled 50 LB -Bolsa Dos Hermanos.,,5.0,27.75,138.75,2626672.79999999,Bulk Rice,Lisset Limpio -020,CAFETERIA y RESTAURANTS,1383243,Apr
2024-04-29,El Palacio de los jugos /  EMMA FOOD CORP,Invoice,008-02966,Arroz a Granel:Parboiled 50 LB -Bolsa Dos Hermanos.,,7.0,27.75,194.25,2626867.04999999,Bulk Rice,Lisset Limpio -020,Cafeteria,1383244,Apr
2024-04-29,El Palacio de Los Jugos / Casa mía Food Restaurant inc,Invoice,008-02967,Arroz a Granel:Parboiled 50 LB -Bolsa Dos Hermanos.,,8.0,27.75,222.0,2627089.04999999,Bulk Rice,Lisset Limpio -020,Cafeteria,1383245,Apr
2024-04-29,El Palacio de los jugos / Caribe Tropical,Invoice,008-02968,Arroz a Granel:Largo Fino 50 LB -Bolsa Dos Hermanos.,,6.0,26.5,159.0,2627248.04999999,Bulk Rice,Lisset Limpio -020,Cafeteria,1383246,Apr
2024-04-29,El Palacio de los jugos / Caribe Tropical,Invoice,008-02968,Arroz a Granel:Parboiled 50 LB -Bolsa Dos Hermanos.,,8.0,27.75,222.0,2627470.04999999,Bulk Rice,Lisset Limpio -020,Cafeteria,1383247,Apr
2024-04-29,El Palacio de los jugos /  Nanos Latin Foods,Invoice,008-02969,Arroz a Granel:Largo Fino 50 LB -Bolsa Dos Hermanos.,,3.0,26.5,79.5,2627549.54999999,Bulk Rice,Lisset Limpio -020,Cafeteria,1383248,Apr
2024-04-29,El Palacio de los jugos /  Nanos Latin Foods,Invoice,008-02969,Arroz a Granel:Parboiled 50 LB -Bolsa Dos Hermanos.,,7.0,27.75,194.25,2627743.79999999,Bulk Rice,Lisset Limpio -020,Cafeteria,1383249,Apr
2024-04-29,Brito Family Corp.,Invoice,008-02970,Arroz a Granel:Parboiled 50 LB -Bolsa Dos Hermanos.,,55.0,25.5,1402.5,2629146.29999999,Bulk Rice,Lisset Limpio -020,CAFETERIA y RESTAURANTS,1383250,Apr
2024-04-29,"YummmyCo, Inc",Invoice,008-02971,Arroz a Granel:Parboiled 50 LB -Bolsa Dos Hermanos.,,55.0,27.5,1512.5,2630658.79999999,Bulk Rice,Armando Carpio - 017,WHOLESALER,1383251,Apr
2024-04-29,Sedanos Supermarkets #20,Credit Memo,008-02972,Varios:Producto vencido/deteriorado (no impacta en inventario),2 unidades Parboiled 5kg,-6.0,3.37,-20.22,2630638.57999999,Branded Rice,Keila Alfaro-Visvikis,RETAIL SEDANOS,1383252,Apr
2024-04-29,Bake Mark USA LLC,Invoice,008-02973,Arroz a Granel:Parboiled 50 LB -Bolsa Dos Hermanos.,PO 42940,1100.0,24.0,26400.0,2657038.57999999,Bulk Rice,Armando Carpio - 017,WHOLESALER MANUFACTURY,1383253,Apr
2024-04-29,Sedanos Supermarkets #27,Invoice,008-02974,Arroz a Granel:Parboiled 50 LB -Bolsa Dos Hermanos.,,6.0,28.25,169.5,2657208.07999999,Bulk Rice,Keila Alfaro-Visvikis,RETAIL SEDANOS,1383254,Apr
2024-04-29,Sedanos Supermarkets #27,Invoice,008-02974,,Discount,,,-3.39,2657204.68999999,,Keila Alfaro-Visvikis,RETAIL SEDANOS,1383255,Apr
2024-04-29,Sedanos Supermarkets #27,Invoice,008-02975,Arroz Envasado:Parboiled 5KG Dos Hermanos.,6 / 11lbs,10.0,40.5,405.0,2657609.68999999,Branded Rice,Keila Alfaro-Visvikis,RETAIL SEDANOS,1383256,Apr
2024-04-29,Sedanos Supermarkets #27,Invoice,008-02975,Arroz Envasado:Parboiled 5KG Dos Hermanos.,6 / 11lbs,10.0,40.5,405.0,2658014.68999999,Branded Rice,Keila Alfaro-Visvikis,RETAIL SEDANOS,1383257,Apr
2024-04-29,Sedanos Supermarkets #27,Invoice,008-02975,,Discount,,,-8.1,2658006.58999999,,Keila Alfaro-Visvikis,RETAIL SEDANOS,1383258,Apr
2024-04-29,Sedanos Supermarkets #34,Invoice,008-02976,Arroz Envasado:Parboiled 5KG Dos Hermanos.,6 / 11lbs,10.0,40.5,405.0,2658411.58999999,Branded Rice,Keila Alfaro-Visvikis,RETAIL SEDANOS,1383259,Apr
2024-04-29,Sedanos Supermarkets #34,Invoice,008-02976,Arroz Envasado:Parboiled 5KG Dos Hermanos.,6 / 11lbs,10.0,40.5,405.0,2658816.58999999,Branded Rice,Keila Alfaro-Visvikis,RETAIL SEDANOS,1383260,Apr
2024-04-29,Sedanos Supermarkets #34,Invoice,008-02976,Rice Snack:Rice Snack Ham Flavored DOS HERMANOS,,1.0,19.9,19.9,2658836.48999999,Puffed Products,Keila Alfaro-Visvikis,RETAIL SEDANOS,1383261,Apr
2024-04-29,Sedanos Supermarkets #34,Invoice,008-02976,,Discount,,,-8.5,2658827.98999999,,Keila Alfaro-Visvikis,RETAIL SEDANOS,1383262,Apr
2024-04-29,Sedanos Supermarkets #24,Invoice,008-02977,Dry Beans:Dry Beans - Black Beans 50,Dry Black Beans 50 lb,2.0,42.5,85.0,2658912.98999999,Dry Beans,Keila Alfaro-Visvikis,RETAIL SEDANOS,1383263,Apr
2024-04-29,Sedanos Supermarkets #24,Invoice,008-02977,Arroz a Granel:Parboiled 50 LB -Bolsa Dos Hermanos.,,14.0,28.25,395.5,2659308.48999999,Bulk Rice,Keila Alfaro-Visvikis,RETAIL SEDANOS,1383264,Apr
2024-04-29,Sedanos Supermarkets #24,Invoice,008-02977,Dry Beans:Dry Beans - Small Red Beans 50 lbs.,Small Red Beans 50 lbs,1.0,46.0,46.0,2659354.48999999,Dry Beans,Keila Alfaro-Visvikis,RETAIL SEDANOS,1383265,Apr
2024-04-29,Sedanos Supermarkets #24,Invoice,008-02977,,Discount,,,-10.53,2659343.95999999,,Keila Alfaro-Visvikis,RETAIL SEDANOS,1383266,Apr
2024-04-29,Sedanos Supermarkets #24,Invoice,008-02978,Arroz Envasado:Parboiled 5KG Dos Hermanos.,6 / 11lbs,15.0,40.5,607.5,2659951.45999999,Branded Rice,Keila Alfaro-Visvikis,RETAIL SEDANOS,1383267,Apr
2024-04-29,Sedanos Supermarkets #24,Invoice,008-02978,Arroz Envasado:Parboiled 5KG Dos Hermanos.,6 / 11lbs,15.0,40.5,607.5,2660558.95999999,Branded Rice,Keila Alfaro-Visvikis,RETAIL SEDANOS,1383268,Apr
2024-04-29,Sedanos Supermarkets #24,Invoice,008-02978,Rice Snack:Rice Snack Ham Flavored DOS HERMANOS,,1.0,19.9,19.9,2660578.85999999,Puffed Products,Keila Alfaro-Visvikis,RETAIL SEDANOS,1383269,Apr
2024-04-29,Sedanos Supermarkets #24,Invoice,008-02978,"Rice Snack:Rice Snack, Pizza DH",,1.0,19.9,19.9,2660598.75999999,Puffed Products,Keila Alfaro-Visvikis,RETAIL SEDANOS,1383270,Apr
2024-04-29,Sedanos Supermarkets #24,Invoice,008-02978,,Discount,,,-12.95,2660585.80999999,,Keila Alfaro-Visvikis,RETAIL SEDANOS,1383271,Apr
2024-04-29,Ideal Food Basket Davie Cafeteria,Invoice,008-02979,Arroz a Granel:Largo Fino 50 LB -Bolsa Dos Hermanos.,,10.0,27.25,272.5,2660858.30999999,Bulk Rice,Keila Alfaro-Visvikis,CAFETERIA y RESTAURANTS,1383272,Apr
2024-04-30,Sedanos Supermarkets #40,Invoice,008-02980,Arroz Envasado:Parboiled 5KG Dos Hermanos.,6 / 11lbs,18.0,40.5,729.0,2661587.30999999,Branded Rice,Armando Carpio - 017,RETAIL SEDANOS,1383273,Apr
2024-04-30,Sedanos Supermarkets #40,Invoice,008-02980,Arroz Envasado:Parboiled 5KG Dos Hermanos.,6 / 11lbs,18.0,40.5,729.0,2662316.30999999,Branded Rice,Armando Carpio - 017,RETAIL SEDANOS,1383274,Apr
2024-04-30,Sedanos Supermarkets #40,Invoice,008-02980,,Discount,,,-14.58,2662301.72999999,,Armando Carpio - 017,RETAIL SEDANOS,1383275,Apr
2024-04-30,Bay supermarket,Invoice,008-02981,Arroz Envasado:Largo Fino 1kg (Long grain rice) Dos Hermanos,,5.0,17.0,85.0,2662386.72999999,Branded Rice,Keila Alfaro-Visvikis,RETAIL  DSD,1383276,Apr
2024-04-30,Bay supermarket,Invoice,008-02981,Rice Snack:Rice Snack Ham Flavored DOS HERMANOS,,1.0,19.9,19.9,2662406.62999999,Puffed Products,Keila Alfaro-Visvikis,RETAIL  DSD,1383277,Apr
2024-04-30,Bay supermarket,Invoice,008-02981,Rice Snack:Rice Snack Salami Flavored DOS HERMANOS,,1.0,19.9,19.9,2662426.52999999,Puffed Products,Keila Alfaro-Visvikis,RETAIL  DSD,1383278,Apr
2024-04-30,Bay supermarket,Invoice,008-02981,"Rice Snack:Rice Snack, Pizza DH",,1.0,19.9,19.9,2662446.42999999,Puffed Products,Keila Alfaro-Visvikis,RETAIL  DSD,1383279,Apr
2024-04-30,Bay supermarket,Invoice,008-02981,Arroz Envasado:Largo Fino 1kg (Long grain rice) Dos Hermanos,,2.0,17.0,34.0,2662480.42999999,Branded Rice,Keila Alfaro-Visvikis,RETAIL  DSD,1383280,Apr
2024-04-30,Bay supermarket,Invoice,008-02981,Rice Snack:Rice Snack Ham Flavored DOS HERMANOS,,1.0,19.9,19.9,2662500.32999999,Puffed Products,Keila Alfaro-Visvikis,RETAIL  DSD,1383281,Apr
2024-04-30,Bay supermarket,Invoice,008-02981,Tostadas de Arroz:Tostadas de Arroz Saladas 120gr,iC/ii/iD/i16,1.0,19.9,19.9,2662520.22999999,Puffed Products,Keila Alfaro-Visvikis,RETAIL  DSD,1383282,Apr
2024-05-01,Arias Supermarket,Invoice,008-02982,Arroz a Granel:Parboiled 50 LB -Bolsa Dos Hermanos.,,8.0,28.8,230.4,2662750.62999999,Bulk Rice,Lisset Limpio -020,CAFETERIA y RESTAURANTS,1383283,May
2024-05-01,Sedanos Supermarkets #33,Invoice,008-02983,Arroz a Granel:Parboiled 50 LB -Bolsa Dos Hermanos.,,4.0,28.5,114.0,2662864.62999999,Bulk Rice,Lisset Limpio -020,RETAIL SEDANOS,1383284,May
2024-05-01,Sedanos Supermarkets #33,Invoice,008-02983,,Discount,,,-2.28,2662862.34999999,,Lisset Limpio -020,RETAIL SEDANOS,1383285,May
2024-05-01,Sedanos Supermarkets #42,Invoice,008-02984,Arroz a Granel:Parboiled 50 LB -Bolsa Dos Hermanos.,,10.0,28.5,285.0,2663147.34999999,Bulk Rice,Lisset Limpio -020,RETAIL SEDANOS,1383286,May
2024-05-01,Sedanos Supermarkets #42,Invoice,008-02984,,Discount,,,-5.7,2663141.64999999,,Lisset Limpio -020,RETAIL SEDANOS,1383287,May
2024-05-01,Sedanos Supermarkets #22,Invoice,008-02985,Arroz a Granel:Parboiled 50 LB -Bolsa Dos Hermanos.,,5.0,28.5,142.5,2663284.14999999,Bulk Rice,Lisset Limpio -020,RETAIL SEDANOS,1383288,May
2024-05-01,Sedanos Supermarkets #22,Invoice,008-02985,,Discount,,,-2.85,2663281.29999999,,Lisset Limpio -020,RETAIL SEDANOS,1383289,May
2024-05-01,Sedanos Supermarkets #28,Invoice,008-02986,Rice Snack:Rice Snack Ham Flavored DOS HERMANOS,,2.0,19.9,39.8,2663321.09999999,Puffed Products,Lisset Limpio -020,RETAIL SEDANOS,1383290,May
2024-05-01,Sedanos Supermarkets #28,Invoice,008-02986,Rice Snack:Rice Snack Salami Flavored DOS HERMANOS,,1.0,19.9,19.9,2663340.99999999,Puffed Products,Lisset Limpio -020,RETAIL SEDANOS,1383291,May
2024-05-01,Sedanos Supermarkets #28,Invoice,008-02986,"Rice Snack:Rice Snack, Pizza DH",,1.0,19.9,19.9,2663360.89999999,Puffed Products,Lisset Limpio -020,RETAIL SEDANOS,1383292,May
2024-05-01,Sedanos Supermarkets #28,Invoice,008-02986,,Discount,,,-1.19,2663359.70999999,,Lisset Limpio -020,RETAIL SEDANOS,1383293,May
2024-05-01,Sedanos Supermarkets #14,Invoice,008-02987,Arroz Envasado:Parboiled 5KG Dos Hermanos.,6 / 11lbs,0.0,,0.0,2663359.70999999,Branded Rice,Lisset Limpio -020,RETAIL SEDANOS,1383294,May
2024-05-01,Sedanos Supermarkets #14,Invoice,008-02987,Arroz Envasado:Parboiled 5KG Dos Hermanos.,6 / 11lbs,0.0,0.0,0.0,2663359.70999999,Branded Rice,Lisset Limpio -020,RETAIL SEDANOS,1383295,May
2024-05-01,Sedanos Supermarkets #7,Invoice,008-02988,Arroz Envasado:Parboiled 5KG Dos Hermanos.,6 / 11lbs,8.0,40.5,324.0,2663683.70999999,Branded Rice,Lisset Limpio -020,RETAIL SEDANOS,1383296,May
2024-05-01,Sedanos Supermarkets #7,Invoice,008-02988,Arroz Envasado:Parboiled 5KG Dos Hermanos.,6 / 11lbs,8.0,40.5,324.0,2664007.70999999,Branded Rice,Lisset Limpio -020,RETAIL SEDANOS,1383297,May
2024-05-01,Sedanos Supermarkets #7,Invoice,008-02988,,Discount,,,-6.48,2664001.22999999,,Lisset Limpio -020,RETAIL SEDANOS,1383298,May
2024-05-01,Sedanos Supermarkets  #4,Invoice,008-02989,Arroz Envasado:Parboiled 5KG Dos Hermanos.,6 / 11lbs,7.0,40.5,283.5,2664284.72999999,Branded Rice,Lisset Limpio -020,RETAIL SEDANOS,1383299,May
2024-05-01,Sedanos Supermarkets  #4,Invoice,008-02989,Arroz Envasado:Parboiled 5KG Dos Hermanos.,6 / 11lbs,7.0,40.5,283.5,2664568.22999999,Branded Rice,Lisset Limpio -020,RETAIL SEDANOS,1383300,May
2024-05-01,Sedanos Supermarkets  #4,Invoice,008-02989,,Discount,,,-5.67,2664562.55999999,,Lisset Limpio -020,RETAIL SEDANOS,1383301,May
2024-05-01,Sedanos Supermarkets #17,Invoice,008-02990,Arroz Envasado:Parboiled 5KG Dos Hermanos.,6 / 11lbs,5.0,40.5,202.5,2664765.05999999,Branded Rice,Lisset Limpio -020,RETAIL SEDANOS,1383302,May
2024-05-01,Sedanos Supermarkets #17,Invoice,008-02990,Arroz Envasado:Parboiled 5KG Dos Hermanos.,6 / 11lbs,5.0,40.5,202.5,2664967.55999999,Branded Rice,Lisset Limpio -020,RETAIL SEDANOS,1383303,May
2024-05-01,Sedanos Supermarkets #17,Invoice,008-02990,,Discount,,,-4.05,2664963.50999999,,Lisset Limpio -020,RETAIL SEDANOS,1383304,May
2024-05-01,Los Mejores Tamales de Miami,Invoice,008-02991,Arroz a Granel:Largo Fino 50 LB -Bolsa Dos Hermanos.,,5.0,26.5,132.5,2665096.00999999,Bulk Rice,Lisset Limpio -020,CAFETERIA y RESTAURANTS,1383305,May
2024-05-01,Los Mejores Tamales de Miami,Invoice,008-02991,Arroz a Granel:Parboiled 50 LB -Bolsa Dos Hermanos.,,5.0,28.5,142.5,2665238.50999999,Bulk Rice,Lisset Limpio -020,CAFETERIA y RESTAURANTS,1383306,May
2024-05-01,Sedanos Supermarkets #28,Credit Memo,008-03161,Varios:Promotional Allowance,"Rice Snack:Rice Snack, Pizza DH",-1.0,19.9,-19.9,2665218.60999999,Puffed Products,Keila Alfaro-Visvikis,RETAIL SEDANOS,1383307,May
2024-05-01,Sedanos Supermarkets #7,Credit Memo,008-03162,Varios:Promotional Allowance,Arroz Envasado:Parboiled 5KG Dos Hermanos.,-8.0,40.5,-324.0,2664894.60999999,Branded Rice,Lisset Limpio -020,RETAIL SEDANOS,1383308,May
2024-05-01,Sedanos Supermarkets #17,Credit Memo,008-03163,Varios:Promotional Allowance,Arroz Envasado:Parboiled 5KG Dos Hermanos.,-5.0,40.5,-202.5,2664692.10999999,Branded Rice,Lisset Limpio -020,RETAIL SEDANOS,1383309,May
2024-05-01,Sedanos Supermarkets  #4,Credit Memo,008-03164,Varios:Promotional Allowance,Arroz Envasado:Parboiled 5KG Dos Hermanos.,-7.0,40.5,-283.5,2664408.60999999,Branded Rice,Lisset Limpio -020,RETAIL SEDANOS,1383310,May
2024-05-02,El Palacio de los jugos / Caribe Tropical,Invoice,008-02992,Arroz a Granel:Largo Fino 50 LB -Bolsa Dos Hermanos.,,4.0,26.5,106.0,2664514.60999999,Bulk Rice,Lisset Limpio -020,Cafeteria,1383311,May
2024-05-02,El Palacio de los jugos / Caribe Tropical,Invoice,008-02992,Arroz a Granel:Parboiled 50 LB -Bolsa Dos Hermanos.,,4.0,27.75,111.0,2664625.60999999,Bulk Rice,Lisset Limpio -020,Cafeteria,1383312,May
2024-05-02,Sedanos Supermarkets #22,Invoice,008-02993,Spices:AS Chicken Base,1 / 30 lb. (box or pail),1.0,39.0,39.0,2664664.60999999,American Spice,Lisset Limpio -020,RETAIL SEDANOS,1383313,May
2024-05-02,Sedanos Supermarkets #22,Invoice,008-02993,,Discount,,,-0.78,2664663.82999999,,Lisset Limpio -020,RETAIL SEDANOS,1383314,May
2024-05-02,Los Caringas Latin America  Foods,Invoice,008-02994,Arroz a Granel:Largo Fino 50 LB -Bolsa Dos Hermanos.,,3.0,26.75,80.25,2664744.07999999,Bulk Rice,Lisset Limpio -020,CAFETERIA y RESTAURANTS,1383315,May
2024-05-02,Los Caringas Latin America  Foods,Invoice,008-02994,Arroz a Granel:Parboiled 50 LB -Bolsa Dos Hermanos.,,3.0,27.75,83.25,2664827.32999999,Bulk Rice,Lisset Limpio -020,CAFETERIA y RESTAURANTS,1383316,May
2024-05-02,"Soriano Brothers Diaz Food Service,Inc",Invoice,008-02995,Arroz a Granel:Largo Fino 50 LB -Bolsa Dos Hermanos.,,10.0,26.5,265.0,2665092.32999999,Bulk Rice,Lisset Limpio -020,CAFETERIA y RESTAURANTS,1383317,May
2024-05-02,"Soriano Brothers Diaz Food Service,Inc",Invoice,008-02995,Arroz a Granel:Parboiled 50 LB -Bolsa Dos Hermanos.,,10.0,27.75,277.5,2665369.82999999,Bulk Rice,Lisset Limpio -020,CAFETERIA y RESTAURANTS,1383318,May
2024-05-02,"Soriano Brothers Diaz Food Service,Inc",Invoice,008-02995,Dry Beans:Dry Beans - Black Beans 50,Dry Black Beans 50 lb,10.0,42.8,428.0,2665797.82999999,Dry Beans,Lisset Limpio -020,CAFETERIA y RESTAURANTS,1383319,May
2024-05-02,"Soriano Brothers Diaz Food Service,Inc",Invoice,008-02995,Dry Beans:Dry Beans - Small Red Beans 50 lbs.,Small Red Beans 50 lbs,3.0,42.0,126.0,2665923.82999999,Dry Beans,Lisset Limpio -020,CAFETERIA y RESTAURANTS,1383320,May
2024-05-02,Bravo   Francisco Diaz,Invoice,008-02996,Arroz a Granel:Largo Fino 50 LB -Bolsa Dos Hermanos.,,3.0,26.5,79.5,2666003.32999999,Bulk Rice,Lisset Limpio -020,RETAIL  DSD,1383321,May
2024-05-02,Sedanos Supermarkets #34,Invoice,008-02997,Arroz a Granel:Parboiled 50 LB -Bolsa Dos Hermanos.,,8.0,28.25,226.0,2666229.32999999,Bulk Rice,Keila Alfaro-Visvikis,RETAIL SEDANOS,1383322,May
2024-05-02,Sedanos Supermarkets #34,Invoice,008-02997,,Discount,,,-4.52,2666224.80999999,,Keila Alfaro-Visvikis,RETAIL SEDANOS,1383323,May
2024-05-02,El Gallego Supermarket,Invoice,008-02998,Arroz a Granel:Parboiled 50 LB -Bolsa Dos Hermanos.,,5.0,28.5,142.5,2666367.30999999,Bulk Rice,Lisset Limpio -020,RETAIL  DSD,1383324,May
2024-05-02,El Gallego Supermarket,Invoice,008-02998,Dry Beans:Dry Beans - Black Beans 50,Dry Black Beans 50 lb,2.0,42.8,85.6,2666452.90999999,Dry Beans,Lisset Limpio -020,RETAIL  DSD,1383325,May
2024-05-02,Rey Chavez Distributor #2,Invoice,008-02999,Arroz a Granel:Parboiled 50 LB -Bolsa Dos Hermanos.,,30.0,27.75,832.5,2667285.40999999,Bulk Rice,Lisset Limpio -020,WHOLESALER,1383326,May
2024-05-02,Sedanos Supermarkets #21,Invoice,008-03000,Arroz Envasado:Parboiled 5KG Dos Hermanos.,6 / 11lbs,10.0,40.5,405.0,2667690.40999999,Branded Rice,Lisset Limpio -020,RETAIL SEDANOS,1383327,May
2024-05-02,Sedanos Supermarkets #21,Invoice,008-03000,Arroz Envasado:Parboiled 5KG Dos Hermanos.,6 / 11lbs,10.0,40.5,405.0,2668095.40999999,Branded Rice,Lisset Limpio -020,RETAIL SEDANOS,1383328,May
2024-05-02,Sedanos Supermarkets #21,Invoice,008-03000,,Discount,,,-8.1,2668087.30999999,,Lisset Limpio -020,RETAIL SEDANOS,1383329,May
2024-05-02,Sedanos Supermarkets #29,Invoice,008-03001,Arroz Envasado:Parboiled 5KG Dos Hermanos.,6 / 11lbs,10.0,40.5,405.0,2668492.30999999,Branded Rice,Lisset Limpio -020,RETAIL SEDANOS,1383330,May
2024-05-02,Sedanos Supermarkets #29,Invoice,008-03001,Arroz Envasado:Parboiled 5KG Dos Hermanos.,6 / 11lbs,10.0,40.5,405.0,2668897.30999999,Branded Rice,Lisset Limpio -020,RETAIL SEDANOS,1383331,May
2024-05-02,Sedanos Supermarkets #29,Invoice,008-03001,,Discount,,,-8.1,2668889.20999999,,Lisset Limpio -020,RETAIL SEDANOS,1383332,May
2024-05-02,Amerifood,Invoice,008-03002,Arroz a Granel:Largo Fino 50 LB -Bolsa Dos Hermanos.,,10.0,26.5,265.0,2669154.20999999,Bulk Rice,Keila Alfaro-Visvikis,WHOLESALER,1383333,May
2024-05-02,Amerifood,Invoice,008-03002,Arroz a Granel:Parboiled 50 LB -Bolsa Dos Hermanos.,,20.0,27.5,550.0,2669704.20999999,Bulk Rice,Keila Alfaro-Visvikis,WHOLESALER,1383334,May
2024-05-02,Amerifood,Invoice,008-03002,Arroz Envasado:Parboiled 1kg Bolsa Dos Hermanos.,.,60.0,18.0,1080.0,2670784.20999999,Branded Rice,Keila Alfaro-Visvikis,WHOLESALER,1383335,May
2024-05-02,Amerifood,Invoice,008-03002,Arroz Envasado:Largo Fino 1kg (Long grain rice) Dos Hermanos,,60.0,16.0,960.0,2671744.20999999,Branded Rice,Keila Alfaro-Visvikis,WHOLESALER,1383336,May
2024-05-02,Amerifood,Invoice,008-03002,Rice Snack:Rice Snack Salami Flavored DOS HERMANOS,,1.0,16.95,16.95,2671761.15999999,Puffed Products,Keila Alfaro-Visvikis,WHOLESALER,1383337,May
2024-05-02,Amerifood,Invoice,008-03002,Rice Snack:Rice Snack Ham Flavored DOS HERMANOS,,1.0,16.95,16.95,2671778.10999999,Puffed Products,Keila Alfaro-Visvikis,WHOLESALER,1383338,May
2024-05-02,Amerifood,Invoice,008-03002,"Rice Snack:Rice Snack, Pizza DH",,1.0,16.95,16.95,2671795.05999999,Puffed Products,Keila Alfaro-Visvikis,WHOLESALER,1383339,May
2024-05-02,Sedanos Supermarkets #21,Credit Memo,008-03165,Varios:Promotional Allowance,Arroz Envasado:Parboiled 5KG Dos Hermanos,-10.0,40.5,-405.0,2671390.05999999,Branded Rice,Lisset Limpio -020,RETAIL SEDANOS,1383340,May
2024-05-02,Sedanos Supermarkets #29,Credit Memo,008-03166,Varios:Promotional Allowance,Arroz Envasado:Parboiled 5KG Dos Hermanos.,-10.0,40.5,-405.0,2670985.05999999,Branded Rice,Lisset Limpio -020,RETAIL SEDANOS,1383341,May
2024-05-06,Hings Chinese,Invoice,008-03003,Arroz a Granel:Parboiled 50 LB -Bolsa Dos Hermanos.,,5.0,27.75,138.75,2671123.80999999,Bulk Rice,Lisset Limpio -020,CAFETERIA y RESTAURANTS,1383342,May
2024-05-06,El Palacio de los jugos /  EMMA FOOD CORP,Invoice,008-03004,Arroz a Granel:Largo Fino 50 LB -Bolsa Dos Hermanos.,,6.0,26.5,159.0,2671282.80999999,Bulk Rice,Lisset Limpio -020,Cafeteria,1383343,May
2024-05-06,El Palacio de los jugos / Caribe Tropical,Invoice,008-03005,Arroz a Granel:Largo Fino 50 LB -Bolsa Dos Hermanos.,,5.0,26.5,132.5,2671415.30999999,Bulk Rice,Lisset Limpio -020,Cafeteria,1383344,May
2024-05-06,El Palacio de los jugos / Caribe Tropical,Invoice,008-03005,Arroz a Granel:Parboiled 50 LB -Bolsa Dos Hermanos.,,8.0,27.75,222.0,2671637.30999999,Bulk Rice,Lisset Limpio -020,Cafeteria,1383345,May
2024-05-06,Sedanos Supermarkets #7,Invoice,008-03006,Rice Snack:Rice Snack Ham Flavored DOS HERMANOS,,1.0,19.9,19.9,2671657.20999999,Puffed Products,Lisset Limpio -020,RETAIL SEDANOS,1383346,May
2024-05-06,Sedanos Supermarkets #7,Invoice,008-03006,Rice Snack:Rice Snack Salami Flavored DOS HERMANOS,,1.0,19.9,19.9,2671677.10999999,Puffed Products,Lisset Limpio -020,RETAIL SEDANOS,1383347,May
2024-05-06,Sedanos Supermarkets #7,Invoice,008-03006,"Rice Snack:Rice Snack, Pizza DH",,1.0,19.9,19.9,2671697.00999999,Puffed Products,Lisset Limpio -020,RETAIL SEDANOS,1383348,May
2024-05-06,Sedanos Supermarkets #7,Invoice,008-03006,"Rice Snack:Rice Snack, Pizza DH",,1.0,19.9,19.9,2671716.90999999,Puffed Products,Lisset Limpio -020,RETAIL SEDANOS,1383349,May
2024-05-06,Sedanos Supermarkets #7,Invoice,008-03006,,Discount,,,-1.19,2671715.71999999,,Lisset Limpio -020,RETAIL SEDANOS,1383350,May
2024-05-06,Sedanos Supermarkets  #37,Invoice,008-03007,Arroz Envasado:Parboiled 5KG Dos Hermanos.,6 / 11lbs,5.0,40.5,202.5,2671918.21999999,Branded Rice,Lisset Limpio -020,RETAIL SEDANOS,1383351,May
2024-05-06,Sedanos Supermarkets  #37,Invoice,008-03007,Arroz Envasado:Parboiled 5KG Dos Hermanos.,6 / 11lbs,5.0,40.5,202.5,2672120.71999999,Branded Rice,Lisset Limpio -020,RETAIL SEDANOS,1383352,May
2024-05-06,Sedanos Supermarkets  #37,Invoice,008-03007,,Discount,,,-4.05,2672116.66999999,,Lisset Limpio -020,RETAIL SEDANOS,1383353,May
2024-05-06,Sedanos Supermarkets #36,Invoice,008-03008,Arroz Envasado:Parboiled 5KG Dos Hermanos.,6 / 11lbs,5.0,40.5,202.5,2672319.16999999,Branded Rice,Keila Alfaro-Visvikis,RETAIL SEDANOS,1383354,May
2024-05-06,Sedanos Supermarkets #36,Invoice,008-03008,Arroz Envasado:Parboiled 5KG Dos Hermanos.,6 / 11lbs,5.0,40.5,202.5,2672521.66999999,Branded Rice,Keila Alfaro-Visvikis,RETAIL SEDANOS,1383355,May
2024-05-06,Sedanos Supermarkets #36,Invoice,008-03008,,Discount,,,-4.05,2672517.61999999,,Keila Alfaro-Visvikis,RETAIL SEDANOS,1383356,May
2024-05-06,Sedanos Supermarkets #18,Invoice,008-03009,Arroz Envasado:Parboiled 5KG Dos Hermanos.,6 / 11lbs,5.0,40.5,202.5,2672720.11999999,Branded Rice,Lisset Limpio -020,RETAIL SEDANOS,1383357,May
2024-05-06,Sedanos Supermarkets #18,Invoice,008-03009,Arroz Envasado:Parboiled 5KG Dos Hermanos.,6 / 11lbs,5.0,40.5,202.5,2672922.61999999,Branded Rice,Lisset Limpio -020,RETAIL SEDANOS,1383358,May
2024-05-06,Sedanos Supermarkets #18,Invoice,008-03009,,Discount,,,-4.05,2672918.56999999,,Lisset Limpio -020,RETAIL SEDANOS,1383359,May
2024-05-06,Sedanos Supermarkets #5,Invoice,008-03010,Arroz Envasado:Parboiled 5KG Dos Hermanos.,6 / 11lbs,0.0,,0.0,2672918.56999999,Branded Rice,Lisset Limpio -020,RETAIL SEDANOS,1383360,May
2024-05-06,Sedanos Supermarkets #5,Invoice,008-03010,Arroz Envasado:Parboiled 5KG Dos Hermanos.,6 / 11lbs,0.0,,0.0,2672918.56999999,Branded Rice,Lisset Limpio -020,RETAIL SEDANOS,1383361,May
2024-05-06,Sedanos Supermarkets #7,Credit Memo,008-03167,Varios:Promotional Allowance,"Rice Snack:Rice Snack, Pizza DH",-1.0,19.9,-19.9,2672898.66999999,Puffed Products,Lisset Limpio -020,RETAIL SEDANOS,1383362,May
2024-05-06,Sedanos Supermarkets  #37,Credit Memo,008-03168,Varios:Promotional Allowance,Arroz Envasado:Parboiled 5KG Dos Hermanos.,-5.0,40.5,-202.5,2672696.16999999,Branded Rice,Lisset Limpio -020,RETAIL SEDANOS,1383363,May
2024-05-06,Sedanos Supermarkets #36,Credit Memo,008-03171,Varios:Promotional Allowance,Arroz Envasado:Parboiled 5KG Dos Hermanos.,-5.0,40.5,-202.5,2672493.66999999,Branded Rice,Keila Alfaro-Visvikis,RETAIL SEDANOS,1383364,May
2024-05-06,Sedanos Supermarkets #18,Credit Memo,008-03173,Varios:Promotional Allowance,Arroz Envasado:Parboiled 5KG Dos Hermanos.,-5.0,40.5,-202.5,2672291.16999999,Branded Rice,Lisset Limpio -020,RETAIL SEDANOS,1383365,May
2024-05-07,"El Toro Loco Meat Distribution, LLC",Invoice,008-03011,Dry Beans:Dry Beans - Black Beans 50,Dry Black Beans 50 lb,12.0,42.5,510.0,2672801.16999999,Dry Beans,Lisset Limpio -020,CAFETERIA y RESTAURANTS,1383366,May
2024-05-07,Sabor Tropical Supermarket #4,Invoice,008-03012,Arroz a Granel:Parboiled 50 LB -Bolsa Dos Hermanos.,,15.0,28.25,423.75,2673224.91999999,Bulk Rice,Keila Alfaro-Visvikis,RETAIL  DSD,1383367,May
2024-05-07,Family and Son,Invoice,008-03013,Arroz a Granel:Parboiled 50 LB -Bolsa Dos Hermanos.,,1100.0,24.75,27225.0,2700449.91999999,Bulk Rice,Armando Carpio - 017,WHOLESALER MANUFACTURY,1383368,May
2024-05-07,Family and Son,Invoice,008-03014,Arroz a Granel:Parboiled 50 LB -Bolsa Dos Hermanos.,,1100.0,24.75,27225.0,2727674.91999999,Bulk Rice,Armando Carpio - 017,WHOLESALER MANUFACTURY,1383369,May
2024-05-07,Family and Son,Invoice,008-03015,Arroz a Granel:Parboiled 50 LB -Bolsa Dos Hermanos.,,1100.0,24.75,27225.0,2754899.91999999,Bulk Rice,Armando Carpio - 017,WHOLESALER MANUFACTURY,1383370,May
2024-05-07,Sabor Tropical Supermarket #4,Credit Memo,008-03035,Varios:Promotional Allowance,Arroz Envasado:Parboiled 5KG Dos Hermanos.,-2.0,45.5,-91.0,2754808.91999999,Branded Rice,Lisset Limpio -020,RETAIL  DSD,1383371,May
2024-05-07,Sedanos Supermarkets #10,Credit Memo,008-03036,Varios:Promotional Allowance,Arroz Envasado:Parboiled 5KG Dos Hermanos.,-10.0,40.5,-405.0,2754403.91999999,Branded Rice,Lisset Limpio -020,RETAIL SEDANOS,1383372,May
2024-05-07,Sedanos Supermarkets #26,Credit Memo,008-03037,Varios:Promotional Allowance,Arroz Envasado:Parboiled 5KG Dos Hermanos.45,-10.0,40.5,-405.0,2753998.91999999,Branded Rice,Lisset Limpio -020,RETAIL SEDANOS,1383373,May
2024-05-08,JMN Dely Corp,Invoice,008-03048,Arroz a Granel:Parboiled 50 LB -Bolsa Dos Hermanos.,,2.0,27.5,55.0,2754053.91999999,Bulk Rice,Keila Alfaro-Visvikis,CAFETERIA y RESTAURANTS,1383374,May
2024-05-08,Sedanos Supermarkets #18,Invoice,008-03049,Arroz a Granel:Parboiled 50 LB -Bolsa Dos Hermanos.,,10.0,28.5,285.0,2754338.91999999,Bulk Rice,Lisset Limpio -020,RETAIL SEDANOS,1383375,May
2024-05-08,Sedanos Supermarkets #18,Invoice,008-03049,,Discount,,,-5.7,2754333.21999999,,Lisset Limpio -020,RETAIL SEDANOS,1383376,May
2024-05-08,Sedanos Supermarkets #42,Invoice,008-03050,Arroz Envasado:Parboiled 5KG Dos Hermanos.,6 / 11lbs,0.0,,0.0,2754333.21999999,Branded Rice,Lisset Limpio -020,RETAIL SEDANOS,1383377,May
2024-05-08,Sedanos Supermarkets #42,Invoice,008-03050,Arroz Envasado:Parboiled 5KG Dos Hermanos.,6 / 11lbs,0.0,0.0,0.0,2754333.21999999,Branded Rice,Lisset Limpio -020,RETAIL SEDANOS,1383378,May
2024-05-08,Sedanos Supermarkets #32,Invoice,008-03051,Arroz a Granel:Parboiled 50 LB -Bolsa Dos Hermanos.,,5.0,28.5,142.5,2754475.71999999,Bulk Rice,Lisset Limpio -020,RETAIL SEDANOS,1383379,May
2024-05-08,Sedanos Supermarkets #32,Invoice,008-03051,,Discount,,,-2.85,2754472.86999999,,Lisset Limpio -020,RETAIL SEDANOS,1383380,May
2024-05-08,Sedanos Supermarkets #43,Invoice,008-03052,Arroz a Granel:Parboiled 50 LB -Bolsa Dos Hermanos.,,6.0,28.5,171.0,2754643.86999999,Bulk Rice,Lisset Limpio -020,RETAIL SEDANOS,1383381,May
2024-05-08,Sedanos Supermarkets #43,Invoice,008-03052,Dry Beans:Dry Beans - Black Beans 50,Dry Black Beans 50 lb,2.0,42.5,85.0,2754728.86999999,Dry Beans,Lisset Limpio -020,RETAIL SEDANOS,1383382,May
2024-05-08,Sedanos Supermarkets #43,Invoice,008-03052,,Discount,,,-5.12,2754723.74999999,,Lisset Limpio -020,RETAIL SEDANOS,1383383,May
2024-05-08,Bravo Fish & Meat supermarket,Invoice,008-03053,Arroz Envasado:Parboiled 1kg Bolsa Dos Hermanos.,.,3.0,19.9,59.7,2754783.44999999,Branded Rice,Keila Alfaro-Visvikis,RETAIL  DSD,1383384,May
2024-05-08,Bravo Fish & Meat supermarket,Invoice,008-03053,Arroz Envasado:Largo Fino 1kg (Long grain rice) Dos Hermanos,,2.0,17.0,34.0,2754817.44999999,Branded Rice,Keila Alfaro-Visvikis,RETAIL  DSD,1383385,May
2024-05-08,Bravo Fish & Meat supermarket,Invoice,008-03053,Arroz Envasado:Largo Fino 1kg (Long grain rice) Dos Hermanos,,1.0,17.0,17.0,2754834.44999999,Branded Rice,Keila Alfaro-Visvikis,RETAIL  DSD,1383386,May
2024-05-08,Price Choice Food Market # 2,Invoice,008-03054,Arroz Envasado:Largo Fino 1kg (Long grain rice) Dos Hermanos,,1.0,17.0,17.0,2754851.44999999,Branded Rice,Keila Alfaro-Visvikis,RETAIL  DSD,1383387,May
2024-05-08,Price Choice Food Market # 2,Invoice,008-03054,Arroz Envasado:Parboiled 1kg Bolsa Dos Hermanos.,.,1.0,19.9,19.9,2754871.34999999,Branded Rice,Keila Alfaro-Visvikis,RETAIL  DSD,1383388,May
2024-05-08,Key Food 7th Ave manager Alex,Invoice,008-03055,Arroz Envasado:Largo Fino 1kg (Long grain rice) Dos Hermanos,,2.0,17.0,34.0,2754905.34999999,Branded Rice,Keila Alfaro-Visvikis,RETAIL  DSD,1383389,May
2024-05-08,Key Food 7th Ave manager Alex,Invoice,008-03055,Arroz Envasado:Parboiled 1kg Bolsa Dos Hermanos.,.,3.0,19.9,59.7,2754965.04999999,Branded Rice,Keila Alfaro-Visvikis,RETAIL  DSD,1383390,May
2024-05-08,Key Food 7th Ave manager Alex,Invoice,008-03055,Arroz Envasado:Largo Fino 1kg (Long grain rice) Dos Hermanos,,1.0,19.9,19.9,2754984.94999999,Branded Rice,Keila Alfaro-Visvikis,RETAIL  DSD,1383391,May
2024-05-08,Price Choice Food Market # 6,Invoice,008-03056,Arroz a Granel:Parboiled 50 LB -Bolsa Dos Hermanos.,,15.0,27.75,416.25,2755401.19999999,Bulk Rice,Lisset Limpio -020,RETAIL  DSD,1383392,May
2024-05-08,Sedanos Supermarkets #33,Invoice,008-03057,Arroz a Granel:Parboiled 50 LB -Bolsa Dos Hermanos.,,4.0,28.5,114.0,2755515.19999999,Bulk Rice,Lisset Limpio -020,RETAIL SEDANOS,1383393,May
2024-05-08,Sedanos Supermarkets #33,Invoice,008-03057,,Discount,,,-2.28,2755512.91999999,,Lisset Limpio -020,RETAIL SEDANOS,1383394,May
2024-05-08,Sedanos Supermarkets #16,Invoice,008-03058,Arroz a Granel:Parboiled 50 LB -Bolsa Dos Hermanos.,,0.0,,0.0,2755512.91999999,Bulk Rice,Lisset Limpio -020,RETAIL SEDANOS,1383395,May
2024-05-08,Sedanos Supermarkets #16,Invoice,008-03058,Dry Beans:Dry Beans - Black Beans 50,Dry Black Beans 50 lb,0.0,,0.0,2755512.91999999,Dry Beans,Lisset Limpio -020,RETAIL SEDANOS,1383396,May
2024-05-08,Sedanos Supermarkets #16,Invoice,008-03059,Arroz a Granel:Parboiled 50 LB -Bolsa Dos Hermanos.,,3.0,28.5,85.5,2755598.41999999,Bulk Rice,Lisset Limpio -020,RETAIL SEDANOS,1383397,May
2024-05-08,Sedanos Supermarkets #16,Invoice,008-03059,,Discount,,,-1.71,2755596.70999999,,Lisset Limpio -020,RETAIL SEDANOS,1383398,May
2024-05-08,Ideal Food Basket Davie Grocery,Invoice,008-03060,Arroz Envasado:Largo Fino 1kg (Long grain rice) Dos Hermanos,,1.0,17.0,17.0,2755613.70999999,Branded Rice,Keila Alfaro-Visvikis,RETAIL  DSD,1383399,May
2024-05-08,Ideal Food Basket Davie Grocery,Invoice,008-03060,Rice Snack:Rice Snack Ham Flavored DOS HERMANOS,,1.0,19.9,19.9,2755633.60999999,Puffed Products,Keila Alfaro-Visvikis,RETAIL  DSD,1383400,May
2024-05-08,Ideal Food Basket Davie Grocery,Invoice,008-03060,Rice Snack:Rice Snack Salami Flavored DOS HERMANOS,,1.0,19.9,19.9,2755653.50999999,Puffed Products,Keila Alfaro-Visvikis,RETAIL  DSD,1383401,May
2024-05-08,Ideal Food Basket Davie Grocery,Invoice,008-03060,"Rice Snack:Rice Snack, Pizza DH",,1.0,19.9,19.9,2755673.40999999,Puffed Products,Keila Alfaro-Visvikis,RETAIL  DSD,1383402,May
2024-05-08,Ideal Food Basket Davie Grocery,Invoice,008-03060,Rice Snack:Rice Snack Ham Flavored DOS HERMANOS,,1.0,19.9,19.9,2755693.30999999,Puffed Products,Keila Alfaro-Visvikis,RETAIL  DSD,1383403,May
2024-05-08,Ideal Food Basket Davie Cafeteria,Invoice,008-03061,Arroz a Granel:Largo Fino 50 LB -Bolsa Dos Hermanos.,,10.0,27.25,272.5,2755965.80999999,Bulk Rice,Keila Alfaro-Visvikis,CAFETERIA y RESTAURANTS,1383404,May
2024-05-08,Key Food Pembroke,Invoice,008-03062,Arroz Envasado:Largo Fino 1kg (Long grain rice) Dos Hermanos,,1.0,17.0,17.0,2755982.80999999,Branded Rice,Keila Alfaro-Visvikis,RETAIL  DSD,1383405,May
2024-05-08,Key Food Pembroke,Invoice,008-03062,Arroz Envasado:Parboiled 1kg Bolsa Dos Hermanos.,.,1.0,19.9,19.9,2756002.70999999,Branded Rice,Keila Alfaro-Visvikis,RETAIL  DSD,1383406,May
2024-05-08,Sedanos Supermarkets #27,Invoice,008-03063,Arroz a Granel:Parboiled 50 LB -Bolsa Dos Hermanos.,,6.0,28.5,171.0,2756173.70999999,Bulk Rice,Keila Alfaro-Visvikis,RETAIL SEDANOS,1383407,May
2024-05-08,Sedanos Supermarkets #27,Invoice,008-03063,,Discount,,,-3.42,2756170.28999999,,Keila Alfaro-Visvikis,RETAIL SEDANOS,1383408,May
2024-05-08,Sedanos Supermarkets #24,Invoice,008-03064,Arroz a Granel:Parboiled 50 LB -Bolsa Dos Hermanos.,,12.0,28.25,339.0,2756509.28999999,Bulk Rice,Keila Alfaro-Visvikis,RETAIL SEDANOS,1383409,May
2024-05-08,Sedanos Supermarkets #24,Invoice,008-03064,,Discount,,,-6.78,2756502.50999999,,Keila Alfaro-Visvikis,RETAIL SEDANOS,1383410,May
2024-05-08,Food Fair Plantation Corp,Invoice,008-03065,Arroz Envasado:Largo Fino 1kg (Long grain rice) Dos Hermanos,,5.0,17.0,85.0,2756587.50999999,Branded Rice,Keila Alfaro-Visvikis,RETAIL  DSD,1383411,May
2024-05-08,Food Fair Plantation Corp,Invoice,008-03065,Arroz Envasado:Parboiled 1kg Bolsa Dos Hermanos.,.,5.0,19.9,99.5,2756687.00999999,Branded Rice,Keila Alfaro-Visvikis,RETAIL  DSD,1383412,May
2024-05-08,Food Fair Plantation Corp,Invoice,008-03065,Arroz Envasado:Largo Fino 1kg (Long grain rice) Dos Hermanos,,1.0,17.0,17.0,2756704.00999999,Branded Rice,Keila Alfaro-Visvikis,RETAIL  DSD,1383413,May
2024-05-08,Food Fair Plantation Corp,Invoice,008-03065,Arroz Envasado:Parboiled 1kg Bolsa Dos Hermanos.,.,1.0,19.9,19.9,2756723.90999999,Branded Rice,Keila Alfaro-Visvikis,RETAIL  DSD,1383414,May
2024-05-08,"Meat Club Market, LLC.",Invoice,008-03066,Arroz Envasado:Largo Fino 1kg (Long grain rice) Dos Hermanos,,2.0,17.0,34.0,2756757.90999999,Branded Rice,Lisset Limpio -020,RETAIL  DSD,1383415,May
2024-05-08,"Meat Club Market, LLC.",Invoice,008-03066,Arroz Envasado:Sushi Rice Dos Hermanos 5kg.,,3.0,60.0,180.0,2756937.90999999,Branded Rice,Lisset Limpio -020,RETAIL  DSD,1383416,May
2024-05-08,Key Foods  / Ivan,Invoice,008-03067,Arroz Envasado:Largo Fino 1kg (Long grain rice) Dos Hermanos,,2.0,17.0,34.0,2756971.90999999,Branded Rice,Keila Alfaro-Visvikis,RETAIL  DSD,1383417,May
2024-05-08,Key Foods  / Ivan,Invoice,008-03067,Arroz Envasado:Parboiled 1kg Bolsa Dos Hermanos.,.,3.0,19.9,59.7,2757031.60999999,Branded Rice,Keila Alfaro-Visvikis,RETAIL  DSD,1383418,May
2024-05-08,Key Foods  / Ivan,Invoice,008-03067,Arroz Envasado:Largo Fino 1kg (Long grain rice) Dos Hermanos,,1.0,0.0,0.0,2757031.60999999,Branded Rice,Keila Alfaro-Visvikis,RETAIL  DSD,1383419,May
2024-05-08,La Ranchera Meat Market #3,Invoice,008-03068,Arroz a Granel:Largo Fino 50 LB -Bolsa Dos Hermanos.,,10.0,27.25,272.5,2757304.10999999,Bulk Rice,Keila Alfaro-Visvikis,CAFETERIA y RESTAURANTS,1383420,May
2024-05-08,Bravo Fish & Meat supermarket,Credit Memo,008-03169,Varios:Promotional Allowance,Arroz Envasado:Largo Fino 1kg (Long grain rice) Dos Hermanos,-1.0,17.0,-17.0,2757287.10999999,Branded Rice,Keila Alfaro-Visvikis,RETAIL  DSD,1383421,May
2024-05-08,Key Food 7th Ave manager Alex,Credit Memo,008-03170,Varios:Promotional Allowance,Arroz Envasado:Largo Fino 1kg (Long grain rice) Dos Hermanos,-1.0,19.9,-19.9,2757267.20999999,Branded Rice,Keila Alfaro-Visvikis,RETAIL  DSD,1383422,May
2024-05-08,Ideal Food Basket Davie Grocery,Credit Memo,008-03174,Varios:Promotional Allowance,,-1.0,19.9,-19.9,2757247.30999999,Puffed Products,Keila Alfaro-Visvikis,RETAIL  DSD,1383423,May
2024-05-08,Food Fair Plantation Corp,Credit Memo,008-03179,Varios:Promotional Allowance,Arroz Envasado:Largo Fino 1kg (Long grain rice) Dos Hermanos,-1.0,17.0,-17.0,2757230.30999999,Branded Rice,Keila Alfaro-Visvikis,RETAIL  DSD,1383424,May
2024-05-08,Food Fair Plantation Corp,Credit Memo,008-03179,Varios:Promotional Allowance,Arroz Envasado:Parboiled 1kg Bolsa Dos Hermanos.,-1.0,19.9,-19.9,2757210.40999999,Branded Rice,Keila Alfaro-Visvikis,RETAIL  DSD,1383425,May
2024-05-09,Sedanos Supermarkets #5,Invoice,008-03069,Arroz Envasado:Parboiled 5KG Dos Hermanos.,6 / 11lbs,5.0,40.5,202.5,2757412.90999999,Branded Rice,Lisset Limpio -020,RETAIL SEDANOS,1383426,May
2024-05-09,Sedanos Supermarkets #5,Invoice,008-03069,Arroz Envasado:Parboiled 5KG Dos Hermanos.,6 / 11lbs,5.0,40.5,202.5,2757615.40999999,Branded Rice,Lisset Limpio -020,RETAIL SEDANOS,1383427,May
2024-05-09,Sedanos Supermarkets #5,Invoice,008-03069,,Discount,,,-8.1,2757607.30999999,,Lisset Limpio -020,RETAIL SEDANOS,1383428,May
2024-05-09,Pena Foods Export Corp,Invoice,008-03070,Arroz a Granel:Parboiled 50 LB -Bolsa Dos Hermanos.,,1.0,28.25,28.25,2757635.55999999,Bulk Rice,Armando Carpio - 017,RETAIL  DSD,1383429,May
2024-05-09,Pena Foods Export Corp,Invoice,008-03070,Rice Snack:Rice Snack Ham Flavored DOS HERMANOS,,1.0,19.9,19.9,2757655.45999999,Puffed Products,Armando Carpio - 017,RETAIL  DSD,1383430,May
2024-05-09,Pena Foods Export Corp,Invoice,008-03070,"Rice Snack:Rice Snack, Pizza DH",,1.0,19.9,19.9,2757675.35999999,Puffed Products,Armando Carpio - 017,RETAIL  DSD,1383431,May
2024-05-09,Pena Foods Export Corp,Credit Memo,008-03180,Varios:Promotional Allowance,Arroz a Granel:Parboiled 50 LB -Bolsa Dos Hermanos.,-1.0,28.25,-28.25,2757647.10999999,Bulk Rice,Armando Carpio - 017,RETAIL  DSD,1383432,May
2024-05-09,Pena Foods Export Corp,Credit Memo,008-03180,Varios:Promotional Allowance,Rice Snack:Rice Snack Ham Flavored DOS HERMANOS,-1.0,19.9,-19.9,2757627.20999999,Puffed Products,Armando Carpio - 017,RETAIL  DSD,1383433,May
2024-05-09,Pena Foods Export Corp,Credit Memo,008-03180,Varios:Promotional Allowance,"Rice Snack:Rice Snack, Pizza DH",-1.0,19.9,-19.9,2757607.30999999,Puffed Products,Armando Carpio - 017,RETAIL  DSD,1383434,May
2024-05-10,El Palacio de los jugos / Caribe Tropical,Invoice,008-03071,Arroz a Granel:Parboiled 50 LB -Bolsa Dos Hermanos.,,15.0,27.75,416.25,2758023.55999999,Bulk Rice,Lisset Limpio -020,Cafeteria,1383435,May
2024-05-10,Los paraditos chinesse,Invoice,008-03072,,,,,0.0,2758023.55999999,,Lisset Limpio -020,CAFETERIA y RESTAURANTS,1383436,May
2024-05-10,Los paraditos chinesse,Invoice,008-03072,Arroz a Granel:Parboiled 50 LB -Bolsa Dos Hermanos.,,10.0,27.75,277.5,2758301.05999999,Bulk Rice,Lisset Limpio -020,CAFETERIA y RESTAURANTS,1383437,May
2024-05-10,Sedanos Supermarkets #31,Invoice,008-03073,Arroz a Granel:Largo Fino 50 LB -Bolsa Dos Hermanos.,,4.0,26.5,106.0,2758407.05999999,Bulk Rice,Lisset Limpio -020,RETAIL SEDANOS,1383438,May
2024-05-10,Sedanos Supermarkets #31,Invoice,008-03073,Arroz a Granel:Parboiled 50 LB -Bolsa Dos Hermanos.,,4.0,28.5,114.0,2758521.05999999,Bulk Rice,Lisset Limpio -020,RETAIL SEDANOS,1383439,May
2024-05-10,Sedanos Supermarkets #31,Invoice,008-03073,,Discount,,,-4.4,2758516.65999999,,Lisset Limpio -020,RETAIL SEDANOS,1383440,May
2024-05-10,Sedanos Supermarkets #42,Invoice,008-03074,Arroz Envasado:Parboiled 5KG Dos Hermanos.,6 / 11lbs,1.5,40.5,60.75,2758577.40999999,Branded Rice,Lisset Limpio -020,RETAIL SEDANOS,1383441,May
2024-05-10,Sedanos Supermarkets #42,Invoice,008-03074,Arroz Envasado:Parboiled 5KG Dos Hermanos.,6 / 11lbs,1.5,40.5,60.75,2758638.15999999,Branded Rice,Lisset Limpio -020,RETAIL SEDANOS,1383442,May
2024-05-10,Sedanos Supermarkets #42,Invoice,008-03074,,Discount,,,-1.22,2758636.93999999,,Lisset Limpio -020,RETAIL SEDANOS,1383443,May
2024-05-10,Sedanos Supermarkets #42,Credit Memo,008-03181,Varios:Promotional Allowance,Arroz Envasado:Parboiled 5KG Dos Hermanos.,-1.5,40.5,-60.75,2758576.18999999,Branded Rice,Lisset Limpio -020,RETAIL SEDANOS,1383444,May
2024-05-10,Total Food supermarket,Credit Memo,008-03182,Varios:Promotional Allowance,Arroz Envasado:Largo Fino 1kg (Long grain rice) Dos Hermanos,-1.0,17.0,-17.0,2758559.18999999,Branded Rice,Keila Alfaro-Visvikis,RETAIL  DSD,1383445,May
2024-05-13,Aries Supermarket & Cafeteria,Invoice,008-03075,Arroz a Granel:Parboiled 50 LB -Bolsa Dos Hermanos.,,10.0,28.5,285.0,2758844.18999999,Bulk Rice,Armando Carpio - 017,CAFETERIA y RESTAURANTS,1383446,May
2024-05-13,El Palacio de los jugos / Caribe Tropical,Invoice,008-03076,Arroz a Granel:Parboiled 50 LB -Bolsa Dos Hermanos.,,8.0,27.75,222.0,2759066.18999999,Bulk Rice,Lisset Limpio -020,Cafeteria,1383447,May
2024-05-14,Mei Chang,Invoice,008-03077,Arroz a Granel:Parboiled 50 LB -Bolsa Dos Hermanos.,,5.0,27.75,138.75,2759204.93999999,Bulk Rice,Lisset Limpio -020,CAFETERIA y RESTAURANTS,1383448,May
2024-05-14,Pacifico Chinese Restaurant,Invoice,008-03078,Arroz a Granel:Parboiled 50 LB -Bolsa Dos Hermanos.,,10.0,27.75,277.5,2759482.43999999,Bulk Rice,Lisset Limpio -020,CAFETERIA y RESTAURANTS,1383449,May
2024-05-15,Total Food supermarket,Invoice,008-03079,Arroz Envasado:Largo Fino 1kg (Long grain rice) Dos Hermanos,,2.0,17.0,34.0,2759516.43999999,Branded Rice,Keila Alfaro-Visvikis,RETAIL  DSD,1383450,May
2024-05-15,Total Food supermarket,Invoice,008-03079,Arroz Envasado:Parboiled 1kg Bolsa Dos Hermanos.,.,3.0,19.9,59.7,2759576.13999999,Branded Rice,Keila Alfaro-Visvikis,RETAIL  DSD,1383451,May
2024-05-15,Total Food supermarket,Invoice,008-03079,Arroz Envasado:Largo Fino 1kg (Long grain rice) Dos Hermanos,,1.0,17.0,17.0,2759593.13999999,Branded Rice,Keila Alfaro-Visvikis,RETAIL  DSD,1383452,May
2024-05-15,"Diaz Grocers, Inc",Invoice,008-03080,Dry Beans:Dry Beans - Small Red Beans 50 lbs.,Small Red Beans 50 lbs,0.0,,0.0,2759593.13999999,Dry Beans,Lisset Limpio -020,RETAIL  DSD,1383453,May
2024-05-15,"Diaz Grocers, Inc",Invoice,008-03080,Arroz a Granel:Parboiled 50 LB -Bolsa Dos Hermanos.,,0.0,,0.0,2759593.13999999,Bulk Rice,Lisset Limpio -020,RETAIL  DSD,1383454,May
2024-05-15,"Diaz Grocers, Inc",Invoice,008-03080,Arroz a Granel:Largo Fino 50 LB -Bolsa Dos Hermanos.,,0.0,,0.0,2759593.13999999,Bulk Rice,Lisset Limpio -020,RETAIL  DSD,1383455,May
2024-05-15,"Soriano Brothers Diaz Food Service,Inc",Invoice,008-03081,Arroz a Granel:Parboiled 50 LB -Bolsa Dos Hermanos.,,30.0,27.75,832.5,2760425.63999999,Bulk Rice,Lisset Limpio -020,CAFETERIA y RESTAURANTS,1383456,May
2024-05-15,"Soriano Brothers Diaz Food Service,Inc",Invoice,008-03081,Arroz a Granel:Largo Fino 50 LB -Bolsa Dos Hermanos.,,5.0,26.5,132.5,2760558.13999999,Bulk Rice,Lisset Limpio -020,CAFETERIA y RESTAURANTS,1383457,May
2024-05-15,"Soriano Brothers Diaz Food Service,Inc",Invoice,008-03081,Dry Beans:Dry Beans - Small Red Beans 50 lbs.,Small Red Beans 50 lbs,2.0,46.0,92.0,2760650.13999999,Dry Beans,Lisset Limpio -020,CAFETERIA y RESTAURANTS,1383458,May
2024-05-15,Sedanos Supermarkets #43,Invoice,008-03082,Dry Beans:Dry Beans - Black Beans 50,Dry Black Beans 50 lb,2.0,42.5,85.0,2760735.13999999,Dry Beans,Lisset Limpio -020,RETAIL SEDANOS,1383459,May
2024-05-15,Sedanos Supermarkets #43,Invoice,008-03082,Dry Beans:Dry Beans - Small Red Beans 50 lbs.,Small Red Beans 50 lbs,2.0,46.0,92.0,2760827.13999999,Dry Beans,Lisset Limpio -020,RETAIL SEDANOS,1383460,May
2024-05-15,Sedanos Supermarkets #43,Invoice,008-03082,,Discount,,,-3.54,2760823.59999999,,Lisset Limpio -020,RETAIL SEDANOS,1383461,May
2024-05-15,Ideal Food Basket Davie Cafeteria,Invoice,008-03083,Arroz a Granel:Largo Fino 50 LB -Bolsa Dos Hermanos.,,5.0,26.5,132.5,2760956.09999999,Bulk Rice,Keila Alfaro-Visvikis,CAFETERIA y RESTAURANTS,1383462,May
2024-05-15,Ideal Food Basket Davie Grocery,Invoice,008-03084,Arroz Envasado:Parboiled 1kg Bolsa Dos Hermanos.,.,3.0,19.9,59.7,2761015.79999999,Branded Rice,Keila Alfaro-Visvikis,RETAIL  DSD,1383463,May
2024-05-15,Ideal Food Basket Davie Grocery,Invoice,008-03084,Arroz Envasado:Largo Fino 1kg (Long grain rice) Dos Hermanos,,2.0,17.0,34.0,2761049.79999999,Branded Rice,Keila Alfaro-Visvikis,RETAIL  DSD,1383464,May
2024-05-15,Ideal Food Basket Davie Grocery,Invoice,008-03084,Arroz Envasado:Largo Fino 1kg (Long grain rice) Dos Hermanos,,1.0,17.0,17.0,2761066.79999999,Branded Rice,Keila Alfaro-Visvikis,RETAIL  DSD,1383465,May
2024-05-15,Rey Chavez Distributor #2,Invoice,008-03085,Arroz a Granel:Parboiled 50 LB -Bolsa Dos Hermanos.,,20.0,27.75,555.0,2761621.79999999,Bulk Rice,Lisset Limpio -020,WHOLESALER,1383466,May
2024-05-15,Sedanos Supermarkets #33,Invoice,008-03086,Arroz a Granel:Parboiled 50 LB -Bolsa Dos Hermanos.,,4.0,28.5,114.0,2761735.79999999,Bulk Rice,Lisset Limpio -020,RETAIL SEDANOS,1383467,May
2024-05-15,Sedanos Supermarkets #33,Invoice,008-03086,,Discount,,,-2.28,2761733.51999999,,Lisset Limpio -020,RETAIL SEDANOS,1383468,May
2024-05-15,Sedanos Supermarkets #27,Invoice,008-03087,Arroz a Granel:Parboiled 50 LB -Bolsa Dos Hermanos.,,6.0,28.25,169.5,2761903.01999999,Bulk Rice,Keila Alfaro-Visvikis,RETAIL SEDANOS,1383469,May
2024-05-15,Sedanos Supermarkets #27,Invoice,008-03087,,Discount,,,-3.39,2761899.62999999,,Keila Alfaro-Visvikis,RETAIL SEDANOS,1383470,May
2024-05-15,Ideal Food Basket Davie Grocery,Credit Memo,008-03183,Varios:Promotional Allowance,Arroz Envasado:Largo Fino 1kg (Long grain rice) Dos Hermanos,-1.0,17.0,-17.0,2761882.62999999,Branded Rice,Keila Alfaro-Visvikis,RETAIL  DSD,1383471,May
2024-05-16,El Palacio de Los Jugos / Casa mía Food Restaurant inc,Invoice,008-03089,Arroz a Granel:Parboiled 50 LB -Bolsa Dos Hermanos.,,15.0,27.75,416.25,2762298.87999999,Bulk Rice,Lisset Limpio -020,Cafeteria,1383472,May
2024-05-16,Fritanga Momotombo,Invoice,008-03090,Arroz a Granel:Largo Fino 50 LB -Bolsa Dos Hermanos.,,5.0,26.5,132.5,2762431.37999999,Bulk Rice,Lisset Limpio -020,CAFETERIA y RESTAURANTS,1383473,May
2024-05-16,Fritanga Momotombo,Invoice,008-03090,Dry Beans:Dry Beans - Small Red Beans 50 lbs.,Small Red Beans 50 lbs,2.0,46.0,92.0,2762523.37999999,Dry Beans,Lisset Limpio -020,CAFETERIA y RESTAURANTS,1383474,May
2024-05-16,Soriano Brothers PB,Invoice,008-03091,Arroz a Granel:Largo Fino 50 LB -Bolsa Dos Hermanos.,,5.0,26.5,132.5,2762655.87999999,Bulk Rice,Lisset Limpio -020,CAFETERIA y RESTAURANTS,1383475,May
2024-05-16,El Gallego Supermarket,Invoice,008-03092,Arroz a Granel:Parboiled 50 LB -Bolsa Dos Hermanos.,,5.0,27.75,138.75,2762794.62999999,Bulk Rice,Lisset Limpio -020,RETAIL  DSD,1383476,May
2024-05-16,El Gallego Supermarket,Invoice,008-03092,Dry Beans:Dry Beans - Black Beans 50,Dry Black Beans 50 lb,1.0,42.5,42.5,2762837.12999999,Dry Beans,Lisset Limpio -020,RETAIL  DSD,1383477,May
2024-05-16,Los Caringas Latin America  Foods,Invoice,008-03093,Arroz a Granel:Largo Fino 50 LB -Bolsa Dos Hermanos.,,2.0,26.5,53.0,2762890.12999999,Bulk Rice,Lisset Limpio -020,CAFETERIA y RESTAURANTS,1383478,May
2024-05-16,Los Caringas Latin America  Foods,Invoice,008-03093,Arroz a Granel:Parboiled 50 LB -Bolsa Dos Hermanos.,,3.0,27.75,83.25,2762973.37999999,Bulk Rice,Lisset Limpio -020,CAFETERIA y RESTAURANTS,1383479,May
2024-05-16,Bravo   Francisco Diaz,Invoice,008-03094,Arroz a Granel:Largo Fino 50 LB -Bolsa Dos Hermanos.,,5.0,26.5,132.5,2763105.87999999,Bulk Rice,Lisset Limpio -020,RETAIL  DSD,1383480,May
2024-05-16,Bravo   Francisco Diaz,Invoice,008-03094,Liquids:AS Cooking Wine,4/1 Gl.,4.0,17.5,70.0,2763175.87999999,American Spice,Lisset Limpio -020,RETAIL  DSD,1383481,May
2024-05-16,Sedanos Supermarkets #34,Invoice,008-03095,Arroz a Granel:Parboiled 50 LB -Bolsa Dos Hermanos.,,6.0,28.5,171.0,2763346.87999999,Bulk Rice,Keila Alfaro-Visvikis,RETAIL SEDANOS,1383482,May
2024-05-16,Sedanos Supermarkets #34,Invoice,008-03095,,Discount,,,-3.42,2763343.45999999,,Keila Alfaro-Visvikis,RETAIL SEDANOS,1383483,May
2024-05-16,Rey Chavez Distributor Corp,Invoice,008-03096,Arroz a Granel:Parboiled 50 LB -Bolsa Dos Hermanos.,,55.0,27.75,1526.25,2764869.70999999,Bulk Rice,Lisset Limpio -020,WHOLESALER,1383484,May
2024-05-16,El Palacio de los jugos /  Nanos Latin Foods,Invoice,008-03097,Arroz a Granel:Parboiled 50 LB -Bolsa Dos Hermanos.,,10.0,27.75,277.5,2765147.20999999,Bulk Rice,Lisset Limpio -020,Cafeteria,1383485,May
2024-05-21,Price Choice 5 YNTO Food Corp.,Invoice,008-03098,Arroz Envasado:Largo Fino 1kg (Long grain rice) Dos Hermanos,,1.0,17.0,17.0,2765164.20999999,Branded Rice,Keila Alfaro-Visvikis,RETAIL  DSD,1383486,May
2024-05-21,Price Choice 5 YNTO Food Corp.,Invoice,008-03098,Arroz Envasado:Parboiled 1kg Bolsa Dos Hermanos.,.,1.0,19.9,19.9,2765184.10999999,Branded Rice,Keila Alfaro-Visvikis,RETAIL  DSD,1383487,May
2024-05-21,Sedanos Supermarkets #10,Invoice,008-03099,Rice Snack:Rice Snack Salami Flavored DOS HERMANOS,,1.0,19.9,19.9,2765204.00999999,Puffed Products,Lisset Limpio -020,RETAIL SEDANOS,1383488,May
2024-05-21,Sedanos Supermarkets #10,Invoice,008-03099,Rice Snack:Rice Snack Ham Flavored DOS HERMANOS,,2.0,19.9,39.8,2765243.80999999,Puffed Products,Lisset Limpio -020,RETAIL SEDANOS,1383489,May
2024-05-21,Sedanos Supermarkets #10,Invoice,008-03099,"Rice Snack:Rice Snack, Pizza DH",,1.0,19.9,19.9,2765263.70999999,Puffed Products,Lisset Limpio -020,RETAIL SEDANOS,1383490,May
2024-05-21,Sedanos Supermarkets #10,Invoice,008-03099,,Discount,,,-1.19,2765262.51999999,,Lisset Limpio -020,RETAIL SEDANOS,1383491,May
2024-05-21,El Palacio de Los Jugos / Casa mía Food Restaurant inc,Invoice,008-03100,Arroz a Granel:Parboiled 50 LB -Bolsa Dos Hermanos.,,15.0,27.75,416.25,2765678.76999999,Bulk Rice,Lisset Limpio -020,Cafeteria,1383492,May
2024-05-21,Sedanos Supermarkets #9,Invoice,008-03101,Rice Snack:Rice Snack Ham Flavored DOS HERMANOS,,2.0,19.9,39.8,2765718.56999999,Puffed Products,Lisset Limpio -020,RETAIL SEDANOS,1383493,May
2024-05-21,Sedanos Supermarkets #9,Invoice,008-03101,Rice Snack:Rice Snack Salami Flavored DOS HERMANOS,,1.0,19.9,19.9,2765738.46999999,Puffed Products,Lisset Limpio -020,RETAIL SEDANOS,1383494,May
2024-05-21,Sedanos Supermarkets #9,Invoice,008-03101,"Rice Snack:Rice Snack, Pizza DH",,1.0,19.9,19.9,2765758.36999999,Puffed Products,Lisset Limpio -020,RETAIL SEDANOS,1383495,May
2024-05-21,Sedanos Supermarkets #9,Invoice,008-03101,,Discount,,,-1.19,2765757.17999999,,Lisset Limpio -020,RETAIL SEDANOS,1383496,May
2024-05-21,Aries Supermarket & Cafeteria,Invoice,008-03102,Arroz a Granel:Parboiled 50 LB -Bolsa Dos Hermanos.,,10.0,28.8,288.0,2766045.17999999,Bulk Rice,Armando Carpio - 017,CAFETERIA y RESTAURANTS,1383497,May
2024-05-21,Sedanos Supermarkets #1,Invoice,008-03103,Rice Snack:Rice Snack Ham Flavored DOS HERMANOS,,2.0,19.9,39.8,2766084.97999999,Puffed Products,Lisset Limpio -020,RETAIL SEDANOS,1383498,May
2024-05-21,Sedanos Supermarkets #1,Invoice,008-03103,Rice Snack:Rice Snack Salami Flavored DOS HERMANOS,,1.0,19.9,19.9,2766104.87999999,Puffed Products,Lisset Limpio -020,RETAIL SEDANOS,1383499,May
2024-05-21,Sedanos Supermarkets #1,Invoice,008-03103,"Rice Snack:Rice Snack, Pizza DH",,1.0,19.9,19.9,2766124.77999999,Puffed Products,Lisset Limpio -020,RETAIL SEDANOS,1383500,May
2024-05-21,Sedanos Supermarkets #1,Invoice,008-03103,,Discount,,,-1.19,2766123.58999999,,Lisset Limpio -020,RETAIL SEDANOS,1383501,May
2024-05-21,JMN Dely Corp,Invoice,008-03104,Arroz a Granel:Largo Fino 50 LB -Bolsa Dos Hermanos.,,1.0,27.25,27.25,2766150.83999999,Bulk Rice,Keila Alfaro-Visvikis,CAFETERIA y RESTAURANTS,1383502,May
2024-05-21,JMN Dely Corp,Invoice,008-03104,Arroz a Granel:Parboiled 50 LB -Bolsa Dos Hermanos.,,3.0,28.8,86.4,2766237.23999999,Bulk Rice,Keila Alfaro-Visvikis,CAFETERIA y RESTAURANTS,1383503,May
2024-05-21,El Palacio de los jugos /  Nanos Latin Foods,Invoice,008-03105,Arroz a Granel:Parboiled 50 LB -Bolsa Dos Hermanos.,,8.0,27.75,222.0,2766459.23999999,Bulk Rice,Lisset Limpio -020,Cafeteria,1383504,May
2024-05-21,Los Mejores Tamales de Miami,Invoice,008-03106,Arroz a Granel:Largo Fino 50 LB -Bolsa Dos Hermanos.,,3.0,26.5,79.5,2766538.73999999,Bulk Rice,Lisset Limpio -020,CAFETERIA y RESTAURANTS,1383505,May
2024-05-21,Los Mejores Tamales de Miami,Invoice,008-03106,Arroz a Granel:Parboiled 50 LB -Bolsa Dos Hermanos.,,5.0,27.75,138.75,2766677.48999999,Bulk Rice,Lisset Limpio -020,CAFETERIA y RESTAURANTS,1383506,May
2024-05-21,Bravo | Mainor Guevara,Invoice,008-03107,Arroz Envasado:Largo Fino 1kg (Long grain rice) Dos Hermanos,,2.0,17.0,34.0,2766711.48999999,Branded Rice,Keila Alfaro-Visvikis,RETAIL  DSD,1383507,May
2024-05-21,Bravo | Mainor Guevara,Invoice,008-03107,Arroz Envasado:Parboiled 1kg Bolsa Dos Hermanos.,.,3.0,19.9,59.7,2766771.18999999,Branded Rice,Keila Alfaro-Visvikis,RETAIL  DSD,1383508,May
2024-05-21,Bravo | Mainor Guevara,Invoice,008-03107,Arroz Envasado:Largo Fino 1kg (Long grain rice) Dos Hermanos,,1.0,17.0,17.0,2766788.18999999,Branded Rice,Keila Alfaro-Visvikis,RETAIL  DSD,1383509,May
2024-05-21,Price Choice 5 YNTO Food Corp.,Credit Memo,008-03184,Varios:Promotional Allowance,Arroz Envasado:Largo Fino 1kg (Long grain rice) Dos Hermanos,-1.0,17.0,-17.0,2766771.18999999,Branded Rice,Lisset Limpio -020,RETAIL  DSD,1383510,May
2024-05-21,Price Choice 5 YNTO Food Corp.,Credit Memo,008-03184,Varios:Promotional Allowance,Arroz Envasado:Parboiled 1kg Bolsa Dos Hermanos.,-1.0,19.9,-19.9,2766751.28999999,Branded Rice,Lisset Limpio -020,RETAIL  DSD,1383511,May
2024-05-21,Sedanos Supermarkets #10,Credit Memo,008-03185,Varios:Promotional Allowance,"Rice Snack:Rice Snack, Pizza DH",-1.0,19.9,-19.9,2766731.38999999,Puffed Products,Lisset Limpio -020,RETAIL SEDANOS,1383512,May
2024-05-21,Sedanos Supermarkets #1,Credit Memo,008-03186,Varios:Promotional Allowance,"Rice Snack:Rice Snack, Pizza DH",-1.0,19.9,-19.9,2766711.48999999,Puffed Products,Lisset Limpio -020,RETAIL SEDANOS,1383513,May
2024-05-21,Bravo | Mainor Guevara,Credit Memo,008-03187,Varios:Promotional Allowance,Arroz Envasado:Largo Fino 1kg (Long grain rice) Dos Hermanos,-1.0,17.0,-17.0,2766694.48999999,Branded Rice,Keila Alfaro-Visvikis,RETAIL  DSD,1383514,May
2024-05-21,Sedanos Supermarkets #9,Credit Memo,008-03188,Varios:Promotional Allowance,"Rice Snack:Rice Snack, Pizza DH",-1.0,19.9,-19.9,2766674.58999999,Puffed Products,Lisset Limpio -020,RETAIL SEDANOS,1383515,May
2024-05-22,Sedanos Supermarkets #27,Credit Memo,008-03108,Varios:Producto vencido/deteriorado (no impacta en inventario),Cierre saldo,-1.0,29.0,-29.0,2766645.58999999,,Keila Alfaro-Visvikis,RETAIL SEDANOS,1383516,May
2024-05-22,Sedanos Supermarkets #24,Credit Memo,008-03109,Varios:Producto vencido/deteriorado (no impacta en inventario),Saldo de 300 a cerrar,-1.0,300.0,-300.0,2766345.58999999,,Keila Alfaro-Visvikis,RETAIL SEDANOS,1383517,May
2024-05-22,Sedanos Supermarkets #40,Credit Memo,008-03110,Varios:Producto vencido/deteriorado (no impacta en inventario),cierre saldo de 300 irrecuperable,-1.0,300.0,-300.0,2766045.58999999,,Armando Carpio - 017,RETAIL SEDANOS,1383518,May
2024-05-22,Ideal Food Basket Davie Cafeteria,Invoice,008-03111,Arroz a Granel:Largo Fino 50 LB -Bolsa Dos Hermanos.,,15.0,27.25,408.75,2766454.33999999,Bulk Rice,Keila Alfaro-Visvikis,CAFETERIA y RESTAURANTS,1383519,May
2024-05-22,Sedanos Supermarkets #17,Invoice,008-03112,Rice Snack:Rice Snack Salami Flavored DOS HERMANOS,,1.0,19.9,19.9,2766474.23999999,Puffed Products,Lisset Limpio -020,RETAIL SEDANOS,1383520,May
2024-05-22,Sedanos Supermarkets #17,Invoice,008-03112,Rice Snack:Rice Snack Ham Flavored DOS HERMANOS,,3.0,19.9,59.7,2766533.93999999,Puffed Products,Lisset Limpio -020,RETAIL SEDANOS,1383521,May
2024-05-22,Sedanos Supermarkets #17,Invoice,008-03112,,,,0.0,0.0,2766533.93999999,,Lisset Limpio -020,RETAIL SEDANOS,1383522,May
2024-05-22,Sedanos Supermarkets #17,Invoice,008-03112,,Discount,,,-1.19,2766532.74999999,,Lisset Limpio -020,RETAIL SEDANOS,1383523,May
2024-05-22,Los paraditos chinesse,Invoice,008-03113,Arroz a Granel:Parboiled 50 LB -Bolsa Dos Hermanos.,,10.0,27.75,277.5,2766810.24999999,Bulk Rice,Lisset Limpio -020,CAFETERIA y RESTAURANTS,1383524,May
2024-05-22,Los paraditos chinesse,Invoice,008-03113,,,,,0.0,2766810.24999999,,Lisset Limpio -020,CAFETERIA y RESTAURANTS,1383525,May
2024-05-22,Albert Deli #2,Invoice,008-03114,Arroz a Granel:Largo Fino 50 LB -Bolsa Dos Hermanos.,,7.0,27.25,190.75,2767000.99999999,Bulk Rice,Keila Alfaro-Visvikis,CAFETERIA y RESTAURANTS,1383526,May
2024-05-22,Albert Deli #2,Invoice,008-03114,Dry Beans:Dry Beans - Black Beans 50,Dry Black Beans 50 lb,1.0,42.5,42.5,2767043.49999999,Dry Beans,Keila Alfaro-Visvikis,CAFETERIA y RESTAURANTS,1383527,May
2024-05-22,Albert Deli #2,Invoice,008-03114,Arroz a Granel:Parboiled 50 LB -Bolsa Dos Hermanos.,,1.0,28.25,28.25,2767071.74999999,Bulk Rice,Keila Alfaro-Visvikis,CAFETERIA y RESTAURANTS,1383528,May
2024-05-22,Mei Chang,Invoice,008-03115,Arroz a Granel:Largo Fino 50 LB -Bolsa Dos Hermanos.,,3.0,27.25,81.75,2767153.49999999,Bulk Rice,Lisset Limpio -020,CAFETERIA y RESTAURANTS,1383529,May
2024-05-22,Sedanos Supermarkets #33,Invoice,008-03116,Arroz a Granel:Parboiled 50 LB -Bolsa Dos Hermanos.,,4.0,28.5,114.0,2767267.49999999,Bulk Rice,Lisset Limpio -020,RETAIL SEDANOS,1383530,May
2024-05-22,Sedanos Supermarkets #33,Invoice,008-03116,,Discount,,,-2.28,2767265.21999999,,Lisset Limpio -020,RETAIL SEDANOS,1383531,May
2024-05-22,Sedanos Supermarkets #17,Credit Memo,008-03189,Varios:Promotional Allowance,Rice Snack:Rice Snack Salami Flavored DOS HERMANOS,-1.0,19.9,-19.9,2767245.31999999,Puffed Products,Lisset Limpio -020,RETAIL SEDANOS,1383532,May
2024-05-23,Soriano Brothers PB,Invoice,008-03117,Dry Beans:Dry Beans - Black Beans 50,Dry Black Beans 50 lb,1.0,42.5,42.5,2767287.81999999,Dry Beans,Lisset Limpio -020,CAFETERIA y RESTAURANTS,1383533,May
2024-05-23,Soriano Brothers PB,Invoice,008-03117,Arroz a Granel:Largo Fino 50 LB -Bolsa Dos Hermanos.,,2.0,26.5,53.0,2767340.81999999,Bulk Rice,Lisset Limpio -020,CAFETERIA y RESTAURANTS,1383534,May
2024-05-23,Soriano Brothers PB,Invoice,008-03117,Spices:AS Sazon (for all),1 / 30 lb (box or pail),2.0,59.0,118.0,2767458.81999999,American Spice,Lisset Limpio -020,CAFETERIA y RESTAURANTS,1383535,May
2024-05-23,Soriano Brothers PB,Invoice,008-03117,Dry Beans:Dry Beans - Small Red Beans 50 lbs.,Small Red Beans 50 lbs,1.0,46.0,46.0,2767504.81999999,Dry Beans,Lisset Limpio -020,CAFETERIA y RESTAURANTS,1383536,May
2024-05-23,Bravo   Francisco Diaz,Invoice,008-03118,Arroz a Granel:Largo Fino 50 LB -Bolsa Dos Hermanos.,,5.0,27.25,136.25,2767641.06999999,Bulk Rice,Lisset Limpio -020,RETAIL  DSD,1383537,May
2024-05-23,Bravo   Francisco Diaz,Invoice,008-03118,Liquids:AS Marinating Sauce (Mojo),,5.0,18.5,92.5,2767733.56999999,American Spice,Lisset Limpio -020,RETAIL  DSD,1383538,May
2024-05-23,Bravo   Francisco Diaz,Invoice,008-03118,Liquids:AS Cooking Wine,4/1 Gl.,4.0,17.5,70.0,2767803.56999999,American Spice,Lisset Limpio -020,RETAIL  DSD,1383539,May
2024-05-23,Bravo   Francisco Diaz,Invoice,008-03118,Liquids:AS White Vinegar,4/1 Gl.,1.0,10.0,10.0,2767813.56999999,American Spice,Lisset Limpio -020,RETAIL  DSD,1383540,May
2024-05-23,Sedanos Supermarkets #31,Invoice,008-03119,Arroz a Granel:Largo Fino 50 LB -Bolsa Dos Hermanos.,,3.0,27.85,83.55,2767897.11999999,Bulk Rice,Lisset Limpio -020,RETAIL SEDANOS,1383541,May
2024-05-23,Sedanos Supermarkets #31,Invoice,008-03119,Arroz a Granel:Parboiled 50 LB -Bolsa Dos Hermanos.,,5.0,28.5,142.5,2768039.61999999,Bulk Rice,Lisset Limpio -020,RETAIL SEDANOS,1383542,May
2024-05-23,Sedanos Supermarkets #31,Invoice,008-03119,,Discount,,,-4.52,2768035.09999999,,Lisset Limpio -020,RETAIL SEDANOS,1383543,May
2024-05-23,Sedanos Supermarkets #18,Invoice,008-03120,Arroz a Granel:Parboiled 50 LB -Bolsa Dos Hermanos.,,15.0,28.5,427.5,2768462.59999999,Bulk Rice,Lisset Limpio -020,RETAIL SEDANOS,1383544,May
2024-05-23,Sedanos Supermarkets #18,Invoice,008-03120,,Discount,,,-8.55,2768454.04999999,,Lisset Limpio -020,RETAIL SEDANOS,1383545,May
2024-05-23,"Soriano Brothers Diaz Food Service,Inc",Invoice,008-03121,Arroz a Granel:Largo Fino 50 LB -Bolsa Dos Hermanos.,,5.0,26.75,133.75,2768587.79999999,Bulk Rice,Lisset Limpio -020,CAFETERIA y RESTAURANTS,1383546,May
2024-05-24,Sedanos Supermarkets #31,Credit Memo,008-03122,Varios:Producto vencido/deteriorado (no impacta en inventario),,-4.0,27.85,-111.4,2768476.39999999,Bulk Rice,Lisset Limpio -020,RETAIL SEDANOS,1383547,May
2024-05-24,Sedanos Supermarkets #31,Credit Memo,008-03122,,Discount,,,2.23,2768478.62999999,,Lisset Limpio -020,RETAIL SEDANOS,1383548,May
2024-05-24,"Soriano Brothers Diaz Food Service,Inc",Credit Memo,008-03123,Arroz a Granel:Largo Fino 50 LB -Bolsa Dos Hermanos.,,-4.0,26.75,-107.0,2768371.62999999,Bulk Rice,Lisset Limpio -020,CAFETERIA y RESTAURANTS,1383549,May
2024-05-28,El Gallego Supermarket,Invoice,008-03124,Dry Beans:Dry Beans - Black Beans 50,Dry Black Beans 50 lb,2.0,42.5,85.0,2768456.62999999,Dry Beans,Lisset Limpio -020,RETAIL  DSD,1383550,May
2024-05-28,El Gallego Supermarket,Invoice,008-03124,Arroz a Granel:Parboiled 50 LB -Bolsa Dos Hermanos.,,5.0,28.5,142.5,2768599.12999999,Bulk Rice,Lisset Limpio -020,RETAIL  DSD,1383551,May
2024-05-28,Los Caringas Latin America  Foods,Invoice,008-03125,Arroz a Granel:Largo Fino 50 LB -Bolsa Dos Hermanos.,,3.0,26.5,79.5,2768678.62999999,Bulk Rice,Lisset Limpio -020,CAFETERIA y RESTAURANTS,1383552,May
2024-05-28,Los Caringas Latin America  Foods,Invoice,008-03125,Arroz a Granel:Parboiled 50 LB -Bolsa Dos Hermanos.,,3.0,27.75,83.25,2768761.87999999,Bulk Rice,Lisset Limpio -020,CAFETERIA y RESTAURANTS,1383553,May
2024-05-28,El Palacio de Los Jugos / Casa mía Food Restaurant inc,Invoice,008-03126,Arroz a Granel:Parboiled 50 LB -Bolsa Dos Hermanos.,,10.0,27.75,277.5,2769039.37999999,Bulk Rice,Lisset Limpio -020,Cafeteria,1383554,May
2024-05-28,Mei Chang,Invoice,008-03127,Arroz a Granel:Parboiled 50 LB -Bolsa Dos Hermanos.,,10.0,27.75,277.5,2769316.87999999,Bulk Rice,Lisset Limpio -020,CAFETERIA y RESTAURANTS,1383555,May
2024-05-28,Hings Chinese,Invoice,008-03128,Arroz a Granel:Parboiled 50 LB -Bolsa Dos Hermanos.,,5.0,27.75,138.75,2769455.62999999,Bulk Rice,Lisset Limpio -020,CAFETERIA y RESTAURANTS,1383556,May
2024-05-28,Fritanga Momotombo,Invoice,008-03129,Arroz a Granel:Largo Fino 50 LB -Bolsa Dos Hermanos.,,6.0,26.5,159.0,2769614.62999999,Bulk Rice,Lisset Limpio -020,CAFETERIA y RESTAURANTS,1383557,May
2024-05-28,Fritanga Momotombo,Invoice,008-03129,Dry Beans:Dry Beans - Small Red Beans 50 lbs.,Small Red Beans 50 lbs,1.0,46.0,46.0,2769660.62999999,Dry Beans,Lisset Limpio -020,CAFETERIA y RESTAURANTS,1383558,May
2024-05-29,Sedanos Supermarkets #33,Invoice,008-03130,Arroz a Granel:Largo Fino 50 LB -Bolsa Dos Hermanos.,,3.0,27.85,83.55,2769744.17999999,Bulk Rice,Lisset Limpio -020,RETAIL SEDANOS,1383559,May
2024-05-29,Sedanos Supermarkets #33,Invoice,008-03130,Arroz a Granel:Parboiled 50 LB -Bolsa Dos Hermanos.,,4.0,28.8,115.2,2769859.37999999,Bulk Rice,Lisset Limpio -020,RETAIL SEDANOS,1383560,May
2024-05-29,Sedanos Supermarkets #33,Invoice,008-03130,,Discount,,,-3.98,2769855.39999999,,Lisset Limpio -020,RETAIL SEDANOS,1383561,May
2024-05-29,Chavez Distributors Inc.,Invoice,008-03131,Arroz a Granel:Parboiled 50 LB -Bolsa Dos Hermanos.,,55.0,27.75,1526.25,2771381.64999999,Bulk Rice,Keila Alfaro-Visvikis,WHOLESALER,1383562,May
2024-05-29,Aries Supermarket & Cafeteria,Invoice,008-03132,Arroz a Granel:Parboiled 50 LB -Bolsa Dos Hermanos.,,5.0,28.8,144.0,2771525.64999999,Bulk Rice,Armando Carpio - 017,CAFETERIA y RESTAURANTS,1383563,May
2024-05-29,Aries Supermarket & Cafeteria,Invoice,008-03132,Dry Beans:Dry Beans - Black Beans 50,Dry Black Beans 50 lb,7.0,39.0,273.0,2771798.64999999,Dry Beans,Armando Carpio - 017,CAFETERIA y RESTAURANTS,1383564,May
2024-05-29,Sedanos Supermarkets #34,Invoice,008-03133,Arroz a Granel:Parboiled 50 LB -Bolsa Dos Hermanos.,,8.0,28.5,228.0,2772026.64999999,Bulk Rice,Keila Alfaro-Visvikis,RETAIL SEDANOS,1383565,May
2024-05-29,Sedanos Supermarkets #34,Invoice,008-03133,,Discount,,,-4.56,2772022.08999999,,Keila Alfaro-Visvikis,RETAIL SEDANOS,1383566,May
2024-05-29,Sedanos Supermarkets #24,Invoice,008-03134,Arroz a Granel:Parboiled 50 LB -Bolsa Dos Hermanos.,,6.0,28.25,169.5,2772191.58999999,Bulk Rice,Keila Alfaro-Visvikis,RETAIL SEDANOS,1383567,May
2024-05-29,Sedanos Supermarkets #24,Invoice,008-03134,,,,0.0,0.0,2772191.58999999,,Keila Alfaro-Visvikis,RETAIL SEDANOS,1383568,May
2024-05-29,Sedanos Supermarkets #24,Invoice,008-03134,,,,0.0,0.0,2772191.58999999,,Keila Alfaro-Visvikis,RETAIL SEDANOS,1383569,May
2024-05-29,Sedanos Supermarkets #24,Invoice,008-03134,,Discount,,,-3.39,2772188.19999999,,Keila Alfaro-Visvikis,RETAIL SEDANOS,1383570,May
2024-05-29,JMN Dely Corp,Invoice,008-03135,Arroz a Granel:Parboiled 50 LB -Bolsa Dos Hermanos.,,4.0,27.75,111.0,2772299.19999999,Bulk Rice,Keila Alfaro-Visvikis,CAFETERIA y RESTAURANTS,1383571,May
2024-05-29,Sedanos Supermarkets #24,Invoice,008-03136,Rice Snack:Rice Snack Ham Flavored DOS HERMANOS,,1.0,19.9,19.9,2772319.09999999,Puffed Products,Keila Alfaro-Visvikis,RETAIL SEDANOS,1383572,May
2024-05-29,Sedanos Supermarkets #24,Invoice,008-03136,"Rice Snack:Rice Snack, Pizza DH",,1.0,19.9,19.9,2772338.99999999,Puffed Products,Keila Alfaro-Visvikis,RETAIL SEDANOS,1383573,May
2024-05-29,Sedanos Supermarkets #24,Invoice,008-03136,,Discount,,,-0.8,2772338.19999999,,Keila Alfaro-Visvikis,RETAIL SEDANOS,1383574,May
2024-05-29,Sedanos Supermarkets #27,Invoice,008-03137,Arroz a Granel:Parboiled 50 LB -Bolsa Dos Hermanos.,,8.0,28.25,226.0,2772564.19999999,Bulk Rice,Keila Alfaro-Visvikis,RETAIL SEDANOS,1383575,May
2024-05-29,Sedanos Supermarkets #27,Invoice,008-03137,,Discount,,,-4.52,2772559.67999999,,Keila Alfaro-Visvikis,RETAIL SEDANOS,1383576,May
2024-05-29,"El Toro Loco Meat Distribution, LLC",Invoice,008-03138,Arroz a Granel:Largo Fino 50 LB -Bolsa Dos Hermanos.,,55.0,26.5,1457.5,2774017.17999999,Bulk Rice,Lisset Limpio -020,CAFETERIA y RESTAURANTS,1383577,May
2024-05-29,"El Toro Loco Meat Distribution, LLC",Invoice,008-03138,Dry Beans:Dry Beans - Black Beans 50,Dry Black Beans 50 lb,12.0,42.5,510.0,2774527.17999999,Dry Beans,Lisset Limpio -020,CAFETERIA y RESTAURANTS,1383578,May
2024-05-30,"American Spice Trading Co, Inc.",Invoice,008-03139,Arroz a Granel:Parboiled 50 LB -Bolsa Dos Hermanos.,,1100.0,27.5,30250.0,2804777.17999999,Bulk Rice,Armando Carpio - 017,WHOLESALER MANUFACTURY,1383579,May
2024-05-30,Family and Son,Invoice,008-03140,Arroz a Granel:Parboiled 50 LB -Bolsa Dos Hermanos.,MRKU 647673 9,1100.0,24.75,27225.0,2832002.17999999,Bulk Rice,Armando Carpio - 017,WHOLESALER MANUFACTURY,1383580,May
2024-05-30,Family and Son,Invoice,008-03141,Arroz a Granel:Parboiled 50 LB -Bolsa Dos Hermanos.,,1100.0,24.75,27225.0,2859227.17999999,Bulk Rice,Armando Carpio - 017,WHOLESALER MANUFACTURY,1383581,May
2024-05-30,Family and Son,Invoice,008-03142,Arroz a Granel:Parboiled 50 LB -Bolsa Dos Hermanos.,,1100.0,24.75,27225.0,2886452.17999999,Bulk Rice,Armando Carpio - 017,WHOLESALER MANUFACTURY,1383582,May
2024-05-31,Rey Chavez Distributor #2,Invoice,008-03143,Arroz a Granel:Parboiled 50 LB -Bolsa Dos Hermanos.,,35.0,27.75,971.25,2887423.42999999,Bulk Rice,Lisset Limpio -020,WHOLESALER,1383583,May
2024-05-31,Price Choice 5 YNTO Food Corp.,Invoice,008-03144,Arroz Envasado:Largo Fino 1kg (Long grain rice) Dos Hermanos,,2.0,17.0,34.0,2887457.42999999,Branded Rice,Keila Alfaro-Visvikis,RETAIL  DSD,1383584,May
2024-05-31,Price Choice 5 YNTO Food Corp.,Invoice,008-03144,Arroz Envasado:Parboiled 1kg Bolsa Dos Hermanos.,.,2.0,19.9,39.8,2887497.22999999,Branded Rice,Keila Alfaro-Visvikis,RETAIL  DSD,1383585,May
2024-05-31,Price Choice 5 YNTO Food Corp.,Invoice,008-03144,Rice Snack:Rice Snack Ham Flavored DOS HERMANOS,,1.0,19.9,19.9,2887517.12999999,Puffed Products,Keila Alfaro-Visvikis,RETAIL  DSD,1383586,May
2024-05-31,Price Choice 5 YNTO Food Corp.,Invoice,008-03144,Rice Snack:Rice Snack Salami Flavored DOS HERMANOS,,1.0,19.9,19.9,2887537.02999999,Puffed Products,Keila Alfaro-Visvikis,RETAIL  DSD,1383587,May
2024-05-31,Price Choice 5 YNTO Food Corp.,Invoice,008-03144,"Rice Snack:Rice Snack, Pizza DH",,1.0,19.9,19.9,2887556.92999999,Puffed Products,Keila Alfaro-Visvikis,RETAIL  DSD,1383588,May
2024-05-31,Bravo   Francisco Diaz,Invoice,008-03145,Arroz a Granel:Largo Fino 50 LB -Bolsa Dos Hermanos.,,7.0,27.85,194.95,2887751.87999999,Bulk Rice,Lisset Limpio -020,RETAIL  DSD,1383589,May
2024-05-31,Bravo   Francisco Diaz,Invoice,008-03145,Liquids:AS White Vinegar,4/1 Gl.,2.0,10.0,20.0,2887771.87999999,American Spice,Lisset Limpio -020,RETAIL  DSD,1383590,May
2024-05-31,"Diaz Grocers, Inc",Invoice,008-03146,Arroz Envasado:Parboiled 5KG Dos Hermanos.,6 / 11lbs,15.0,45.6,684.0,2888455.87999999,Branded Rice,Lisset Limpio -020,RETAIL  DSD,1383591,May
2024-05-31,"Diaz Grocers, Inc",Invoice,008-03146,Arroz Envasado:Parboiled 5KG Dos Hermanos.,6 / 11lbs,2.0,45.6,91.2,2888547.07999999,Branded Rice,Lisset Limpio -020,RETAIL  DSD,1383592,May
2024-05-31,Los Mejores Tamales de Miami,Invoice,008-03147,Arroz a Granel:Largo Fino 50 LB -Bolsa Dos Hermanos.,,3.0,27.85,83.55,2888630.62999999,Bulk Rice,Lisset Limpio -020,CAFETERIA y RESTAURANTS,1383593,May
2024-05-31,Los Mejores Tamales de Miami,Invoice,008-03147,Arroz a Granel:Parboiled 50 LB -Bolsa Dos Hermanos.,,5.0,27.75,138.75,2888769.37999999,Bulk Rice,Lisset Limpio -020,CAFETERIA y RESTAURANTS,1383594,May
2024-05-31,Sedanos Supermarkets #22,Invoice,008-03148,Spices:AS Chicken Base,1 / 30 lb. (box or pail),1.0,39.0,39.0,2888808.37999999,American Spice,Lisset Limpio -020,RETAIL SEDANOS,1383595,May
2024-05-31,Sedanos Supermarkets #22,Invoice,008-03148,Arroz a Granel:Parboiled 50 LB -Bolsa Dos Hermanos.,,4.0,28.25,113.0,2888921.37999999,Bulk Rice,Lisset Limpio -020,RETAIL SEDANOS,1383596,May
2024-05-31,Sedanos Supermarkets #22,Invoice,008-03148,,Discount,,,-3.04,2888918.33999999,,Lisset Limpio -020,RETAIL SEDANOS,1383597,May
2024-05-31,Sedanos Supermarkets #42,Invoice,008-03149,Arroz Envasado:Parboiled 5KG Dos Hermanos.,6 / 11lbs,10.0,40.5,405.0,2889323.33999999,Branded Rice,Lisset Limpio -020,RETAIL SEDANOS,1383598,May
2024-05-31,Sedanos Supermarkets #42,Invoice,008-03149,Arroz Envasado:Parboiled 5KG Dos Hermanos.,6 / 11lbs,10.0,40.5,405.0,2889728.33999999,Branded Rice,Lisset Limpio -020,RETAIL SEDANOS,1383599,May
2024-05-31,Sedanos Supermarkets #42,Invoice,008-03149,,Discount,,,-8.1,2889720.23999999,,Lisset Limpio -020,RETAIL SEDANOS,1383600,May
2024-05-31,Sedanos Supermarkets #23,Invoice,008-03150,Arroz Envasado:Parboiled 5KG Dos Hermanos.,6 / 11lbs,5.0,40.5,202.5,2889922.73999999,Branded Rice,Lisset Limpio -020,RETAIL SEDANOS,1383601,May
2024-05-31,Sedanos Supermarkets #23,Invoice,008-03150,Rice Snack:Rice Snack Ham Flavored DOS HERMANOS,,1.0,19.9,19.9,2889942.63999999,Puffed Products,Lisset Limpio -020,RETAIL SEDANOS,1383602,May
2024-05-31,Sedanos Supermarkets #23,Invoice,008-03150,Rice Snack:Rice Snack Salami Flavored DOS HERMANOS,,1.0,19.9,19.9,2889962.53999999,Puffed Products,Lisset Limpio -020,RETAIL SEDANOS,1383603,May
2024-05-31,Sedanos Supermarkets #23,Invoice,008-03150,Arroz Envasado:Parboiled 5KG Dos Hermanos.,6 / 11lbs,5.0,40.5,202.5,2890165.03999999,Branded Rice,Lisset Limpio -020,RETAIL SEDANOS,1383604,May
2024-05-31,Sedanos Supermarkets #23,Invoice,008-03150,,Discount,,,-4.85,2890160.18999999,,Lisset Limpio -020,RETAIL SEDANOS,1383605,May
2024-05-31,Sedanos Supermarkets #42,Credit Memo,008-03190,Varios:Promotional Allowance,Arroz Envasado:Parboiled 5KG Dos Hermanos.,-10.0,40.5,-405.0,2889755.18999999,Branded Rice,Lisset Limpio -020,RETAIL SEDANOS,1383606,May
2024-05-31,"Diaz Grocers, Inc",Credit Memo,008-03191,Varios:Promotional Allowance,Arroz Envasado:Parboiled 5KG Dos Hermanos.,-2.0,45.6,-91.2,2889663.98999999,Branded Rice,Lisset Limpio -020,RETAIL  DSD,1383607,May
2024-05-31,Sedanos Supermarkets #23,Credit Memo,008-03192,Varios:Promotional Allowance,Arroz Envasado:Parboiled 5KG Dos Hermanos.,-5.0,40.5,-202.5,2889461.48999999,Branded Rice,Lisset Limpio -020,RETAIL SEDANOS,1383608,May
2024-06-03,Food-Star Supermarket,Invoice,008-03151,Arroz Envasado:Parboiled 5KG Dos Hermanos.,6 / 11lbs,15.0,46.5,697.5,2890158.98999999,Branded Rice,Lisset Limpio -020,RETAIL  DSD,1383609,Jun
2024-06-03,Food-Star Supermarket,Invoice,008-03151,Arroz Envasado:Parboiled 5KG Dos Hermanos.,6 / 11lbs,2.0,46.5,93.0,2890251.98999999,Branded Rice,Lisset Limpio -020,RETAIL  DSD,1383610,Jun
2024-06-03,Sedanos Supermarkets #22,Invoice,008-03152,Rice Snack:Rice Snack Ham Flavored DOS HERMANOS,,2.0,19.9,39.8,2890291.78999999,Puffed Products,Lisset Limpio -020,RETAIL SEDANOS,1383611,Jun
2024-06-03,Sedanos Supermarkets #22,Invoice,008-03152,Rice Snack:Rice Snack Salami Flavored DOS HERMANOS,,1.0,19.9,19.9,2890311.68999999,Puffed Products,Lisset Limpio -020,RETAIL SEDANOS,1383612,Jun
2024-06-03,Sedanos Supermarkets #22,Invoice,008-03152,Rice Snack:Rice Snack Salami Flavored DOS HERMANOS,,1.0,19.9,19.9,2890331.58999999,Puffed Products,Lisset Limpio -020,RETAIL SEDANOS,1383613,Jun
2024-06-03,Sedanos Supermarkets #22,Invoice,008-03152,,Discount,,,-1.19,2890330.39999999,,Lisset Limpio -020,RETAIL SEDANOS,1383614,Jun
2024-06-03,Sedanos Supermarkets #26,Invoice,008-03153,Arroz a Granel:Parboiled 50 LB -Bolsa Dos Hermanos.,,2.0,28.25,56.5,2890386.89999999,Bulk Rice,Lisset Limpio -020,RETAIL SEDANOS,1383615,Jun
2024-06-03,Sedanos Supermarkets #26,Invoice,008-03153,,Discount,,,-1.13,2890385.76999999,,Lisset Limpio -020,RETAIL SEDANOS,1383616,Jun
2024-06-03,Key Food / Holywood,Invoice,008-03154,Arroz Envasado:Largo Fino 1kg (Long grain rice) Dos Hermanos,,10.0,17.0,170.0,2890555.76999999,Branded Rice,Keila Alfaro-Visvikis,RETAIL  DSD,1383617,Jun
2024-06-03,Key Food / Holywood,Invoice,008-03154,Arroz Envasado:Parboiled 1kg Bolsa Dos Hermanos.,.,2.0,17.0,34.0,2890589.76999999,Branded Rice,Keila Alfaro-Visvikis,RETAIL  DSD,1383618,Jun
2024-06-03,Key Food / Holywood,Invoice,008-03154,Arroz Envasado:Parboiled 5KG Dos Hermanos.,6 / 11lbs,5.0,46.5,232.5,2890822.26999999,Branded Rice,Keila Alfaro-Visvikis,RETAIL  DSD,1383619,Jun
2024-06-03,Key Food / Holywood,Invoice,008-03154,Arroz Envasado:Parboiled 5KG Dos Hermanos.,6 / 11lbs,1.0,46.5,46.5,2890868.76999999,Branded Rice,Keila Alfaro-Visvikis,RETAIL  DSD,1383620,Jun
2024-06-03,Fritanga Momotombo,Invoice,008-03155,Arroz a Granel:Largo Fino 50 LB -Bolsa Dos Hermanos.,,5.0,27.85,139.25,2891008.01999999,Bulk Rice,Lisset Limpio -020,CAFETERIA y RESTAURANTS,1383621,Jun
2024-06-03,Fritanga Momotombo,Invoice,008-03155,Dry Beans:Dry Beans - Small Red Beans 50 lbs.,Small Red Beans 50 lbs,2.0,46.0,92.0,2891100.01999999,Dry Beans,Lisset Limpio -020,CAFETERIA y RESTAURANTS,1383622,Jun
2024-06-03,Sedanos Supermarkets #14,Invoice,008-03156,Arroz Envasado:Parboiled 5KG Dos Hermanos.,6 / 11lbs,3.0,40.5,121.5,2891221.51999999,Branded Rice,Lisset Limpio -020,RETAIL SEDANOS,1383623,Jun
2024-06-03,Sedanos Supermarkets #14,Invoice,008-03156,Arroz Envasado:Parboiled 5KG Dos Hermanos.,6 / 11lbs,3.0,40.5,121.5,2891343.01999999,Branded Rice,Lisset Limpio -020,RETAIL SEDANOS,1383624,Jun
2024-06-03,Sedanos Supermarkets #14,Invoice,008-03156,,Discount,,,-2.43,2891340.58999999,,Lisset Limpio -020,RETAIL SEDANOS,1383625,Jun
2024-06-03,Price Choice Food Market # 2,Invoice,008-03157,Arroz Envasado:Parboiled 5KG Dos Hermanos.,6 / 11lbs,10.0,45.5,455.0,2891795.58999999,Branded Rice,Keila Alfaro-Visvikis,RETAIL  DSD,1383626,Jun
2024-06-03,Price Choice Food Market # 2,Invoice,008-03157,Arroz Envasado:Parboiled 5KG Dos Hermanos.,6 / 11lbs,2.0,45.5,91.0,2891886.58999999,Branded Rice,Keila Alfaro-Visvikis,RETAIL  DSD,1383627,Jun
2024-06-03,Ideal Food Basket Davie Cafeteria,Invoice,008-03158,Arroz a Granel:Largo Fino 50 LB -Bolsa Dos Hermanos.,,12.0,27.25,327.0,2892213.58999999,Bulk Rice,Keila Alfaro-Visvikis,CAFETERIA y RESTAURANTS,1383628,Jun
2024-06-03,Sabor Tropical Supermarket #7,Invoice,008-03159,Arroz Envasado:Largo Fino 1kg (Long grain rice) Dos Hermanos,,4.0,17.0,68.0,2892281.58999999,Branded Rice,Keila Alfaro-Visvikis,RETAIL  DSD,1383629,Jun
2024-06-03,Sabor Tropical Supermarket #7,Invoice,008-03159,Arroz Envasado:Parboiled 1kg Bolsa Dos Hermanos.,.,1.0,19.9,19.9,2892301.48999999,Branded Rice,Keila Alfaro-Visvikis,RETAIL  DSD,1383630,Jun
2024-06-03,Sabor Tropical Supermarket #7,Invoice,008-03159,Arroz Envasado:Largo Fino 1kg (Long grain rice) Dos Hermanos,,1.0,17.0,17.0,2892318.48999999,Branded Rice,Keila Alfaro-Visvikis,RETAIL  DSD,1383631,Jun
2024-06-03,Sedanos Supermarkets #5,Invoice,008-03160,Arroz Envasado:Parboiled 5KG Dos Hermanos.,6 / 11lbs,5.0,40.5,202.5,2892520.98999999,Branded Rice,Lisset Limpio -020,RETAIL SEDANOS,1383632,Jun
2024-06-03,Sedanos Supermarkets #5,Invoice,008-03160,Arroz Envasado:Parboiled 5KG Dos Hermanos.,6 / 11lbs,5.0,40.5,202.5,2892723.48999999,Branded Rice,Lisset Limpio -020,RETAIL SEDANOS,1383633,Jun
2024-06-03,Sedanos Supermarkets #5,Invoice,008-03160,,Discount,,,-4.05,2892719.43999999,,Lisset Limpio -020,RETAIL SEDANOS,1383634,Jun
2024-06-03,Sabor Tropical Supermarket #7,Credit Memo,008-03285,Varios:Promotional Allowance,Arroz Envasado:Largo Fino 1kg (Long grain rice) Dos Hermanos,-1.0,17.0,-17.0,2892702.43999999,Branded Rice,Keila Alfaro-Visvikis,RETAIL  DSD,1383635,Jun
2024-06-03,Food-Star Supermarket,Credit Memo,008-03286,Varios:Promotional Allowance,Arroz Envasado:Parboiled 5KG Dos Hermanos.,-2.0,46.5,-93.0,2892609.43999999,Branded Rice,Lisset Limpio -020,RETAIL  DSD,1383636,Jun
2024-06-03,Sedanos Supermarkets #5,Credit Memo,008-03287,Varios:Promotional Allowance,Arroz Envasado:Parboiled 5KG Dos Hermanos.,-5.0,40.5,-202.5,2892406.93999999,Branded Rice,Lisset Limpio -020,RETAIL SEDANOS,1383637,Jun
2024-06-03,Sedanos Supermarkets #22,Credit Memo,008-03288,Varios:Promotional Allowance,Rice Snack:Rice Snack Salami Flavored DOS HERMANOS,-1.0,19.9,-19.9,2892387.03999999,Puffed Products,Lisset Limpio -020,RETAIL SEDANOS,1383638,Jun
2024-06-03,Key Food / Holywood,Credit Memo,008-03289,Varios:Promotional Allowance,Arroz Envasado:Parboiled 1kg Bolsa Dos Hermanos.,-2.0,17.0,-34.0,2892353.03999999,Branded Rice,Keila Alfaro-Visvikis,RETAIL  DSD,1383639,Jun
2024-06-03,Key Food / Holywood,Credit Memo,008-03289,Varios:Promotional Allowance,Arroz Envasado:Parboiled 5KG Dos Hermanos.,-1.0,46.5,-46.5,2892306.53999999,Branded Rice,Keila Alfaro-Visvikis,RETAIL  DSD,1383640,Jun
2024-06-03,Sedanos Supermarkets #14,Credit Memo,008-03290,Varios:Promotional Allowance,Arroz Envasado:Parboiled 5KG Dos Hermanos.,-3.0,40.5,-121.5,2892185.03999999,Branded Rice,Lisset Limpio -020,RETAIL SEDANOS,1383641,Jun
2024-06-03,Price Choice Food Market # 2,Credit Memo,008-03291,Varios:Promotional Allowance,Arroz Envasado:Parboiled 5KG Dos Hermanos.,-2.0,45.5,-91.0,2892094.03999999,Branded Rice,Keila Alfaro-Visvikis,RETAIL  DSD,1383642,Jun
2024-06-03,Armando Carpio,Credit Memo,008-03292,Varios:Promotional Allowance,Arroz Envasado:Parboiled 5KG Dos Hermanos.,-1.0,40.5,-40.5,2892053.53999999,Branded Rice,Armando Carpio - 017,OTHER,1383643,Jun
2024-06-03,Armando Carpio,Credit Memo,008-03292,Varios:Promotional Allowance,Arroz Envasado:Largo Fino 1kg (Long grain rice) Dos Hermanos,-1.0,17.0,-17.0,2892036.53999999,Branded Rice,Armando Carpio - 017,OTHER,1383644,Jun
2024-06-03,Armando Carpio,Credit Memo,008-03292,Varios:Promotional Allowance,Arroz Envasado:Parboiled 1kg Bolsa Dos Hermanos.,-1.0,19.9,-19.9,2892016.63999999,Branded Rice,Armando Carpio - 017,OTHER,1383645,Jun
2024-06-03,Armando Carpio,Credit Memo,008-03292,Varios:Promotional Allowance,Rice Snack:Rice Snack Ham Flavored DOS HERMANOS,-1.0,19.9,-19.9,2891996.73999999,Puffed Products,Armando Carpio - 017,OTHER,1383646,Jun
2024-06-04,Armando Carpio,Invoice,008-03175,Arroz Envasado:Parboiled 5KG Dos Hermanos.,6 / 11lbs,1.0,40.5,40.5,2892037.23999999,Branded Rice,Armando Carpio - 017,OTHER,1383647,Jun
2024-06-04,Armando Carpio,Invoice,008-03175,Arroz Envasado:Largo Fino 1kg (Long grain rice) Dos Hermanos,,1.0,17.0,17.0,2892054.23999999,Branded Rice,Armando Carpio - 017,OTHER,1383648,Jun
2024-06-04,Armando Carpio,Invoice,008-03175,Arroz Envasado:Parboiled 1kg Bolsa Dos Hermanos.,.,1.0,19.9,19.9,2892074.13999999,Branded Rice,Armando Carpio - 017,OTHER,1383649,Jun
2024-06-04,Armando Carpio,Invoice,008-03175,Rice Snack:Rice Snack Ham Flavored DOS HERMANOS,,1.0,19.9,19.9,2892094.03999999,Puffed Products,Armando Carpio - 017,OTHER,1383650,Jun
2024-06-04,Price Choice Food Market # 6,Invoice,008-03176,Arroz a Granel:Parboiled 50 LB -Bolsa Dos Hermanos.,,15.0,28.25,423.75,2892517.78999999,Bulk Rice,Lisset Limpio -020,RETAIL  DSD,1383651,Jun
2024-06-04,Angie Deli,Invoice,008-03177,Arroz a Granel:Largo Fino 50 LB -Bolsa Dos Hermanos.,,4.0,27.85,111.4,2892629.18999999,Bulk Rice,Lisset Limpio -020,CAFETERIA y RESTAURANTS,1383652,Jun
2024-06-04,Angie Deli,Invoice,008-03177,Arroz a Granel:Parboiled 50 LB -Bolsa Dos Hermanos.,,2.0,28.25,56.5,2892685.68999999,Bulk Rice,Lisset Limpio -020,CAFETERIA y RESTAURANTS,1383653,Jun
2024-06-04,JMN Dely Corp,Invoice,008-03178,Arroz a Granel:Parboiled 50 LB -Bolsa Dos Hermanos.,,3.0,28.25,84.75,2892770.43999999,Bulk Rice,Keila Alfaro-Visvikis,CAFETERIA y RESTAURANTS,1383654,Jun
2024-06-04,JMN Dely Corp,Invoice,008-03178,Dry Beans:Dry Beans - Black Beans 50,Dry Black Beans 50 lb,1.0,42.5,42.5,2892812.93999999,Dry Beans,Keila Alfaro-Visvikis,CAFETERIA y RESTAURANTS,1383655,Jun
2024-06-06,Bravo   Francisco Diaz,Invoice,008-03193,Liquids:AS Cooking Wine,4/1 Gl.,5.0,17.5,87.5,2892900.43999999,American Spice,Lisset Limpio -020,RETAIL  DSD,1383656,Jun
2024-06-06,Bravo   Francisco Diaz,Invoice,008-03193,Spices:AS Chicken Base,1 / 30 lb. (box or pail),1.0,39.0,39.0,2892939.43999999,American Spice,Lisset Limpio -020,RETAIL  DSD,1383657,Jun
2024-06-06,Bravo   Francisco Diaz,Invoice,008-03193,Arroz a Granel:Largo Fino 50 LB -Bolsa Dos Hermanos.,,7.0,27.85,194.95,2893134.38999999,Bulk Rice,Lisset Limpio -020,RETAIL  DSD,1383658,Jun
2024-06-06,"El Toro Loco Meat Distribution, LLC",Invoice,008-03194,Dry Beans:Dry Beans - Black Beans 50,Dry Black Beans 50 lb,20.0,42.5,850.0,2893984.38999999,Dry Beans,Lisset Limpio -020,CAFETERIA y RESTAURANTS,1383659,Jun
2024-06-06,Hings Chinese,Invoice,008-03195,Arroz a Granel:Parboiled 50 LB -Bolsa Dos Hermanos.,,5.0,28.25,141.25,2894125.63999999,Bulk Rice,Lisset Limpio -020,CAFETERIA y RESTAURANTS,1383660,Jun
2024-06-06,Sedanos Supermarkets  #4,Invoice,008-03196,Arroz Envasado:Parboiled 5KG Dos Hermanos.,6 / 11lbs,5.0,40.5,202.5,2894328.13999999,Branded Rice,Lisset Limpio -020,RETAIL SEDANOS,1383661,Jun
2024-06-06,Sedanos Supermarkets  #4,Invoice,008-03196,Arroz Envasado:Parboiled 5KG Dos Hermanos.,6 / 11lbs,5.0,40.5,202.5,2894530.63999999,Branded Rice,Lisset Limpio -020,RETAIL SEDANOS,1383662,Jun
2024-06-06,Sedanos Supermarkets  #4,Invoice,008-03196,,Discount,,,-4.05,2894526.58999999,,Lisset Limpio -020,RETAIL SEDANOS,1383663,Jun
2024-06-06,Key Foods  / Ivan,Invoice,008-03197,Arroz Envasado:Parboiled 5KG Dos Hermanos.,6 / 11lbs,15.0,46.5,697.5,2895224.08999999,Branded Rice,Keila Alfaro-Visvikis,RETAIL  DSD,1383664,Jun
2024-06-06,Key Foods  / Ivan,Invoice,008-03197,Arroz Envasado:Parboiled 5KG Dos Hermanos.,6 / 11lbs,2.0,46.5,93.0,2895317.08999999,Branded Rice,Keila Alfaro-Visvikis,RETAIL  DSD,1383665,Jun
2024-06-06,Arias Supermarket,Invoice,008-03198,Dry Beans:Dry Beans - Black Beans 50,Dry Black Beans 50 lb,8.0,39.0,312.0,2895629.08999999,Dry Beans,Armando Carpio - 017,CAFETERIA y RESTAURANTS,1383666,Jun
2024-06-06,Arias Supermarket,Invoice,008-03198,Arroz a Granel:Parboiled 50 LB -Bolsa Dos Hermanos.,,8.0,28.8,230.4,2895859.48999999,Bulk Rice,Armando Carpio - 017,CAFETERIA y RESTAURANTS,1383667,Jun
2024-06-06,Sedanos Supermarkets  #4,Credit Memo,008-03293,Varios:Promotional Allowance,Arroz Envasado:Parboiled 5KG Dos Hermanos.,-5.0,40.5,-202.5,2895656.98999999,Branded Rice,Lisset Limpio -020,RETAIL SEDANOS,1383668,Jun
2024-06-06,Key Foods  / Ivan,Credit Memo,008-03294,Varios:Promotional Allowance,Arroz Envasado:Parboiled 5KG Dos Hermanos.,-2.0,46.5,-93.0,2895563.98999999,Branded Rice,Keila Alfaro-Visvikis,RETAIL  DSD,1383669,Jun
2024-06-07,"American Spice Trading Co, Inc.",Invoice,008-03199,Arroz a Granel:Parboiled 50 LB -Bolsa Dos Hermanos.,,1100.0,27.5,30250.0,2925813.98999999,Bulk Rice,Armando Carpio - 017,WHOLESALER MANUFACTURY,1383670,Jun
2024-06-07,Family and Son,Invoice,008-03200,Arroz a Granel:Parboiled 50 LB -Bolsa Dos Hermanos.,MRSU 643390 9,1100.0,24.75,27225.0,2953038.98999999,Bulk Rice,Armando Carpio - 017,WHOLESALER MANUFACTURY,1383671,Jun
2024-06-07,Family and Son,Invoice,008-03201,Arroz a Granel:Parboiled 50 LB -Bolsa Dos Hermanos.,,1100.0,24.75,27225.0,2980263.98999999,Bulk Rice,Armando Carpio - 017,WHOLESALER MANUFACTURY,1383672,Jun
2024-06-07,"Soriano Brothers Diaz Food Service,Inc",Invoice,008-03202,Dry Beans:Dry Beans - Black Beans 50,Dry Black Beans 50 lb,12.0,42.5,510.0,2980773.98999999,Dry Beans,Lisset Limpio -020,CAFETERIA y RESTAURANTS,1383673,Jun
2024-06-07,Cash Sales,Invoice,008-03203,Dry Beans:Dry Beans - Black Beans 50,Dry Black Beans 50 lb,1.0,42.5,42.5,2980816.48999999,Dry Beans,Armando Carpio - 017,CAFETERIA y RESTAURANTS,1383674,Jun
2024-06-10,Family and Son,Invoice,008-03204,Arroz a Granel:Parboiled 50 LB -Bolsa Dos Hermanos.,,1100.0,24.75,27225.0,3008041.48999999,Bulk Rice,Armando Carpio - 017,WHOLESALER MANUFACTURY,1383675,Jun
2024-06-10,Family and Son,Invoice,008-03205,Arroz a Granel:Parboiled 50 LB -Bolsa Dos Hermanos.,,1100.0,24.75,27225.0,3035266.48999999,Bulk Rice,Armando Carpio - 017,WHOLESALER MANUFACTURY,1383676,Jun
2024-06-10,Family and Son,Invoice,008-03206,Arroz a Granel:Parboiled 50 LB -Bolsa Dos Hermanos.,TCNU 256388 4,1100.0,24.75,27225.0,3062491.48999999,Bulk Rice,Armando Carpio - 017,WHOLESALER MANUFACTURY,1383677,Jun
2024-06-10,Family and Son,Invoice,008-03207,Arroz a Granel:Parboiled 50 LB -Bolsa Dos Hermanos.,,1100.0,24.75,27225.0,3089716.48999999,Bulk Rice,Armando Carpio - 017,WHOLESALER MANUFACTURY,1383678,Jun
2024-06-10,Sedanos Supermarkets #34,Invoice,008-03210,Arroz a Granel:Parboiled 50 LB -Bolsa Dos Hermanos.,,6.0,28.25,169.5,3089885.98999999,Bulk Rice,Keila Alfaro-Visvikis,RETAIL SEDANOS,1383679,Jun
2024-06-10,Sedanos Supermarkets #34,Invoice,008-03210,,Discount,,,-3.39,3089882.59999999,,Keila Alfaro-Visvikis,RETAIL SEDANOS,1383680,Jun
2024-06-10,Sedanos Supermarkets #27,Invoice,008-03211,Arroz a Granel:Parboiled 50 LB -Bolsa Dos Hermanos.,,6.0,28.25,169.5,3090052.09999999,Bulk Rice,Keila Alfaro-Visvikis,RETAIL SEDANOS,1383681,Jun
2024-06-10,Sedanos Supermarkets #27,Invoice,008-03211,,Discount,,,-3.39,3090048.70999999,,Keila Alfaro-Visvikis,RETAIL SEDANOS,1383682,Jun
2024-06-10,Sedanos Supermarkets #24,Invoice,008-03212,Arroz a Granel:Parboiled 50 LB -Bolsa Dos Hermanos.,,15.0,28.25,423.75,3090472.45999999,Bulk Rice,Keila Alfaro-Visvikis,RETAIL SEDANOS,1383683,Jun
2024-06-10,Sedanos Supermarkets #24,Invoice,008-03212,,,,,0.0,3090472.45999999,,Keila Alfaro-Visvikis,RETAIL SEDANOS,1383684,Jun
2024-06-10,Sedanos Supermarkets #24,Invoice,008-03212,,,,,0.0,3090472.45999999,,Keila Alfaro-Visvikis,RETAIL SEDANOS,1383685,Jun
2024-06-10,Sedanos Supermarkets #24,Invoice,008-03212,,Discount,,,-8.48,3090463.97999999,,Keila Alfaro-Visvikis,RETAIL SEDANOS,1383686,Jun
2024-06-10,Sedanos Supermarkets #24,Invoice,008-03213,Rice Snack:Rice Snack Salami Flavored DOS HERMANOS,,1.0,19.9,19.9,3090483.87999999,Puffed Products,Keila Alfaro-Visvikis,RETAIL SEDANOS,1383687,Jun
2024-06-10,Sedanos Supermarkets #24,Invoice,008-03213,Rice Snack:Rice Snack Ham Flavored DOS HERMANOS,,1.0,19.9,19.9,3090503.77999999,Puffed Products,Keila Alfaro-Visvikis,RETAIL SEDANOS,1383688,Jun
2024-06-10,Sedanos Supermarkets #24,Invoice,008-03213,,Discount,,,-0.8,3090502.97999999,,Keila Alfaro-Visvikis,RETAIL SEDANOS,1383689,Jun
2024-06-10,Ideal Food Basket Davie Cafeteria,Invoice,008-03214,Arroz a Granel:Largo Fino 50 LB -Bolsa Dos Hermanos.,,12.0,27.25,327.0,3090829.97999999,Bulk Rice,Keila Alfaro-Visvikis,CAFETERIA y RESTAURANTS,1383690,Jun
2024-06-10,JMN Dely Corp,Invoice,008-03215,Arroz a Granel:Largo Fino 50 LB -Bolsa Dos Hermanos.,,4.0,27.25,109.0,3090938.97999999,Bulk Rice,Keila Alfaro-Visvikis,CAFETERIA y RESTAURANTS,1383691,Jun
2024-06-10,JMN Dely Corp,Invoice,008-03215,Arroz a Granel:Parboiled 50 LB -Bolsa Dos Hermanos.,,2.0,28.25,56.5,3090995.47999999,Bulk Rice,Keila Alfaro-Visvikis,CAFETERIA y RESTAURANTS,1383692,Jun
2024-06-11,Pacifico Chinese Restaurant,Invoice,008-03208,Arroz a Granel:Parboiled 50 LB -Bolsa Dos Hermanos.,,10.0,28.25,282.5,3091277.97999999,Bulk Rice,Lisset Limpio -020,CAFETERIA y RESTAURANTS,1383693,Jun
2024-06-11,Soriano Brothers PB,Invoice,008-03209,Spices:AS Chicken Base,1 / 30 lb. (box or pail),3.0,39.0,117.0,3091394.97999999,American Spice,Lisset Limpio -020,CAFETERIA y RESTAURANTS,1383694,Jun
2024-06-11,"Soriano Brothers Diaz Food Service,Inc",Credit Memo,008-03216,Arroz a Granel:Largo Fino 50 LB -Bolsa Dos Hermanos.,,-5.0,26.75,-133.75,3091261.22999999,Bulk Rice,Lisset Limpio -020,CAFETERIA y RESTAURANTS,1383695,Jun
2024-06-11,BRAVO KISSIMME,Credit Memo,008-03217,Arroz Envasado:Parboiled 5KG Dos Hermanos.,6 / 11lbs,-12.0,20.06,-240.72,3091020.50999999,Branded Rice,Keila Alfaro-Visvikis,RETAIL  DSD,1383696,Jun
2024-06-13,Food Fair Plantation Corp,Invoice,008-03218,Arroz a Granel:Parboiled 50 LB -Bolsa Dos Hermanos.,,55.0,28.25,1553.75,3092574.25999999,Bulk Rice,Keila Alfaro-Visvikis,RETAIL  DSD,1383697,Jun
2024-06-13,"Meat Club Market, LLC.",Invoice,008-03219,Arroz Envasado:Sushi Rice Dos Hermanos.,.,5.0,25.5,127.5,3092701.75999999,Branded Rice,Lisset Limpio -020,RETAIL  DSD,1383698,Jun
2024-06-13,"Meat Club Market, LLC.",Invoice,008-03219,Arroz Envasado:Parboiled 1kg Bolsa Dos Hermanos.,.,2.0,19.9,39.8,3092741.55999999,Branded Rice,Lisset Limpio -020,RETAIL  DSD,1383699,Jun
2024-06-13,"Meat Club Market, LLC.",Invoice,008-03219,Arroz Envasado:Largo Fino 1kg (Long grain rice) Dos Hermanos,,1.0,17.0,17.0,3092758.55999999,Branded Rice,Lisset Limpio -020,RETAIL  DSD,1383700,Jun
2024-06-13,"Meat Club Market, LLC.",Invoice,008-03219,Rice Snack:Rice Snack Ham Flavored DOS HERMANOS,,1.0,19.9,19.9,3092778.45999999,Puffed Products,Lisset Limpio -020,RETAIL  DSD,1383701,Jun
2024-06-13,Sabor Tropical Supermarket #4,Invoice,008-03220,Arroz Envasado:Parboiled 1kg Bolsa Dos Hermanos.,.,3.0,19.9,59.7,3092838.15999999,Branded Rice,Keila Alfaro-Visvikis,RETAIL  DSD,1383702,Jun
2024-06-13,Sabor Tropical Supermarket #4,Invoice,008-03220,Arroz Envasado:Largo Fino 1kg (Long grain rice) Dos Hermanos,,1.0,17.0,17.0,3092855.15999999,Branded Rice,Keila Alfaro-Visvikis,RETAIL  DSD,1383703,Jun
2024-06-13,Sabor Tropical Supermarket #4,Invoice,008-03220,Arroz Envasado:Largo Fino 1kg (Long grain rice) Dos Hermanos,,2.0,17.0,34.0,3092889.15999999,Branded Rice,Keila Alfaro-Visvikis,RETAIL  DSD,1383704,Jun
2024-06-13,Sabor Tropical Supermarket #4,Invoice,008-03220,Arroz Envasado:Parboiled 5KG Dos Hermanos.,6 / 11lbs,5.0,46.5,232.5,3093121.65999999,Branded Rice,Keila Alfaro-Visvikis,RETAIL  DSD,1383705,Jun
2024-06-13,Sabor Tropical Supermarket #4,Invoice,008-03220,Arroz Envasado:Parboiled 5KG Dos Hermanos.,6 / 11lbs,1.0,46.5,46.5,3093168.15999999,Branded Rice,Keila Alfaro-Visvikis,RETAIL  DSD,1383706,Jun
2024-06-13,Sedanos Supermarkets #43,Invoice,008-03221,Arroz a Granel:Parboiled 50 LB -Bolsa Dos Hermanos.,,5.0,28.25,141.25,3093309.40999999,Bulk Rice,Lisset Limpio -020,RETAIL SEDANOS,1383707,Jun
2024-06-13,Sedanos Supermarkets #43,Invoice,008-03221,,Discount,,,-2.83,3093306.57999999,,Lisset Limpio -020,RETAIL SEDANOS,1383708,Jun
2024-06-13,Price Choice Food Market # 7,Invoice,008-03222,Arroz Envasado:Largo Fino 1kg (Long grain rice) Dos Hermanos,,2.0,17.0,34.0,3093340.57999999,Branded Rice,Keila Alfaro-Visvikis,RETAIL  DSD,1383709,Jun
2024-06-13,Price Choice Food Market # 7,Invoice,008-03222,Arroz Envasado:Parboiled 1kg Bolsa Dos Hermanos.,.,3.0,19.9,59.7,3093400.27999999,Branded Rice,Keila Alfaro-Visvikis,RETAIL  DSD,1383710,Jun
2024-06-13,Price Choice Food Market # 7,Invoice,008-03222,Rice Snack:Rice Snack Ham Flavored DOS HERMANOS,,1.0,19.9,19.9,3093420.17999999,Puffed Products,Keila Alfaro-Visvikis,RETAIL  DSD,1383711,Jun
2024-06-13,Price Choice Food Market # 7,Invoice,008-03222,Rice Snack:Rice Snack Salami Flavored DOS HERMANOS,,1.0,19.9,19.9,3093440.07999999,Puffed Products,Keila Alfaro-Visvikis,RETAIL  DSD,1383712,Jun
2024-06-13,Price Choice Food Market # 7,Invoice,008-03222,"Rice Snack:Rice Snack, Pizza DH",,1.0,19.9,19.9,3093459.97999999,Puffed Products,Keila Alfaro-Visvikis,RETAIL  DSD,1383713,Jun
2024-06-13,Price Choice Food Market # 7,Invoice,008-03222,Arroz Envasado:Parboiled 5KG Dos Hermanos.,6 / 11lbs,5.0,46.5,232.5,3093692.47999999,Branded Rice,Keila Alfaro-Visvikis,RETAIL  DSD,1383714,Jun
2024-06-13,Price Choice Food Market # 7,Invoice,008-03222,Arroz Envasado:Largo Fino 1kg (Long grain rice) Dos Hermanos,,1.0,17.0,17.0,3093709.47999999,Branded Rice,Keila Alfaro-Visvikis,RETAIL  DSD,1383715,Jun
2024-06-13,Price Choice Food Market # 7,Invoice,008-03222,Arroz Envasado:Parboiled 5KG Dos Hermanos.,6 / 11lbs,1.0,46.5,46.5,3093755.97999999,Branded Rice,Keila Alfaro-Visvikis,RETAIL  DSD,1383716,Jun
2024-06-13,Price Choice Food Market # 7,Invoice,008-03222,Rice Snack:Rice Snack Ham Flavored DOS HERMANOS,,1.0,19.9,19.9,3093775.87999999,Puffed Products,Keila Alfaro-Visvikis,RETAIL  DSD,1383717,Jun
2024-06-13,Sabor Tropical Supermarket #4,Credit Memo,008-03295,Varios:Promotional Allowance,Arroz Envasado:Largo Fino 1kg (Long grain rice) Dos Hermanos,-1.0,17.0,-17.0,3093758.87999999,Branded Rice,Keila Alfaro-Visvikis,RETAIL  DSD,1383718,Jun
2024-06-13,Sabor Tropical Supermarket #4,Credit Memo,008-03295,Varios:Promotional Allowance,Arroz Envasado:Parboiled 5KG Dos Hermanos.,-1.0,46.5,-46.5,3093712.37999999,Branded Rice,Keila Alfaro-Visvikis,RETAIL  DSD,1383719,Jun
2024-06-13,Price Choice Food Market # 7,Credit Memo,008-03332,Varios:Promotional Allowance,Arroz Envasado:Largo Fino 1kg (Long grain rice) Dos Hermanos,-1.0,17.0,-17.0,3093695.37999999,Branded Rice,Keila Alfaro-Visvikis,RETAIL  DSD,1383720,Jun
2024-06-13,Price Choice Food Market # 7,Credit Memo,008-03332,Varios:Promotional Allowance,Arroz Envasado:Parboiled 5KG Dos Hermanos.,-1.0,46.5,-46.5,3093648.87999999,Branded Rice,Keila Alfaro-Visvikis,RETAIL  DSD,1383721,Jun
2024-06-13,Price Choice Food Market # 7,Credit Memo,008-03332,Varios:Promotional Allowance,Rice Snack:Rice Snack Ham Flavored DOS HERMANOS,-1.0,19.9,-19.9,3093628.97999999,Puffed Products,Keila Alfaro-Visvikis,RETAIL  DSD,1383722,Jun
2024-06-14,Los Caringas Latin America  Foods,Invoice,008-03223,Arroz a Granel:Largo Fino 50 LB -Bolsa Dos Hermanos.,,2.0,27.85,55.7,3093684.67999999,Bulk Rice,Lisset Limpio -020,CAFETERIA y RESTAURANTS,1383723,Jun
2024-06-14,Los Caringas Latin America  Foods,Invoice,008-03223,Arroz a Granel:Parboiled 50 LB -Bolsa Dos Hermanos.,,3.0,28.25,84.75,3093769.42999999,Bulk Rice,Lisset Limpio -020,CAFETERIA y RESTAURANTS,1383724,Jun
2024-06-14,Fritanga Momotombo,Invoice,008-03224,Arroz a Granel:Largo Fino 50 LB -Bolsa Dos Hermanos.,,5.0,27.85,139.25,3093908.67999999,Bulk Rice,Lisset Limpio -020,CAFETERIA y RESTAURANTS,1383725,Jun
2024-06-14,Fritanga Momotombo,Invoice,008-03224,Dry Beans:Dry Beans - Small Red Beans 50 lbs.,Small Red Beans 50 lbs,1.0,46.0,46.0,3093954.67999999,Dry Beans,Lisset Limpio -020,CAFETERIA y RESTAURANTS,1383726,Jun
2024-06-14,Rey Chavez Distributor Corp,Invoice,008-03225,Arroz a Granel:Parboiled 50 LB -Bolsa Dos Hermanos.,,110.0,28.8,3168.0,3097122.67999999,Bulk Rice,Lisset Limpio -020,WHOLESALER,1383727,Jun
2024-06-14,Los paraditos chinesse,Invoice,008-03226,Arroz a Granel:Parboiled 50 LB -Bolsa Dos Hermanos.,,11.0,28.25,310.75,3097433.42999999,Bulk Rice,Lisset Limpio -020,CAFETERIA y RESTAURANTS,1383728,Jun
2024-06-14,Soriano Brothers PB,Invoice,008-03227,Spices:AS Sazon (for all),1 / 30 lb (box or pail),3.0,59.0,177.0,3097610.42999999,American Spice,Lisset Limpio -020,CAFETERIA y RESTAURANTS,1383729,Jun
2024-06-14,Los Mejores Tamales de Miami,Invoice,008-03228,Arroz a Granel:Parboiled 50 LB -Bolsa Dos Hermanos.,,5.0,28.25,141.25,3097751.67999999,Bulk Rice,Lisset Limpio -020,CAFETERIA y RESTAURANTS,1383730,Jun
2024-06-14,El Gallego Supermarket,Invoice,008-03229,Arroz Envasado:Parboiled 1kg Bolsa Dos Hermanos.,.,1.0,19.9,19.9,3097771.57999999,Branded Rice,Lisset Limpio -020,RETAIL  DSD,1383731,Jun
2024-06-14,El Gallego Supermarket,Invoice,008-03229,Arroz a Granel:Parboiled 50 LB -Bolsa Dos Hermanos.,,5.0,28.25,141.25,3097912.82999999,Bulk Rice,Lisset Limpio -020,RETAIL  DSD,1383732,Jun
2024-06-14,El Gallego Supermarket,Invoice,008-03229,Dry Beans:Dry Beans - Black Beans 50,Dry Black Beans 50 lb,2.0,42.5,85.0,3097997.82999999,Dry Beans,Lisset Limpio -020,RETAIL  DSD,1383733,Jun
2024-06-14,El Gallego Supermarket,Invoice,008-03229,Arroz Envasado:Parboiled 5KG Dos Hermanos.,6 / 11lbs,1.0,46.5,46.5,3098044.32999999,Branded Rice,Lisset Limpio -020,RETAIL  DSD,1383734,Jun
2024-06-14,Sedanos Supermarkets #18,Invoice,008-03230,Arroz a Granel:Parboiled 50 LB -Bolsa Dos Hermanos.,,10.0,28.25,282.5,3098326.82999999,Bulk Rice,Lisset Limpio -020,RETAIL SEDANOS,1383735,Jun
2024-06-14,Sedanos Supermarkets #18,Invoice,008-03230,,Discount,,,-5.65,3098321.17999999,,Lisset Limpio -020,RETAIL SEDANOS,1383736,Jun
2024-06-14,Sedanos Supermarkets #31,Invoice,008-03231,Arroz Envasado:Parboiled 5KG Dos Hermanos.,6 / 11lbs,10.0,40.5,405.0,3098726.17999999,Branded Rice,Lisset Limpio -020,RETAIL SEDANOS,1383737,Jun
2024-06-14,Sedanos Supermarkets #31,Invoice,008-03231,Arroz Envasado:Parboiled 5KG Dos Hermanos.,6 / 11lbs,10.0,40.5,405.0,3099131.17999999,Branded Rice,Lisset Limpio -020,RETAIL SEDANOS,1383738,Jun
2024-06-14,Sedanos Supermarkets #31,Invoice,008-03231,,,,,0.0,3099131.17999999,,Lisset Limpio -020,RETAIL SEDANOS,1383739,Jun
2024-06-14,Sedanos Supermarkets #31,Invoice,008-03231,,Discount,,,-8.1,3099123.07999999,,Lisset Limpio -020,RETAIL SEDANOS,1383740,Jun
2024-06-14,Sedanos Supermarkets #31,Invoice,008-03232,Arroz a Granel:Largo Fino 50 LB -Bolsa Dos Hermanos.,,2.0,27.85,55.7,3099178.77999999,Bulk Rice,Lisset Limpio -020,RETAIL SEDANOS,1383741,Jun
2024-06-14,Sedanos Supermarkets #31,Invoice,008-03232,Arroz a Granel:Parboiled 50 LB -Bolsa Dos Hermanos.,,5.0,28.25,141.25,3099320.02999999,Bulk Rice,Lisset Limpio -020,RETAIL SEDANOS,1383742,Jun
2024-06-14,Sedanos Supermarkets #31,Invoice,008-03232,,Discount,,,-3.94,3099316.08999999,,Lisset Limpio -020,RETAIL SEDANOS,1383743,Jun
2024-06-14,El Palacio de los jugos /  Nanos Latin Foods,Invoice,008-03233,Arroz a Granel:Largo Fino 50 LB -Bolsa Dos Hermanos.,,10.0,27.85,278.5,3099594.58999999,Bulk Rice,Lisset Limpio -020,Cafeteria,1383744,Jun
2024-06-14,Sedanos Supermarkets #31,Credit Memo,008-03297,Varios:Promotional Allowance,Arroz Envasado:Parboiled 5KG Dos Hermanos.,-10.0,40.5,-405.0,3099189.58999999,Branded Rice,Lisset Limpio -020,RETAIL SEDANOS,1383745,Jun
2024-06-17,Price Choice Food Market # 6,Invoice,008-03235,Arroz a Granel:Parboiled 50 LB -Bolsa Dos Hermanos.,,15.0,28.25,423.75,3099613.33999999,Bulk Rice,Lisset Limpio -020,RETAIL  DSD,1383746,Jun
2024-06-17,Key Food 7th Ave manager Alex,Invoice,008-03236,Arroz a Granel:Largo Fino 50 LB -Bolsa Dos Hermanos.,,1.0,27.5,27.5,3099640.83999999,Bulk Rice,Keila Alfaro-Visvikis,RETAIL  DSD,1383747,Jun
2024-06-17,JMN Dely Corp,Invoice,008-03237,Dry Beans:Dry Beans - Black Beans 50,Dry Black Beans 50 lb,2.0,42.5,85.0,3099725.83999999,Dry Beans,Keila Alfaro-Visvikis,CAFETERIA y RESTAURANTS,1383748,Jun
2024-06-17,JMN Dely Corp,Invoice,008-03237,Arroz a Granel:Largo Fino 50 LB -Bolsa Dos Hermanos.,,5.0,27.25,136.25,3099862.08999999,Bulk Rice,Keila Alfaro-Visvikis,CAFETERIA y RESTAURANTS,1383749,Jun
2024-06-17,JMN Dely Corp,Invoice,008-03237,Arroz a Granel:Parboiled 50 LB -Bolsa Dos Hermanos.,,3.0,28.25,84.75,3099946.83999999,Bulk Rice,Keila Alfaro-Visvikis,CAFETERIA y RESTAURANTS,1383750,Jun
2024-06-17,Sedanos Supermarkets #7,Invoice,008-03238,Arroz Envasado:Parboiled 5KG Dos Hermanos.,6 / 11lbs,5.0,40.5,202.5,3100149.33999999,Branded Rice,Lisset Limpio -020,RETAIL SEDANOS,1383751,Jun
2024-06-17,Sedanos Supermarkets #7,Invoice,008-03238,Rice Snack:Rice Snack Salami Flavored DOS HERMANOS,,1.0,19.9,19.9,3100169.23999999,Puffed Products,Lisset Limpio -020,RETAIL SEDANOS,1383752,Jun
2024-06-17,Sedanos Supermarkets #7,Invoice,008-03238,Rice Snack:Rice Snack Ham Flavored DOS HERMANOS,,2.0,19.9,39.8,3100209.03999999,Puffed Products,Lisset Limpio -020,RETAIL SEDANOS,1383753,Jun
2024-06-17,Sedanos Supermarkets #7,Invoice,008-03238,Arroz Envasado:Parboiled 5KG Dos Hermanos.,6 / 11lbs,5.0,40.5,202.5,3100411.53999999,Branded Rice,Lisset Limpio -020,RETAIL SEDANOS,1383754,Jun
2024-06-17,Sedanos Supermarkets #7,Invoice,008-03238,Rice Snack:Rice Snack Salami Flavored DOS HERMANOS,,1.0,19.9,19.9,3100431.43999999,Puffed Products,Lisset Limpio -020,RETAIL SEDANOS,1383755,Jun
2024-06-17,Sedanos Supermarkets #7,Invoice,008-03238,,Discount,,,-5.24,3100426.19999999,,Lisset Limpio -020,RETAIL SEDANOS,1383756,Jun
2024-06-17,Aries Supermarket & Cafeteria,Invoice,008-03239,Arroz a Granel:Parboiled 50 LB -Bolsa Dos Hermanos.,,10.0,28.8,288.0,3100714.19999999,Bulk Rice,Armando Carpio - 017,CAFETERIA y RESTAURANTS,1383757,Jun
2024-06-17,Sedanos Supermarkets #7,Credit Memo,008-03298,Varios:Promotional Allowance,Arroz Envasado:Parboiled 5KG Dos Hermanos.,-5.0,40.5,-202.5,3100511.69999999,Branded Rice,Lisset Limpio -020,RETAIL SEDANOS,1383758,Jun
2024-06-17,Sedanos Supermarkets #7,Credit Memo,008-03298,Varios:Promotional Allowance,Rice Snack:Rice Snack Salami Flavored DOS HERMANOS,-1.0,19.9,-19.9,3100491.79999999,Puffed Products,Lisset Limpio -020,RETAIL SEDANOS,1383759,Jun
2024-06-18,Sedanos Supermarkets #26,Invoice,008-03234,Arroz a Granel:Parboiled 50 LB -Bolsa Dos Hermanos.,,3.0,28.25,84.75,3100576.54999999,Bulk Rice,Lisset Limpio -020,RETAIL SEDANOS,1383760,Jun
2024-06-18,Sedanos Supermarkets #26,Invoice,008-03234,,Discount,,,-1.7,3100574.84999999,,Lisset Limpio -020,RETAIL SEDANOS,1383761,Jun
2024-06-18,Ideal Food Basket Davie Cafeteria,Invoice,008-03240,Arroz a Granel:Largo Fino 50 LB -Bolsa Dos Hermanos.,,9.0,27.25,245.25,3100820.09999999,Bulk Rice,Keila Alfaro-Visvikis,CAFETERIA y RESTAURANTS,1383762,Jun
2024-06-18,Cash Sales,Invoice,008-03241,Dry Beans:Dry Beans - Black Beans 50,Dry Black Beans 50 lb,1.0,42.5,42.5,3100862.59999999,Dry Beans,Armando Carpio - 017,CAFETERIA y RESTAURANTS,1383763,Jun
2024-06-18,Cash Sales,Invoice,008-03241,Arroz a Granel:Largo Fino 50 LB -Bolsa Dos Hermanos.,,1.0,28.25,28.25,3100890.84999999,Bulk Rice,Armando Carpio - 017,CAFETERIA y RESTAURANTS,1383764,Jun
2024-06-21,Fritanga Momotombo,Invoice,008-03242,Arroz a Granel:Largo Fino 50 LB -Bolsa Dos Hermanos.,,5.0,27.85,139.25,3101030.09999999,Bulk Rice,Lisset Limpio -020,CAFETERIA y RESTAURANTS,1383765,Jun
2024-06-21,Sedanos Supermarkets #22,Invoice,008-03243,Arroz a Granel:Parboiled 50 LB -Bolsa Dos Hermanos.,,4.0,28.25,113.0,3101143.09999999,Bulk Rice,Lisset Limpio -020,RETAIL SEDANOS,1383766,Jun
2024-06-21,Sedanos Supermarkets #22,Invoice,008-03243,,Discount,,,-2.26,3101140.83999999,,Lisset Limpio -020,RETAIL SEDANOS,1383767,Jun
2024-06-21,Bravo   Francisco Diaz,Invoice,008-03244,Liquids:AS Cooking Wine,4/1 Gl.,5.0,17.5,87.5,3101228.33999999,American Spice,Lisset Limpio -020,RETAIL  DSD,1383768,Jun
2024-06-21,Bravo   Francisco Diaz,Invoice,008-03244,Arroz a Granel:Largo Fino 50 LB -Bolsa Dos Hermanos.,,7.0,27.85,194.95,3101423.28999999,Bulk Rice,Lisset Limpio -020,RETAIL  DSD,1383769,Jun
2024-06-21,Bravo   Francisco Diaz,Invoice,008-03244,Liquids:AS White Vinegar,4/1 Gl.,2.0,10.0,20.0,3101443.28999999,American Spice,Lisset Limpio -020,RETAIL  DSD,1383770,Jun
2024-06-21,Sedanos Supermarkets #16,Invoice,008-03245,Arroz a Granel:Parboiled 50 LB -Bolsa Dos Hermanos.,,4.0,28.25,113.0,3101556.28999999,Bulk Rice,Lisset Limpio -020,RETAIL SEDANOS,1383771,Jun
2024-06-21,Sedanos Supermarkets #16,Invoice,008-03245,,Discount,,,-2.26,3101554.02999999,,Lisset Limpio -020,RETAIL SEDANOS,1383772,Jun
2024-06-21,El Palacio de los jugos /  Nanos Latin Foods,Invoice,008-03246,Arroz a Granel:Parboiled 50 LB -Bolsa Dos Hermanos.,,10.0,25.43,254.3,3101808.32999999,Bulk Rice,Lisset Limpio -020,Cafeteria,1383773,Jun
2024-06-21,Hings Chinese,Invoice,008-03247,Arroz a Granel:Parboiled 50 LB -Bolsa Dos Hermanos.,,5.0,28.25,141.25,3101949.57999999,Bulk Rice,Lisset Limpio -020,CAFETERIA y RESTAURANTS,1383774,Jun
2024-06-21,Sedanos Supermarkets #38,Invoice,008-03248,Arroz Envasado:Parboiled 5KG Dos Hermanos.,6 / 11lbs,10.0,40.5,405.0,3102354.57999999,Branded Rice,Lisset Limpio -020,RETAIL SEDANOS,1383775,Jun
2024-06-21,Sedanos Supermarkets #38,Invoice,008-03248,Arroz Envasado:Parboiled 5KG Dos Hermanos.,6 / 11lbs,10.0,40.5,405.0,3102759.57999999,Branded Rice,Lisset Limpio -020,RETAIL SEDANOS,1383776,Jun
2024-06-21,Sedanos Supermarkets #38,Invoice,008-03248,,Discount,,,-8.1,3102751.47999999,,Lisset Limpio -020,RETAIL SEDANOS,1383777,Jun
2024-06-21,Sedanos Supermarkets #18,Invoice,008-03249,Arroz Envasado:Parboiled 5KG Dos Hermanos.,6 / 11lbs,0.0,,0.0,3102751.47999999,Branded Rice,Lisset Limpio -020,RETAIL SEDANOS,1383778,Jun
2024-06-21,Sedanos Supermarkets #18,Invoice,008-03249,Arroz Envasado:Parboiled 5KG Dos Hermanos.,6 / 11lbs,0.0,0.0,0.0,3102751.47999999,Branded Rice,Lisset Limpio -020,RETAIL SEDANOS,1383779,Jun
2024-06-21,Soriano Brothers PB,Invoice,008-03250,Arroz a Granel:Largo Fino 50 LB -Bolsa Dos Hermanos.,,1.0,27.85,27.85,3102779.32999999,Bulk Rice,Lisset Limpio -020,CAFETERIA y RESTAURANTS,1383780,Jun
2024-06-21,Soriano Brothers PB,Invoice,008-03250,Arroz a Granel:Parboiled 50 LB -Bolsa Dos Hermanos.,,1.0,28.25,28.25,3102807.57999999,Bulk Rice,Lisset Limpio -020,CAFETERIA y RESTAURANTS,1383781,Jun
2024-06-21,Lissete Limpio,Invoice,008-03251,Arroz Envasado:Largo Fino 1kg (Long grain rice) Dos Hermanos,,1.0,17.0,17.0,3102824.57999999,Branded Rice,Lisset Limpio -020,OTHER,1383782,Jun
2024-06-21,Lissete Limpio,Invoice,008-03251,Arroz Envasado:Parboiled 1kg Bolsa Dos Hermanos.,.,1.0,19.9,19.9,3102844.47999999,Branded Rice,Lisset Limpio -020,OTHER,1383783,Jun
2024-06-21,Lissete Limpio,Invoice,008-03251,Arroz Envasado:Sushi Rice Dos Hermanos.,.,1.0,21.25,21.25,3102865.72999999,Branded Rice,Lisset Limpio -020,OTHER,1383784,Jun
2024-06-21,Lissete Limpio,Credit Memo,008-03299,Varios:Promotional Allowance,Arroz Envasado:Largo Fino 1kg (Long grain rice) Dos Hermanos,-1.0,17.0,-17.0,3102848.72999999,Branded Rice,Lisset Limpio -020,OTHER,1383785,Jun
2024-06-21,Lissete Limpio,Credit Memo,008-03299,Varios:Promotional Allowance,Arroz Envasado:Parboiled 1kg Bolsa Dos Hermanos.,-1.0,19.9,-19.9,3102828.82999999,Branded Rice,Lisset Limpio -020,OTHER,1383786,Jun
2024-06-21,Lissete Limpio,Credit Memo,008-03299,Varios:Promotional Allowance,Arroz Envasado:Sushi Rice Dos Hermanos.,-1.0,21.25,-21.25,3102807.57999999,Branded Rice,Lisset Limpio -020,OTHER,1383787,Jun
2024-06-21,Sedanos Supermarkets #38,Credit Memo,008-03301,Varios:Promotional Allowance,Arroz Envasado:Parboiled 5KG Dos Hermanos.,-10.0,40.5,-405.0,3102402.57999999,Branded Rice,Lisset Limpio -020,RETAIL SEDANOS,1383788,Jun
2024-06-24,"American Spice Trading Co, Inc.",Invoice,008-03252,Arroz a Granel:Parboiled 50 LB -Bolsa Dos Hermanos.,,1100.0,27.5,30250.0,3132652.57999999,Bulk Rice,Armando Carpio - 017,WHOLESALER MANUFACTURY,1383789,Jun
2024-06-24,Sedanos Supermarkets #5,Invoice,008-03253,Rice Snack:Rice Snack Ham Flavored DOS HERMANOS,,2.0,19.9,39.8,3132692.37999999,Puffed Products,Lisset Limpio -020,RETAIL SEDANOS,1383790,Jun
2024-06-24,Sedanos Supermarkets #5,Invoice,008-03253,Rice Snack:Rice Snack Salami Flavored DOS HERMANOS,,1.0,19.9,19.9,3132712.27999999,Puffed Products,Lisset Limpio -020,RETAIL SEDANOS,1383791,Jun
2024-06-24,Sedanos Supermarkets #5,Invoice,008-03253,"Rice Snack:Rice Snack, Pizza DH",,1.0,19.9,19.9,3132732.17999999,Puffed Products,Lisset Limpio -020,RETAIL SEDANOS,1383792,Jun
2024-06-24,Sedanos Supermarkets #5,Invoice,008-03253,,Discount,,,-1.19,3132730.98999999,,Lisset Limpio -020,RETAIL SEDANOS,1383793,Jun
2024-06-24,Enrique nueva Casa latina (Miami Gardem),Invoice,008-03254,"Rice Snack:Rice Snack, Pizza DH",,1.0,19.9,19.9,3132750.88999999,Puffed Products,Keila Alfaro-Visvikis,CAFETERIA y RESTAURANTS,1383794,Jun
2024-06-24,Enrique nueva Casa latina (Miami Gardem),Invoice,008-03254,Rice Snack:Rice Snack Salami Flavored DOS HERMANOS,,2.0,19.9,39.8,3132790.68999999,Puffed Products,Keila Alfaro-Visvikis,CAFETERIA y RESTAURANTS,1383795,Jun
2024-06-24,Enrique nueva Casa latina (Miami Gardem),Invoice,008-03254,Rice Snack:Rice Snack Ham Flavored DOS HERMANOS,,2.0,19.9,39.8,3132830.48999999,Puffed Products,Keila Alfaro-Visvikis,CAFETERIA y RESTAURANTS,1383796,Jun
2024-06-24,Enrique nueva Casa latina (Miami Gardem),Invoice,008-03254,Arroz Envasado:Largo Fino 1kg (Long grain rice) Dos Hermanos,,5.0,17.0,85.0,3132915.48999999,Branded Rice,Keila Alfaro-Visvikis,CAFETERIA y RESTAURANTS,1383797,Jun
2024-06-24,Los Caringas Latin America  Foods,Invoice,008-03255,Arroz a Granel:Parboiled 50 LB -Bolsa Dos Hermanos.,,3.0,28.25,84.75,3133000.23999999,Bulk Rice,Lisset Limpio -020,CAFETERIA y RESTAURANTS,1383798,Jun
2024-06-24,Los Caringas Latin America  Foods,Invoice,008-03255,Arroz a Granel:Largo Fino 50 LB -Bolsa Dos Hermanos.,,3.0,27.85,83.55,3133083.78999999,Bulk Rice,Lisset Limpio -020,CAFETERIA y RESTAURANTS,1383799,Jun
2024-06-24,JMN Dely Corp,Invoice,008-03256,Dry Beans:Dry Beans - Black Beans 50,Dry Black Beans 50 lb,1.0,43.5,43.5,3133127.28999999,Dry Beans,Keila Alfaro-Visvikis,CAFETERIA y RESTAURANTS,1383800,Jun
2024-06-24,JMN Dely Corp,Invoice,008-03256,Arroz a Granel:Parboiled 50 LB -Bolsa Dos Hermanos.,,3.0,28.0,84.0,3133211.28999999,Bulk Rice,Keila Alfaro-Visvikis,CAFETERIA y RESTAURANTS,1383801,Jun
2024-06-24,JMN Dely Corp,Invoice,008-03256,Arroz a Granel:Largo Fino 50 LB -Bolsa Dos Hermanos.,,4.0,27.85,111.4,3133322.68999999,Bulk Rice,Keila Alfaro-Visvikis,CAFETERIA y RESTAURANTS,1383802,Jun
2024-06-24,Soriano Brothers PB,Invoice,008-03257,Arroz a Granel:Largo Fino 50 LB -Bolsa Dos Hermanos.,,55.0,27.75,1526.25,3134848.93999999,Bulk Rice,Lisset Limpio -020,CAFETERIA y RESTAURANTS,1383803,Jun
2024-06-24,Sedanos Supermarkets #14,Invoice,008-03258,Arroz a Granel:Parboiled 50 LB -Bolsa Dos Hermanos.,,1.0,28.25,28.25,3134877.18999999,Bulk Rice,Lisset Limpio -020,RETAIL SEDANOS,1383804,Jun
2024-06-24,Sedanos Supermarkets #14,Invoice,008-03258,,Discount,,,-0.57,3134876.61999999,,Lisset Limpio -020,RETAIL SEDANOS,1383805,Jun
2024-06-24,Sedanos Supermarkets #14,Invoice,008-03259,Rice Snack:Rice Snack Ham Flavored DOS HERMANOS,,2.0,19.9,39.8,3134916.41999999,Puffed Products,Lisset Limpio -020,RETAIL SEDANOS,1383806,Jun
2024-06-24,Sedanos Supermarkets #14,Invoice,008-03259,Rice Snack:Rice Snack Salami Flavored DOS HERMANOS,,1.0,19.9,19.9,3134936.31999999,Puffed Products,Lisset Limpio -020,RETAIL SEDANOS,1383807,Jun
2024-06-24,Sedanos Supermarkets #14,Invoice,008-03259,"Rice Snack:Rice Snack, Pizza DH",,1.0,19.9,19.9,3134956.21999999,Puffed Products,Lisset Limpio -020,RETAIL SEDANOS,1383808,Jun
2024-06-24,Sedanos Supermarkets #14,Invoice,008-03259,,Discount,,,-1.19,3134955.02999999,,Lisset Limpio -020,RETAIL SEDANOS,1383809,Jun
2024-06-24,Sedanos Supermarkets #23,Invoice,008-03260,Rice Snack:Rice Snack Ham Flavored DOS HERMANOS,,2.0,19.9,39.8,3134994.82999999,Puffed Products,Lisset Limpio -020,RETAIL SEDANOS,1383810,Jun
2024-06-24,Sedanos Supermarkets #23,Invoice,008-03260,Rice Snack:Rice Snack Salami Flavored DOS HERMANOS,,1.0,19.9,19.9,3135014.72999999,Puffed Products,Lisset Limpio -020,RETAIL SEDANOS,1383811,Jun
2024-06-24,Sedanos Supermarkets #23,Invoice,008-03260,"Rice Snack:Rice Snack, Pizza DH",,1.0,19.9,19.9,3135034.62999999,Puffed Products,Lisset Limpio -020,RETAIL SEDANOS,1383812,Jun
2024-06-24,Sedanos Supermarkets #23,Invoice,008-03260,,Discount,,,-1.19,3135033.43999999,,Lisset Limpio -020,RETAIL SEDANOS,1383813,Jun
2024-06-24,Aries Supermarket & Cafeteria,Invoice,008-03261,Dry Beans:Dry Beans - Black Beans 50,Dry Black Beans 50 lb,10.0,39.5,395.0,3135428.43999999,Dry Beans,Armando Carpio - 017,CAFETERIA y RESTAURANTS,1383814,Jun
2024-06-24,Aries Supermarket & Cafeteria,Invoice,008-03261,Arroz a Granel:Parboiled 50 LB -Bolsa Dos Hermanos.,,5.0,28.8,144.0,3135572.43999999,Bulk Rice,Armando Carpio - 017,CAFETERIA y RESTAURANTS,1383815,Jun
2024-06-24,Sedanos Supermarkets #5,Credit Memo,008-03300,Varios:Promotional Allowance,"Rice Snack:Rice Snack, Pizza DH",-1.0,19.9,-19.9,3135552.53999999,Puffed Products,Lisset Limpio -020,RETAIL SEDANOS,1383816,Jun
2024-06-24,Sedanos Supermarkets #14,Credit Memo,008-03302,Varios:Promotional Allowance,"Rice Snack:Rice Snack, Pizza DH",-1.0,19.9,-19.9,3135532.63999999,Puffed Products,Lisset Limpio -020,RETAIL SEDANOS,1383817,Jun
2024-06-24,Sedanos Supermarkets #23,Credit Memo,008-03303,Varios:Promotional Allowance,"Rice Snack:Rice Snack, Pizza DH",-1.0,19.9,-19.9,3135512.73999999,Puffed Products,Lisset Limpio -020,RETAIL SEDANOS,1383818,Jun
2024-06-26,Armando Carpio,Invoice,008-03262,Arroz a Granel:Largo Fino 50 LB -Bolsa Dos Hermanos.,,1.0,27.85,27.85,3135540.58999999,Bulk Rice,Armando Carpio - 017,OTHER,1383819,Jun
2024-06-26,Armando Carpio,Invoice,008-03262,Arroz a Granel:Parboiled 50 LB -Bolsa Dos Hermanos.,,1.0,28.25,28.25,3135568.83999999,Bulk Rice,Armando Carpio - 017,OTHER,1383820,Jun
2024-06-26,Armando Carpio,Credit Memo,008-03304,Varios:Promotional Allowance,Arroz a Granel:Largo Fino 50 LB -Bolsa Dos Hermanos.,-1.0,27.85,-27.85,3135540.98999999,Bulk Rice,Armando Carpio - 017,OTHER,1383821,Jun
2024-06-26,Armando Carpio,Credit Memo,008-03304,Varios:Promotional Allowance,Arroz a Granel:Parboiled 50 LB -Bolsa Dos Hermanos.,-1.0,28.25,-28.25,3135512.73999999,Bulk Rice,Armando Carpio - 017,OTHER,1383822,Jun
2024-06-27,El Palacio de los jugos /  Nanos Latin Foods,Invoice,008-03263,Arroz a Granel:Parboiled 50 LB -Bolsa Dos Hermanos.,,11.0,27.75,305.25,3135817.98999999,Bulk Rice,Lisset Limpio -020,Cafeteria,1383823,Jun
2024-06-27,El Palacio de los jugos /  Nanos Latin Foods,Invoice,008-03263,Dry Beans:Dry Beans - Black Beans 50,Dry Black Beans 50 lb,1.0,42.5,42.5,3135860.48999999,Dry Beans,Lisset Limpio -020,Cafeteria,1383824,Jun
2024-06-27,El Palacio de los jugos /  Nanos Latin Foods,Invoice,008-03263,Arroz a Granel:Largo Fino 50 LB -Bolsa Dos Hermanos.,,1.0,27.85,27.85,3135888.33999999,Bulk Rice,Lisset Limpio -020,Cafeteria,1383825,Jun
2024-06-27,Los Mejores Tamales de Miami,Invoice,008-03264,Arroz a Granel:Largo Fino 50 LB -Bolsa Dos Hermanos.,,2.0,27.85,55.7,3135944.03999999,Bulk Rice,Lisset Limpio -020,CAFETERIA y RESTAURANTS,1383826,Jun
2024-06-27,Los Mejores Tamales de Miami,Invoice,008-03264,Arroz a Granel:Parboiled 50 LB -Bolsa Dos Hermanos.,,3.0,28.25,84.75,3136028.78999999,Bulk Rice,Lisset Limpio -020,CAFETERIA y RESTAURANTS,1383827,Jun
2024-06-27,Bravo   Francisco Diaz,Invoice,008-03265,Arroz a Granel:Largo Fino 50 LB -Bolsa Dos Hermanos.,,4.0,27.85,111.4,3136140.18999999,Bulk Rice,Lisset Limpio -020,RETAIL  DSD,1383828,Jun
2024-06-27,Sedanos Supermarkets #29,Invoice,008-03266,Rice Snack:Rice Snack Salami Flavored DOS HERMANOS,,1.0,19.9,19.9,3136160.08999999,Puffed Products,Lisset Limpio -020,RETAIL SEDANOS,1383829,Jun
2024-06-27,Sedanos Supermarkets #29,Invoice,008-03266,"Rice Snack:Rice Snack, Pizza DH",,1.0,19.0,19.0,3136179.08999999,Puffed Products,Lisset Limpio -020,RETAIL SEDANOS,1383830,Jun
2024-06-27,Sedanos Supermarkets #29,Invoice,008-03266,Rice Snack:Rice Snack Ham Flavored DOS HERMANOS,,2.0,19.9,39.8,3136218.88999999,Puffed Products,Lisset Limpio -020,RETAIL SEDANOS,1383831,Jun
2024-06-27,Sedanos Supermarkets #29,Invoice,008-03266,Arroz Envasado:Parboiled 5KG Dos Hermanos.,6 / 11lbs,10.0,40.5,405.0,3136623.88999999,Branded Rice,Lisset Limpio -020,RETAIL SEDANOS,1383832,Jun
2024-06-27,Sedanos Supermarkets #29,Invoice,008-03266,Arroz Envasado:Parboiled 5KG Dos Hermanos.,6 / 11lbs,10.0,40.5,405.0,3137028.88999999,Branded Rice,Lisset Limpio -020,RETAIL SEDANOS,1383833,Jun
2024-06-27,Sedanos Supermarkets #29,Invoice,008-03266,,Discount,,,-8.39,3137020.49999999,,Lisset Limpio -020,RETAIL SEDANOS,1383834,Jun
2024-06-27,Rey Chavez Distributor #2,Invoice,008-03267,Arroz a Granel:Parboiled 50 LB -Bolsa Dos Hermanos.,,30.0,28.8,864.0,3137884.49999999,Bulk Rice,Lisset Limpio -020,WHOLESALER,1383835,Jun
2024-06-27,Sedanos Supermarkets #33,Invoice,008-03268,Arroz a Granel:Parboiled 50 LB -Bolsa Dos Hermanos.,,5.0,28.25,141.25,3138025.74999999,Bulk Rice,Lisset Limpio -020,RETAIL SEDANOS,1383836,Jun
2024-06-27,Sedanos Supermarkets #33,Invoice,008-03268,,Discount,,,-2.83,3138022.91999999,,Lisset Limpio -020,RETAIL SEDANOS,1383837,Jun
2024-06-27,Mei Chang,Invoice,008-03269,Arroz a Granel:Parboiled 50 LB -Bolsa Dos Hermanos.,,10.0,28.25,282.5,3138305.41999999,Bulk Rice,Lisset Limpio -020,CAFETERIA y RESTAURANTS,1383838,Jun
2024-06-27,Sedanos Supermarkets #43,Invoice,008-03270,Arroz a Granel:Parboiled 50 LB -Bolsa Dos Hermanos.,,4.0,28.25,113.0,3138418.41999999,Bulk Rice,Lisset Limpio -020,RETAIL SEDANOS,1383839,Jun
2024-06-27,Sedanos Supermarkets #43,Invoice,008-03270,,Discount,,,-2.26,3138416.15999999,,Lisset Limpio -020,RETAIL SEDANOS,1383840,Jun
2024-06-27,El Palacio de los jugos / Delicias Criollas (DIAGO FOOD_MILLER),Invoice,008-03271,Arroz a Granel:Parboiled 50 LB -Bolsa Dos Hermanos.,,11.0,27.75,305.25,3138721.40999999,Bulk Rice,Lisset Limpio -020,Cafeteria,1383841,Jun
2024-06-27,El Palacio de los jugos / Delicias Criollas (DIAGO FOOD_MILLER),Invoice,008-03271,Dry Beans:Dry Beans - Black Beans 50,Dry Black Beans 50 lb,1.0,42.5,42.5,3138763.90999999,Dry Beans,Lisset Limpio -020,Cafeteria,1383842,Jun
2024-06-27,El Palacio de los jugos / Delicias Criollas (DIAGO FOOD_MILLER),Invoice,008-03271,Arroz a Granel:Parboiled 50 LB -Bolsa Dos Hermanos.,,1.0,27.75,27.75,3138791.65999999,Bulk Rice,Lisset Limpio -020,Cafeteria,1383843,Jun
2024-06-27,El Palacio de Los Jugos / Casa mía Food Restaurant inc,Invoice,008-03272,Arroz a Granel:Parboiled 50 LB -Bolsa Dos Hermanos.,,11.0,27.75,305.25,3139096.90999999,Bulk Rice,Lisset Limpio -020,Cafeteria,1383844,Jun
2024-06-27,El Palacio de Los Jugos / Casa mía Food Restaurant inc,Invoice,008-03272,Dry Beans:Dry Beans - Black Beans 50,Dry Black Beans 50 lb,1.0,42.5,42.5,3139139.40999999,Dry Beans,Lisset Limpio -020,Cafeteria,1383845,Jun
2024-06-27,El Palacio de Los Jugos / Casa mía Food Restaurant inc,Invoice,008-03272,Arroz a Granel:Parboiled 50 LB -Bolsa Dos Hermanos.,,1.0,28.25,28.25,3139167.65999999,Bulk Rice,Lisset Limpio -020,Cafeteria,1383846,Jun
2024-06-27,El Gallego Supermarket,Invoice,008-03273,Dry Beans:Dry Beans - Black Beans 50,Dry Black Beans 50 lb,1.0,39.5,39.5,3139207.15999999,Dry Beans,Lisset Limpio -020,RETAIL  DSD,1383847,Jun
2024-06-27,El Gallego Supermarket,Invoice,008-03273,Arroz a Granel:Parboiled 50 LB -Bolsa Dos Hermanos.,,5.0,28.25,141.25,3139348.40999999,Bulk Rice,Lisset Limpio -020,RETAIL  DSD,1383848,Jun
2024-06-27,El Palacio de Los Jugos / Casa mía Food Restaurant inc,Credit Memo,008-03305,Varios:Promotional Allowance,Arroz a Granel:Parboiled 50 LB -Bolsa Dos Hermanos.,-1.0,28.25,-28.25,3139320.15999999,Bulk Rice,Lisset Limpio -020,Cafeteria,1383849,Jun
2024-06-27,El Palacio de los jugos /  Nanos Latin Foods,Credit Memo,008-03306,Varios:Promotional Allowance,Arroz a Granel:Largo Fino 50 LB -Bolsa Dos Hermanos.,-1.0,27.85,-27.85,3139292.30999999,Bulk Rice,Lisset Limpio -020,Cafeteria,1383850,Jun
2024-06-27,Sedanos Supermarkets #29,Credit Memo,008-03307,Varios:Promotional Allowance,"Rice Snack:Rice Snack, Pizza DH",-1.0,19.9,-19.9,3139272.40999999,Puffed Products,Lisset Limpio -020,RETAIL SEDANOS,1383851,Jun
2024-06-27,Sedanos Supermarkets #29,Credit Memo,008-03307,Varios:Promotional Allowance,Arroz Envasado:Parboiled 5KG Dos Hermanos.,-10.0,40.5,-405.0,3138867.40999999,Branded Rice,Lisset Limpio -020,RETAIL SEDANOS,1383852,Jun
2024-06-27,El Palacio de los jugos / Delicias Criollas (DIAGO FOOD_MILLER),Credit Memo,008-03308,Varios:Promotional Allowance,Arroz a Granel:Parboiled 50 LB -Bolsa Dos Hermanos.,-1.0,27.25,-27.25,3138840.15999999,Bulk Rice,Lisset Limpio -020,Cafeteria,1383853,Jun
2024-06-28,Sedanos Supermarkets #31,Invoice,008-03274,Arroz a Granel:Largo Fino 50 LB -Bolsa Dos Hermanos.,,2.0,27.85,55.7,3138895.85999999,Bulk Rice,Lisset Limpio -020,RETAIL SEDANOS,1383854,Jun
2024-06-28,Sedanos Supermarkets #31,Invoice,008-03274,Arroz a Granel:Parboiled 50 LB -Bolsa Dos Hermanos.,,2.0,28.25,56.5,3138952.35999999,Bulk Rice,Lisset Limpio -020,RETAIL SEDANOS,1383855,Jun
2024-06-28,Sedanos Supermarkets #31,Invoice,008-03274,,Discount,,,-2.24,3138950.11999999,,Lisset Limpio -020,RETAIL SEDANOS,1383856,Jun
2024-07-01,Los paraditos chinesse,Invoice,008-03275,Arroz a Granel:Parboiled 50 LB -Bolsa Dos Hermanos.,,10.0,28.25,282.5,3139232.61999999,Bulk Rice,Lisset Limpio -020,CAFETERIA y RESTAURANTS,1383857,Jul
2024-07-01,Soriano Brothers PB,Invoice,008-03276,Arroz a Granel:Parboiled 50 LB -Bolsa Dos Hermanos.,,22.0,27.75,610.5,3139843.11999999,Bulk Rice,Lisset Limpio -020,CAFETERIA y RESTAURANTS,1383858,Jul
2024-07-01,Soriano Brothers PB,Invoice,008-03276,Spices:AS Sazon (for all),1 / 30 lb (box or pail),2.0,59.0,118.0,3139961.11999999,American Spice,Lisset Limpio -020,CAFETERIA y RESTAURANTS,1383859,Jul
2024-07-01,Soriano Brothers PB,Invoice,008-03276,Dry Beans:Dry Beans - Small Red Beans 50 lbs.,Small Red Beans 50 lbs,1.0,46.0,46.0,3140007.11999999,Dry Beans,Lisset Limpio -020,CAFETERIA y RESTAURANTS,1383860,Jul
2024-07-01,Soriano Brothers PB,Invoice,008-03276,Arroz a Granel:Parboiled 50 LB -Bolsa Dos Hermanos.,,2.0,27.75,55.5,3140062.61999999,Bulk Rice,Lisset Limpio -020,CAFETERIA y RESTAURANTS,1383861,Jul
2024-07-01,El Palacio de Los Jugos / Casa mía Food Restaurant inc,Invoice,008-03277,Dry Beans:Dry Beans - Black Beans 50,Dry Black Beans 50 lb,1.0,42.5,42.5,3140105.11999999,Dry Beans,Lisset Limpio -020,Cafeteria,1383862,Jul
2024-07-01,El Palacio de Los Jugos / Casa mía Food Restaurant inc,Invoice,008-03277,Arroz a Granel:Parboiled 50 LB -Bolsa Dos Hermanos.,,11.0,27.75,305.25,3140410.36999999,Bulk Rice,Lisset Limpio -020,Cafeteria,1383863,Jul
2024-07-01,El Palacio de Los Jugos / Casa mía Food Restaurant inc,Invoice,008-03277,Arroz a Granel:Parboiled 50 LB -Bolsa Dos Hermanos.,,1.0,27.75,27.75,3140438.11999999,Bulk Rice,Lisset Limpio -020,Cafeteria,1383864,Jul
2024-07-01,Ideal Food Basket Davie Cafeteria,Invoice,008-03278,Arroz a Granel:Largo Fino 50 LB -Bolsa Dos Hermanos.,,10.0,27.25,272.5,3140710.61999999,Bulk Rice,Keila Alfaro-Visvikis,CAFETERIA y RESTAURANTS,1383865,Jul
2024-07-01,Aries Supermarket & Cafeteria,Invoice,008-03279,Arroz a Granel:Parboiled 50 LB -Bolsa Dos Hermanos.,,10.0,28.85,288.5,3140999.11999999,Bulk Rice,Armando Carpio - 017,CAFETERIA y RESTAURANTS,1383866,Jul
2024-07-01,Sedanos Supermarkets #24,Invoice,008-03280,Arroz a Granel:Parboiled 50 LB -Bolsa Dos Hermanos.,,15.0,28.25,423.75,3141422.86999999,Bulk Rice,Keila Alfaro-Visvikis,RETAIL SEDANOS,1383867,Jul
2024-07-01,Sedanos Supermarkets #24,Invoice,008-03280,,Discount,,,-8.48,3141414.38999999,,Keila Alfaro-Visvikis,RETAIL SEDANOS,1383868,Jul
2024-07-01,JMN Dely Corp,Invoice,008-03281,Arroz a Granel:Largo Fino 50 LB -Bolsa Dos Hermanos.,,5.0,27.25,136.25,3141550.63999999,Bulk Rice,Keila Alfaro-Visvikis,CAFETERIA y RESTAURANTS,1383869,Jul
2024-07-01,JMN Dely Corp,Invoice,008-03281,Arroz a Granel:Parboiled 50 LB -Bolsa Dos Hermanos.,,3.0,28.25,84.75,3141635.38999999,Bulk Rice,Keila Alfaro-Visvikis,CAFETERIA y RESTAURANTS,1383870,Jul
2024-07-01,JMN Dely Corp,Invoice,008-03281,Dry Beans:Dry Beans - Black Beans 50,Dry Black Beans 50 lb,1.0,42.5,42.5,3141677.88999999,Dry Beans,Keila Alfaro-Visvikis,CAFETERIA y RESTAURANTS,1383871,Jul
2024-07-01,Sedanos Supermarkets #1,Invoice,008-03282,Arroz Envasado:Parboiled 5KG Dos Hermanos.,6 / 11lbs,0.0,,0.0,3141677.88999999,Branded Rice,Lisset Limpio -020,RETAIL SEDANOS,1383872,Jul
2024-07-01,Sedanos Supermarkets #1,Invoice,008-03282,Arroz Envasado:Parboiled 5KG Dos Hermanos.,6 / 11lbs,0.0,,0.0,3141677.88999999,Branded Rice,Lisset Limpio -020,RETAIL SEDANOS,1383873,Jul
2024-07-01,Sedanos Supermarkets  #37,Invoice,008-03283,Arroz Envasado:Parboiled 5KG Dos Hermanos.,6 / 11lbs,5.0,40.5,202.5,3141880.38999999,Branded Rice,Lisset Limpio -020,RETAIL SEDANOS,1383874,Jul
2024-07-01,Sedanos Supermarkets  #37,Invoice,008-03283,Arroz Envasado:Parboiled 5KG Dos Hermanos.,6 / 11lbs,5.0,40.5,202.5,3142082.88999999,Branded Rice,Lisset Limpio -020,RETAIL SEDANOS,1383875,Jul
2024-07-01,Sedanos Supermarkets  #37,Invoice,008-03283,,Discount,,,-4.05,3142078.83999999,,Lisset Limpio -020,RETAIL SEDANOS,1383876,Jul
2024-07-01,Soriano Brothers PB,Credit Memo,008-03441,Varios:Promotional Allowance,Parboiled 50 LB,-2.0,27.75,-55.5,3142023.33999999,Bulk Rice,Lisset Limpio -020,CAFETERIA y RESTAURANTS,1383877,Jul
2024-07-01,El Palacio de Los Jugos / Casa mía Food Restaurant inc,Credit Memo,008-03442,Varios:Promotional Allowance,Parboiled 50LB,-1.0,27.75,-27.75,3141995.58999999,Bulk Rice,Lisset Limpio -020,Cafeteria,1383878,Jul
2024-07-01,Sedanos Supermarkets #1,Credit Memo,008-03443,Varios:Promotional Allowance,Parboiled 5kg,-5.0,40.5,-202.5,3141793.08999999,Branded Rice,Lisset Limpio -020,RETAIL SEDANOS,1383879,Jul
2024-07-01,Sedanos Supermarkets  #37,Credit Memo,008-03444,Varios:Promotional Allowance,Parboiled 5kg,-5.0,40.5,-202.5,3141590.58999999,Branded Rice,Lisset Limpio -020,RETAIL SEDANOS,1383880,Jul
2024-07-02,Las vegas cuban cuisine,Invoice,008-03284,Arroz a Granel:Largo Fino 50 LB -Bolsa Dos Hermanos.,,1.0,27.85,27.85,3141618.43999999,Bulk Rice,Keila Alfaro-Visvikis,CAFETERIA y RESTAURANTS,1383881,Jul
2024-07-02,Las vegas cuban cuisine,Invoice,008-03284,Arroz a Granel:Parboiled 50 LB -Bolsa Dos Hermanos.,,1.0,28.25,28.25,3141646.68999999,Bulk Rice,Keila Alfaro-Visvikis,CAFETERIA y RESTAURANTS,1383882,Jul
2024-07-02,Las vegas cuban cuisine,Credit Memo,008-03445,Varios:Promotional Allowance,Parboiled 50LB,-1.0,28.25,-28.25,3141618.43999999,Bulk Rice,Keila Alfaro-Visvikis,CAFETERIA y RESTAURANTS,1383883,Jul
2024-07-02,Las vegas cuban cuisine,Credit Memo,008-03445,Varios:Promotional Allowance,LF 50 LB,-1.0,27.85,-27.85,3141590.58999999,Bulk Rice,Keila Alfaro-Visvikis,CAFETERIA y RESTAURANTS,1383884,Jul
2024-07-03,"American Spice Trading Co, Inc.",Invoice,008-03296,Arroz a Granel:Parboiled 50 LB -Bolsa Dos Hermanos.,MRSU 481754 6,1100.0,27.5,30250.0,3171840.58999999,Bulk Rice,Armando Carpio - 017,WHOLESALER MANUFACTURY,1383885,Jul
2024-07-05,Family and Son,Invoice,008-03309,Arroz a Granel:Parboiled 50 LB -Bolsa Dos Hermanos.,HLBU 322885 3,1100.0,24.75,27225.0,3199065.58999999,Bulk Rice,Armando Carpio - 017,WHOLESALER MANUFACTURY,1383886,Jul
2024-07-05,Family and Son,Invoice,008-03310,Arroz a Granel:Parboiled 50 LB -Bolsa Dos Hermanos.,TCKU 730354 5,1100.0,24.75,27225.0,3226290.58999999,Bulk Rice,Armando Carpio - 017,WHOLESALER MANUFACTURY,1383887,Jul
2024-07-05,El Palacio de Los Jugos / Casa mía Food Restaurant inc,Invoice,008-03311,Arroz a Granel:Parboiled 50 LB -Bolsa Dos Hermanos.,,11.0,27.75,305.25,3226595.83999999,Bulk Rice,Lisset Limpio -020,Cafeteria,1383888,Jul
2024-07-05,El Palacio de Los Jugos / Casa mía Food Restaurant inc,Invoice,008-03311,Dry Beans:Dry Beans - Black Beans 50,Dry Black Beans 50 lb,1.0,43.5,43.5,3226639.33999999,Dry Beans,Lisset Limpio -020,Cafeteria,1383889,Jul
2024-07-05,El Palacio de Los Jugos / Casa mía Food Restaurant inc,Invoice,008-03311,Arroz a Granel:Parboiled 50 LB -Bolsa Dos Hermanos.,,1.0,27.75,27.75,3226667.08999999,Bulk Rice,Lisset Limpio -020,Cafeteria,1383890,Jul
2024-07-05,El Palacio de los jugos /  Mires Restaurants,Invoice,008-03312,Dry Beans:Dry Beans - Black Beans 50,Dry Black Beans 50 lb,1.0,43.5,43.5,3226710.58999999,Dry Beans,Lisset Limpio -020,Cafeteria,1383891,Jul
2024-07-05,El Palacio de los jugos /  Mires Restaurants,Invoice,008-03312,Arroz a Granel:Parboiled 50 LB -Bolsa Dos Hermanos.,,11.0,27.75,305.25,3227015.83999999,Bulk Rice,Lisset Limpio -020,Cafeteria,1383892,Jul
2024-07-05,El Palacio de los jugos /  Mires Restaurants,Invoice,008-03312,Arroz a Granel:Parboiled 50 LB -Bolsa Dos Hermanos.,,1.0,27.75,27.75,3227043.58999999,Bulk Rice,Lisset Limpio -020,Cafeteria,1383893,Jul
2024-07-05,El Palacio de los jugos / Delicias Criollas (DIAGO FOOD_MILLER),Invoice,008-03313,Arroz a Granel:Parboiled 50 LB -Bolsa Dos Hermanos.,,11.0,27.75,305.25,3227348.83999999,Bulk Rice,Lisset Limpio -020,Cafeteria,1383894,Jul
2024-07-05,El Palacio de los jugos / Delicias Criollas (DIAGO FOOD_MILLER),Invoice,008-03313,Dry Beans:Dry Beans - Black Beans 50,Dry Black Beans 50 lb,1.0,43.5,43.5,3227392.33999999,Dry Beans,Lisset Limpio -020,Cafeteria,1383895,Jul
2024-07-05,El Palacio de los jugos / Delicias Criollas (DIAGO FOOD_MILLER),Invoice,008-03313,Arroz a Granel:Parboiled 50 LB -Bolsa Dos Hermanos.,,1.0,27.75,27.75,3227420.08999999,Bulk Rice,Lisset Limpio -020,Cafeteria,1383896,Jul
2024-07-05,El Palacio de los jugos /  Nanos Latin Foods,Invoice,008-03314,Arroz a Granel:Parboiled 50 LB -Bolsa Dos Hermanos.,,11.0,27.75,305.25,3227725.33999999,Bulk Rice,Lisset Limpio -020,Cafeteria,1383897,Jul
2024-07-05,El Palacio de los jugos /  Nanos Latin Foods,Invoice,008-03314,Dry Beans:Dry Beans - Black Beans 50,Dry Black Beans 50 lb,1.0,43.5,43.5,3227768.83999999,Dry Beans,Lisset Limpio -020,Cafeteria,1383898,Jul
2024-07-05,El Palacio de los jugos /  Nanos Latin Foods,Invoice,008-03314,Arroz a Granel:Parboiled 50 LB -Bolsa Dos Hermanos.,,1.0,27.75,27.75,3227796.58999999,Bulk Rice,Lisset Limpio -020,Cafeteria,1383899,Jul
2024-07-05,Sedanos Supermarkets #18,Invoice,008-03315,Arroz a Granel:Parboiled 50 LB -Bolsa Dos Hermanos.,,10.0,28.25,282.5,3228079.08999999,Bulk Rice,Lisset Limpio -020,RETAIL SEDANOS,1383900,Jul
2024-07-05,Sedanos Supermarkets #18,Invoice,008-03315,,Discount,,,-5.65,3228073.43999999,,Lisset Limpio -020,RETAIL SEDANOS,1383901,Jul
2024-07-05,Sedanos Supermarkets #18,Invoice,008-03316,Arroz Envasado:Parboiled 5KG Dos Hermanos.,6 / 11lbs,2.0,40.5,81.0,3228154.43999999,Branded Rice,Lisset Limpio -020,RETAIL SEDANOS,1383902,Jul
2024-07-05,Sedanos Supermarkets #18,Invoice,008-03316,Arroz Envasado:Parboiled 5KG Dos Hermanos.,6 / 11lbs,2.0,40.5,81.0,3228235.43999999,Branded Rice,Lisset Limpio -020,RETAIL SEDANOS,1383903,Jul
2024-07-05,Sedanos Supermarkets #18,Invoice,008-03316,,Discount,,,-1.62,3228233.81999999,,Lisset Limpio -020,RETAIL SEDANOS,1383904,Jul
2024-07-05,Sedanos Supermarkets #26,Invoice,008-03317,Arroz a Granel:Parboiled 50 LB -Bolsa Dos Hermanos.,,4.0,28.25,113.0,3228346.81999999,Bulk Rice,Lisset Limpio -020,RETAIL SEDANOS,1383905,Jul
2024-07-05,Sedanos Supermarkets #26,Invoice,008-03317,,Discount,,,-2.26,3228344.55999999,,Lisset Limpio -020,RETAIL SEDANOS,1383906,Jul
2024-07-05,Pacifico Chinese Restaurant,Invoice,008-03318,Arroz a Granel:Parboiled 50 LB -Bolsa Dos Hermanos.,,10.0,28.25,282.5,3228627.05999999,Bulk Rice,Lisset Limpio -020,CAFETERIA y RESTAURANTS,1383907,Jul
2024-07-05,Sedanos Supermarkets #22,Invoice,008-03319,Arroz a Granel:Parboiled 50 LB -Bolsa Dos Hermanos.,,4.0,28.25,113.0,3228740.05999999,Bulk Rice,Lisset Limpio -020,RETAIL SEDANOS,1383908,Jul
2024-07-05,Sedanos Supermarkets #22,Invoice,008-03319,,Discount,,,-2.26,3228737.79999999,,Lisset Limpio -020,RETAIL SEDANOS,1383909,Jul
2024-07-05,Hings Chinese,Invoice,008-03320,Arroz a Granel:Parboiled 50 LB -Bolsa Dos Hermanos.,,5.0,28.25,141.25,3228879.04999999,Bulk Rice,Lisset Limpio -020,CAFETERIA y RESTAURANTS,1383910,Jul
2024-07-05,"El Toro Loco Meat Distribution, LLC",Invoice,008-03321,Dry Beans:Dry Beans - Black Beans 50,Dry Black Beans 50 lb,50.0,43.5,2175.0,3231054.04999999,Dry Beans,Lisset Limpio -020,CAFETERIA y RESTAURANTS,1383911,Jul
2024-07-05,"El Toro Loco Meat Distribution, LLC",Invoice,008-03321,Arroz a Granel:Largo Fino 50 LB -Bolsa Dos Hermanos.,,55.0,27.85,1531.75,3232585.79999999,Bulk Rice,Lisset Limpio -020,CAFETERIA y RESTAURANTS,1383912,Jul
2024-07-05,Fritanga Momotombo,Invoice,008-03322,Arroz a Granel:Largo Fino 50 LB -Bolsa Dos Hermanos.,,5.0,27.85,139.25,3232725.04999999,Bulk Rice,Lisset Limpio -020,CAFETERIA y RESTAURANTS,1383913,Jul
2024-07-05,Sedanos Supermarkets #31,Invoice,008-03323,Arroz a Granel:Largo Fino 50 LB -Bolsa Dos Hermanos.,,1.0,27.85,27.85,3232752.89999999,Bulk Rice,Lisset Limpio -020,RETAIL SEDANOS,1383914,Jul
2024-07-05,Sedanos Supermarkets #31,Invoice,008-03323,Arroz a Granel:Parboiled 50 LB -Bolsa Dos Hermanos.,,4.0,28.25,113.0,3232865.89999999,Bulk Rice,Lisset Limpio -020,RETAIL SEDANOS,1383915,Jul
2024-07-05,Sedanos Supermarkets #31,Invoice,008-03323,,Discount,,,-2.82,3232863.07999999,,Lisset Limpio -020,RETAIL SEDANOS,1383916,Jul
2024-07-05,Family and Son,Invoice,008-03324,Arroz a Granel:Parboiled 50 LB -Bolsa Dos Hermanos.,MRSU 425846 5,1100.0,24.75,27225.0,3260088.07999999,Bulk Rice,Armando Carpio - 017,WHOLESALER MANUFACTURY,1383917,Jul
2024-07-05,El Palacio de Los Jugos / Casa mía Food Restaurant inc,Credit Memo,008-03446,Varios:Promotional Allowance,Parboiled 50LB,-1.0,27.75,-27.75,3260060.32999999,Bulk Rice,Lisset Limpio -020,Cafeteria,1383918,Jul
2024-07-05,El Palacio de los jugos /  Mires Restaurants,Credit Memo,008-03447,Varios:Promotional Allowance,50Lb Parboiled,-1.0,27.75,-27.75,3260032.57999999,Bulk Rice,Lisset Limpio -020,Cafeteria,1383919,Jul
2024-07-05,El Palacio de los jugos / Delicias Criollas (DIAGO FOOD_MILLER),Credit Memo,008-03448,Varios:Promotional Allowance,Parboiled 50LB,-1.0,27.75,-27.75,3260004.82999999,Bulk Rice,Lisset Limpio -020,Cafeteria,1383920,Jul
2024-07-05,El Palacio de los jugos /  Nanos Latin Foods,Credit Memo,008-03449,Varios:Promotional Allowance,Parboiled 50LB,-1.0,27.75,-27.75,3259977.07999999,Bulk Rice,Lisset Limpio -020,Cafeteria,1383921,Jul
2024-07-05,Sedanos Supermarkets #18,Credit Memo,008-03450,Varios:Promotional Allowance,5kg Parboil,-2.0,40.5,-81.0,3259896.07999999,Branded Rice,Lisset Limpio -020,RETAIL SEDANOS,1383922,Jul
2024-07-08,JMN Dely Corp,Invoice,008-03325,Arroz a Granel:Largo Fino 50 LB -Bolsa Dos Hermanos.,,5.0,27.25,136.25,3260032.32999999,Bulk Rice,Keila Alfaro-Visvikis,CAFETERIA y RESTAURANTS,1383923,Jul
2024-07-08,JMN Dely Corp,Invoice,008-03325,Arroz a Granel:Parboiled 50 LB -Bolsa Dos Hermanos.,,3.0,28.25,84.75,3260117.07999999,Bulk Rice,Keila Alfaro-Visvikis,CAFETERIA y RESTAURANTS,1383924,Jul
2024-07-08,JMN Dely Corp,Invoice,008-03325,Dry Beans:Dry Beans - Black Beans 50,Dry Black Beans 50 lb,1.0,43.5,43.5,3260160.57999999,Dry Beans,Keila Alfaro-Visvikis,CAFETERIA y RESTAURANTS,1383925,Jul
2024-07-08,Sabor Tropical Supermarket #7,Invoice,008-03326,Arroz Envasado:Parboiled 1kg Bolsa Dos Hermanos.,.,3.0,19.9,59.7,3260220.27999999,Branded Rice,Keila Alfaro-Visvikis,RETAIL  DSD,1383926,Jul
2024-07-08,Sabor Tropical Supermarket #7,Invoice,008-03326,Rice Snack:Rice Snack Ham Flavored DOS HERMANOS,,2.0,19.9,39.8,3260260.07999999,Puffed Products,Keila Alfaro-Visvikis,RETAIL  DSD,1383927,Jul
2024-07-08,Sabor Tropical Supermarket #7,Invoice,008-03326,Rice Snack:Rice Snack Salami Flavored DOS HERMANOS,,1.0,19.9,19.9,3260279.97999999,Puffed Products,Keila Alfaro-Visvikis,RETAIL  DSD,1383928,Jul
2024-07-08,Sabor Tropical Supermarket #7,Invoice,008-03326,"Rice Snack:Rice Snack, Pizza DH",,1.0,19.9,19.9,3260299.87999999,Puffed Products,Keila Alfaro-Visvikis,RETAIL  DSD,1383929,Jul
2024-07-08,Los Mejores Tamales de Miami,Invoice,008-03327,Arroz a Granel:Parboiled 50 LB -Bolsa Dos Hermanos.,,4.0,28.25,113.0,3260412.87999999,Bulk Rice,Lisset Limpio -020,CAFETERIA y RESTAURANTS,1383930,Jul
2024-07-08,Sabor Tropical Supermarket #7,Credit Memo,008-03451,Varios:Promotional Allowance,Snack pizza,-1.0,19.9,-19.9,3260392.97999999,Puffed Products,Keila Alfaro-Visvikis,RETAIL  DSD,1383931,Jul
2024-07-09,Price Choice 5 YNTO Food Corp.,Invoice,008-03328,Arroz Envasado:Largo Fino 1kg (Long grain rice) Dos Hermanos,,2.0,17.0,34.0,3260426.97999999,Branded Rice,Keila Alfaro-Visvikis,RETAIL  DSD,1383932,Jul
2024-07-09,Price Choice 5 YNTO Food Corp.,Invoice,008-03328,Rice Snack:Rice Snack Ham Flavored DOS HERMANOS,,2.0,19.9,39.8,3260466.77999999,Puffed Products,Keila Alfaro-Visvikis,RETAIL  DSD,1383933,Jul
2024-07-09,Price Choice 5 YNTO Food Corp.,Invoice,008-03328,Rice Snack:Rice Snack Salami Flavored DOS HERMANOS,,1.0,19.9,19.9,3260486.67999999,Puffed Products,Keila Alfaro-Visvikis,RETAIL  DSD,1383934,Jul
2024-07-09,Price Choice 5 YNTO Food Corp.,Invoice,008-03328,"Rice Snack:Rice Snack, Pizza DH",,1.0,19.9,19.9,3260506.57999999,Puffed Products,Keila Alfaro-Visvikis,RETAIL  DSD,1383935,Jul
2024-07-09,Albert Deli #2,Invoice,008-03329,Arroz a Granel:Largo Fino 50 LB -Bolsa Dos Hermanos.,,6.0,27.85,167.1,3260673.67999999,Bulk Rice,Keila Alfaro-Visvikis,CAFETERIA y RESTAURANTS,1383936,Jul
2024-07-09,Albert Deli #2,Invoice,008-03329,Arroz a Granel:Parboiled 50 LB -Bolsa Dos Hermanos.,,4.0,28.25,113.0,3260786.67999999,Bulk Rice,Keila Alfaro-Visvikis,CAFETERIA y RESTAURANTS,1383937,Jul
2024-07-09,Albert Deli #2,Invoice,008-03329,Dry Beans:Dry Beans - Small Red Beans 50 lbs.,Small Red Beans 50 lbs,1.0,46.0,46.0,3260832.67999999,Dry Beans,Keila Alfaro-Visvikis,CAFETERIA y RESTAURANTS,1383938,Jul
2024-07-09,Albert Deli #2,Invoice,008-03329,Dry Beans:Dry Beans - Black Beans 50,Dry Black Beans 50 lb,1.0,43.5,43.5,3260876.17999999,Dry Beans,Keila Alfaro-Visvikis,CAFETERIA y RESTAURANTS,1383939,Jul
2024-07-09,Albert Deli #2,Invoice,008-03329,,,,,0.0,3260876.17999999,,Keila Alfaro-Visvikis,CAFETERIA y RESTAURANTS,1383940,Jul
2024-07-09,Sedanos Supermarkets #40,Invoice,008-03330,Arroz Envasado:Parboiled 5KG Dos Hermanos.,6 / 11lbs,20.0,40.5,810.0,3261686.17999999,Branded Rice,Armando Carpio - 017,RETAIL SEDANOS,1383941,Jul
2024-07-09,Sedanos Supermarkets #40,Invoice,008-03330,Arroz Envasado:Parboiled 5KG Dos Hermanos.,6 / 11lbs,20.0,40.5,810.0,3262496.17999999,Branded Rice,Armando Carpio - 017,RETAIL SEDANOS,1383942,Jul
2024-07-09,Sedanos Supermarkets #40,Invoice,008-03330,,Discount,,,-16.2,3262479.97999999,,Armando Carpio - 017,RETAIL SEDANOS,1383943,Jul
2024-07-09,Sedanos Supermarkets #41,Invoice,008-03331,Arroz Envasado:Parboiled 5KG Dos Hermanos.,6 / 11lbs,10.0,40.5,405.0,3262884.97999999,Branded Rice,Armando Carpio - 017,RETAIL SEDANOS,1383944,Jul
2024-07-09,Sedanos Supermarkets #41,Invoice,008-03331,Arroz Envasado:Parboiled 5KG Dos Hermanos.,6 / 11lbs,10.0,40.5,405.0,3263289.97999999,Branded Rice,Armando Carpio - 017,RETAIL SEDANOS,1383945,Jul
2024-07-09,Sedanos Supermarkets #41,Invoice,008-03331,,Discount,,,-8.1,3263281.87999999,,Armando Carpio - 017,RETAIL SEDANOS,1383946,Jul
2024-07-09,Sedanos Supermarkets #40,Credit Memo,008-03452,Varios:Promotional Allowance,5kg parboil,-20.0,40.5,-810.0,3262471.87999999,Branded Rice,Armando Carpio - 017,RETAIL SEDANOS,1383947,Jul
2024-07-09,Price Choice 5 YNTO Food Corp.,Credit Memo,008-03453,Varios:Promotional Allowance,Snack pizza,-1.0,19.9,-19.9,3262451.97999999,Puffed Products,Keila Alfaro-Visvikis,RETAIL  DSD,1383948,Jul
2024-07-09,Sedanos Supermarkets #41,Credit Memo,008-03454,Varios:Promotional Allowance,5kg parboiled,-10.0,40.5,-405.0,3262046.97999999,Branded Rice,Armando Carpio - 017,RETAIL SEDANOS,1383949,Jul
2024-07-10,Sedanos Supermarkets #33,Invoice,008-03333,Arroz a Granel:Parboiled 50 LB -Bolsa Dos Hermanos.,,4.0,28.25,113.0,3262159.97999999,Bulk Rice,Lisset Limpio -020,RETAIL SEDANOS,1383950,Jul
2024-07-10,Sedanos Supermarkets #33,Invoice,008-03333,,Discount,,,-2.26,3262157.71999999,,Lisset Limpio -020,RETAIL SEDANOS,1383951,Jul
2024-07-10,Price Choice Food Market # 6,Invoice,008-03334,Arroz a Granel:Parboiled 50 LB -Bolsa Dos Hermanos.,,20.0,28.25,565.0,3262722.71999999,Bulk Rice,Lisset Limpio -020,RETAIL  DSD,1383952,Jul
2024-07-10,El Palacio de Los Jugos / Casa mía Food Restaurant inc,Invoice,008-03335,Arroz a Granel:Parboiled 50 LB -Bolsa Dos Hermanos.,,11.0,27.75,305.25,3263027.96999999,Bulk Rice,Lisset Limpio -020,Cafeteria,1383953,Jul
2024-07-10,El Palacio de Los Jugos / Casa mía Food Restaurant inc,Invoice,008-03335,Dry Beans:Dry Beans - Black Beans 50,Dry Black Beans 50 lb,1.0,43.5,43.5,3263071.46999999,Dry Beans,Lisset Limpio -020,Cafeteria,1383954,Jul
2024-07-10,El Palacio de Los Jugos / Casa mía Food Restaurant inc,Invoice,008-03335,Arroz a Granel:Parboiled 50 LB -Bolsa Dos Hermanos.,,1.0,27.75,27.75,3263099.21999999,Bulk Rice,Lisset Limpio -020,Cafeteria,1383955,Jul
2024-07-10,Sedanos Supermarkets #43,Invoice,008-03336,Arroz a Granel:Parboiled 50 LB -Bolsa Dos Hermanos.,,5.0,28.25,141.25,3263240.46999999,Bulk Rice,Lisset Limpio -020,RETAIL SEDANOS,1383956,Jul
2024-07-10,Sedanos Supermarkets #43,Invoice,008-03336,,Discount,,,-2.83,3263237.63999999,,Lisset Limpio -020,RETAIL SEDANOS,1383957,Jul
2024-07-10,Ideal Food Basket Davie Cafeteria,Invoice,008-03337,Arroz a Granel:Largo Fino 50 LB -Bolsa Dos Hermanos.,,10.0,27.85,278.5,3263516.13999999,Bulk Rice,Keila Alfaro-Visvikis,CAFETERIA y RESTAURANTS,1383958,Jul
2024-07-10,BRAVO - Flamingo #3,Invoice,008-03338,Arroz Envasado:Largo Fino 1kg (Long grain rice) Dos Hermanos,,3.0,17.0,51.0,3263567.13999999,Branded Rice,Keila Alfaro-Visvikis,RETAIL  DSD,1383959,Jul
2024-07-10,BRAVO - Flamingo #3,Invoice,008-03338,Arroz Envasado:Parboiled 1kg Bolsa Dos Hermanos.,.,2.0,19.9,39.8,3263606.93999999,Branded Rice,Keila Alfaro-Visvikis,RETAIL  DSD,1383960,Jul
2024-07-10,BRAVO - Flamingo #3,Invoice,008-03338,Rice Snack:Rice Snack Ham Flavored DOS HERMANOS,,1.0,19.9,19.9,3263626.83999999,Puffed Products,Keila Alfaro-Visvikis,RETAIL  DSD,1383961,Jul
2024-07-10,BRAVO - Flamingo #3,Invoice,008-03338,Rice Snack:Rice Snack Salami Flavored DOS HERMANOS,,1.0,19.9,19.9,3263646.73999999,Puffed Products,Keila Alfaro-Visvikis,RETAIL  DSD,1383962,Jul
2024-07-10,BRAVO - Flamingo #3,Invoice,008-03338,"Rice Snack:Rice Snack, Pizza DH",,1.0,19.9,19.9,3263666.63999999,Puffed Products,Keila Alfaro-Visvikis,RETAIL  DSD,1383963,Jul
2024-07-10,BRAVO - Flamingo #3,Invoice,008-03338,Arroz Envasado:Parboiled 1kg Bolsa Dos Hermanos.,.,1.0,19.9,19.9,3263686.53999999,Branded Rice,Keila Alfaro-Visvikis,RETAIL  DSD,1383964,Jul
2024-07-10,El Palacio de los jugos /  Nanos Latin Foods,Invoice,008-03339,Arroz a Granel:Parboiled 50 LB -Bolsa Dos Hermanos.,,11.0,27.75,305.25,3263991.78999999,Bulk Rice,Lisset Limpio -020,Cafeteria,1383965,Jul
2024-07-10,El Palacio de los jugos /  Nanos Latin Foods,Invoice,008-03339,Dry Beans:Dry Beans - Black Beans 50,Dry Black Beans 50 lb,1.0,43.5,43.5,3264035.28999999,Dry Beans,Lisset Limpio -020,Cafeteria,1383966,Jul
2024-07-10,El Palacio de los jugos /  Nanos Latin Foods,Invoice,008-03339,Arroz a Granel:Parboiled 50 LB -Bolsa Dos Hermanos.,,1.0,27.75,27.75,3264063.03999999,Bulk Rice,Lisset Limpio -020,Cafeteria,1383967,Jul
2024-07-10,Los Caringas Latin America  Foods,Invoice,008-03340,Arroz a Granel:Largo Fino 50 LB -Bolsa Dos Hermanos.,,2.0,27.85,55.7,3264118.73999999,Bulk Rice,Lisset Limpio -020,CAFETERIA y RESTAURANTS,1383968,Jul
2024-07-10,Los Caringas Latin America  Foods,Invoice,008-03340,Arroz a Granel:Parboiled 50 LB -Bolsa Dos Hermanos.,,3.0,28.25,84.75,3264203.48999999,Bulk Rice,Lisset Limpio -020,CAFETERIA y RESTAURANTS,1383969,Jul
2024-07-10,El Palacio de Los Jugos / Casa mía Food Restaurant inc,Credit Memo,008-03455,Varios:Promotional Allowance,Parboil 50LB,-1.0,27.75,-27.75,3264175.73999999,Bulk Rice,Lisset Limpio -020,Cafeteria,1383970,Jul
2024-07-10,BRAVO - Flamingo #3,Credit Memo,008-03456,Varios:Promotional Allowance,parboil 1kg,-1.0,19.9,-19.9,3264155.83999999,Branded Rice,Keila Alfaro-Visvikis,RETAIL  DSD,1383971,Jul
2024-07-10,El Palacio de los jugos /  Nanos Latin Foods,Credit Memo,008-03457,Varios:Promotional Allowance,Parboiled 50LB,-1.0,27.75,-27.75,3264128.08999999,Bulk Rice,Lisset Limpio -020,Cafeteria,1383972,Jul
2024-07-12,El Gallego Supermarket,Invoice,008-03341,Arroz a Granel:Largo Fino 50 LB -Bolsa Dos Hermanos.,,4.0,28.25,113.0,3264241.08999999,Bulk Rice,Lisset Limpio -020,RETAIL  DSD,1383973,Jul
2024-07-12,El Gallego Supermarket,Invoice,008-03341,Dry Beans:Dry Beans - Black Beans 50,Dry Black Beans 50 lb,2.0,43.5,87.0,3264328.08999999,Dry Beans,Lisset Limpio -020,RETAIL  DSD,1383974,Jul
2024-07-12,Sedanos Supermarkets #38,Invoice,008-03342,Arroz Envasado:Parboiled 5KG Dos Hermanos.,6 / 11lbs,20.0,40.5,810.0,3265138.08999999,Branded Rice,Lisset Limpio -020,RETAIL SEDANOS,1383975,Jul
2024-07-12,Sedanos Supermarkets #38,Invoice,008-03342,Arroz Envasado:Parboiled 5KG Dos Hermanos.,6 / 11lbs,20.0,40.5,810.0,3265948.08999999,Branded Rice,Lisset Limpio -020,RETAIL SEDANOS,1383976,Jul
2024-07-12,Sedanos Supermarkets #38,Invoice,008-03342,,Discount,,,-16.2,3265931.88999999,,Lisset Limpio -020,RETAIL SEDANOS,1383977,Jul
2024-07-12,Sedanos Supermarkets #31,Invoice,008-03343,Arroz a Granel:Largo Fino 50 LB -Bolsa Dos Hermanos.,,3.0,27.85,83.55,3266015.43999999,Bulk Rice,Lisset Limpio -020,RETAIL SEDANOS,1383978,Jul
2024-07-12,Sedanos Supermarkets #31,Invoice,008-03343,Arroz a Granel:Parboiled 50 LB -Bolsa Dos Hermanos.,,4.0,28.25,113.0,3266128.43999999,Bulk Rice,Lisset Limpio -020,RETAIL SEDANOS,1383979,Jul
2024-07-12,Sedanos Supermarkets #31,Invoice,008-03343,,Discount,,,-3.93,3266124.50999999,,Lisset Limpio -020,RETAIL SEDANOS,1383980,Jul
2024-07-12,El Palacio de los jugos / Delicias Criollas (DIAGO FOOD_MILLER),Invoice,008-03344,Arroz a Granel:Parboiled 50 LB -Bolsa Dos Hermanos.,,11.0,28.25,310.75,3266435.25999999,Bulk Rice,Lisset Limpio -020,Cafeteria,1383981,Jul
2024-07-12,El Palacio de los jugos / Delicias Criollas (DIAGO FOOD_MILLER),Invoice,008-03344,Liquids:AS Marinating Sauce (Mojo),,1.0,18.5,18.5,3266453.75999999,American Spice,Lisset Limpio -020,Cafeteria,1383982,Jul
2024-07-12,El Palacio de los jugos / Delicias Criollas (DIAGO FOOD_MILLER),Invoice,008-03344,Arroz a Granel:Parboiled 50 LB -Bolsa Dos Hermanos.,,1.0,28.25,28.25,3266482.00999999,Bulk Rice,Lisset Limpio -020,Cafeteria,1383983,Jul
2024-07-12,Fritanga Momotombo,Invoice,008-03345,Arroz a Granel:Largo Fino 50 LB -Bolsa Dos Hermanos.,,3.0,27.85,83.55,3266565.55999999,Bulk Rice,Lisset Limpio -020,CAFETERIA y RESTAURANTS,1383984,Jul
2024-07-12,Sedanos Supermarkets #21,Invoice,008-03346,Rice Snack:Rice Snack Salami Flavored DOS HERMANOS,,1.0,19.9,19.9,3266585.45999999,Puffed Products,Lisset Limpio -020,RETAIL SEDANOS,1383985,Jul
2024-07-12,Sedanos Supermarkets #21,Invoice,008-03346,Rice Snack:Rice Snack Ham Flavored DOS HERMANOS,,2.0,19.9,39.8,3266625.25999999,Puffed Products,Lisset Limpio -020,RETAIL SEDANOS,1383986,Jul
2024-07-12,Sedanos Supermarkets #21,Invoice,008-03346,"Rice Snack:Rice Snack, Pizza DH",,1.0,19.9,19.9,3266645.15999998,Puffed Products,Lisset Limpio -020,RETAIL SEDANOS,1383987,Jul
2024-07-12,Sedanos Supermarkets #21,Invoice,008-03346,,Discount,,,-1.19,3266643.96999998,,Lisset Limpio -020,RETAIL SEDANOS,1383988,Jul
2024-07-12,Sedanos Supermarkets #31,Invoice,008-03347,Arroz Envasado:Parboiled 5KG Dos Hermanos.,6 / 11lbs,20.0,40.5,810.0,3267453.96999998,Branded Rice,Lisset Limpio -020,RETAIL SEDANOS,1383989,Jul
2024-07-12,Sedanos Supermarkets #31,Invoice,008-03347,Arroz Envasado:Parboiled 5KG Dos Hermanos.,6 / 11lbs,20.0,40.5,810.0,3268263.96999998,Branded Rice,Lisset Limpio -020,RETAIL SEDANOS,1383990,Jul
2024-07-12,Sedanos Supermarkets #31,Invoice,008-03347,,Discount,,,-16.2,3268247.76999998,,Lisset Limpio -020,RETAIL SEDANOS,1383991,Jul
2024-07-12,Bravo   Francisco Diaz,Invoice,008-03348,Liquids:AS White Vinegar,4/1 Gl.,3.0,10.0,30.0,3268277.76999998,American Spice,Lisset Limpio -020,RETAIL  DSD,1383992,Jul
2024-07-12,Bravo   Francisco Diaz,Invoice,008-03348,Arroz a Granel:Largo Fino 50 LB -Bolsa Dos Hermanos.,,4.0,27.85,111.4,3268389.16999998,Bulk Rice,Lisset Limpio -020,RETAIL  DSD,1383993,Jul
2024-07-12,Bravo   Francisco Diaz,Invoice,008-03348,Liquids:AS Cooking Wine,4/1 Gl.,4.0,17.5,70.0,3268459.16999998,American Spice,Lisset Limpio -020,RETAIL  DSD,1383994,Jul
2024-07-12,Key Foods  / Ivan,Invoice,008-03349,Rice Snack:Rice Snack Ham Flavored DOS HERMANOS,,1.0,19.9,19.9,3268479.06999998,Puffed Products,Keila Alfaro-Visvikis,RETAIL  DSD,1383995,Jul
2024-07-12,Key Foods  / Ivan,Invoice,008-03349,Rice Snack:Rice Snack Salami Flavored DOS HERMANOS,,1.0,19.9,19.9,3268498.96999998,Puffed Products,Keila Alfaro-Visvikis,RETAIL  DSD,1383996,Jul
2024-07-12,Key Foods  / Ivan,Invoice,008-03349,"Rice Snack:Rice Snack, Pizza DH",,1.0,19.9,19.9,3268518.86999998,Puffed Products,Keila Alfaro-Visvikis,RETAIL  DSD,1383997,Jul
2024-07-12,"Virtue Distributor, Inc",Invoice,008-03350,Arroz Envasado:Parboiled 1kg Bolsa Dos Hermanos.,.,5.0,15.2,76.0,3268594.86999998,Branded Rice,Armando Carpio - 017,Distributor,1383998,Jul
2024-07-12,"Virtue Distributor, Inc",Invoice,008-03350,Arroz a Granel:Largo Fino 50 LB -Bolsa Dos Hermanos.,,55.0,27.15,1493.25,3270088.11999998,Bulk Rice,Armando Carpio - 017,Distributor,1383999,Jul
2024-07-12,Glow Aesthetic Boutique,Invoice,008-03351,Rice Snack:Rice Snack Ham Flavored DOS HERMANOS,,2.0,19.9,39.8,3270127.91999998,Puffed Products,Armando Carpio - 017,CAFETERIA y RESTAURANTS,1384000,Jul
2024-07-12,Glow Aesthetic Boutique,Invoice,008-03351,Rice Snack:Rice Snack Salami Flavored DOS HERMANOS,,1.0,19.9,19.9,3270147.81999998,Puffed Products,Armando Carpio - 017,CAFETERIA y RESTAURANTS,1384001,Jul
2024-07-12,Glow Aesthetic Boutique,Invoice,008-03351,"Rice Snack:Rice Snack, Pizza DH",,1.0,19.9,19.9,3270167.71999998,Puffed Products,Armando Carpio - 017,CAFETERIA y RESTAURANTS,1384002,Jul
2024-07-12,Sedanos Supermarkets #38,Credit Memo,008-03458,Varios:Promotional Allowance,Parboil 5 kg,-20.0,40.5,-810.0,3269357.71999998,Branded Rice,Lisset Limpio -020,RETAIL SEDANOS,1384003,Jul
2024-07-12,El Palacio de los jugos / Delicias Criollas (DIAGO FOOD_MILLER),Credit Memo,008-03459,Varios:Promotional Allowance,50Lb Parboiled,-1.0,28.25,-28.25,3269329.46999998,Bulk Rice,Lisset Limpio -020,Cafeteria,1384004,Jul
2024-07-12,Sedanos Supermarkets #21,Credit Memo,008-03460,Varios:Promotional Allowance,Pizza,-1.0,19.9,-19.9,3269309.56999998,Puffed Products,Lisset Limpio -020,RETAIL SEDANOS,1384005,Jul
2024-07-12,Sedanos Supermarkets #31,Credit Memo,008-03461,Varios:Promotional Allowance,5kg parboiled,-20.0,40.5,-810.0,3268499.56999998,Branded Rice,Lisset Limpio -020,RETAIL SEDANOS,1384006,Jul
2024-07-12,Glow Aesthetic Boutique,Credit Memo,008-03462,Varios:Promotional Allowance,pizza,-1.0,19.6,-19.6,3268479.96999998,Puffed Products,Armando Carpio - 017,CAFETERIA y RESTAURANTS,1384007,Jul
2024-07-16,Soriano Brothers PB,Invoice,008-03352,Dry Beans:Dry Beans - Black Beans 50,Dry Black Beans 50 lb,2.0,43.5,87.0,3268566.96999998,Dry Beans,Lisset Limpio -020,CAFETERIA y RESTAURANTS,1384008,Jul
2024-07-16,Soriano Brothers PB,Invoice,008-03352,Arroz a Granel:Parboiled 50 LB -Bolsa Dos Hermanos.,,22.0,27.75,610.5,3269177.46999998,Bulk Rice,Lisset Limpio -020,CAFETERIA y RESTAURANTS,1384009,Jul
2024-07-16,Soriano Brothers PB,Invoice,008-03352,Arroz a Granel:Parboiled 50 LB -Bolsa Dos Hermanos.,,2.0,27.75,55.5,3269232.96999998,Bulk Rice,Lisset Limpio -020,CAFETERIA y RESTAURANTS,1384010,Jul
2024-07-16,JMN Dely Corp,Invoice,008-03353,Arroz a Granel:Parboiled 50 LB -Bolsa Dos Hermanos.,,2.0,28.25,56.5,3269289.46999998,Bulk Rice,Keila Alfaro-Visvikis,CAFETERIA y RESTAURANTS,1384011,Jul
2024-07-16,JMN Dely Corp,Invoice,008-03353,Dry Beans:Dry Beans - Black Beans 50,Dry Black Beans 50 lb,1.0,43.5,43.5,3269332.96999998,Dry Beans,Keila Alfaro-Visvikis,CAFETERIA y RESTAURANTS,1384012,Jul
2024-07-16,JMN Dely Corp,Invoice,008-03353,Arroz a Granel:Largo Fino 50 LB -Bolsa Dos Hermanos.,,6.0,27.85,167.1,3269500.06999998,Bulk Rice,Keila Alfaro-Visvikis,CAFETERIA y RESTAURANTS,1384013,Jul
2024-07-16,"Soriano Brothers Diaz Food Service,Inc",Invoice,008-03354,Arroz a Granel:Parboiled 50 LB -Bolsa Dos Hermanos.,,33.0,27.75,915.75,3270415.81999998,Bulk Rice,Lisset Limpio -020,CAFETERIA y RESTAURANTS,1384014,Jul
2024-07-16,"Soriano Brothers Diaz Food Service,Inc",Invoice,008-03354,Dry Beans:Dry Beans - Black Beans 50,Dry Black Beans 50 lb,6.0,43.5,261.0,3270676.81999998,Dry Beans,Lisset Limpio -020,CAFETERIA y RESTAURANTS,1384015,Jul
2024-07-16,"Soriano Brothers Diaz Food Service,Inc",Invoice,008-03354,Arroz a Granel:Largo Fino 50 LB -Bolsa Dos Hermanos.,,10.0,27.85,278.5,3270955.31999998,Bulk Rice,Lisset Limpio -020,CAFETERIA y RESTAURANTS,1384016,Jul
2024-07-16,"Soriano Brothers Diaz Food Service,Inc",Invoice,008-03354,Arroz a Granel:Parboiled 50 LB -Bolsa Dos Hermanos.,,3.0,27.75,83.25,3271038.56999998,Bulk Rice,Lisset Limpio -020,CAFETERIA y RESTAURANTS,1384017,Jul
2024-07-16,"Soriano Brothers Diaz Food Service,Inc",Invoice,008-03354,Dry Beans:Dry Beans - Small Red Beans 50 lbs.,Small Red Beans 50 lbs,2.0,46.0,92.0,3271130.56999998,Dry Beans,Lisset Limpio -020,CAFETERIA y RESTAURANTS,1384018,Jul
2024-07-16,Chavez Distributors Inc.,Invoice,008-03355,Arroz a Granel:Parboiled 50 LB -Bolsa Dos Hermanos.,,55.0,27.75,1526.25,3272656.81999998,Bulk Rice,Keila Alfaro-Visvikis,WHOLESALER,1384019,Jul
2024-07-16,Aries Supermarket & Cafeteria,Invoice,008-03356,Arroz a Granel:Parboiled 50 LB -Bolsa Dos Hermanos.,,10.0,28.25,282.5,3272939.31999998,Bulk Rice,Armando Carpio - 017,CAFETERIA y RESTAURANTS,1384020,Jul
2024-07-16,Aries Supermarket & Cafeteria,Invoice,008-03356,Dry Beans:Dry Beans - Black Beans 50,Dry Black Beans 50 lb,10.0,39.5,395.0,3273334.31999998,Dry Beans,Armando Carpio - 017,CAFETERIA y RESTAURANTS,1384021,Jul
2024-07-16,Arias Supermarket,Invoice,008-03357,Rice Snack:Rice Snack Salami Flavored DOS HERMANOS,,1.0,19.9,19.9,3273354.21999998,Puffed Products,Armando Carpio - 017,CAFETERIA y RESTAURANTS,1384022,Jul
2024-07-16,Arias Supermarket,Invoice,008-03357,Rice Snack:Rice Snack Ham Flavored DOS HERMANOS,,1.0,19.9,19.9,3273374.11999998,Puffed Products,Armando Carpio - 017,CAFETERIA y RESTAURANTS,1384023,Jul
2024-07-16,Arias Supermarket,Invoice,008-03357,Arroz Envasado:Parboiled 5KG Dos Hermanos.,6 / 11lbs,1.0,46.5,46.5,3273420.61999998,Branded Rice,Armando Carpio - 017,CAFETERIA y RESTAURANTS,1384024,Jul
2024-07-16,Arias Supermarket,Invoice,008-03357,Arroz Envasado:Parboiled 5KG Dos Hermanos.,6 / 11lbs,1.0,46.5,46.5,3273467.11999998,Branded Rice,Armando Carpio - 017,CAFETERIA y RESTAURANTS,1384025,Jul
2024-07-16,Festival Supermarket #1,Invoice,008-03358,Arroz Envasado:Parboiled 5KG Dos Hermanos.,6 / 11lbs,15.0,46.5,697.5,3274164.61999998,Branded Rice,Lisset Limpio -020,RETAIL  DSD,1384026,Jul
2024-07-16,Festival Supermarket #1,Invoice,008-03358,Arroz Envasado:Parboiled 5KG Dos Hermanos.,6 / 11lbs,2.0,46.5,93.0,3274257.61999998,Branded Rice,Lisset Limpio -020,RETAIL  DSD,1384027,Jul
2024-07-16,Bay supermarket,Invoice,008-03359,Rice Snack:Rice Snack Ham Flavored DOS HERMANOS,,1.0,19.9,19.9,3274277.51999998,Puffed Products,Keila Alfaro-Visvikis,RETAIL  DSD,1384028,Jul
2024-07-16,Bay supermarket,Invoice,008-03359,Rice Snack:Rice Snack Salami Flavored DOS HERMANOS,,1.0,19.9,19.9,3274297.41999998,Puffed Products,Keila Alfaro-Visvikis,RETAIL  DSD,1384029,Jul
2024-07-16,Bay supermarket,Invoice,008-03359,"Rice Snack:Rice Snack, Pizza DH",,1.0,19.9,19.9,3274317.31999998,Puffed Products,Keila Alfaro-Visvikis,RETAIL  DSD,1384030,Jul
2024-07-16,Bay supermarket,Invoice,008-03359,Tostadas de Arroz:Tostadas de Arroz Saladas 120gr,iC/ii/iD/i16,1.0,19.9,19.9,3274337.21999998,Puffed Products,Keila Alfaro-Visvikis,RETAIL  DSD,1384031,Jul
2024-07-16,Bay supermarket,Invoice,008-03359,Rice Snack:Rice Snack Ham Flavored DOS HERMANOS,,1.0,19.9,19.9,3274357.11999998,Puffed Products,Keila Alfaro-Visvikis,RETAIL  DSD,1384032,Jul
2024-07-16,"Criollos Food USA, LLC",Invoice,008-03360,Arroz a Granel:Parboiled 50 LB -Bolsa Dos Hermanos.,,110.0,28.25,3107.5,3277464.61999998,Bulk Rice,Armando Carpio - 017,WHOLESALER,1384033,Jul
2024-07-16,"Soriano Brothers Diaz Food Service,Inc",Credit Memo,008-03463,Varios:Promotional Allowance,Parboiled 50LB,-3.0,27.75,-83.25,3277381.36999998,Bulk Rice,Lisset Limpio -020,CAFETERIA y RESTAURANTS,1384034,Jul
2024-07-16,Arias Supermarket,Credit Memo,008-03464,Varios:Promotional Allowance,snack salame y jamon,-2.0,19.9,-39.8,3277341.56999998,Puffed Products,Armando Carpio - 017,CAFETERIA y RESTAURANTS,1384035,Jul
2024-07-16,Arias Supermarket,Credit Memo,008-03464,Varios:Promotional Allowance,5kg,-1.0,46.5,-46.5,3277295.06999998,Branded Rice,Armando Carpio - 017,CAFETERIA y RESTAURANTS,1384036,Jul
2024-07-16,Festival Supermarket #1,Credit Memo,008-03465,Varios:Promotional Allowance,Parboiled 5kg,-2.0,46.5,-93.0,3277202.06999998,Bulk Rice,Keila Alfaro-Visvikis,RETAIL  DSD,1384037,Jul
2024-07-16,Bay supermarket,Credit Memo,008-03466,Varios:Promotional Allowance,Snack jamon,-1.0,19.9,-19.9,3277182.16999998,Puffed Products,Keila Alfaro-Visvikis,RETAIL  DSD,1384038,Jul
2024-07-16,Soriano Brothers PB,Credit Memo,008-03467,Varios:Promotional Allowance,50LB parboiled,-2.0,27.75,-55.5,3277126.66999998,Bulk Rice,Lisset Limpio -020,CAFETERIA y RESTAURANTS,1384039,Jul
2024-07-17,Soriano Brothers PB,Invoice,008-03361,Spices:AS Sazon (for all),1 / 30 lb (box or pail),1.0,59.0,59.0,3277185.66999998,American Spice,Lisset Limpio -020,CAFETERIA y RESTAURANTS,1384040,Jul
2024-07-18,Los Mejores Tamales de Miami,Invoice,008-03362,Arroz a Granel:Largo Fino 50 LB -Bolsa Dos Hermanos.,,2.0,27.85,55.7,3277241.36999998,Bulk Rice,Lisset Limpio -020,CAFETERIA y RESTAURANTS,1384041,Jul
2024-07-18,Los Mejores Tamales de Miami,Invoice,008-03362,Arroz a Granel:Parboiled 50 LB -Bolsa Dos Hermanos.,,4.0,28.25,113.0,3277354.36999998,Bulk Rice,Lisset Limpio -020,CAFETERIA y RESTAURANTS,1384042,Jul
2024-07-18,Sedanos Supermarkets #16,Invoice,008-03363,Arroz a Granel:Parboiled 50 LB -Bolsa Dos Hermanos.,,3.0,28.25,84.75,3277439.11999998,Bulk Rice,Lisset Limpio -020,RETAIL SEDANOS,1384043,Jul
2024-07-18,Sedanos Supermarkets #16,Invoice,008-03363,,Discount,,,-1.7,3277437.41999998,,Lisset Limpio -020,RETAIL SEDANOS,1384044,Jul
2024-07-18,Sedanos Supermarkets #9,Invoice,008-03364,Arroz Envasado:Parboiled 5KG Dos Hermanos.,6 / 11lbs,5.0,40.5,202.5,3277639.91999998,Branded Rice,Lisset Limpio -020,RETAIL SEDANOS,1384045,Jul
2024-07-18,Sedanos Supermarkets #9,Invoice,008-03364,Rice Snack:Rice Snack Ham Flavored DOS HERMANOS,,2.0,19.9,39.8,3277679.71999998,Puffed Products,Lisset Limpio -020,RETAIL SEDANOS,1384046,Jul
2024-07-18,Sedanos Supermarkets #9,Invoice,008-03364,Rice Snack:Rice Snack Salami Flavored DOS HERMANOS,,1.0,19.9,19.9,3277699.61999998,Puffed Products,Lisset Limpio -020,RETAIL SEDANOS,1384047,Jul
2024-07-18,Sedanos Supermarkets #9,Invoice,008-03364,"Rice Snack:Rice Snack, Pizza DH",,1.0,19.9,19.9,3277719.51999998,Puffed Products,Lisset Limpio -020,RETAIL SEDANOS,1384048,Jul
2024-07-18,Sedanos Supermarkets #9,Invoice,008-03364,Arroz Envasado:Parboiled 5KG Dos Hermanos.,6 / 11lbs,5.0,40.5,202.5,3277922.01999998,Branded Rice,Lisset Limpio -020,RETAIL SEDANOS,1384049,Jul
2024-07-18,Sedanos Supermarkets #9,Invoice,008-03364,,Discount,,,-5.24,3277916.77999998,,Lisset Limpio -020,RETAIL SEDANOS,1384050,Jul
2024-07-18,Sedanos Supermarkets #8,Invoice,008-03365,Rice Snack:Rice Snack Ham Flavored DOS HERMANOS,,2.0,19.9,39.8,3277956.57999998,Puffed Products,Lisset Limpio -020,RETAIL SEDANOS,1384051,Jul
2024-07-18,Sedanos Supermarkets #8,Invoice,008-03365,Rice Snack:Rice Snack Salami Flavored DOS HERMANOS,,1.0,19.9,19.9,3277976.47999998,Puffed Products,Lisset Limpio -020,RETAIL SEDANOS,1384052,Jul
2024-07-18,Sedanos Supermarkets #8,Invoice,008-03365,"Rice Snack:Rice Snack, Pizza DH",,1.0,19.9,19.9,3277996.37999998,Puffed Products,Lisset Limpio -020,RETAIL SEDANOS,1384053,Jul
2024-07-18,Sedanos Supermarkets #8,Invoice,008-03365,,Discount,,,-1.19,3277995.18999998,,Lisset Limpio -020,RETAIL SEDANOS,1384054,Jul
2024-07-18,Sedanos Supermarkets #28,Invoice,008-03366,Arroz Envasado:Parboiled 5KG Dos Hermanos.,6 / 11lbs,20.0,40.5,810.0,3278805.18999998,Branded Rice,Lisset Limpio -020,RETAIL SEDANOS,1384055,Jul
2024-07-18,Sedanos Supermarkets #28,Invoice,008-03366,Arroz Envasado:Parboiled 5KG Dos Hermanos.,6 / 11lbs,20.0,40.5,810.0,3279615.18999998,Branded Rice,Lisset Limpio -020,RETAIL SEDANOS,1384056,Jul
2024-07-18,Sedanos Supermarkets #28,Invoice,008-03366,,Discount,,,-16.2,3279598.98999998,,Lisset Limpio -020,RETAIL SEDANOS,1384057,Jul
2024-07-18,El Palacio de Los Jugos / Casa mía Food Restaurant inc,Invoice,008-03367,Arroz a Granel:Parboiled 50 LB -Bolsa Dos Hermanos.,,11.0,27.75,305.25,3279904.23999998,Bulk Rice,Lisset Limpio -020,Cafeteria,1384058,Jul
2024-07-18,El Palacio de Los Jugos / Casa mía Food Restaurant inc,Invoice,008-03367,Dry Beans:Dry Beans - Black Beans 50,Dry Black Beans 50 lb,1.0,43.5,43.5,3279947.73999998,Dry Beans,Lisset Limpio -020,Cafeteria,1384059,Jul
2024-07-18,El Palacio de Los Jugos / Casa mía Food Restaurant inc,Invoice,008-03367,Arroz a Granel:Parboiled 50 LB -Bolsa Dos Hermanos.,,1.0,27.75,27.75,3279975.48999998,Bulk Rice,Lisset Limpio -020,Cafeteria,1384060,Jul
2024-07-18,El Palacio de los jugos /  Nanos Latin Foods,Invoice,008-03368,Arroz a Granel:Parboiled 50 LB -Bolsa Dos Hermanos.,,11.0,27.75,305.25,3280280.73999998,Bulk Rice,Lisset Limpio -020,Cafeteria,1384061,Jul
2024-07-18,El Palacio de los jugos /  Nanos Latin Foods,Invoice,008-03368,Dry Beans:Dry Beans - Black Beans 50,Dry Black Beans 50 lb,1.0,43.5,43.5,3280324.23999998,Dry Beans,Lisset Limpio -020,Cafeteria,1384062,Jul
2024-07-18,El Palacio de los jugos /  Nanos Latin Foods,Invoice,008-03368,Arroz a Granel:Parboiled 50 LB -Bolsa Dos Hermanos.,,1.0,27.75,27.75,3280351.98999998,Bulk Rice,Lisset Limpio -020,Cafeteria,1384063,Jul
2024-07-18,Sedanos Supermarkets #42,Invoice,008-03369,Rice Snack:Rice Snack Salami Flavored DOS HERMANOS,,1.0,19.9,19.9,3280371.88999998,Puffed Products,Lisset Limpio -020,RETAIL SEDANOS,1384064,Jul
2024-07-18,Sedanos Supermarkets #42,Invoice,008-03369,"Rice Snack:Rice Snack, Pizza DH",,1.0,19.9,19.9,3280391.78999998,Puffed Products,Lisset Limpio -020,RETAIL SEDANOS,1384065,Jul
2024-07-18,Sedanos Supermarkets #42,Invoice,008-03369,Rice Snack:Rice Snack Ham Flavored DOS HERMANOS,,2.0,19.9,39.8,3280431.58999998,Puffed Products,Lisset Limpio -020,RETAIL SEDANOS,1384066,Jul
2024-07-18,Sedanos Supermarkets #42,Invoice,008-03369,,Discount,,,-1.19,3280430.39999998,,Lisset Limpio -020,RETAIL SEDANOS,1384067,Jul
2024-07-18,Sedanos Supermarkets #42,Invoice,008-03370,Arroz a Granel:Parboiled 50 LB -Bolsa Dos Hermanos.,,7.0,28.25,197.75,3280628.14999998,Bulk Rice,Lisset Limpio -020,RETAIL SEDANOS,1384068,Jul
2024-07-18,Sedanos Supermarkets #42,Invoice,008-03370,,Discount,,,-3.96,3280624.18999998,,Lisset Limpio -020,RETAIL SEDANOS,1384069,Jul
2024-07-18,Sedanos Supermarkets #26,Credit Memo,008-03371,Varios:Producto vencido/deteriorado (no impacta en inventario),"credito al Sedanos 26, por 2 cajas de snacks espiradas, $14.92",-2.0,14.92,-29.84,3280594.34999998,Puffed Products,Lisset Limpio -020,RETAIL SEDANOS,1384070,Jul
2024-07-18,Sedanos Supermarkets #27,Invoice,008-03372,Rice Snack:Rice Snack Ham Flavored DOS HERMANOS,,1.0,19.9,19.9,3280614.24999998,Puffed Products,Keila Alfaro-Visvikis,RETAIL SEDANOS,1384071,Jul
2024-07-18,Sedanos Supermarkets #27,Invoice,008-03372,Rice Snack:Rice Snack Salami Flavored DOS HERMANOS,,1.0,19.9,19.9,3280634.14999998,Puffed Products,Keila Alfaro-Visvikis,RETAIL SEDANOS,1384072,Jul
2024-07-18,Sedanos Supermarkets #27,Invoice,008-03372,"Rice Snack:Rice Snack, Pizza DH",,1.0,19.9,19.9,3280654.04999998,Puffed Products,Keila Alfaro-Visvikis,RETAIL SEDANOS,1384073,Jul
2024-07-18,Sedanos Supermarkets #27,Invoice,008-03372,Rice Snack:Rice Snack Ham Flavored DOS HERMANOS,,1.0,19.9,19.9,3280673.94999998,Puffed Products,Keila Alfaro-Visvikis,RETAIL SEDANOS,1384074,Jul
2024-07-18,Sedanos Supermarkets #27,Invoice,008-03372,,Discount,,,-1.19,3280672.75999998,,Keila Alfaro-Visvikis,RETAIL SEDANOS,1384075,Jul
2024-07-18,Sedanos Supermarkets  #4,Invoice,008-03373,Arroz Envasado:Parboiled 5KG Dos Hermanos.,6 / 11lbs,5.0,40.5,202.5,3280875.25999998,Branded Rice,Lisset Limpio -020,RETAIL SEDANOS,1384076,Jul
2024-07-18,Sedanos Supermarkets  #4,Invoice,008-03373,Arroz Envasado:Parboiled 5KG Dos Hermanos.,6 / 11lbs,5.0,40.5,202.5,3281077.75999998,Branded Rice,Lisset Limpio -020,RETAIL SEDANOS,1384077,Jul
2024-07-18,Sedanos Supermarkets  #4,Invoice,008-03373,,Discount,,,-4.05,3281073.70999998,,Lisset Limpio -020,RETAIL SEDANOS,1384078,Jul
2024-07-18,Sedanos Supermarkets #24,Invoice,008-03374,Arroz a Granel:Parboiled 50 LB -Bolsa Dos Hermanos.,,10.0,28.25,282.5,3281356.20999998,Bulk Rice,Keila Alfaro-Visvikis,RETAIL SEDANOS,1384079,Jul
2024-07-18,Sedanos Supermarkets #24,Invoice,008-03374,,Discount,,,-5.65,3281350.55999998,,Keila Alfaro-Visvikis,RETAIL SEDANOS,1384080,Jul
2024-07-18,Sedanos Supermarkets #24,Invoice,008-03375,Rice Snack:Rice Snack Ham Flavored DOS HERMANOS,,1.0,19.9,19.9,3281370.45999998,Puffed Products,Keila Alfaro-Visvikis,RETAIL SEDANOS,1384081,Jul
2024-07-18,Sedanos Supermarkets #24,Invoice,008-03375,,Discount,,,-0.4,3281370.05999998,,Keila Alfaro-Visvikis,RETAIL SEDANOS,1384082,Jul
2024-07-18,Sedanos Supermarkets #26,Invoice,008-03376,Rice Snack:Rice Snack Ham Flavored DOS HERMANOS,,2.0,19.9,39.8,3281409.85999998,Puffed Products,Lisset Limpio -020,RETAIL SEDANOS,1384083,Jul
2024-07-18,Sedanos Supermarkets #26,Invoice,008-03376,Rice Snack:Rice Snack Salami Flavored DOS HERMANOS,,1.0,19.9,19.9,3281429.75999998,Puffed Products,Lisset Limpio -020,RETAIL SEDANOS,1384084,Jul
2024-07-18,Sedanos Supermarkets #26,Invoice,008-03376,"Rice Snack:Rice Snack, Pizza DH",,1.0,19.9,19.9,3281449.65999998,Puffed Products,Lisset Limpio -020,RETAIL SEDANOS,1384085,Jul
2024-07-18,Sedanos Supermarkets #26,Invoice,008-03376,,Discount,,,-1.19,3281448.46999998,,Lisset Limpio -020,RETAIL SEDANOS,1384086,Jul
2024-07-18,Ideal Food Basket,Invoice,008-03377,Arroz a Granel:Largo Fino 50 LB -Bolsa Dos Hermanos.,,10.0,27.85,278.5,3281726.96999998,Bulk Rice,Keila Alfaro-Visvikis,RETAIL  DSD,1384087,Jul
2024-07-18,Sedanos Supermarkets #9,Credit Memo,008-03468,Varios:Promotional Allowance,snack pizza,-1.0,19.9,-19.9,3281707.06999998,Puffed Products,Lisset Limpio -020,RETAIL SEDANOS,1384088,Jul
2024-07-18,Sedanos Supermarkets #9,Credit Memo,008-03468,Varios:Promotional Allowance,5kg parboiled,-5.0,40.5,-202.5,3281504.56999998,Branded Rice,Lisset Limpio -020,RETAIL SEDANOS,1384089,Jul
2024-07-18,Sedanos Supermarkets #8,Credit Memo,008-03469,Varios:Promotional Allowance,snack pizza,-1.0,19.9,-19.9,3281484.66999998,Puffed Products,Lisset Limpio -020,RETAIL SEDANOS,1384090,Jul
2024-07-18,Sedanos Supermarkets #28,Credit Memo,008-03470,Varios:Promotional Allowance,5kg parboiled,-20.0,40.5,-810.0,3280674.66999998,Branded Rice,Keila Alfaro-Visvikis,RETAIL SEDANOS,1384091,Jul
2024-07-18,El Palacio de Los Jugos / Casa mía Food Restaurant inc,Credit Memo,008-03471,Varios:Promotional Allowance,50Lb parboil,-1.0,27.75,-27.75,3280646.91999998,Bulk Rice,Lisset Limpio -020,Cafeteria,1384092,Jul
2024-07-18,El Palacio de los jugos /  Nanos Latin Foods,Credit Memo,008-03472,Varios:Promotional Allowance,Parboiled 50Lb,-1.0,27.75,-27.75,3280619.16999998,Bulk Rice,Lisset Limpio -020,Cafeteria,1384093,Jul
2024-07-18,Sedanos Supermarkets #42,Credit Memo,008-03473,Varios:Promotional Allowance,snack pizza,-1.0,19.9,-19.9,3280599.26999998,Puffed Products,Lisset Limpio -020,RETAIL SEDANOS,1384094,Jul
2024-07-18,Sedanos Supermarkets #27,Credit Memo,008-03474,Varios:Promotional Allowance,snack jamon,-1.0,19.9,-19.9,3280579.36999998,Puffed Products,Keila Alfaro-Visvikis,RETAIL SEDANOS,1384095,Jul
2024-07-18,Sedanos Supermarkets  #4,Credit Memo,008-03475,Varios:Promotional Allowance,5kg parboiled,-5.0,40.5,-202.5,3280376.86999998,Branded Rice,Lisset Limpio -020,RETAIL SEDANOS,1384096,Jul
2024-07-18,Sedanos Supermarkets #26,Credit Memo,008-03476,Varios:Promotional Allowance,snack pizza,-1.0,19.9,-19.9,3280356.96999998,Puffed Products,Lisset Limpio -020,RETAIL SEDANOS,1384097,Jul
2024-07-19,Hings Chinese,Invoice,008-03378,Arroz a Granel:Parboiled 50 LB -Bolsa Dos Hermanos.,,5.0,28.25,141.25,3280498.21999998,Bulk Rice,Lisset Limpio -020,CAFETERIA y RESTAURANTS,1384098,Jul
2024-07-19,Bravo   Francisco Diaz,Invoice,008-03379,Arroz a Granel:Largo Fino 50 LB -Bolsa Dos Hermanos.,,5.0,27.85,139.25,3280637.46999998,Bulk Rice,Lisset Limpio -020,RETAIL  DSD,1384099,Jul
2024-07-19,Bravo   Francisco Diaz,Invoice,008-03379,Liquids:AS Cooking Wine,4/1 Gl.,4.0,17.5,70.0,3280707.46999998,American Spice,Lisset Limpio -020,RETAIL  DSD,1384100,Jul
2024-07-19,Sedanos Supermarkets #18,Invoice,008-03380,Arroz a Granel:Parboiled 50 LB -Bolsa Dos Hermanos.,,10.0,28.25,282.5,3280989.96999998,Bulk Rice,Lisset Limpio -020,RETAIL SEDANOS,1384101,Jul
2024-07-19,Sedanos Supermarkets #18,Invoice,008-03380,,Discount,,,-5.65,3280984.31999998,,Lisset Limpio -020,RETAIL SEDANOS,1384102,Jul
2024-07-19,Rey Chavez Distributor #2,Invoice,008-03381,Arroz a Granel:Parboiled 50 LB -Bolsa Dos Hermanos.,,25.0,28.8,720.0,3281704.31999998,Bulk Rice,Lisset Limpio -020,WHOLESALER,1384103,Jul
2024-07-19,Sedanos Supermarkets #33,Invoice,008-03382,Arroz a Granel:Parboiled 50 LB -Bolsa Dos Hermanos.,,4.0,28.25,113.0,3281817.31999998,Bulk Rice,Lisset Limpio -020,RETAIL SEDANOS,1384104,Jul
2024-07-19,Sedanos Supermarkets #33,Invoice,008-03382,,Discount,,,-2.26,3281815.05999998,,Lisset Limpio -020,RETAIL SEDANOS,1384105,Jul
2024-07-19,Sabor Tropical Supermarket #4,Invoice,008-03383,Arroz a Granel:Parboiled 50 LB -Bolsa Dos Hermanos.,,20.0,28.25,565.0,3282380.05999998,Bulk Rice,Keila Alfaro-Visvikis,RETAIL  DSD,1384106,Jul
2024-07-19,Sabor Tropical Supermarket #4,Invoice,008-03383,Arroz Envasado:Parboiled 5KG Dos Hermanos.,6 / 11lbs,5.0,46.5,232.5,3282612.55999998,Branded Rice,Keila Alfaro-Visvikis,RETAIL  DSD,1384107,Jul
2024-07-19,Sabor Tropical Supermarket #4,Invoice,008-03383,Arroz Envasado:Parboiled 5KG Dos Hermanos.,6 / 11lbs,1.0,46.5,46.5,3282659.05999998,Branded Rice,Keila Alfaro-Visvikis,RETAIL  DSD,1384108,Jul
2024-07-19,Max Food Distributors,Invoice,008-03384,Arroz a Granel:Parboiled 50 LB -Bolsa Dos Hermanos.,,25.0,27.75,693.75,3283352.80999998,Bulk Rice,Lisset Limpio -020,WHOLESALER,1384109,Jul
2024-07-19,Sedanos Supermarkets #22,Invoice,008-03385,Spices:AS Chicken Base,1 / 30 lb. (box or pail),2.0,39.0,78.0,3283430.80999998,American Spice,Lisset Limpio -020,RETAIL SEDANOS,1384110,Jul
2024-07-19,Sedanos Supermarkets #22,Invoice,008-03385,,Discount,,,-1.56,3283429.24999998,,Lisset Limpio -020,RETAIL SEDANOS,1384111,Jul
2024-07-19,Los Caringas Latin America  Foods,Invoice,008-03386,Arroz a Granel:Largo Fino 50 LB -Bolsa Dos Hermanos.,,3.0,27.85,83.55,3283512.79999998,Bulk Rice,Lisset Limpio -020,CAFETERIA y RESTAURANTS,1384112,Jul
2024-07-19,Los Caringas Latin America  Foods,Invoice,008-03386,Arroz a Granel:Parboiled 50 LB -Bolsa Dos Hermanos.,,4.0,28.25,113.0,3283625.79999998,Bulk Rice,Lisset Limpio -020,CAFETERIA y RESTAURANTS,1384113,Jul
2024-07-19,El Palacio de los jugos / Delicias Criollas (DIAGO FOOD_MILLER),Invoice,008-03387,Dry Beans:Dry Beans - Black Beans 50,Dry Black Beans 50 lb,1.0,43.5,43.5,3283669.29999998,Dry Beans,Lisset Limpio -020,Cafeteria,1384114,Jul
2024-07-19,El Palacio de los jugos / Delicias Criollas (DIAGO FOOD_MILLER),Invoice,008-03387,Arroz a Granel:Parboiled 50 LB -Bolsa Dos Hermanos.,,11.0,27.75,305.25,3283974.54999998,Bulk Rice,Lisset Limpio -020,Cafeteria,1384115,Jul
2024-07-19,El Palacio de los jugos / Delicias Criollas (DIAGO FOOD_MILLER),Invoice,008-03387,Arroz a Granel:Parboiled 50 LB -Bolsa Dos Hermanos.,,1.0,27.75,27.75,3284002.29999998,Bulk Rice,Lisset Limpio -020,Cafeteria,1384116,Jul
2024-07-19,Sedanos Supermarkets #7,Credit Memo,008-03395,Varios:Producto vencido/deteriorado (no impacta en inventario),Aritos de cebolla,-8.0,1.49,-11.92,3283990.37999998,Puffed Products,Lisset Limpio -020,RETAIL SEDANOS,1384117,Jul
2024-07-19,Sedanos Supermarkets #7,Credit Memo,008-03395,,Discount,11.92,0.0024,0.03,3283990.40999998,,Lisset Limpio -020,RETAIL SEDANOS,1384118,Jul
2024-07-19,Sabor Tropical Supermarket #4,Credit Memo,008-03477,Varios:Promotional Allowance,5kg,-1.0,46.5,-46.5,3283943.90999998,Branded Rice,Keila Alfaro-Visvikis,RETAIL  DSD,1384119,Jul
2024-07-19,El Palacio de los jugos / Delicias Criollas (DIAGO FOOD_MILLER),Credit Memo,008-03478,Varios:Promotional Allowance,Parobiled 50LB,-1.0,27.75,-27.75,3283916.15999998,Bulk Rice,Lisset Limpio -020,Cafeteria,1384120,Jul
2024-07-22,El Palacio de los jugos /  Nanos Latin Foods,Invoice,008-03388,Arroz a Granel:Parboiled 50 LB -Bolsa Dos Hermanos.,,11.0,27.75,305.25,3284221.40999998,Bulk Rice,Lisset Limpio -020,Cafeteria,1384121,Jul
2024-07-22,El Palacio de los jugos /  Nanos Latin Foods,Invoice,008-03388,Dry Beans:Dry Beans - Black Beans 50,Dry Black Beans 50 lb,1.0,43.5,43.5,3284264.90999998,Dry Beans,Lisset Limpio -020,Cafeteria,1384122,Jul
2024-07-22,El Palacio de los jugos /  Nanos Latin Foods,Invoice,008-03388,Arroz a Granel:Parboiled 50 LB -Bolsa Dos Hermanos.,,1.0,27.75,27.75,3284292.65999998,Bulk Rice,Lisset Limpio -020,Cafeteria,1384123,Jul
2024-07-22,El Palacio de los jugos / Lita Foods Inc.,Invoice,008-03389,Arroz a Granel:Parboiled 50 LB -Bolsa Dos Hermanos.,,11.0,27.75,305.25,3284597.90999998,Bulk Rice,Lisset Limpio -020,Cafeteria,1384124,Jul
2024-07-22,El Palacio de los jugos / Lita Foods Inc.,Invoice,008-03389,Dry Beans:Dry Beans - Black Beans 50,Dry Black Beans 50 lb,1.0,43.5,43.5,3284641.40999998,Dry Beans,Lisset Limpio -020,Cafeteria,1384125,Jul
2024-07-22,El Palacio de los jugos / Lita Foods Inc.,Invoice,008-03389,Spices:AS Chicken Base 4/5lb,4/5lb,1.0,38.0,38.0,3284679.40999998,American Spice,Lisset Limpio -020,Cafeteria,1384126,Jul
2024-07-22,El Palacio de los jugos / Lita Foods Inc.,Invoice,008-03389,Arroz a Granel:Parboiled 50 LB -Bolsa Dos Hermanos.,,1.0,27.75,27.75,3284707.15999998,Bulk Rice,Lisset Limpio -020,Cafeteria,1384127,Jul
2024-07-22,Fritanga Momotombo,Invoice,008-03390,Arroz a Granel:Largo Fino 50 LB -Bolsa Dos Hermanos.,,5.0,27.85,139.25,3284846.40999998,Bulk Rice,Lisset Limpio -020,CAFETERIA y RESTAURANTS,1384128,Jul
2024-07-22,Rey Chavez Distributor Corp,Invoice,008-03391,Arroz a Granel:Parboiled 50 LB -Bolsa Dos Hermanos.,,55.0,28.8,1584.0,3286430.40999998,Bulk Rice,Lisset Limpio -020,WHOLESALER,1384129,Jul
2024-07-22,Sedanos Supermarkets #17,Invoice,008-03393,Rice Snack:Rice Snack Ham Flavored DOS HERMANOS,,2.0,19.9,39.8,3286470.20999998,Puffed Products,Lisset Limpio -020,RETAIL SEDANOS,1384130,Jul
2024-07-22,Sedanos Supermarkets #17,Invoice,008-03393,Rice Snack:Rice Snack Salami Flavored DOS HERMANOS,,1.0,19.9,19.9,3286490.10999998,Puffed Products,Lisset Limpio -020,RETAIL SEDANOS,1384131,Jul
2024-07-22,Sedanos Supermarkets #17,Invoice,008-03393,Rice Snack:Rice Snack Salami Flavored DOS HERMANOS,,1.0,19.9,19.9,3286510.00999998,Puffed Products,Lisset Limpio -020,RETAIL SEDANOS,1384132,Jul
2024-07-22,Sedanos Supermarkets #17,Invoice,008-03393,,Discount,,,-1.19,3286508.81999998,,Lisset Limpio -020,RETAIL SEDANOS,1384133,Jul
2024-07-22,Sedanos Supermarkets #7,Invoice,008-03394,Rice Snack:Rice Snack Salami Flavored DOS HERMANOS,,1.0,19.9,19.9,3286528.71999998,Puffed Products,Lisset Limpio -020,RETAIL SEDANOS,1384134,Jul
2024-07-22,Sedanos Supermarkets #7,Invoice,008-03394,Rice Snack:Rice Snack Ham Flavored DOS HERMANOS,,2.0,19.9,39.8,3286568.51999998,Puffed Products,Lisset Limpio -020,RETAIL SEDANOS,1384135,Jul
2024-07-22,Sedanos Supermarkets #7,Invoice,008-03394,Rice Snack:Rice Snack Ham Flavored DOS HERMANOS,,1.0,19.9,19.9,3286588.41999998,Puffed Products,Lisset Limpio -020,RETAIL SEDANOS,1384136,Jul
2024-07-22,Sedanos Supermarkets #7,Invoice,008-03394,,Discount,,,-0.98,3286587.43999998,,Lisset Limpio -020,RETAIL SEDANOS,1384137,Jul
2024-07-22,Vitos Meat and Provisions,Invoice,008-03396,Arroz a Granel:Parboiled 50 LB -Bolsa Dos Hermanos.,,1.0,28.25,28.25,3286615.68999998,Bulk Rice,Keila Alfaro-Visvikis,WHOLESALER,1384138,Jul
2024-07-22,Vitos Meat and Provisions,Invoice,008-03396,Arroz Envasado:Carnaroli Dos Hermanos,.,1.0,17.0,17.0,3286632.68999998,Branded Rice,Keila Alfaro-Visvikis,WHOLESALER,1384139,Jul
2024-07-22,Vitos Meat and Provisions,Invoice,008-03396,Arroz Envasado:Organico LF Dos Hermanos,.,1.0,19.9,19.9,3286652.58999998,Branded Rice,Keila Alfaro-Visvikis,WHOLESALER,1384140,Jul
2024-07-22,Vitos Meat and Provisions,Invoice,008-03396,Arroz Envasado:Sushi Rice Dos Hermanos.,.,1.0,21.25,21.25,3286673.83999998,Branded Rice,Keila Alfaro-Visvikis,WHOLESALER,1384141,Jul
2024-07-22,Vitos Meat and Provisions,Invoice,008-03396,Arroz Envasado:Parboiled 5KG Dos Hermanos.,6 / 11lbs,1.0,46.5,46.5,3286720.33999998,Branded Rice,Keila Alfaro-Visvikis,WHOLESALER,1384142,Jul
2024-07-22,JMN Dely Corp,Invoice,008-03397,Arroz a Granel:Largo Fino 50 LB -Bolsa Dos Hermanos.,,5.0,27.85,139.25,3286859.58999998,Bulk Rice,Keila Alfaro-Visvikis,CAFETERIA y RESTAURANTS,1384143,Jul
2024-07-22,JMN Dely Corp,Invoice,008-03397,Arroz a Granel:Parboiled 50 LB -Bolsa Dos Hermanos.,,2.0,28.25,56.5,3286916.08999998,Bulk Rice,Keila Alfaro-Visvikis,CAFETERIA y RESTAURANTS,1384144,Jul
2024-07-22,JMN Dely Corp,Invoice,008-03397,Dry Beans:Dry Beans - Black Beans 50,Dry Black Beans 50 lb,1.0,43.5,43.5,3286959.58999998,Dry Beans,Keila Alfaro-Visvikis,CAFETERIA y RESTAURANTS,1384145,Jul
2024-07-22,Sedanos Supermarkets  #37,Invoice,008-03398,"Rice Snack:Rice Snack, Pizza DH",,1.0,19.9,19.9,3286979.48999998,Puffed Products,Lisset Limpio -020,RETAIL SEDANOS,1384146,Jul
2024-07-22,Sedanos Supermarkets  #37,Invoice,008-03398,Rice Snack:Rice Snack Salami Flavored DOS HERMANOS,,2.0,19.9,39.8,3287019.28999998,Puffed Products,Lisset Limpio -020,RETAIL SEDANOS,1384147,Jul
2024-07-22,Sedanos Supermarkets  #37,Invoice,008-03398,Rice Snack:Rice Snack Ham Flavored DOS HERMANOS,,1.0,19.9,19.9,3287039.18999998,Puffed Products,Lisset Limpio -020,RETAIL SEDANOS,1384148,Jul
2024-07-22,Sedanos Supermarkets  #37,Invoice,008-03398,,Discount,,,-1.19,3287037.99999998,,Lisset Limpio -020,RETAIL SEDANOS,1384149,Jul
2024-07-22,El Palacio de los jugos / Lita Foods Inc.,Credit Memo,008-03479,Varios:Promotional Allowance,Parboiled 50LB,-1.0,27.75,-27.75,3287010.24999998,Bulk Rice,Lisset Limpio -020,Cafeteria,1384150,Jul
2024-07-22,El Palacio de los jugos /  Nanos Latin Foods,Credit Memo,008-03480,Varios:Promotional Allowance,Parboiled 50LB,-1.0,27.75,-27.75,3286982.49999998,Bulk Rice,Lisset Limpio -020,Cafeteria,1384151,Jul
2024-07-22,Sedanos Supermarkets #17,Credit Memo,008-03481,Varios:Promotional Allowance,snack salami,-1.0,19.9,-19.9,3286962.59999998,Puffed Products,Lisset Limpio -020,RETAIL SEDANOS,1384152,Jul
2024-07-22,Sedanos Supermarkets #7,Credit Memo,008-03482,Varios:Promotional Allowance,snack,-1.0,19.9,-19.9,3286942.69999998,Puffed Products,Lisset Limpio -020,RETAIL SEDANOS,1384153,Jul
2024-07-22,Vitos Meat and Provisions,Credit Memo,008-03483,Varios:Promotional Allowance,Parboil 50LB,-1.0,28.25,-28.25,3286914.44999998,Bulk Rice,Keila Alfaro-Visvikis,WHOLESALER,1384154,Jul
2024-07-22,Vitos Meat and Provisions,Credit Memo,008-03483,Varios:Promotional Allowance,Carnaroli,-1.0,17.0,-17.0,3286897.44999998,Branded Rice,Keila Alfaro-Visvikis,WHOLESALER,1384155,Jul
2024-07-22,Vitos Meat and Provisions,Credit Memo,008-03483,Varios:Promotional Allowance,Arroz Envasado:Organico LF Dos Hermanos,-1.0,19.9,-19.9,3286877.54999998,Branded Rice,Keila Alfaro-Visvikis,WHOLESALER,1384156,Jul
2024-07-22,Vitos Meat and Provisions,Credit Memo,008-03483,Varios:Promotional Allowance,Arroz Envasado:Sushi Rice Dos Hermanos.,-1.0,21.25,-21.25,3286856.29999998,Branded Rice,Keila Alfaro-Visvikis,WHOLESALER,1384157,Jul
2024-07-22,Vitos Meat and Provisions,Credit Memo,008-03483,Varios:Sales,5kg parbo,-1.0,46.5,-46.5,3286809.79999998,Branded Rice,Keila Alfaro-Visvikis,WHOLESALER,1384158,Jul
2024-07-22,Sedanos Supermarkets  #37,Credit Memo,008-03484,Varios:Promotional Allowance,snack pizza,-1.0,19.9,-19.9,3286789.89999998,Puffed Products,Lisset Limpio -020,RETAIL SEDANOS,1384159,Jul
2024-07-24,El Palacio de Los Jugos / Casa mía Food Restaurant inc,Invoice,008-03399,Dry Beans:Dry Beans - Black Beans 50,Dry Black Beans 50 lb,1.0,43.5,43.5,3286833.39999998,Dry Beans,Lisset Limpio -020,Cafeteria,1384160,Jul
2024-07-24,El Palacio de Los Jugos / Casa mía Food Restaurant inc,Invoice,008-03399,Arroz a Granel:Parboiled 50 LB -Bolsa Dos Hermanos.,,11.0,27.75,305.25,3287138.64999998,Bulk Rice,Lisset Limpio -020,Cafeteria,1384161,Jul
2024-07-24,El Palacio de Los Jugos / Casa mía Food Restaurant inc,Invoice,008-03399,Arroz a Granel:Parboiled 50 LB -Bolsa Dos Hermanos.,,1.0,27.75,27.75,3287166.39999998,Bulk Rice,Lisset Limpio -020,Cafeteria,1384162,Jul
2024-07-24,Los paraditos chinesse,Invoice,008-03400,Arroz a Granel:Parboiled 50 LB -Bolsa Dos Hermanos.,,10.0,28.25,282.5,3287448.89999998,Bulk Rice,Lisset Limpio -020,CAFETERIA y RESTAURANTS,1384163,Jul
2024-07-24,El Palacio de Los Jugos / Casa mía Food Restaurant inc,Credit Memo,008-03485,Varios:Promotional Allowance,Parboiled 50LB,-1.0,27.75,-27.75,3287421.14999998,Bulk Rice,Lisset Limpio -020,Cafeteria,1384164,Jul
2024-07-25,La Ranchera Meat Market #3,Invoice,008-03401,Arroz a Granel:Largo Fino 50 LB -Bolsa Dos Hermanos.,,10.0,27.85,278.5,3287699.64999998,Bulk Rice,Keila Alfaro-Visvikis,CAFETERIA y RESTAURANTS,1384165,Jul
2024-07-25,Ocho Rios - Miami Inc.,Invoice,008-03402,Arroz a Granel:Largo Fino 50 LB -Bolsa Dos Hermanos.,,1.0,27.3,27.3,3287726.94999998,Bulk Rice,Armando Carpio - 017,WHOLESALER,1384166,Jul
2024-07-25,Ocho Rios - Miami Inc.,Invoice,008-03402,Arroz a Granel:Parboiled 50 LB -Bolsa Dos Hermanos.,,1.0,27.75,27.75,3287754.69999998,Bulk Rice,Armando Carpio - 017,WHOLESALER,1384167,Jul
2024-07-26,Soriano Brothers PB,Invoice,008-03403,Spices:AS Sazon (for all),1 / 30 lb (box or pail),1.0,59.0,59.0,3287813.69999998,American Spice,Lisset Limpio -020,CAFETERIA y RESTAURANTS,1384168,Jul
2024-07-26,Soriano Brothers PB,Invoice,008-03403,Dry Beans:Dry Beans - Black Beans 50,Dry Black Beans 50 lb,1.0,43.5,43.5,3287857.19999998,Dry Beans,Lisset Limpio -020,CAFETERIA y RESTAURANTS,1384169,Jul
2024-07-26,Soriano Brothers PB,Invoice,008-03403,Dry Beans:Dry Beans - Small Red Beans 50 lbs.,Small Red Beans 50 lbs,1.0,46.0,46.0,3287903.19999998,Dry Beans,Lisset Limpio -020,CAFETERIA y RESTAURANTS,1384170,Jul
2024-07-26,Soriano Brothers PB,Invoice,008-03403,Arroz a Granel:Parboiled 50 LB -Bolsa Dos Hermanos.,,11.0,27.75,305.25,3288208.44999998,Bulk Rice,Lisset Limpio -020,CAFETERIA y RESTAURANTS,1384171,Jul
2024-07-26,Soriano Brothers PB,Invoice,008-03403,Arroz a Granel:Parboiled 50 LB -Bolsa Dos Hermanos.,,1.0,27.75,27.75,3288236.19999998,Bulk Rice,Lisset Limpio -020,CAFETERIA y RESTAURANTS,1384172,Jul
2024-07-26,Bravo   Francisco Diaz,Invoice,008-03404,Arroz a Granel:Largo Fino 50 LB -Bolsa Dos Hermanos.,,5.0,27.85,139.25,3288375.44999998,Bulk Rice,Lisset Limpio -020,RETAIL  DSD,1384173,Jul
2024-07-26,El Palacio de los jugos /  Mires Restaurants,Invoice,008-03405,Spices:AS Chicken Base 4/5lb,4/5lb,1.0,39.5,39.5,3288414.94999998,American Spice,Lisset Limpio -020,Cafeteria,1384174,Jul
2024-07-26,El Palacio de los jugos /  Mires Restaurants,Invoice,008-03405,Arroz a Granel:Parboiled 50 LB -Bolsa Dos Hermanos.,,11.0,27.75,305.25,3288720.19999998,Bulk Rice,Lisset Limpio -020,Cafeteria,1384175,Jul
2024-07-26,El Palacio de los jugos /  Mires Restaurants,Invoice,008-03405,Arroz a Granel:Parboiled 50 LB -Bolsa Dos Hermanos.,,1.0,27.75,27.75,3288747.94999998,Bulk Rice,Lisset Limpio -020,Cafeteria,1384176,Jul
2024-07-26,El Palacio de los jugos / Delicias Criollas (DIAGO FOOD_MILLER),Invoice,008-03406,Arroz a Granel:Parboiled 50 LB -Bolsa Dos Hermanos.,,11.0,27.75,305.25,3289053.19999998,Bulk Rice,Lisset Limpio -020,Cafeteria,1384177,Jul
2024-07-26,El Palacio de los jugos / Delicias Criollas (DIAGO FOOD_MILLER),Invoice,008-03406,Arroz a Granel:Parboiled 50 LB -Bolsa Dos Hermanos.,,1.0,27.75,27.75,3289080.94999998,Bulk Rice,Lisset Limpio -020,Cafeteria,1384178,Jul
2024-07-26,El Palacio de los jugos / Delicias Criollas (DIAGO FOOD_MILLER),Invoice,008-03406,Liquids:AS Cooking Wine,4/1 Gl.,1.0,17.5,17.5,3289098.44999998,American Spice,Lisset Limpio -020,Cafeteria,1384179,Jul
2024-07-26,El Gallego Supermarket,Invoice,008-03407,Dry Beans:Dry Beans - Black Beans 50,Dry Black Beans 50 lb,2.0,43.5,87.0,3289185.44999998,Dry Beans,Lisset Limpio -020,RETAIL  DSD,1384180,Jul
2024-07-26,El Gallego Supermarket,Invoice,008-03407,Arroz a Granel:Parboiled 50 LB -Bolsa Dos Hermanos.,,5.0,28.25,141.25,3289326.69999998,Bulk Rice,Lisset Limpio -020,RETAIL  DSD,1384181,Jul
2024-07-26,Sedanos Supermarkets #16,Invoice,008-03408,Arroz a Granel:Parboiled 50 LB -Bolsa Dos Hermanos.,,3.0,28.25,84.75,3289411.44999998,Bulk Rice,Lisset Limpio -020,RETAIL SEDANOS,1384182,Jul
2024-07-26,Sedanos Supermarkets #16,Invoice,008-03408,,Discount,,,-1.7,3289409.74999998,,Lisset Limpio -020,RETAIL SEDANOS,1384183,Jul
2024-07-26,El Palacio de los jugos /  Nanos Latin Foods,Invoice,008-03409,Arroz a Granel:Parboiled 50 LB -Bolsa Dos Hermanos.,,11.0,27.75,305.25,3289714.99999998,Bulk Rice,Lisset Limpio -020,Cafeteria,1384184,Jul
2024-07-26,El Palacio de los jugos /  Nanos Latin Foods,Invoice,008-03409,Dry Beans:Dry Beans - Black Beans 50,Dry Black Beans 50 lb,1.0,43.5,43.5,3289758.49999998,Dry Beans,Lisset Limpio -020,Cafeteria,1384185,Jul
2024-07-26,El Palacio de los jugos /  Nanos Latin Foods,Invoice,008-03409,Arroz a Granel:Parboiled 50 LB -Bolsa Dos Hermanos.,,1.0,27.75,27.75,3289786.24999998,Bulk Rice,Lisset Limpio -020,Cafeteria,1384186,Jul
2024-07-26,Price Choice Food Market # 2,Invoice,008-03410,Arroz a Granel:Parboiled 50 LB -Bolsa Dos Hermanos.,,10.0,28.25,282.5,3290068.74999998,Bulk Rice,Keila Alfaro-Visvikis,RETAIL  DSD,1384187,Jul
2024-07-26,Sedanos Supermarkets #20,Invoice,008-03411,Arroz Envasado:Parboiled 5KG Dos Hermanos.,6 / 11lbs,10.0,40.5,405.0,3290473.74999998,Branded Rice,Keila Alfaro-Visvikis,RETAIL SEDANOS,1384188,Jul
2024-07-26,Sedanos Supermarkets #20,Invoice,008-03411,Arroz Envasado:Parboiled 5KG Dos Hermanos.,6 / 11lbs,10.0,40.5,405.0,3290878.74999998,Branded Rice,Keila Alfaro-Visvikis,RETAIL SEDANOS,1384189,Jul
2024-07-26,Sedanos Supermarkets #20,Invoice,008-03411,Rice Snack:Rice Snack Salami Flavored DOS HERMANOS,,2.0,19.9,39.8,3290918.54999998,Puffed Products,Keila Alfaro-Visvikis,RETAIL SEDANOS,1384190,Jul
2024-07-26,Sedanos Supermarkets #20,Invoice,008-03411,"Rice Snack:Rice Snack, Pizza DH",,1.0,19.9,19.9,3290938.44999998,Puffed Products,Keila Alfaro-Visvikis,RETAIL SEDANOS,1384191,Jul
2024-07-26,Sedanos Supermarkets #20,Invoice,008-03411,,Discount,,,-22.1,3290916.34999998,,Keila Alfaro-Visvikis,RETAIL SEDANOS,1384192,Jul
2024-07-26,Price Choice # 8,Invoice,008-03412,Arroz Envasado:Largo Fino 1kg (Long grain rice) Dos Hermanos,,1.0,17.0,17.0,3290933.34999998,Branded Rice,Keila Alfaro-Visvikis,RETAIL  DSD,1384193,Jul
2024-07-26,Price Choice # 8,Invoice,008-03412,Arroz Envasado:Parboiled 1kg Bolsa Dos Hermanos.,.,1.0,19.9,19.9,3290953.24999998,Branded Rice,Keila Alfaro-Visvikis,RETAIL  DSD,1384194,Jul
2024-07-26,Price Choice # 8,Invoice,008-03412,Arroz Envasado:Parboiled 5KG Dos Hermanos.,6 / 11lbs,1.0,46.5,46.5,3290999.74999998,Branded Rice,Keila Alfaro-Visvikis,RETAIL  DSD,1384195,Jul
2024-07-26,Price Choice # 8,Invoice,008-03412,Arroz Envasado:Largo Fino 1kg (Long grain rice) Dos Hermanos,,1.0,17.0,17.0,3291016.74999998,Branded Rice,Keila Alfaro-Visvikis,RETAIL  DSD,1384196,Jul
2024-07-26,Price Choice # 8,Invoice,008-03412,Arroz Envasado:Parboiled 1kg Bolsa Dos Hermanos.,.,1.0,19.9,19.9,3291036.64999998,Branded Rice,Keila Alfaro-Visvikis,RETAIL  DSD,1384197,Jul
2024-07-26,Price Choice # 8,Invoice,008-03412,Arroz Envasado:Parboiled 5KG Dos Hermanos.,6 / 11lbs,1.0,46.5,46.5,3291083.14999998,Branded Rice,Keila Alfaro-Visvikis,RETAIL  DSD,1384198,Jul
2024-07-26,Ideal Food Basket Davie Cafeteria,Invoice,008-03413,Arroz a Granel:Largo Fino 50 LB -Bolsa Dos Hermanos.,,10.0,27.85,278.5,3291361.64999998,Bulk Rice,Keila Alfaro-Visvikis,CAFETERIA y RESTAURANTS,1384199,Jul
2024-07-26,Soriano Brothers PB,Credit Memo,008-03486,Varios:Promotional Allowance,Parboiled 50LB,-1.0,27.75,-27.75,3291333.89999998,Bulk Rice,Lisset Limpio -020,CAFETERIA y RESTAURANTS,1384200,Jul
2024-07-26,El Palacio de los jugos /  Mires Restaurants,Credit Memo,008-03487,Varios:Promotional Allowance,Parboiled 550LLB,-1.0,27.75,-27.75,3291306.14999998,Bulk Rice,Lisset Limpio -020,Cafeteria,1384201,Jul
2024-07-26,El Palacio de los jugos / Delicias Criollas (DIAGO FOOD_MILLER),Credit Memo,008-03488,Varios:Promotional Allowance,Parboiled 50LB,-1.0,27.75,-27.75,3291278.39999998,Bulk Rice,Lisset Limpio -020,Cafeteria,1384202,Jul
2024-07-26,El Palacio de los jugos /  Nanos Latin Foods,Credit Memo,008-03489,Varios:Promotional Allowance,Parboiled 50 LB,-1.0,27.75,-27.75,3291250.64999998,Bulk Rice,Lisset Limpio -020,Cafeteria,1384203,Jul
2024-07-26,Sedanos Supermarkets #20,Credit Memo,008-03490,Varios:Promotional Allowance,Parboil 5kg,-10.0,40.5,-405.0,3290845.64999998,Branded Rice,Keila Alfaro-Visvikis,RETAIL SEDANOS,1384204,Jul
2024-07-26,Price Choice # 8,Credit Memo,008-03491,Varios:Promotional Allowance,LF 1 kg,-1.0,17.0,-17.0,3290828.64999998,Branded Rice,Keila Alfaro-Visvikis,RETAIL  DSD,1384205,Jul
2024-07-26,Price Choice # 8,Credit Memo,008-03491,Varios:Promotional Allowance,Parbo 1kg,-1.0,19.9,-19.9,3290808.74999998,Branded Rice,Keila Alfaro-Visvikis,RETAIL  DSD,1384206,Jul
2024-07-26,Price Choice # 8,Credit Memo,008-03491,Varios:Promotional Allowance,Parbo 5kg,-1.0,46.5,-46.5,3290762.24999998,Branded Rice,Keila Alfaro-Visvikis,RETAIL  DSD,1384207,Jul
2024-07-29,Aries Supermarket & Cafeteria,Invoice,008-03414,Arroz a Granel:Parboiled 50 LB -Bolsa Dos Hermanos.,,10.0,28.25,282.5,3291044.74999998,Bulk Rice,Armando Carpio - 017,CAFETERIA y RESTAURANTS,1384208,Jul
2024-07-29,El Palacio de Los Jugos / Casa mía Food Restaurant inc,Invoice,008-03415,Dry Beans:Dry Beans - Black Beans 50,Dry Black Beans 50 lb,1.0,43.5,43.5,3291088.24999998,Dry Beans,Lisset Limpio -020,Cafeteria,1384209,Jul
2024-07-29,El Palacio de Los Jugos / Casa mía Food Restaurant inc,Invoice,008-03415,Arroz a Granel:Parboiled 50 LB -Bolsa Dos Hermanos.,,11.0,27.75,305.25,3291393.49999998,Bulk Rice,Lisset Limpio -020,Cafeteria,1384210,Jul
2024-07-29,El Palacio de Los Jugos / Casa mía Food Restaurant inc,Invoice,008-03415,Arroz a Granel:Largo Fino 50 LB -Bolsa Dos Hermanos.,,1.0,27.75,27.75,3291421.24999998,Bulk Rice,Lisset Limpio -020,Cafeteria,1384211,Jul
2024-07-29,El Palacio de los jugos / Lita Foods Inc.,Invoice,008-03416,Dry Beans:Dry Beans - Black Beans 50,Dry Black Beans 50 lb,1.0,43.5,43.5,3291464.74999998,Dry Beans,Lisset Limpio -020,Cafeteria,1384212,Jul
2024-07-29,El Palacio de los jugos / Lita Foods Inc.,Invoice,008-03416,Arroz a Granel:Parboiled 50 LB -Bolsa Dos Hermanos.,,11.0,27.75,305.25,3291769.99999998,Bulk Rice,Lisset Limpio -020,Cafeteria,1384213,Jul
2024-07-29,El Palacio de los jugos / Lita Foods Inc.,Invoice,008-03416,Arroz a Granel:Parboiled 50 LB -Bolsa Dos Hermanos.,,1.0,27.75,27.75,3291797.74999998,Bulk Rice,Lisset Limpio -020,Cafeteria,1384214,Jul
2024-07-29,Sedanos Supermarkets #27,Invoice,008-03417,Arroz a Granel:Parboiled 50 LB -Bolsa Dos Hermanos.,,0.0,,0.0,3291797.74999998,Bulk Rice,Keila Alfaro-Visvikis,RETAIL SEDANOS,1384215,Jul
2024-07-29,Key Food / Holywood,Invoice,008-03418,Arroz Envasado:Largo Fino 1kg (Long grain rice) Dos Hermanos,,10.0,17.0,170.0,3291967.74999998,Branded Rice,Keila Alfaro-Visvikis,RETAIL  DSD,1384216,Jul
2024-07-29,Key Food / Holywood,Invoice,008-03418,Arroz Envasado:Parboiled 1kg Bolsa Dos Hermanos.,.,10.0,19.9,199.0,3292166.74999998,Branded Rice,Keila Alfaro-Visvikis,RETAIL  DSD,1384217,Jul
2024-07-29,Key Food / Holywood,Invoice,008-03418,Arroz Envasado:Parboiled 5KG Dos Hermanos.,6 / 11lbs,5.0,46.5,232.5,3292399.24999998,Branded Rice,Keila Alfaro-Visvikis,RETAIL  DSD,1384218,Jul
2024-07-29,Key Food / Holywood,Invoice,008-03418,Arroz Envasado:Parboiled 5KG Dos Hermanos.,6 / 11lbs,1.0,46.5,46.5,3292445.74999998,Branded Rice,Keila Alfaro-Visvikis,RETAIL  DSD,1384219,Jul
2024-07-29,Key Food / Holywood,Invoice,008-03418,Rice Snack:Rice Snack Salami Flavored DOS HERMANOS,,1.0,19.9,19.9,3292465.64999998,Puffed Products,Keila Alfaro-Visvikis,RETAIL  DSD,1384220,Jul
2024-07-29,Key Food / Holywood,Invoice,008-03418,Tostadas de Arroz:Tostadas de Arroz Saladas 120gr,iC/ii/iD/i16,1.0,19.9,19.9,3292485.54999998,Puffed Products,Keila Alfaro-Visvikis,RETAIL  DSD,1384221,Jul
2024-07-29,Key Food / Holywood,Invoice,008-03418,Arroz Envasado:Largo Fino 1kg (Long grain rice) Dos Hermanos,,2.0,17.0,34.0,3292519.54999998,Branded Rice,Keila Alfaro-Visvikis,RETAIL  DSD,1384222,Jul
2024-07-29,Price Choice 5 YNTO Food Corp.,Invoice,008-03419,Arroz Envasado:Largo Fino 1kg (Long grain rice) Dos Hermanos,,3.0,17.0,51.0,3292570.54999998,Branded Rice,Keila Alfaro-Visvikis,RETAIL  DSD,1384223,Jul
2024-07-29,Price Choice 5 YNTO Food Corp.,Invoice,008-03419,Arroz Envasado:Parboiled 1kg Bolsa Dos Hermanos.,.,1.0,19.9,19.9,3292590.44999998,Branded Rice,Keila Alfaro-Visvikis,RETAIL  DSD,1384224,Jul
2024-07-29,Price Choice 5 YNTO Food Corp.,Invoice,008-03419,Tostadas de Arroz:Tostadas de Arroz Saladas 120gr,iC/ii/iD/i16,1.0,19.9,19.9,3292610.34999998,Puffed Products,Keila Alfaro-Visvikis,RETAIL  DSD,1384225,Jul
2024-07-29,Price Choice 5 YNTO Food Corp.,Invoice,008-03419,Rice Snack:Rice Snack Salami Flavored DOS HERMANOS,,1.0,19.9,19.9,3292630.24999998,Puffed Products,Keila Alfaro-Visvikis,RETAIL  DSD,1384226,Jul
2024-07-29,JMN Dely Corp,Invoice,008-03420,Arroz a Granel:Largo Fino 50 LB -Bolsa Dos Hermanos.,,5.0,27.85,139.25,3292769.49999998,Bulk Rice,Keila Alfaro-Visvikis,CAFETERIA y RESTAURANTS,1384227,Jul
2024-07-29,JMN Dely Corp,Invoice,008-03420,Arroz a Granel:Parboiled 50 LB -Bolsa Dos Hermanos.,,3.0,28.25,84.75,3292854.24999998,Bulk Rice,Keila Alfaro-Visvikis,CAFETERIA y RESTAURANTS,1384228,Jul
2024-07-29,JMN Dely Corp,Invoice,008-03420,Dry Beans:Dry Beans - Black Beans 50,Dry Black Beans 50 lb,1.0,42.5,42.5,3292896.74999998,Dry Beans,Keila Alfaro-Visvikis,CAFETERIA y RESTAURANTS,1384229,Jul
2024-07-29,Superior Meat and Fish,Invoice,008-03421,Arroz Envasado:Largo Fino 1kg (Long grain rice) Dos Hermanos,,2.0,17.0,34.0,3292930.74999998,Branded Rice,Keila Alfaro-Visvikis,RETAIL  DSD,1384230,Jul
2024-07-29,Superior Meat and Fish,Invoice,008-03421,Arroz Envasado:Parboiled 1kg Bolsa Dos Hermanos.,.,3.0,19.9,59.7,3292990.44999998,Branded Rice,Keila Alfaro-Visvikis,RETAIL  DSD,1384231,Jul
2024-07-29,Superior Meat and Fish,Invoice,008-03421,Arroz Envasado:Parboiled 5KG Dos Hermanos.,6 / 11lbs,15.0,46.5,697.5,3293687.94999998,Branded Rice,Keila Alfaro-Visvikis,RETAIL  DSD,1384232,Jul
2024-07-29,Superior Meat and Fish,Invoice,008-03421,Arroz Envasado:Parboiled 5KG Dos Hermanos.,6 / 11lbs,2.0,46.5,93.0,3293780.94999998,Branded Rice,Keila Alfaro-Visvikis,RETAIL  DSD,1384233,Jul
2024-07-29,Superior Meat and Fish,Invoice,008-03421,Arroz Envasado:Largo Fino 1kg (Long grain rice) Dos Hermanos,,1.0,17.0,17.0,3293797.94999998,Branded Rice,Keila Alfaro-Visvikis,RETAIL  DSD,1384234,Jul
2024-07-29,Festival Supermarket #35- Southgate,Invoice,008-03422,Arroz Envasado:Largo Fino 1kg (Long grain rice) Dos Hermanos,,2.0,17.0,34.0,3293831.94999998,Branded Rice,Keila Alfaro-Visvikis,RETAIL  DSD,1384235,Jul
2024-07-29,Festival Supermarket #35- Southgate,Invoice,008-03422,Arroz Envasado:Parboiled 1kg Bolsa Dos Hermanos.,.,3.0,19.9,59.7,3293891.64999998,Branded Rice,Keila Alfaro-Visvikis,RETAIL  DSD,1384236,Jul
2024-07-29,Festival Supermarket #35- Southgate,Invoice,008-03422,Arroz Envasado:Largo Fino 1kg (Long grain rice) Dos Hermanos,,1.0,17.0,17.0,3293908.64999998,Branded Rice,Keila Alfaro-Visvikis,RETAIL  DSD,1384237,Jul
2024-07-29,Ideal Food Basket Davie Grocery,Invoice,008-03423,Arroz Envasado:Largo Fino 1kg (Long grain rice) Dos Hermanos,,5.0,17.0,85.0,3293993.64999998,Branded Rice,Keila Alfaro-Visvikis,RETAIL  DSD,1384238,Jul
2024-07-29,Ideal Food Basket Davie Grocery,Invoice,008-03423,Arroz Envasado:Largo Fino 1kg (Long grain rice) Dos Hermanos,,1.0,17.0,17.0,3294010.64999998,Branded Rice,Keila Alfaro-Visvikis,RETAIL  DSD,1384239,Jul
2024-07-29,Ideal Food Basket Davie Grocery,Invoice,008-03423,Rice Snack:Rice Snack Salami Flavored DOS HERMANOS,,2.0,19.9,39.8,3294050.44999998,Puffed Products,Keila Alfaro-Visvikis,RETAIL  DSD,1384240,Jul
2024-07-29,Ideal Food Basket Davie Grocery,Invoice,008-03423,"Rice Snack:Rice Snack, Pizza DH",,1.0,19.9,19.9,3294070.34999998,Puffed Products,Keila Alfaro-Visvikis,RETAIL  DSD,1384241,Jul
2024-07-29,Ideal Food Basket Davie Grocery,Invoice,008-03423,Tostadas de Arroz:Tostadas de Arroz Saladas 120gr,iC/ii/iD/i16,1.0,19.9,19.9,3294090.24999998,Puffed Products,Keila Alfaro-Visvikis,RETAIL  DSD,1384242,Jul
2024-07-29,Ideal Food Basket Davie Grocery,Invoice,008-03423,Rice Cakes:Rice Cakes salty DH,,1.0,19.9,19.9,3294110.14999998,Puffed Products,Keila Alfaro-Visvikis,RETAIL  DSD,1384243,Jul
2024-07-29,Ideal Food Basket Davie Grocery,Invoice,008-03423,Rice Cakes:Rice Cakes Sweet DH,,1.0,19.9,19.9,3294130.04999998,Puffed Products,Keila Alfaro-Visvikis,RETAIL  DSD,1384244,Jul
2024-07-29,Ideal Food Basket Davie Grocery,Invoice,008-03423,Rice Cakes:Rice Cake Un Salty DH,,1.0,19.9,19.9,3294149.94999998,Puffed Products,Keila Alfaro-Visvikis,RETAIL  DSD,1384245,Jul
2024-07-29,El Palacio de Los Jugos / Casa mía Food Restaurant inc,Credit Memo,008-03492,Varios:Promotional Allowance,Parbo 50LB,-1.0,27.75,-27.75,3294122.19999998,Bulk Rice,Lisset Limpio -020,Cafeteria,1384246,Jul
2024-07-29,El Palacio de los jugos / Lita Foods Inc.,Credit Memo,008-03493,Varios:Promotional Allowance,Parbo 50lb,-1.0,27.75,-27.75,3294094.44999998,Bulk Rice,Lisset Limpio -020,Cafeteria,1384247,Jul
2024-07-29,Key Food / Holywood,Credit Memo,008-03494,Varios:Promotional Allowance,5kg,-1.0,46.5,-46.5,3294047.94999998,Branded Rice,Keila Alfaro-Visvikis,RETAIL  DSD,1384248,Jul
2024-07-29,Key Food / Holywood,Credit Memo,008-03494,Varios:Promotional Allowance,salami,-1.0,19.9,-19.9,3294028.04999998,Puffed Products,Keila Alfaro-Visvikis,RETAIL  DSD,1384249,Jul
2024-07-29,Key Food / Holywood,Credit Memo,008-03494,Varios:Promotional Allowance,tostadas,-1.0,19.9,-19.9,3294008.14999998,Puffed Products,Keila Alfaro-Visvikis,RETAIL  DSD,1384250,Jul
2024-07-29,Key Food / Holywood,Credit Memo,008-03494,Varios:Promotional Allowance,LF 1kg,-2.0,17.0,-34.0,3293974.14999998,Branded Rice,Keila Alfaro-Visvikis,RETAIL  DSD,1384251,Jul
2024-07-29,Price Choice 5 YNTO Food Corp.,Credit Memo,008-03495,Varios:Promotional Allowance,tostadas,-1.0,19.9,-19.9,3293954.24999998,Puffed Products,Keila Alfaro-Visvikis,RETAIL  DSD,1384252,Jul
2024-07-29,Price Choice 5 YNTO Food Corp.,Credit Memo,008-03495,Varios:Promotional Allowance,Salami,-1.0,19.9,-19.9,3293934.34999998,Puffed Products,Keila Alfaro-Visvikis,RETAIL  DSD,1384253,Jul
2024-07-29,Superior Meat and Fish,Credit Memo,008-03496,Varios:Promotional Allowance,5kg,-2.0,46.5,-93.0,3293841.34999998,Branded Rice,Keila Alfaro-Visvikis,RETAIL  DSD,1384254,Jul
2024-07-29,Superior Meat and Fish,Credit Memo,008-03496,Varios:Promotional Allowance,1kg Lf,-1.0,17.0,-17.0,3293824.34999998,Branded Rice,Keila Alfaro-Visvikis,RETAIL  DSD,1384255,Jul
2024-07-29,Festival Supermarket #35- Southgate,Credit Memo,008-03497,Varios:Promotional Allowance,LF 1kg,-1.0,17.0,-17.0,3293807.34999998,Branded Rice,Keila Alfaro-Visvikis,RETAIL  DSD,1384256,Jul
2024-07-29,Ideal Food Basket Davie Grocery,Credit Memo,008-03498,Varios:Promotional Allowance,LF 1kg,-1.0,17.0,-17.0,3293790.34999998,Branded Rice,Keila Alfaro-Visvikis,RETAIL  DSD,1384257,Jul
2024-07-29,Ideal Food Basket Davie Grocery,Credit Memo,008-03498,Varios:Promotional Allowance,tostadas,-1.0,19.9,-19.9,3293770.44999998,Puffed Products,Keila Alfaro-Visvikis,RETAIL  DSD,1384258,Jul
2024-07-31,Sedanos Supermarkets #18,Invoice,008-03424,Arroz Envasado:Parboiled 5KG Dos Hermanos.,6 / 11lbs,6.0,40.5,243.0,3294013.44999998,Branded Rice,Lisset Limpio -020,RETAIL SEDANOS,1384259,Jul
2024-07-31,Sedanos Supermarkets #18,Invoice,008-03424,Arroz Envasado:Parboiled 5KG Dos Hermanos.,6 / 11lbs,6.0,40.5,243.0,3294256.44999998,Branded Rice,Lisset Limpio -020,RETAIL SEDANOS,1384260,Jul
2024-07-31,Sedanos Supermarkets #18,Invoice,008-03424,,Discount,,,-4.86,3294251.58999998,,Lisset Limpio -020,RETAIL SEDANOS,1384261,Jul
2024-07-31,Pacifico Chinese Restaurant,Invoice,008-03425,Arroz a Granel:Parboiled 50 LB -Bolsa Dos Hermanos.,,10.0,28.25,282.5,3294534.08999998,Bulk Rice,Lisset Limpio -020,CAFETERIA y RESTAURANTS,1384262,Jul
2024-07-31,"Soriano Brothers Diaz Food Service,Inc",Invoice,008-03426,Arroz a Granel:Largo Fino 50 LB -Bolsa Dos Hermanos.,,30.0,27.85,835.5,3295369.58999998,Bulk Rice,Lisset Limpio -020,CAFETERIA y RESTAURANTS,1384263,Jul
2024-07-31,"Soriano Brothers Diaz Food Service,Inc",Invoice,008-03426,Dry Beans:Dry Beans - Black Beans 50,Dry Black Beans 50 lb,4.0,43.5,174.0,3295543.58999998,Dry Beans,Lisset Limpio -020,CAFETERIA y RESTAURANTS,1384264,Jul
2024-07-31,Price Choice Food Market # 6,Invoice,008-03427,Arroz a Granel:Parboiled 50 LB -Bolsa Dos Hermanos.,,20.0,28.25,565.0,3296108.58999998,Bulk Rice,Lisset Limpio -020,RETAIL  DSD,1384265,Jul
2024-07-31,Panda Depot,Invoice,008-03428,Arroz a Granel:Parboiled 50 LB -Bolsa Dos Hermanos.,Sample / had issues with the last purchase.,1.0,27.75,27.75,3296136.33999998,Bulk Rice,Lisset Limpio -020,WHOLESALER,1384266,Jul
2024-07-31,Sedanos Supermarkets #31,Invoice,008-03429,Arroz a Granel:Largo Fino 50 LB -Bolsa Dos Hermanos.,,4.0,27.85,111.4,3296247.73999998,Bulk Rice,Lisset Limpio -020,RETAIL SEDANOS,1384267,Jul
2024-07-31,Sedanos Supermarkets #31,Invoice,008-03429,Arroz a Granel:Parboiled 50 LB -Bolsa Dos Hermanos.,,4.0,28.25,113.0,3296360.73999998,Bulk Rice,Lisset Limpio -020,RETAIL SEDANOS,1384268,Jul
2024-07-31,Sedanos Supermarkets #31,Invoice,008-03429,,Discount,,,-4.49,3296356.24999998,,Lisset Limpio -020,RETAIL SEDANOS,1384269,Jul
2024-07-31,Sedanos Supermarkets #16,Invoice,008-03430,Arroz a Granel:Parboiled 50 LB -Bolsa Dos Hermanos.,,5.0,28.25,141.25,3296497.49999998,Bulk Rice,Lisset Limpio -020,RETAIL SEDANOS,1384270,Jul
2024-07-31,Sedanos Supermarkets #16,Invoice,008-03430,,Discount,,,-2.83,3296494.66999998,,Lisset Limpio -020,RETAIL SEDANOS,1384271,Jul
2024-07-31,Sedanos Supermarkets #18,Credit Memo,008-03500,Varios:Promotional Allowance,5kg,-6.0,40.5,-243.0,3296251.66999998,Branded Rice,Lisset Limpio -020,RETAIL SEDANOS,1384272,Jul
2024-07-31,Panda Depot,Credit Memo,008-03501,Varios:Promotional Allowance,5kg,-1.0,27.75,-27.75,3296223.91999998,Branded Rice,Lisset Limpio -020,WHOLESALER,1384273,Jul
2024-08-02,Fritanga Momotombo,Invoice,008-03431,Arroz a Granel:Largo Fino 50 LB -Bolsa Dos Hermanos.,,5.0,27.85,139.25,3296363.16999998,Bulk Rice,Lisset Limpio -020,CAFETERIA y RESTAURANTS,1384274,Aug
2024-08-02,Los Caringas Latin America  Foods,Invoice,008-03432,Arroz a Granel:Largo Fino 50 LB -Bolsa Dos Hermanos.,,3.0,27.85,83.55,3296446.71999998,Bulk Rice,Lisset Limpio -020,CAFETERIA y RESTAURANTS,1384275,Aug
2024-08-02,Los Caringas Latin America  Foods,Invoice,008-03432,Arroz a Granel:Parboiled 50 LB -Bolsa Dos Hermanos.,,3.0,28.25,84.75,3296531.46999998,Bulk Rice,Lisset Limpio -020,CAFETERIA y RESTAURANTS,1384276,Aug
2024-08-02,Soriano Brothers PB,Invoice,008-03433,Spices:AS Sazon (for all),1 / 30 lb (box or pail),1.0,59.0,59.0,3296590.46999998,American Spice,Lisset Limpio -020,CAFETERIA y RESTAURANTS,1384277,Aug
2024-08-02,Soriano Brothers PB,Invoice,008-03433,Dry Beans:Dry Beans - Black Beans 50,Dry Black Beans 50 lb,1.0,43.5,43.5,3296633.96999998,Dry Beans,Lisset Limpio -020,CAFETERIA y RESTAURANTS,1384278,Aug
2024-08-02,Soriano Brothers PB,Invoice,008-03433,Arroz a Granel:Parboiled 50 LB -Bolsa Dos Hermanos.,,11.0,27.75,305.25,3296939.21999998,Bulk Rice,Lisset Limpio -020,CAFETERIA y RESTAURANTS,1384279,Aug
2024-08-02,Soriano Brothers PB,Invoice,008-03433,Arroz a Granel:Parboiled 50 LB -Bolsa Dos Hermanos.,,1.0,27.75,27.75,3296966.96999998,Bulk Rice,Lisset Limpio -020,CAFETERIA y RESTAURANTS,1384280,Aug
2024-08-02,Be Your Will LLC,Invoice,008-03434,Dry Beans:Dry Beans - Black Beans 50,Dry Black Beans 50 lb,1.0,43.5,43.5,3297010.46999998,Dry Beans,Lisset Limpio -020,CAFETERIA y RESTAURANTS,1384281,Aug
2024-08-02,Be Your Will LLC,Invoice,008-03434,Arroz a Granel:Parboiled 50 LB -Bolsa Dos Hermanos.,,11.0,27.75,305.25,3297315.71999998,Bulk Rice,Lisset Limpio -020,CAFETERIA y RESTAURANTS,1384282,Aug
2024-08-02,Be Your Will LLC,Invoice,008-03434,Arroz a Granel:Parboiled 50 LB -Bolsa Dos Hermanos.,,1.0,27.75,27.75,3297343.46999998,Bulk Rice,Lisset Limpio -020,CAFETERIA y RESTAURANTS,1384283,Aug
2024-08-02,ALS Foods,Invoice,008-03435,Dry Beans:Dry Beans - Black Beans 50,Dry Black Beans 50 lb,1.0,43.5,43.5,3297386.96999998,Dry Beans,Lisset Limpio -020,CAFETERIA y RESTAURANTS,1384284,Aug
2024-08-02,ALS Foods,Invoice,008-03435,Arroz a Granel:Largo Fino 50 LB -Bolsa Dos Hermanos.,,10.0,27.85,278.5,3297665.46999998,Bulk Rice,Lisset Limpio -020,CAFETERIA y RESTAURANTS,1384285,Aug
2024-08-02,El Palacio de Los Jugos / Casa mía Food Restaurant inc,Invoice,008-03436,Arroz a Granel:Parboiled 50 LB -Bolsa Dos Hermanos.,,11.0,27.75,305.25,3297970.71999998,Bulk Rice,Lisset Limpio -020,Cafeteria,1384286,Aug
2024-08-02,El Palacio de Los Jugos / Casa mía Food Restaurant inc,Invoice,008-03436,Dry Beans:Dry Beans - Black Beans 50,Dry Black Beans 50 lb,1.0,39.5,39.5,3298010.21999998,Dry Beans,Lisset Limpio -020,Cafeteria,1384287,Aug
2024-08-02,El Palacio de Los Jugos / Casa mía Food Restaurant inc,Invoice,008-03436,Arroz a Granel:Parboiled 50 LB -Bolsa Dos Hermanos.,,1.0,27.75,27.75,3298037.96999998,Bulk Rice,Lisset Limpio -020,Cafeteria,1384288,Aug
2024-08-02,El Palacio de los jugos / Lita Foods Inc.,Invoice,008-03437,Arroz a Granel:Parboiled 50 LB -Bolsa Dos Hermanos.,,11.0,27.75,305.25,3298343.21999998,Bulk Rice,Lisset Limpio -020,Cafeteria,1384289,Aug
2024-08-02,El Palacio de los jugos / Lita Foods Inc.,Invoice,008-03437,Spices:AS Chicken Base 4/5lb,4/5lb,1.0,39.5,39.5,3298382.71999998,American Spice,Lisset Limpio -020,Cafeteria,1384290,Aug
2024-08-02,El Palacio de los jugos / Lita Foods Inc.,Invoice,008-03437,Arroz a Granel:Parboiled 50 LB -Bolsa Dos Hermanos.,,1.0,27.75,27.75,3298410.46999998,Bulk Rice,Lisset Limpio -020,Cafeteria,1384291,Aug
2024-08-02,El Palacio de los jugos /  Nanos Latin Foods,Invoice,008-03438,Arroz a Granel:Parboiled 50 LB -Bolsa Dos Hermanos.,,11.0,27.75,305.25,3298715.71999998,Bulk Rice,Lisset Limpio -020,Cafeteria,1384292,Aug
2024-08-02,El Palacio de los jugos /  Nanos Latin Foods,Invoice,008-03438,Dry Beans:Dry Beans - Black Beans 50,Dry Black Beans 50 lb,1.0,43.5,43.5,3298759.21999998,Dry Beans,Lisset Limpio -020,Cafeteria,1384293,Aug
2024-08-02,El Palacio de los jugos /  Nanos Latin Foods,Invoice,008-03438,Arroz a Granel:Parboiled 50 LB -Bolsa Dos Hermanos.,,1.0,27.75,27.75,3298786.96999998,Bulk Rice,Lisset Limpio -020,Cafeteria,1384294,Aug
2024-08-02,Hings Chinese,Invoice,008-03439,Arroz a Granel:Parboiled 50 LB -Bolsa Dos Hermanos.,,5.0,28.25,141.25,3298928.21999998,Bulk Rice,Lisset Limpio -020,CAFETERIA y RESTAURANTS,1384295,Aug
2024-08-02,El Palacio de los jugos / Delicias Criollas (DIAGO FOOD_MILLER),Invoice,008-03440,Arroz a Granel:Parboiled 50 LB -Bolsa Dos Hermanos.,,11.0,27.75,305.25,3299233.46999998,Bulk Rice,Lisset Limpio -020,Cafeteria,1384296,Aug
2024-08-02,El Palacio de los jugos / Delicias Criollas (DIAGO FOOD_MILLER),Invoice,008-03440,Dry Beans:Dry Beans - Black Beans 50,Dry Black Beans 50 lb,1.0,43.5,43.5,3299276.96999998,Dry Beans,Lisset Limpio -020,Cafeteria,1384297,Aug
2024-08-02,El Palacio de los jugos / Delicias Criollas (DIAGO FOOD_MILLER),Invoice,008-03440,Arroz a Granel:Parboiled 50 LB -Bolsa Dos Hermanos.,,1.0,27.75,27.75,3299304.71999998,Bulk Rice,Lisset Limpio -020,Cafeteria,1384298,Aug
2024-08-02,"American Spice Trading Co, Inc.",Invoice,008-03499,Arroz a Granel:Parboiled 50 LB -Bolsa Dos Hermanos.,,1100.0,27.5,30250.0,3329554.71999998,Bulk Rice,Armando Carpio - 017,WHOLESALER MANUFACTURY,1384299,Aug
2024-08-02,Soriano Brothers PB,Credit Memo,008-03633,Varios:Promotional Allowance,parboil 50lb,-1.0,27.75,-27.75,3329526.96999998,Bulk Rice,Lisset Limpio -020,CAFETERIA y RESTAURANTS,1384300,Aug
2024-08-02,Be Your Will LLC,Credit Memo,008-03634,Varios:Promotional Allowance,50 lb,-1.0,27.75,-27.75,3329499.21999998,Bulk Rice,Lisset Limpio -020,CAFETERIA y RESTAURANTS,1384301,Aug
2024-08-02,El Palacio de Los Jugos / Casa mía Food Restaurant inc,Credit Memo,008-03635,Varios:Promotional Allowance,,-1.0,27.75,-27.75,3329471.46999998,Bulk Rice,Lisset Limpio -020,Cafeteria,1384302,Aug
2024-08-02,El Palacio de los jugos / Lita Foods Inc.,Credit Memo,008-03636,Varios:Promotional Allowance,,-1.0,27.75,-27.75,3329443.71999998,Bulk Rice,Lisset Limpio -020,Cafeteria,1384303,Aug
2024-08-02,El Palacio de los jugos /  Nanos Latin Foods,Credit Memo,008-03637,Varios:Promotional Allowance,Parbo 50lb,-1.0,27.75,-27.75,3329415.96999998,Bulk Rice,Lisset Limpio -020,Cafeteria,1384304,Aug
2024-08-02,El Palacio de los jugos / Delicias Criollas (DIAGO FOOD_MILLER),Credit Memo,008-03638,Varios:Promotional Allowance,parbo 50lb,-1.0,27.75,-27.75,3329388.21999998,Bulk Rice,Lisset Limpio -020,Cafeteria,1384305,Aug
2024-08-04,Los Mejores Tamales de Miami,Invoice,008-03502,Arroz a Granel:Parboiled 50 LB -Bolsa Dos Hermanos.,,3.0,28.25,84.75,3329472.96999998,Bulk Rice,Lisset Limpio -020,CAFETERIA y RESTAURANTS,1384306,Aug
2024-08-04,Rey Chavez Distributor Corp,Invoice,008-03503,Arroz a Granel:Parboiled 50 LB -Bolsa Dos Hermanos.,,55.0,28.8,1584.0,3331056.96999998,Bulk Rice,Lisset Limpio -020,WHOLESALER,1384307,Aug
2024-08-04,Ideal Food Basket Davie Cafeteria,Invoice,008-03504,Arroz a Granel:Largo Fino 50 LB -Bolsa Dos Hermanos.,,12.0,27.85,334.2,3331391.16999998,Bulk Rice,Keila Alfaro-Visvikis,CAFETERIA y RESTAURANTS,1384308,Aug
2024-08-04,Key Food Pembroke,Invoice,008-03505,Arroz Envasado:Parboiled 1kg Bolsa Dos Hermanos.,.,3.0,19.9,59.7,3331450.86999998,Branded Rice,Keila Alfaro-Visvikis,RETAIL  DSD,1384309,Aug
2024-08-04,Key Food Pembroke,Invoice,008-03505,Arroz Envasado:Largo Fino 1kg (Long grain rice) Dos Hermanos,,2.0,17.0,34.0,3331484.86999998,Branded Rice,Keila Alfaro-Visvikis,RETAIL  DSD,1384310,Aug
2024-08-04,Key Food Pembroke,Invoice,008-03505,Arroz Envasado:Largo Fino 1kg (Long grain rice) Dos Hermanos,,1.0,17.0,17.0,3331501.86999998,Branded Rice,Keila Alfaro-Visvikis,RETAIL  DSD,1384311,Aug
2024-08-04,Key Food Kimberly Blvd.,Invoice,008-03506,Arroz Envasado:Parboiled 5KG Dos Hermanos.,6 / 11lbs,10.0,46.5,465.0,3331966.86999998,Branded Rice,Keila Alfaro-Visvikis,RETAIL  DSD,1384312,Aug
2024-08-04,Key Food Kimberly Blvd.,Invoice,008-03506,Arroz Envasado:Largo Fino 1kg (Long grain rice) Dos Hermanos,,2.0,17.0,34.0,3332000.86999998,Branded Rice,Keila Alfaro-Visvikis,RETAIL  DSD,1384313,Aug
2024-08-04,Key Food Kimberly Blvd.,Invoice,008-03506,Arroz Envasado:Parboiled 1kg Bolsa Dos Hermanos.,.,3.0,19.9,59.7,3332060.56999998,Branded Rice,Keila Alfaro-Visvikis,RETAIL  DSD,1384314,Aug
2024-08-04,Key Food Kimberly Blvd.,Invoice,008-03506,Arroz Envasado:Sushi Rice Dos Hermanos.,.,1.0,20.0,20.0,3332080.56999998,Branded Rice,Keila Alfaro-Visvikis,RETAIL  DSD,1384315,Aug
2024-08-04,Key Food Kimberly Blvd.,Invoice,008-03506,Arroz Envasado:Parboiled 5KG Dos Hermanos.,6 / 11lbs,1.0,46.5,46.5,3332127.06999998,Branded Rice,Keila Alfaro-Visvikis,RETAIL  DSD,1384316,Aug
2024-08-04,Key Food Kimberly Blvd.,Invoice,008-03506,Arroz Envasado:Largo Fino 1kg (Long grain rice) Dos Hermanos,,1.0,19.9,19.9,3332146.96999998,Branded Rice,Keila Alfaro-Visvikis,RETAIL  DSD,1384317,Aug
2024-08-04,Key Food Weston,Invoice,008-03507,Arroz Envasado:Largo Fino 1kg (Long grain rice) Dos Hermanos,,2.0,17.0,34.0,3332180.96999998,Branded Rice,Keila Alfaro-Visvikis,RETAIL  DSD,1384318,Aug
2024-08-04,Key Food Weston,Invoice,008-03507,Arroz Envasado:Parboiled 1kg Bolsa Dos Hermanos.,.,3.0,19.9,59.7,3332240.66999998,Branded Rice,Keila Alfaro-Visvikis,RETAIL  DSD,1384319,Aug
2024-08-04,Key Food Weston,Invoice,008-03507,Rice Snack:Rice Snack Salami Flavored DOS HERMANOS,,1.0,19.9,19.9,3332260.56999998,Puffed Products,Keila Alfaro-Visvikis,RETAIL  DSD,1384320,Aug
2024-08-04,Key Food Weston,Invoice,008-03507,Rice Snack:Rice Snack Ham Flavored DOS HERMANOS,,1.0,19.9,19.9,3332280.46999998,Puffed Products,Keila Alfaro-Visvikis,RETAIL  DSD,1384321,Aug
2024-08-04,Key Food Weston,Invoice,008-03507,Arroz Envasado:Sushi Rice Dos Hermanos.,.,1.0,20.0,20.0,3332300.46999998,Branded Rice,Keila Alfaro-Visvikis,RETAIL  DSD,1384322,Aug
2024-08-04,Key Food Weston,Invoice,008-03507,Tostadas de Arroz:Tostadas de Arroz Saladas 120gr,iC/ii/iD/i16,1.0,19.9,19.9,3332320.36999998,Puffed Products,Keila Alfaro-Visvikis,RETAIL  DSD,1384323,Aug
2024-08-04,Key Food Weston,Invoice,008-03507,Arroz Envasado:Largo Fino 1kg (Long grain rice) Dos Hermanos,,1.0,17.0,17.0,3332337.36999998,Branded Rice,Keila Alfaro-Visvikis,RETAIL  DSD,1384324,Aug
2024-08-04,Key Food Weston,Invoice,008-03507,Tostadas de Arroz:Tostadas de Arroz Sin Sal 120gr,iE/iG/iH/i24/,1.0,19.9,19.9,3332357.26999998,Puffed Products,Keila Alfaro-Visvikis,RETAIL  DSD,1384325,Aug
2024-08-04,Sabor Tropical Supermarket #7,Invoice,008-03508,Arroz Envasado:Largo Fino 1kg (Long grain rice) Dos Hermanos,,5.0,17.0,85.0,3332442.26999998,Branded Rice,Keila Alfaro-Visvikis,RETAIL  DSD,1384326,Aug
2024-08-04,Sabor Tropical Supermarket #7,Invoice,008-03508,Rice Snack:Rice Snack Ham Flavored DOS HERMANOS,,1.0,19.9,19.9,3332462.16999998,Puffed Products,Keila Alfaro-Visvikis,RETAIL  DSD,1384327,Aug
2024-08-04,Sabor Tropical Supermarket #7,Invoice,008-03508,Rice Snack:Rice Snack Salami Flavored DOS HERMANOS,,1.0,19.9,19.9,3332482.06999998,Puffed Products,Keila Alfaro-Visvikis,RETAIL  DSD,1384328,Aug
2024-08-04,Sabor Tropical Supermarket #7,Invoice,008-03508,Tostadas de Arroz:Tostadas de Arroz Saladas 120gr,iC/ii/iD/i16,1.0,19.9,19.9,3332501.96999998,Puffed Products,Keila Alfaro-Visvikis,RETAIL  DSD,1384329,Aug
2024-08-04,Sabor Tropical Supermarket #7,Invoice,008-03508,Arroz Envasado:Largo Fino 1kg (Long grain rice) Dos Hermanos,,1.0,17.0,17.0,3332518.96999998,Branded Rice,Keila Alfaro-Visvikis,RETAIL  DSD,1384330,Aug
2024-08-04,Key Food Pembroke,Credit Memo,008-03639,Varios:Promotional Allowance,lf 1kg,-1.0,17.0,-17.0,3332501.96999998,Branded Rice,Keila Alfaro-Visvikis,RETAIL  DSD,1384331,Aug
2024-08-04,Key Food Kimberly Blvd.,Credit Memo,008-03640,Varios:Promotional Allowance,parbo 5kg,-1.0,46.5,-46.5,3332455.46999998,Branded Rice,Keila Alfaro-Visvikis,RETAIL  DSD,1384332,Aug
2024-08-04,Key Food Kimberly Blvd.,Credit Memo,008-03640,Varios:Promotional Allowance,LF 1kg,-1.0,19.9,-19.9,3332435.56999998,Branded Rice,Keila Alfaro-Visvikis,RETAIL  DSD,1384333,Aug
2024-08-04,Key Food Weston,Credit Memo,008-03641,Varios:Promotional Allowance,tostadas saladas,-1.0,19.9,-19.9,3332415.66999998,Puffed Products,Lisset Limpio -020,RETAIL  DSD,1384334,Aug
2024-08-04,Key Food Weston,Credit Memo,008-03641,Varios:Promotional Allowance,lf 1kg,-1.0,17.0,-17.0,3332398.66999998,Branded Rice,Lisset Limpio -020,RETAIL  DSD,1384335,Aug
2024-08-04,Key Food Weston,Credit Memo,008-03641,Varios:Promotional Allowance,tostadas sin sal,-1.0,19.9,-19.9,3332378.76999998,Puffed Products,Lisset Limpio -020,RETAIL  DSD,1384336,Aug
2024-08-04,Sabor Tropical Supermarket #7,Credit Memo,008-03642,Varios:Promotional Allowance,lf,-1.0,17.0,-17.0,3332361.76999998,Branded Rice,Keila Alfaro-Visvikis,RETAIL  DSD,1384337,Aug
2024-08-05,El Palacio de los jugos /  Nanos Latin Foods,Invoice,008-03509,Arroz a Granel:Parboiled 50 LB -Bolsa Dos Hermanos.,,11.0,27.75,305.25,3332667.01999998,Bulk Rice,Lisset Limpio -020,Cafeteria,1384338,Aug
2024-08-05,El Palacio de los jugos /  Nanos Latin Foods,Invoice,008-03509,Dry Beans:Dry Beans - Black Beans 50,Dry Black Beans 50 lb,1.0,43.5,43.5,3332710.51999998,Dry Beans,Lisset Limpio -020,Cafeteria,1384339,Aug
2024-08-05,El Palacio de los jugos /  Nanos Latin Foods,Invoice,008-03509,Arroz a Granel:Parboiled 50 LB -Bolsa Dos Hermanos.,,1.0,27.75,27.75,3332738.26999998,Bulk Rice,Lisset Limpio -020,Cafeteria,1384340,Aug
2024-08-05,"Soriano Brothers Diaz Food Service,Inc",Invoice,008-03510,Arroz a Granel:Parboiled 50 LB -Bolsa Dos Hermanos.,,2.0,27.75,55.5,3332793.76999998,Bulk Rice,Lisset Limpio -020,CAFETERIA y RESTAURANTS,1384341,Aug
2024-08-05,"Soriano Brothers Diaz Food Service,Inc",Invoice,008-03510,Arroz a Granel:Parboiled 50 LB -Bolsa Dos Hermanos.,,22.0,27.75,610.5,3333404.26999998,Bulk Rice,Lisset Limpio -020,CAFETERIA y RESTAURANTS,1384342,Aug
2024-08-05,Soriano Brothers PB,Invoice,008-03511,Spices:AS Sazon (for all),1 / 30 lb (box or pail),2.0,59.0,118.0,3333522.26999998,American Spice,Lisset Limpio -020,CAFETERIA y RESTAURANTS,1384343,Aug
2024-08-05,Soriano Brothers PB,Invoice,008-03511,Arroz a Granel:Largo Fino 50 LB -Bolsa Dos Hermanos.,,15.0,27.85,417.75,3333940.01999998,Bulk Rice,Lisset Limpio -020,CAFETERIA y RESTAURANTS,1384344,Aug
2024-08-05,Sedanos Supermarkets #31,Invoice,008-03512,Rice Snack:Rice Snack Ham Flavored DOS HERMANOS,,2.0,19.9,39.8,3333979.81999998,Puffed Products,Lisset Limpio -020,RETAIL SEDANOS,1384345,Aug
2024-08-05,Sedanos Supermarkets #31,Invoice,008-03512,Rice Snack:Rice Snack Salami Flavored DOS HERMANOS,,1.0,19.9,19.9,3333999.71999998,Puffed Products,Lisset Limpio -020,RETAIL SEDANOS,1384346,Aug
2024-08-05,Sedanos Supermarkets #31,Invoice,008-03512,"Rice Snack:Rice Snack, Pizza DH",,1.0,19.9,19.9,3334019.61999998,Puffed Products,Lisset Limpio -020,RETAIL SEDANOS,1384347,Aug
2024-08-05,Sedanos Supermarkets #31,Invoice,008-03512,,Discount,,,-1.19,3334018.42999998,,Lisset Limpio -020,RETAIL SEDANOS,1384348,Aug
2024-08-05,JMN Dely Corp,Invoice,008-03513,Arroz a Granel:Largo Fino 50 LB -Bolsa Dos Hermanos.,,5.0,27.85,139.25,3334157.67999998,Bulk Rice,Keila Alfaro-Visvikis,CAFETERIA y RESTAURANTS,1384349,Aug
2024-08-05,JMN Dely Corp,Invoice,008-03513,Dry Beans:Dry Beans - Black Beans 50,Dry Black Beans 50 lb,1.0,43.5,43.5,3334201.17999998,Dry Beans,Keila Alfaro-Visvikis,CAFETERIA y RESTAURANTS,1384350,Aug
2024-08-05,JMN Dely Corp,Invoice,008-03513,Arroz a Granel:Parboiled 50 LB -Bolsa Dos Hermanos.,,3.0,28.25,84.75,3334285.92999998,Bulk Rice,Keila Alfaro-Visvikis,CAFETERIA y RESTAURANTS,1384351,Aug
2024-08-05,Bravo   Francisco Diaz,Invoice,008-03514,Liquids:AS Cooking Wine,4/1 Gl.,3.0,17.5,52.5,3334338.42999998,American Spice,Lisset Limpio -020,RETAIL  DSD,1384352,Aug
2024-08-05,Bravo   Francisco Diaz,Invoice,008-03514,Liquids:AS White Vinegar,4/1 Gl.,3.0,10.0,30.0,3334368.42999998,American Spice,Lisset Limpio -020,RETAIL  DSD,1384353,Aug
2024-08-05,Bravo   Francisco Diaz,Invoice,008-03514,Arroz a Granel:Largo Fino 50 LB -Bolsa Dos Hermanos.,,5.0,27.85,139.25,3334507.67999998,Bulk Rice,Lisset Limpio -020,RETAIL  DSD,1384354,Aug
2024-08-05,Sedanos Supermarkets #24,Invoice,008-03515,Arroz a Granel:Parboiled 50 LB -Bolsa Dos Hermanos.,,15.0,28.25,423.75,3334931.42999998,Bulk Rice,Keila Alfaro-Visvikis,RETAIL SEDANOS,1384355,Aug
2024-08-05,Sedanos Supermarkets #24,Invoice,008-03515,,Discount,,,-8.48,3334922.94999998,,Keila Alfaro-Visvikis,RETAIL SEDANOS,1384356,Aug
2024-08-05,El Palacio de los jugos /  Nanos Latin Foods,Credit Memo,008-03643,Varios:Promotional Allowance,,-1.0,27.75,-27.75,3334895.19999998,Bulk Rice,Lisset Limpio -020,Cafeteria,1384357,Aug
2024-08-05,"Soriano Brothers Diaz Food Service,Inc",Credit Memo,008-03644,Varios:Promotional Allowance,,-2.0,27.75,-55.5,3334839.69999998,Bulk Rice,Lisset Limpio -020,CAFETERIA y RESTAURANTS,1384358,Aug
2024-08-05,Sedanos Supermarkets #31,Credit Memo,008-03645,Varios:Promotional Allowance,,-1.0,19.9,-19.9,3334819.79999998,Puffed Products,Lisset Limpio -020,RETAIL SEDANOS,1384359,Aug
2024-08-06,Vitos Meat and Provisions,Invoice,008-03516,Arroz a Granel:Parboiled 50 LB -Bolsa Dos Hermanos.,,10.0,27.5,275.0,3335094.79999998,Bulk Rice,Keila Alfaro-Visvikis,WHOLESALER,1384360,Aug
2024-08-07,Sedanos Supermarkets #42,Invoice,008-03517,Arroz Envasado:Parboiled 5KG Dos Hermanos.,6 / 11lbs,5.0,40.5,202.5,3335297.29999998,Branded Rice,Lisset Limpio -020,RETAIL SEDANOS,1384361,Aug
2024-08-07,Sedanos Supermarkets #42,Invoice,008-03517,Arroz Envasado:Parboiled 5KG Dos Hermanos.,6 / 11lbs,5.0,40.5,202.5,3335499.79999998,Branded Rice,Lisset Limpio -020,RETAIL SEDANOS,1384362,Aug
2024-08-07,Sedanos Supermarkets #42,Invoice,008-03517,,Discount,,,-4.05,3335495.74999998,,Lisset Limpio -020,RETAIL SEDANOS,1384363,Aug
2024-08-07,Sedanos Supermarkets  #4,Invoice,008-03518,Rice Snack:Rice Snack Ham Flavored DOS HERMANOS,,3.0,19.9,59.7,3335555.44999998,Puffed Products,Lisset Limpio -020,RETAIL SEDANOS,1384364,Aug
2024-08-07,Sedanos Supermarkets  #4,Invoice,008-03518,Rice Snack:Rice Snack Salami Flavored DOS HERMANOS,,1.0,19.9,19.9,3335575.34999998,Puffed Products,Lisset Limpio -020,RETAIL SEDANOS,1384365,Aug
2024-08-07,Sedanos Supermarkets  #4,Invoice,008-03518,,Discount,,,-1.19,3335574.15999998,,Lisset Limpio -020,RETAIL SEDANOS,1384366,Aug
2024-08-07,Sedanos Supermarkets #43,Invoice,008-03519,Arroz a Granel:Parboiled 50 LB -Bolsa Dos Hermanos.,,5.0,28.25,141.25,3335715.40999998,Bulk Rice,Lisset Limpio -020,RETAIL SEDANOS,1384367,Aug
2024-08-07,Sedanos Supermarkets #43,Invoice,008-03519,,Discount,,,-2.83,3335712.57999998,,Lisset Limpio -020,RETAIL SEDANOS,1384368,Aug
2024-08-07,Sedanos Supermarkets #22,Invoice,008-03520,Arroz a Granel:Parboiled 50 LB -Bolsa Dos Hermanos.,,4.0,28.25,113.0,3335825.57999998,Bulk Rice,Lisset Limpio -020,RETAIL SEDANOS,1384369,Aug
2024-08-07,Sedanos Supermarkets #22,Invoice,008-03520,,Discount,,,-2.26,3335823.31999998,,Lisset Limpio -020,RETAIL SEDANOS,1384370,Aug
2024-08-07,Sedanos Supermarkets #26,Invoice,008-03521,Arroz a Granel:Parboiled 50 LB -Bolsa Dos Hermanos.,,5.0,28.25,141.25,3335964.56999998,Bulk Rice,Lisset Limpio -020,RETAIL SEDANOS,1384371,Aug
2024-08-07,Sedanos Supermarkets #26,Invoice,008-03521,,Discount,,,-2.83,3335961.73999998,,Lisset Limpio -020,RETAIL SEDANOS,1384372,Aug
2024-08-07,Ideal Food Basket - Dania Beach,Invoice,008-03522,Arroz Envasado:Largo Fino 1kg (Long grain rice) Dos Hermanos,,2.0,17.0,34.0,3335995.73999998,Branded Rice,Keila Alfaro-Visvikis,RETAIL  DSD,1384373,Aug
2024-08-07,Ideal Food Basket - Dania Beach,Invoice,008-03522,Arroz Envasado:Parboiled 1kg Bolsa Dos Hermanos.,.,3.0,19.9,59.7,3336055.43999998,Branded Rice,Keila Alfaro-Visvikis,RETAIL  DSD,1384374,Aug
2024-08-07,Ideal Food Basket - Dania Beach,Invoice,008-03522,Arroz Envasado:Parboiled 5KG Dos Hermanos.,6 / 11lbs,10.0,46.5,465.0,3336520.43999998,Branded Rice,Keila Alfaro-Visvikis,RETAIL  DSD,1384375,Aug
2024-08-07,Ideal Food Basket - Dania Beach,Invoice,008-03522,Rice Snack:Rice Snack Ham Flavored DOS HERMANOS,,1.0,19.9,19.9,3336540.33999998,Puffed Products,Keila Alfaro-Visvikis,RETAIL  DSD,1384376,Aug
2024-08-07,Ideal Food Basket - Dania Beach,Invoice,008-03522,Rice Snack:Rice Snack Salami Flavored DOS HERMANOS,,1.0,19.9,19.9,3336560.23999998,Puffed Products,Keila Alfaro-Visvikis,RETAIL  DSD,1384377,Aug
2024-08-07,Ideal Food Basket - Dania Beach,Invoice,008-03522,"Rice Snack:Rice Snack, Pizza DH",,1.0,19.9,19.9,3336580.13999998,Puffed Products,Keila Alfaro-Visvikis,RETAIL  DSD,1384378,Aug
2024-08-07,Ideal Food Basket - Dania Beach,Invoice,008-03522,Arroz Envasado:Sushi Rice Dos Hermanos.,.,1.0,20.0,20.0,3336600.13999998,Branded Rice,Keila Alfaro-Visvikis,RETAIL  DSD,1384379,Aug
2024-08-07,Ideal Food Basket - Dania Beach,Invoice,008-03522,Arroz Envasado:Organico LF Dos Hermanos,.,1.0,24.0,24.0,3336624.13999998,Branded Rice,Keila Alfaro-Visvikis,RETAIL  DSD,1384380,Aug
2024-08-07,Ideal Food Basket - Dania Beach,Invoice,008-03522,Arroz Envasado:Aromatic Type Rice Dos Hermanos.,.,1.0,20.0,20.0,3336644.13999998,Branded Rice,Keila Alfaro-Visvikis,RETAIL  DSD,1384381,Aug
2024-08-07,Ideal Food Basket - Dania Beach,Invoice,008-03522,Tostadas de Arroz:Tostadas de Arroz Saladas 120gr,iC/ii/iD/i16,1.0,19.9,19.9,3336664.03999998,Puffed Products,Keila Alfaro-Visvikis,RETAIL  DSD,1384382,Aug
2024-08-07,Ideal Food Basket - Dania Beach,Invoice,008-03522,Arroz Envasado:Largo Fino 1kg (Long grain rice) Dos Hermanos,,1.0,17.0,17.0,3336681.03999998,Branded Rice,Keila Alfaro-Visvikis,RETAIL  DSD,1384383,Aug
2024-08-07,Ideal Food Basket - Dania Beach,Invoice,008-03522,Arroz Envasado:Parboiled 5KG Dos Hermanos.,6 / 11lbs,1.0,46.5,46.5,3336727.53999998,Branded Rice,Keila Alfaro-Visvikis,RETAIL  DSD,1384384,Aug
2024-08-07,Sedanos Supermarkets #42,Credit Memo,008-03646,Varios:Promotional Allowance,5kg parbo,-5.0,40.5,-202.5,3336525.03999998,Bulk Rice,Lisset Limpio -020,RETAIL SEDANOS,1384385,Aug
2024-08-07,Sedanos Supermarkets  #4,Credit Memo,008-03647,Varios:Promotional Allowance,salami,-1.0,19.9,-19.9,3336505.13999998,Puffed Products,Lisset Limpio -020,RETAIL SEDANOS,1384386,Aug
2024-08-07,Ideal Food Basket - Dania Beach,Credit Memo,008-03648,Varios:Promotional Allowance,aromatic,-1.0,20.0,-20.0,3336485.13999998,Branded Rice,Keila Alfaro-Visvikis,RETAIL  DSD,1384387,Aug
2024-08-07,Ideal Food Basket - Dania Beach,Credit Memo,008-03648,Varios:Promotional Allowance,tostadas salada,-1.0,19.9,-19.9,3336465.23999998,Puffed Products,Keila Alfaro-Visvikis,RETAIL  DSD,1384388,Aug
2024-08-07,Ideal Food Basket - Dania Beach,Credit Memo,008-03648,Varios:Promotional Allowance,LF 1kg,-1.0,17.0,-17.0,3336448.23999998,Branded Rice,Keila Alfaro-Visvikis,RETAIL  DSD,1384389,Aug
2024-08-07,Ideal Food Basket - Dania Beach,Credit Memo,008-03648,Varios:Promotional Allowance,parbo 5kg,-1.0,46.5,-46.5,3336401.73999998,Branded Rice,Keila Alfaro-Visvikis,RETAIL  DSD,1384390,Aug
2024-08-08,Rey Chavez Distributor #2,Invoice,008-03523,Arroz a Granel:Parboiled 50 LB -Bolsa Dos Hermanos.,,25.0,27.75,693.75,3337095.48999998,Bulk Rice,Lisset Limpio -020,WHOLESALER,1384391,Aug
2024-08-08,El Palacio de Los Jugos / Casa mía Food Restaurant inc,Invoice,008-03524,Dry Beans:Dry Beans - Black Beans 50,Dry Black Beans 50 lb,1.0,45.7,45.7,3337141.18999998,Dry Beans,Lisset Limpio -020,Cafeteria,1384392,Aug
2024-08-08,El Palacio de Los Jugos / Casa mía Food Restaurant inc,Invoice,008-03524,Arroz a Granel:Parboiled 50 LB -Bolsa Dos Hermanos.,,11.0,27.75,305.25,3337446.43999998,Bulk Rice,Lisset Limpio -020,Cafeteria,1384393,Aug
2024-08-08,El Palacio de Los Jugos / Casa mía Food Restaurant inc,Invoice,008-03524,Arroz a Granel:Parboiled 50 LB -Bolsa Dos Hermanos.,,1.0,27.75,27.75,3337474.18999998,Bulk Rice,Lisset Limpio -020,Cafeteria,1384394,Aug
2024-08-08,Aries Supermarket & Cafeteria,Invoice,008-03525,Arroz a Granel:Parboiled 50 LB -Bolsa Dos Hermanos.,,10.0,28.25,282.5,3337756.68999998,Bulk Rice,Armando Carpio - 017,CAFETERIA y RESTAURANTS,1384395,Aug
2024-08-08,Mei Chang,Invoice,008-03526,Arroz a Granel:Largo Fino 50 LB -Bolsa Dos Hermanos.,,2.0,27.85,55.7,3337812.38999998,Bulk Rice,Lisset Limpio -020,CAFETERIA y RESTAURANTS,1384396,Aug
2024-08-08,Mei Chang,Invoice,008-03526,Arroz a Granel:Parboiled 50 LB -Bolsa Dos Hermanos.,,5.0,28.25,141.25,3337953.63999998,Bulk Rice,Lisset Limpio -020,CAFETERIA y RESTAURANTS,1384397,Aug
2024-08-08,El Palacio de los jugos /  Nanos Latin Foods,Invoice,008-03527,Arroz a Granel:Parboiled 50 LB -Bolsa Dos Hermanos.,,11.0,27.75,305.25,3338258.88999998,Bulk Rice,Lisset Limpio -020,Cafeteria,1384398,Aug
2024-08-08,El Palacio de los jugos /  Nanos Latin Foods,Invoice,008-03527,Dry Beans:Dry Beans - Black Beans 50,Dry Black Beans 50 lb,1.0,45.7,45.7,3338304.58999998,Dry Beans,Lisset Limpio -020,Cafeteria,1384399,Aug
2024-08-08,El Palacio de los jugos /  Nanos Latin Foods,Invoice,008-03527,Arroz a Granel:Parboiled 50 LB -Bolsa Dos Hermanos.,,1.0,27.75,27.75,3338332.33999998,Bulk Rice,Lisset Limpio -020,Cafeteria,1384400,Aug
2024-08-08,El Palacio de los jugos / Delicias Criollas (DIAGO FOOD_MILLER),Invoice,008-03528,Arroz a Granel:Parboiled 50 LB -Bolsa Dos Hermanos.,,11.0,27.75,305.25,3338637.58999998,Bulk Rice,Lisset Limpio -020,Cafeteria,1384401,Aug
2024-08-08,El Palacio de los jugos / Delicias Criollas (DIAGO FOOD_MILLER),Invoice,008-03528,Liquids:AS Cooking Wine,4/1 Gl.,1.0,18.5,18.5,3338656.08999998,American Spice,Lisset Limpio -020,Cafeteria,1384402,Aug
2024-08-08,El Palacio de los jugos / Delicias Criollas (DIAGO FOOD_MILLER),Invoice,008-03528,Arroz a Granel:Parboiled 50 LB -Bolsa Dos Hermanos.,,1.0,27.75,27.75,3338683.83999998,Bulk Rice,Lisset Limpio -020,Cafeteria,1384403,Aug
2024-08-08,El Palacio de los jugos / Lita Foods Inc.,Invoice,008-03529,Dry Beans:Dry Beans - Black Beans 50,Dry Black Beans 50 lb,1.0,45.7,45.7,3338729.53999998,Dry Beans,Lisset Limpio -020,Cafeteria,1384404,Aug
2024-08-08,El Palacio de los jugos / Lita Foods Inc.,Invoice,008-03529,Arroz a Granel:Parboiled 50 LB -Bolsa Dos Hermanos.,,11.0,27.75,305.25,3339034.78999998,Bulk Rice,Lisset Limpio -020,Cafeteria,1384405,Aug
2024-08-08,El Palacio de los jugos / Lita Foods Inc.,Invoice,008-03529,Arroz a Granel:Parboiled 50 LB -Bolsa Dos Hermanos.,,1.0,27.75,27.75,3339062.53999998,Bulk Rice,Lisset Limpio -020,Cafeteria,1384406,Aug
2024-08-08,Sedanos Supermarkets #18,Invoice,008-03530,Arroz a Granel:Parboiled 50 LB -Bolsa Dos Hermanos.,,10.0,28.25,282.5,3339345.03999998,Bulk Rice,Lisset Limpio -020,RETAIL SEDANOS,1384407,Aug
2024-08-08,Sedanos Supermarkets #18,Invoice,008-03530,,Discount,,,-5.65,3339339.38999998,,Lisset Limpio -020,RETAIL SEDANOS,1384408,Aug
2024-08-08,Sedanos Supermarkets #32,Invoice,008-03531,Rice Snack:Rice Snack Ham Flavored DOS HERMANOS,,2.0,19.9,39.8,3339379.18999998,Puffed Products,Lisset Limpio -020,RETAIL SEDANOS,1384409,Aug
2024-08-08,Sedanos Supermarkets #32,Invoice,008-03531,Arroz Envasado:Parboiled 5KG Dos Hermanos.,6 / 11lbs,3.0,40.5,121.5,3339500.68999998,Branded Rice,Lisset Limpio -020,RETAIL SEDANOS,1384410,Aug
2024-08-08,Sedanos Supermarkets #32,Invoice,008-03531,Arroz Envasado:Parboiled 5KG Dos Hermanos.,6 / 11lbs,3.0,40.5,121.5,3339622.18999998,Branded Rice,Lisset Limpio -020,RETAIL SEDANOS,1384411,Aug
2024-08-08,Sedanos Supermarkets #32,Invoice,008-03531,,Discount,,,-2.93,3339619.25999998,,Lisset Limpio -020,RETAIL SEDANOS,1384412,Aug
2024-08-08,Sedanos Supermarkets #32,Credit Memo,008-03532,Varios:Producto vencido/deteriorado (no impacta en inventario),"10 Unidades Pizza Snack, fuere de fecha.",-1.0,14.92,-14.92,3339604.33999998,Puffed Products,Lisset Limpio -020,RETAIL SEDANOS,1384413,Aug
2024-08-08,Sedanos Supermarkets #8,Invoice,008-03533,Arroz Envasado:Parboiled 5KG Dos Hermanos.,6 / 11lbs,5.0,40.5,202.5,3339806.83999998,Branded Rice,Lisset Limpio -020,RETAIL SEDANOS,1384414,Aug
2024-08-08,Sedanos Supermarkets #8,Invoice,008-03533,Arroz Envasado:Parboiled 5KG Dos Hermanos.,6 / 11lbs,5.0,40.5,202.5,3340009.33999998,Branded Rice,Lisset Limpio -020,RETAIL SEDANOS,1384415,Aug
2024-08-08,Sedanos Supermarkets #8,Invoice,008-03533,,Discount,,,-4.05,3340005.28999998,,Lisset Limpio -020,RETAIL SEDANOS,1384416,Aug
2024-08-08,Los paraditos chinesse,Invoice,008-03534,Arroz a Granel:Parboiled 50 LB -Bolsa Dos Hermanos.,,10.0,28.25,282.5,3340287.78999998,Bulk Rice,Lisset Limpio -020,CAFETERIA y RESTAURANTS,1384417,Aug
2024-08-08,El Palacio de los jugos /  Nanos Latin Foods,Credit Memo,008-03649,Varios:Promotional Allowance,parbo 50lb,-1.0,27.75,-27.75,3340260.03999998,Bulk Rice,Lisset Limpio -020,Cafeteria,1384418,Aug
2024-08-08,El Palacio de los jugos / Delicias Criollas (DIAGO FOOD_MILLER),Credit Memo,008-03650,Varios:Promotional Allowance,50lb parbo,-1.0,27.75,-27.75,3340232.28999998,Bulk Rice,Lisset Limpio -020,Cafeteria,1384419,Aug
2024-08-08,El Palacio de los jugos / Lita Foods Inc.,Credit Memo,008-03651,Varios:Promotional Allowance,,-1.0,27.75,-27.75,3340204.53999998,Bulk Rice,Lisset Limpio -020,Cafeteria,1384420,Aug
2024-08-08,Sedanos Supermarkets #8,Credit Memo,008-03652,Varios:Promotional Allowance,,-1.0,27.75,-27.75,3340176.78999998,Bulk Rice,Lisset Limpio -020,RETAIL SEDANOS,1384421,Aug
2024-08-08,Sedanos Supermarkets #32,Credit Memo,008-03653,Varios:Promotional Allowance,,-3.0,40.5,-121.5,3340055.28999998,Branded Rice,Lisset Limpio -020,RETAIL SEDANOS,1384422,Aug
2024-08-08,El Palacio de Los Jugos / Casa mía Food Restaurant inc,Credit Memo,008-03654,Varios:Promotional Allowance,,-1.0,27.75,-27.75,3340027.53999998,Bulk Rice,Lisset Limpio -020,Cafeteria,1384423,Aug
2024-08-09,Sedanos Supermarkets #8,Credit Memo,008-03967,Varios:Promotional Allowance,6 / 11lbs,-5.0,40.5,-202.5,3339825.03999998,Branded Rice,Keila Alfaro-Visvikis,RETAIL SEDANOS,1384424,Aug
2024-08-12,Bravo   Francisco Diaz,Invoice,008-03535,Arroz a Granel:Largo Fino 50 LB -Bolsa Dos Hermanos.,,4.0,27.85,111.4,3339936.43999998,Bulk Rice,Lisset Limpio -020,RETAIL  DSD,1384425,Aug
2024-08-12,El Gallego Supermarket,Invoice,008-03536,Dry Beans:Dry Beans - Black Beans 50,Dry Black Beans 50 lb,2.0,45.7,91.4,3340027.83999998,Dry Beans,Lisset Limpio -020,RETAIL  DSD,1384426,Aug
2024-08-12,El Gallego Supermarket,Invoice,008-03536,Arroz a Granel:Parboiled 50 LB -Bolsa Dos Hermanos.,,5.0,28.25,141.25,3340169.08999998,Bulk Rice,Lisset Limpio -020,RETAIL  DSD,1384427,Aug
2024-08-12,El Palacio de Los Jugos / Casa mía Food Restaurant inc,Invoice,008-03537,Dry Beans:Dry Beans - Black Beans 50,Dry Black Beans 50 lb,1.0,45.7,45.7,3340214.78999998,Dry Beans,Lisset Limpio -020,Cafeteria,1384428,Aug
2024-08-12,El Palacio de Los Jugos / Casa mía Food Restaurant inc,Invoice,008-03537,Arroz a Granel:Parboiled 50 LB -Bolsa Dos Hermanos.,,11.0,27.75,305.25,3340520.03999998,Bulk Rice,Lisset Limpio -020,Cafeteria,1384429,Aug
2024-08-12,El Palacio de Los Jugos / Casa mía Food Restaurant inc,Invoice,008-03537,Arroz a Granel:Parboiled 50 LB -Bolsa Dos Hermanos.,,1.0,27.75,27.75,3340547.78999998,Bulk Rice,Lisset Limpio -020,Cafeteria,1384430,Aug
2024-08-12,JMN Dely Corp,Invoice,008-03538,Dry Beans:Dry Beans - Black Beans 50,Dry Black Beans 50 lb,2.0,46.5,93.0,3340640.78999998,Dry Beans,Keila Alfaro-Visvikis,CAFETERIA y RESTAURANTS,1384431,Aug
2024-08-12,JMN Dely Corp,Invoice,008-03538,Arroz a Granel:Largo Fino 50 LB -Bolsa Dos Hermanos.,,5.0,27.85,139.25,3340780.03999998,Bulk Rice,Keila Alfaro-Visvikis,CAFETERIA y RESTAURANTS,1384432,Aug
2024-08-12,JMN Dely Corp,Invoice,008-03538,Arroz a Granel:Parboiled 50 LB -Bolsa Dos Hermanos.,,3.0,28.25,84.75,3340864.78999998,Bulk Rice,Keila Alfaro-Visvikis,CAFETERIA y RESTAURANTS,1384433,Aug
2024-08-12,El Palacio de los jugos / Lita Foods Inc.,Invoice,008-03539,Dry Beans:Dry Beans - Black Beans 50,Dry Black Beans 50 lb,1.0,45.7,45.7,3340910.48999998,Dry Beans,Lisset Limpio -020,Cafeteria,1384434,Aug
2024-08-12,El Palacio de los jugos / Lita Foods Inc.,Invoice,008-03539,Arroz a Granel:Parboiled 50 LB -Bolsa Dos Hermanos.,,11.0,27.75,305.25,3341215.73999998,Bulk Rice,Lisset Limpio -020,Cafeteria,1384435,Aug
2024-08-12,El Palacio de los jugos / Lita Foods Inc.,Invoice,008-03539,Arroz a Granel:Parboiled 50 LB -Bolsa Dos Hermanos.,,1.0,27.75,27.75,3341243.48999998,Bulk Rice,Lisset Limpio -020,Cafeteria,1384436,Aug
2024-08-12,El Palacio de los jugos /  Mires Restaurants,Invoice,008-03540,Arroz a Granel:Parboiled 50 LB -Bolsa Dos Hermanos.,,11.0,27.75,305.25,3341548.73999998,Bulk Rice,Lisset Limpio -020,Cafeteria,1384437,Aug
2024-08-12,El Palacio de los jugos /  Mires Restaurants,Invoice,008-03540,Liquids:AS Marinating Sauce (Mojo),,1.0,19.5,19.5,3341568.23999998,American Spice,Lisset Limpio -020,Cafeteria,1384438,Aug
2024-08-12,El Palacio de los jugos /  Mires Restaurants,Invoice,008-03540,Arroz a Granel:Parboiled 50 LB -Bolsa Dos Hermanos.,,1.0,27.75,27.75,3341595.98999998,Bulk Rice,Lisset Limpio -020,Cafeteria,1384439,Aug
2024-08-12,El Palacio de los jugos / Delicias Criollas (DIAGO FOOD_MILLER),Invoice,008-03541,Liquids:AS Marinating Sauce (Mojo),,1.0,19.5,19.5,3341615.48999998,American Spice,Lisset Limpio -020,Cafeteria,1384440,Aug
2024-08-12,El Palacio de los jugos / Delicias Criollas (DIAGO FOOD_MILLER),Invoice,008-03541,Arroz a Granel:Parboiled 50 LB -Bolsa Dos Hermanos.,,11.0,27.75,305.25,3341920.73999998,Bulk Rice,Lisset Limpio -020,Cafeteria,1384441,Aug
2024-08-12,El Palacio de los jugos / Delicias Criollas (DIAGO FOOD_MILLER),Invoice,008-03541,Arroz a Granel:Parboiled 50 LB -Bolsa Dos Hermanos.,,1.0,27.75,27.75,3341948.48999998,Bulk Rice,Lisset Limpio -020,Cafeteria,1384442,Aug
2024-08-12,Fritanga Momotombo,Invoice,008-03542,Arroz a Granel:Largo Fino 50 LB -Bolsa Dos Hermanos.,,5.0,27.85,139.25,3342087.73999998,Bulk Rice,Lisset Limpio -020,CAFETERIA y RESTAURANTS,1384443,Aug
2024-08-12,"Meat Club Market, LLC.",Invoice,008-03543,Arroz Envasado:Largo Fino 1kg (Long grain rice) Dos Hermanos,,3.0,16.5,49.5,3342137.23999998,Branded Rice,Lisset Limpio -020,RETAIL  DSD,1384444,Aug
2024-08-12,"Meat Club Market, LLC.",Invoice,008-03543,Arroz Envasado:Sushi Rice Dos Hermanos.,.,3.0,25.5,76.5,3342213.73999998,Branded Rice,Lisset Limpio -020,RETAIL  DSD,1384445,Aug
2024-08-12,"Meat Club Market, LLC.",Invoice,008-03543,Arroz Envasado:Sushi Rice Dos Hermanos 5kg.,,3.0,60.0,180.0,3342393.73999998,Branded Rice,Lisset Limpio -020,RETAIL  DSD,1384446,Aug
2024-08-12,Sedanos Supermarkets  #37,Invoice,008-03544,Arroz Envasado:Parboiled 5KG Dos Hermanos.,6 / 11lbs,10.0,40.5,405.0,3342798.73999998,Branded Rice,Lisset Limpio -020,RETAIL SEDANOS,1384447,Aug
2024-08-12,Sedanos Supermarkets  #37,Invoice,008-03544,Arroz Envasado:Parboiled 5KG Dos Hermanos.,6 / 11lbs,10.0,40.5,405.0,3343203.73999998,Branded Rice,Lisset Limpio -020,RETAIL SEDANOS,1384448,Aug
2024-08-12,Sedanos Supermarkets  #37,Invoice,008-03544,,Discount,,,-8.1,3343195.63999998,,Lisset Limpio -020,RETAIL SEDANOS,1384449,Aug
2024-08-12,Sedanos Supermarkets #14,Invoice,008-03545,Arroz Envasado:Parboiled 5KG Dos Hermanos.,6 / 11lbs,5.0,40.5,202.5,3343398.13999998,Branded Rice,Lisset Limpio -020,RETAIL SEDANOS,1384450,Aug
2024-08-12,Sedanos Supermarkets #14,Invoice,008-03545,Arroz Envasado:Parboiled 5KG Dos Hermanos.,6 / 11lbs,5.0,40.5,202.5,3343600.63999998,Branded Rice,Lisset Limpio -020,RETAIL SEDANOS,1384451,Aug
2024-08-12,Sedanos Supermarkets #14,Invoice,008-03545,,Discount,,,-4.05,3343596.58999998,,Lisset Limpio -020,RETAIL SEDANOS,1384452,Aug
2024-08-12,El Palacio de los jugos /  Mires Restaurants,Credit Memo,008-03655,Varios:Promotional Allowance,,-1.0,27.75,-27.75,3343568.83999998,Bulk Rice,Lisset Limpio -020,Cafeteria,1384453,Aug
2024-08-12,El Palacio de los jugos / Delicias Criollas (DIAGO FOOD_MILLER),Credit Memo,008-03656,Varios:Promotional Allowance,,-1.0,27.75,-27.75,3343541.08999998,Bulk Rice,Lisset Limpio -020,Cafeteria,1384454,Aug
2024-08-12,Sedanos Supermarkets  #37,Credit Memo,008-03657,Varios:Promotional Allowance,5kg,-10.0,40.5,-405.0,3343136.08999998,Branded Rice,Lisset Limpio -020,RETAIL SEDANOS,1384455,Aug
2024-08-12,Sedanos Supermarkets #14,Credit Memo,008-03658,Varios:Promotional Allowance,,-5.0,40.5,-202.5,3342933.58999998,Branded Rice,Lisset Limpio -020,RETAIL SEDANOS,1384456,Aug
2024-08-12,El Palacio de Los Jugos / Casa mía Food Restaurant inc,Credit Memo,008-03659,Varios:Promotional Allowance,50  lb parbo,-1.0,27.75,-27.75,3342905.83999998,,Lisset Limpio -020,Cafeteria,1384457,Aug
2024-08-12,El Palacio de Los Jugos / Casa mía Food Restaurant inc,Credit Memo,008-03660,Varios:Promotional Allowance,,-1.0,27.75,-27.75,3342878.08999998,Bulk Rice,Lisset Limpio -020,Cafeteria,1384458,Aug
2024-08-12,El Palacio de los jugos / Lita Foods Inc.,Credit Memo,008-03661,Varios:Promotional Allowance,,-1.0,27.75,-27.75,3342850.33999998,Bulk Rice,Lisset Limpio -020,Cafeteria,1384459,Aug
2024-08-14,Albert Deli #2,Invoice,008-03546,,,,,0.0,3342850.33999998,,Keila Alfaro-Visvikis,CAFETERIA y RESTAURANTS,1384460,Aug
2024-08-14,Albert Deli #2,Invoice,008-03546,Dry Beans:Dry Beans - Black Beans 50,Dry Black Beans 50 lb,1.0,45.5,45.5,3342895.83999998,Dry Beans,Keila Alfaro-Visvikis,CAFETERIA y RESTAURANTS,1384461,Aug
2024-08-14,Albert Deli #2,Invoice,008-03546,Arroz a Granel:Largo Fino 50 LB -Bolsa Dos Hermanos.,,5.0,27.85,139.25,3343035.08999998,Bulk Rice,Keila Alfaro-Visvikis,CAFETERIA y RESTAURANTS,1384462,Aug
2024-08-14,Albert Deli #2,Invoice,008-03546,Arroz a Granel:Parboiled 50 LB -Bolsa Dos Hermanos.,,5.0,28.25,141.25,3343176.33999998,Bulk Rice,Keila Alfaro-Visvikis,CAFETERIA y RESTAURANTS,1384463,Aug
2024-08-14,Key Foods  / Ivan,Invoice,008-03547,Arroz Envasado:Parboiled 1kg Bolsa Dos Hermanos.,.,2.0,19.9,39.8,3343216.13999998,Branded Rice,Keila Alfaro-Visvikis,RETAIL  DSD,1384464,Aug
2024-08-14,Key Foods  / Ivan,Invoice,008-03547,Arroz Envasado:Largo Fino 1kg (Long grain rice) Dos Hermanos,,3.0,17.0,51.0,3343267.13999998,Branded Rice,Keila Alfaro-Visvikis,RETAIL  DSD,1384465,Aug
2024-08-14,Key Foods  / Ivan,Invoice,008-03547,Arroz Envasado:Parboiled 5KG Dos Hermanos.,6 / 11lbs,15.0,46.5,697.5,3343964.63999998,Branded Rice,Keila Alfaro-Visvikis,RETAIL  DSD,1384466,Aug
2024-08-14,Key Foods  / Ivan,Invoice,008-03547,Arroz Envasado:Parboiled 5KG Dos Hermanos.,6 / 11lbs,2.0,46.5,93.0,3344057.63999998,Branded Rice,Keila Alfaro-Visvikis,RETAIL  DSD,1384467,Aug
2024-08-14,Key Foods  / Ivan,Invoice,008-03547,Arroz Envasado:Largo Fino 1kg (Long grain rice) Dos Hermanos,,1.0,17.0,17.0,3344074.63999998,Branded Rice,Keila Alfaro-Visvikis,RETAIL  DSD,1384468,Aug
2024-08-14,BRAVO - Flamingo #3,Invoice,008-03548,Arroz Envasado:Parboiled 1kg Bolsa Dos Hermanos.,.,3.0,19.9,59.7,3344134.33999998,Branded Rice,Keila Alfaro-Visvikis,RETAIL  DSD,1384469,Aug
2024-08-14,BRAVO - Flamingo #3,Invoice,008-03548,Arroz Envasado:Largo Fino 1kg (Long grain rice) Dos Hermanos,,2.0,17.0,34.0,3344168.33999998,Branded Rice,Keila Alfaro-Visvikis,RETAIL  DSD,1384470,Aug
2024-08-14,BRAVO - Flamingo #3,Invoice,008-03548,Arroz Envasado:Parboiled 5KG Dos Hermanos.,6 / 11lbs,10.0,46.5,465.0,3344633.33999998,Branded Rice,Keila Alfaro-Visvikis,RETAIL  DSD,1384471,Aug
2024-08-14,BRAVO - Flamingo #3,Invoice,008-03548,Arroz Envasado:Parboiled 5KG Dos Hermanos.,6 / 11lbs,2.0,46.5,93.0,3344726.33999998,Branded Rice,Keila Alfaro-Visvikis,RETAIL  DSD,1384472,Aug
2024-08-14,BRAVO - Flamingo #3,Invoice,008-03548,Arroz Envasado:Largo Fino 1kg (Long grain rice) Dos Hermanos,,1.0,17.0,17.0,3344743.33999998,Branded Rice,Keila Alfaro-Visvikis,RETAIL  DSD,1384473,Aug
2024-08-14,Ideal Food Basket Davie Cafeteria,Invoice,008-03549,Arroz a Granel:Largo Fino 50 LB -Bolsa Dos Hermanos.,,12.0,27.85,334.2,3345077.53999998,Bulk Rice,Keila Alfaro-Visvikis,CAFETERIA y RESTAURANTS,1384474,Aug
2024-08-14,Sedanos Supermarkets #27,Invoice,008-03550,Arroz a Granel:Parboiled 50 LB -Bolsa Dos Hermanos.,,6.0,28.25,169.5,3345247.03999998,Bulk Rice,Keila Alfaro-Visvikis,RETAIL SEDANOS,1384475,Aug
2024-08-14,Sedanos Supermarkets #27,Invoice,008-03550,,,,,0.0,3345247.03999998,,Keila Alfaro-Visvikis,RETAIL SEDANOS,1384476,Aug
2024-08-14,Sedanos Supermarkets #27,Invoice,008-03550,,Discount,,,-3.39,3345243.64999998,,Keila Alfaro-Visvikis,RETAIL SEDANOS,1384477,Aug
2024-08-14,Food Fair Plantation Corp,Invoice,008-03551,Arroz a Granel:Parboiled 50 LB -Bolsa Dos Hermanos.,,55.0,27.75,1526.25,3346769.89999998,Bulk Rice,Keila Alfaro-Visvikis,RETAIL  DSD,1384478,Aug
2024-08-14,Food Fair Plantation Corp,Invoice,008-03551,Arroz Envasado:Largo Fino 1kg (Long grain rice) Dos Hermanos,,5.0,17.0,85.0,3346854.89999998,Branded Rice,Keila Alfaro-Visvikis,RETAIL  DSD,1384479,Aug
2024-08-14,Food Fair Plantation Corp,Invoice,008-03551,Arroz Envasado:Parboiled 1kg Bolsa Dos Hermanos.,.,3.0,19.9,59.7,3346914.59999998,Branded Rice,Keila Alfaro-Visvikis,RETAIL  DSD,1384480,Aug
2024-08-14,Food Fair Plantation Corp,Invoice,008-03551,Arroz Envasado:Largo Fino 1kg (Long grain rice) Dos Hermanos,,1.0,17.0,17.0,3346931.59999998,Branded Rice,Keila Alfaro-Visvikis,RETAIL  DSD,1384481,Aug
2024-08-14,Food Fair Plantation Corp,Invoice,008-03551,Arroz Envasado:Parboiled 1kg Bolsa Dos Hermanos.,.,1.0,19.9,19.9,3346951.49999998,Branded Rice,Keila Alfaro-Visvikis,RETAIL  DSD,1384482,Aug
2024-08-14,Sedanos Supermarkets #27,Invoice,008-03552,Arroz Envasado:Parboiled 5KG Dos Hermanos.,6 / 11lbs,3.0,40.5,121.5,3347072.99999998,Branded Rice,Keila Alfaro-Visvikis,RETAIL SEDANOS,1384483,Aug
2024-08-14,Sedanos Supermarkets #27,Invoice,008-03552,Arroz Envasado:Parboiled 5KG Dos Hermanos.,6 / 11lbs,3.0,40.5,121.5,3347194.49999998,Branded Rice,Keila Alfaro-Visvikis,RETAIL SEDANOS,1384484,Aug
2024-08-14,Sedanos Supermarkets #27,Invoice,008-03552,,Discount,,,-2.43,3347192.06999998,,Keila Alfaro-Visvikis,RETAIL SEDANOS,1384485,Aug
2024-08-14,Price Choice Food Market# 9,Invoice,008-03553,Arroz a Granel:Parboiled 50 LB -Bolsa Dos Hermanos.,,15.0,28.25,423.75,3347615.81999998,Bulk Rice,Keila Alfaro-Visvikis,RETAIL  DSD,1384486,Aug
2024-08-14,Price Choice Food Market# 9,Invoice,008-03553,Arroz Envasado:Parboiled 5KG Dos Hermanos.,6 / 11lbs,15.0,46.5,697.5,3348313.31999998,Branded Rice,Keila Alfaro-Visvikis,RETAIL  DSD,1384487,Aug
2024-08-14,Price Choice Food Market# 9,Invoice,008-03553,Arroz Envasado:Parboiled 5KG Dos Hermanos.,6 / 11lbs,2.0,46.5,93.0,3348406.31999998,Branded Rice,Keila Alfaro-Visvikis,RETAIL  DSD,1384488,Aug
2024-08-14,Key Food Kimberly Blvd.,Invoice,008-03554,Arroz a Granel:Parboiled 50 LB -Bolsa Dos Hermanos.,,7.0,28.25,197.75,3348604.06999998,Bulk Rice,Keila Alfaro-Visvikis,RETAIL  DSD,1384489,Aug
2024-08-14,Price Choice Food Market# 9,Credit Memo,008-03555,Arroz a Granel:Parboiled 50 LB -Bolsa Dos Hermanos.,,-2.0,28.25,-56.5,3348547.56999998,Bulk Rice,Keila Alfaro-Visvikis,RETAIL  DSD,1384490,Aug
2024-08-14,Key Food Kimberly Blvd.,Credit Memo,008-03556,Arroz a Granel:Parboiled 50 LB -Bolsa Dos Hermanos.,Cambio,-7.0,28.25,-197.75,3348349.81999998,Bulk Rice,Keila Alfaro-Visvikis,RETAIL  DSD,1384491,Aug
2024-08-14,Sedanos Supermarkets #40,Invoice,008-03557,Arroz a Granel:Parboiled 50 LB -Bolsa Dos Hermanos.,Igor,0.0,,0.0,3348349.81999998,Bulk Rice,Armando Carpio - 017,RETAIL SEDANOS,1384492,Aug
2024-08-14,Food Fair Plantation Corp,Credit Memo,008-03662,Varios:Promotional Allowance,parbo 1kg,-1.0,19.9,-19.9,3348329.91999998,Branded Rice,Keila Alfaro-Visvikis,RETAIL  DSD,1384493,Aug
2024-08-14,Food Fair Plantation Corp,Credit Memo,008-03662,Varios:Promotional Allowance,lf 1kg,-1.0,17.0,-17.0,3348312.91999998,Branded Rice,Keila Alfaro-Visvikis,RETAIL  DSD,1384494,Aug
2024-08-14,Sedanos Supermarkets #27,Credit Memo,008-03663,Varios:Promotional Allowance,,-3.0,40.5,-121.5,3348191.41999998,Branded Rice,Keila Alfaro-Visvikis,RETAIL SEDANOS,1384495,Aug
2024-08-14,Price Choice Food Market# 9,Credit Memo,008-03664,Varios:Promotional Allowance,,-2.0,46.5,-93.0,3348098.41999998,Bulk Rice,Keila Alfaro-Visvikis,RETAIL  DSD,1384496,Aug
2024-08-14,Key Foods  / Ivan,Credit Memo,008-03665,Varios:Promotional Allowance,5kg,-2.0,46.5,-93.0,3348005.41999998,Branded Rice,Keila Alfaro-Visvikis,RETAIL  DSD,1384497,Aug
2024-08-14,Key Foods  / Ivan,Credit Memo,008-03665,Varios:Promotional Allowance,1kg lf,-1.0,17.0,-17.0,3347988.41999998,Branded Rice,Keila Alfaro-Visvikis,RETAIL  DSD,1384498,Aug
2024-08-14,BRAVO - Flamingo #3,Credit Memo,008-03666,Varios:Promotional Allowance,,-2.0,46.5,-93.0,3347895.41999998,Branded Rice,Keila Alfaro-Visvikis,RETAIL  DSD,1384499,Aug
2024-08-14,BRAVO - Flamingo #3,Credit Memo,008-03666,Varios:Promotional Allowance,,-1.0,17.0,-17.0,3347878.41999998,Branded Rice,Keila Alfaro-Visvikis,RETAIL  DSD,1384500,Aug
2024-08-15,Sedanos Supermarkets #16,Invoice,008-03558,Arroz a Granel:Parboiled 50 LB -Bolsa Dos Hermanos.,,4.0,28.25,113.0,3347991.41999998,Bulk Rice,Lisset Limpio -020,RETAIL SEDANOS,1384501,Aug
2024-08-15,Sedanos Supermarkets #16,Invoice,008-03558,,Discount,,,-2.26,3347989.15999998,,Lisset Limpio -020,RETAIL SEDANOS,1384502,Aug
2024-08-15,Los Mejores Tamales de Miami,Invoice,008-03559,Arroz a Granel:Parboiled 50 LB -Bolsa Dos Hermanos.,,3.0,28.25,84.75,3348073.90999998,Bulk Rice,Lisset Limpio -020,CAFETERIA y RESTAURANTS,1384503,Aug
2024-08-15,Sedanos Supermarkets #32,Invoice,008-03560,Arroz a Granel:Parboiled 50 LB -Bolsa Dos Hermanos.,,5.0,28.25,141.25,3348215.15999998,Bulk Rice,Lisset Limpio -020,RETAIL SEDANOS,1384504,Aug
2024-08-15,Sedanos Supermarkets #32,Invoice,008-03560,,Discount,,,-2.83,3348212.32999998,,Lisset Limpio -020,RETAIL SEDANOS,1384505,Aug
2024-08-15,Sedanos Supermarkets #38,Invoice,008-03561,Rice Snack:Rice Snack Ham Flavored DOS HERMANOS,,2.0,19.9,39.8,3348252.12999998,Puffed Products,Lisset Limpio -020,RETAIL SEDANOS,1384506,Aug
2024-08-15,Sedanos Supermarkets #38,Invoice,008-03561,Rice Snack:Rice Snack Salami Flavored DOS HERMANOS,,1.0,19.9,19.9,3348272.02999998,Puffed Products,Lisset Limpio -020,RETAIL SEDANOS,1384507,Aug
2024-08-15,Sedanos Supermarkets #38,Invoice,008-03561,"Rice Snack:Rice Snack, Pizza DH",,1.0,19.9,19.9,3348291.92999998,Puffed Products,Lisset Limpio -020,RETAIL SEDANOS,1384508,Aug
2024-08-15,Sedanos Supermarkets #38,Invoice,008-03561,,Discount,,,-1.19,3348290.73999998,,Lisset Limpio -020,RETAIL SEDANOS,1384509,Aug
2024-08-15,Brito Family Corp.,Invoice,008-03562,Arroz a Granel:Largo Fino 50 LB -Bolsa Dos Hermanos.,,55.0,27.85,1531.75,3349822.48999998,Bulk Rice,Lisset Limpio -020,CAFETERIA y RESTAURANTS,1384510,Aug
2024-08-15,Brito Family Corp.,Invoice,008-03562,Arroz a Granel:Parboiled 50 LB -Bolsa Dos Hermanos.,,55.0,27.75,1526.25,3351348.73999998,Bulk Rice,Lisset Limpio -020,CAFETERIA y RESTAURANTS,1384511,Aug
2024-08-15,Sedanos Supermarkets #38,Credit Memo,008-03563,Varios:Producto vencido/deteriorado (no impacta en inventario),vencidos,-1.0,14.92,-14.92,3351333.81999998,Puffed Products,Lisset Limpio -020,RETAIL SEDANOS,1384512,Aug
2024-08-15,Los Mejores Tamales de Miami,Credit Memo,008-03564,Arroz a Granel:Largo Fino 50 LB -Bolsa Dos Hermanos.,,-3.0,27.85,-83.55,3351250.26999998,Bulk Rice,Lisset Limpio -020,CAFETERIA y RESTAURANTS,1384513,Aug
2024-08-15,Los Mejores Tamales de Miami,Invoice,008-03565,Arroz a Granel:Parboiled 50 LB -Bolsa Dos Hermanos.,,3.0,27.85,83.55,3351333.81999998,Bulk Rice,Lisset Limpio -020,CAFETERIA y RESTAURANTS,1384514,Aug
2024-08-15,El Palacio de los jugos /  Nanos Latin Foods,Invoice,008-03566,Arroz a Granel:Parboiled 50 LB -Bolsa Dos Hermanos.,,11.0,27.75,305.25,3351639.06999998,Bulk Rice,Lisset Limpio -020,Cafeteria,1384515,Aug
2024-08-15,El Palacio de los jugos /  Nanos Latin Foods,Invoice,008-03566,Arroz a Granel:Parboiled 50 LB -Bolsa Dos Hermanos.,,1.0,27.75,27.75,3351666.81999998,Bulk Rice,Lisset Limpio -020,Cafeteria,1384516,Aug
2024-08-15,Sedanos Supermarkets #38,Credit Memo,008-03667,Varios:Promotional Allowance,,-1.0,19.9,-19.9,3351646.91999998,Puffed Products,Lisset Limpio -020,RETAIL SEDANOS,1384517,Aug
2024-08-15,El Palacio de los jugos /  Nanos Latin Foods,Credit Memo,008-03668,Varios:Promotional Allowance,,-1.0,27.75,-27.75,3351619.16999998,Branded Rice,Lisset Limpio -020,Cafeteria,1384518,Aug
2024-08-16,Sedanos Supermarkets #31,Invoice,008-03567,Arroz a Granel:Parboiled 50 LB -Bolsa Dos Hermanos.,,3.0,28.25,84.75,3351703.91999998,Bulk Rice,Lisset Limpio -020,RETAIL SEDANOS,1384519,Aug
2024-08-16,Sedanos Supermarkets #31,Invoice,008-03567,,Discount,,,-1.7,3351702.21999998,,Lisset Limpio -020,RETAIL SEDANOS,1384520,Aug
2024-08-16,El Palacio de los jugos /  Nanos Latin Foods,Invoice,008-03568,Spices:AS Sazon (for all),1 / 30 lb (box or pail),0.0,,0.0,3351702.21999998,American Spice,Lisset Limpio -020,Cafeteria,1384521,Aug
2024-08-19,"Meat Club Market, LLC.",Credit Memo,008-03569,Varios:Promotional Allowance,Rice snack ham-,-1.0,19.9,-19.9,3351682.31999998,Puffed Products,Lisset Limpio -020,RETAIL  DSD,1384522,Aug
2024-08-19,Sedanos Supermarkets #29,Invoice,008-03570,Arroz Envasado:Parboiled 5KG Dos Hermanos.,6 / 11lbs,10.0,40.5,405.0,3352087.31999998,Branded Rice,Lisset Limpio -020,RETAIL SEDANOS,1384523,Aug
2024-08-19,Sedanos Supermarkets #29,Invoice,008-03570,Arroz Envasado:Parboiled 5KG Dos Hermanos.,6 / 11lbs,10.0,40.5,405.0,3352492.31999998,Branded Rice,Lisset Limpio -020,RETAIL SEDANOS,1384524,Aug
2024-08-19,Sedanos Supermarkets #29,Invoice,008-03570,,Discount,,,-8.1,3352484.21999998,,Lisset Limpio -020,RETAIL SEDANOS,1384525,Aug
2024-08-19,JMN Dely Corp,Invoice,008-03571,Arroz a Granel:Largo Fino 50 LB -Bolsa Dos Hermanos.,,5.0,27.85,139.25,3352623.46999998,Bulk Rice,Keila Alfaro-Visvikis,CAFETERIA y RESTAURANTS,1384526,Aug
2024-08-19,JMN Dely Corp,Invoice,008-03571,Arroz a Granel:Parboiled 50 LB -Bolsa Dos Hermanos.,,2.0,28.25,56.5,3352679.96999998,Bulk Rice,Keila Alfaro-Visvikis,CAFETERIA y RESTAURANTS,1384527,Aug
2024-08-19,Soriano Brothers PB,Invoice,008-03572,Spices:AS Sazon (for all),1 / 30 lb (box or pail),1.0,59.0,59.0,3352738.96999998,American Spice,Lisset Limpio -020,CAFETERIA y RESTAURANTS,1384528,Aug
2024-08-19,Soriano Brothers PB,Invoice,008-03572,Dry Beans:Dry Beans - Black Beans 50,Dry Black Beans 50 lb,1.0,45.7,45.7,3352784.66999998,Dry Beans,Lisset Limpio -020,CAFETERIA y RESTAURANTS,1384529,Aug
2024-08-19,Soriano Brothers PB,Invoice,008-03572,Arroz a Granel:Parboiled 50 LB -Bolsa Dos Hermanos.,,22.0,27.75,610.5,3353395.16999998,Bulk Rice,Lisset Limpio -020,CAFETERIA y RESTAURANTS,1384530,Aug
2024-08-19,Soriano Brothers PB,Invoice,008-03572,Arroz a Granel:Largo Fino 50 LB -Bolsa Dos Hermanos.,,10.0,27.85,278.5,3353673.66999998,Bulk Rice,Lisset Limpio -020,CAFETERIA y RESTAURANTS,1384531,Aug
2024-08-19,Soriano Brothers PB,Invoice,008-03572,Arroz a Granel:Parboiled 50 LB -Bolsa Dos Hermanos.,,2.0,27.85,55.7,3353729.36999998,Bulk Rice,Lisset Limpio -020,CAFETERIA y RESTAURANTS,1384532,Aug
2024-08-19,Los Caringas Latin America  Foods,Invoice,008-03573,Arroz a Granel:Largo Fino 50 LB -Bolsa Dos Hermanos.,,3.0,27.85,83.55,3353812.91999998,Bulk Rice,Lisset Limpio -020,CAFETERIA y RESTAURANTS,1384533,Aug
2024-08-19,Los Caringas Latin America  Foods,Invoice,008-03573,Arroz a Granel:Parboiled 50 LB -Bolsa Dos Hermanos.,,3.0,28.25,84.75,3353897.66999998,Bulk Rice,Lisset Limpio -020,CAFETERIA y RESTAURANTS,1384534,Aug
2024-08-19,Bravo   Francisco Diaz,Invoice,008-03574,Liquids:AS Marinating Sauce (Mojo),,3.0,18.5,55.5,3353953.16999998,American Spice,Lisset Limpio -020,RETAIL  DSD,1384535,Aug
2024-08-19,Bravo   Francisco Diaz,Invoice,008-03574,Arroz a Granel:Largo Fino 50 LB -Bolsa Dos Hermanos.,,5.0,27.85,139.25,3354092.41999998,Bulk Rice,Lisset Limpio -020,RETAIL  DSD,1384536,Aug
2024-08-19,Bravo   Francisco Diaz,Invoice,008-03574,Liquids:AS White Vinegar,4/1 Gl.,1.0,10.0,10.0,3354102.41999998,American Spice,Lisset Limpio -020,RETAIL  DSD,1384537,Aug
2024-08-19,Bravo   Francisco Diaz,Invoice,008-03574,Liquids:AS Cooking Wine,4/1 Gl.,1.0,17.5,17.5,3354119.91999998,American Spice,Lisset Limpio -020,RETAIL  DSD,1384538,Aug
2024-08-19,Bravo   Francisco Diaz,Invoice,008-03574,Liquids:AS Lemon Juice 4/1 Gl,,1.0,14.95,14.95,3354134.86999998,American Spice,Lisset Limpio -020,RETAIL  DSD,1384539,Aug
2024-08-19,El Palacio de los jugos / Lita Foods Inc.,Invoice,008-03575,Dry Beans:Dry Beans - Black Beans 50,Dry Black Beans 50 lb,1.0,45.7,45.7,3354180.56999998,Dry Beans,Lisset Limpio -020,Cafeteria,1384540,Aug
2024-08-19,El Palacio de los jugos / Lita Foods Inc.,Invoice,008-03575,Arroz a Granel:Parboiled 50 LB -Bolsa Dos Hermanos.,,11.0,27.75,305.25,3354485.81999998,Bulk Rice,Lisset Limpio -020,Cafeteria,1384541,Aug
2024-08-19,El Palacio de los jugos / Lita Foods Inc.,Invoice,008-03575,Arroz a Granel:Parboiled 50 LB -Bolsa Dos Hermanos.,,1.0,27.75,27.75,3354513.56999998,Bulk Rice,Lisset Limpio -020,Cafeteria,1384542,Aug
2024-08-19,Hings Chinese,Invoice,008-03576,Arroz a Granel:Parboiled 50 LB -Bolsa Dos Hermanos.,,5.0,28.25,141.25,3354654.81999998,Bulk Rice,Lisset Limpio -020,CAFETERIA y RESTAURANTS,1384543,Aug
2024-08-19,Food-Star Supermarket,Invoice,008-03577,Arroz Envasado:Largo Fino 1kg (Long grain rice) Dos Hermanos,,10.0,17.0,170.0,3354824.81999998,Branded Rice,Lisset Limpio -020,RETAIL  DSD,1384544,Aug
2024-08-19,Food-Star Supermarket,Invoice,008-03577,Arroz Envasado:Largo Fino 1kg (Long grain rice) Dos Hermanos,,2.0,17.0,34.0,3354858.81999998,Branded Rice,Lisset Limpio -020,RETAIL  DSD,1384545,Aug
2024-08-19,Chavez Distributors Inc.,Invoice,008-03578,Arroz a Granel:Parboiled 50 LB -Bolsa Dos Hermanos.,,55.0,27.75,1526.25,3356385.06999998,Bulk Rice,Keila Alfaro-Visvikis,WHOLESALER,1384546,Aug
2024-08-19,Sedanos Supermarkets #24,Invoice,008-03579,Arroz a Granel:Parboiled 50 LB -Bolsa Dos Hermanos.,,15.0,28.25,423.75,3356808.81999998,Bulk Rice,Keila Alfaro-Visvikis,RETAIL SEDANOS,1384547,Aug
2024-08-19,Sedanos Supermarkets #24,Invoice,008-03579,Arroz Envasado:Parboiled 5KG Dos Hermanos.,6 / 11lbs,1.0,40.5,40.5,3356849.31999998,Branded Rice,Keila Alfaro-Visvikis,RETAIL SEDANOS,1384548,Aug
2024-08-19,Sedanos Supermarkets #24,Invoice,008-03579,Rice Snack:Rice Snack Ham Flavored DOS HERMANOS,,1.0,19.9,19.9,3356869.21999998,Puffed Products,Keila Alfaro-Visvikis,RETAIL SEDANOS,1384549,Aug
2024-08-19,Sedanos Supermarkets #24,Invoice,008-03579,,Discount,,,-9.68,3356859.53999998,,Keila Alfaro-Visvikis,RETAIL SEDANOS,1384550,Aug
2024-08-19,Soriano Brothers PB,Credit Memo,008-03669,Varios:Promotional Allowance,,-2.0,27.85,-55.7,3356803.83999998,Bulk Rice,Lisset Limpio -020,CAFETERIA y RESTAURANTS,1384551,Aug
2024-08-19,Sedanos Supermarkets #29,Credit Memo,008-03670,Varios:Promotional Allowance,,-10.0,40.5,-405.0,3356398.83999998,Branded Rice,Lisset Limpio -020,RETAIL SEDANOS,1384552,Aug
2024-08-19,El Palacio de los jugos / Lita Foods Inc.,Credit Memo,008-03671,Varios:Promotional Allowance,,-1.0,27.75,-27.75,3356371.08999998,Puffed Products,Lisset Limpio -020,Cafeteria,1384553,Aug
2024-08-19,Food-Star Supermarket,Credit Memo,008-03672,Varios:Promotional Allowance,,-2.0,17.0,-34.0,3356337.08999998,Branded Rice,Lisset Limpio -020,RETAIL  DSD,1384554,Aug
2024-08-21,Total Food supermarket,Invoice,008-03580,Arroz a Granel:Parboiled 50 LB -Bolsa Dos Hermanos.,,10.0,28.25,282.5,3356619.58999998,Bulk Rice,Keila Alfaro-Visvikis,RETAIL  DSD,1384555,Aug
2024-08-21,Sedanos Supermarkets #43,Invoice,008-03581,Arroz a Granel:Parboiled 50 LB -Bolsa Dos Hermanos.,,4.0,28.25,113.0,3356732.58999998,Bulk Rice,Lisset Limpio -020,RETAIL SEDANOS,1384556,Aug
2024-08-21,Sedanos Supermarkets #43,Invoice,008-03581,,Discount,,,-2.26,3356730.32999998,,Lisset Limpio -020,RETAIL SEDANOS,1384557,Aug
2024-08-21,Sedanos Supermarkets #26,Invoice,008-03582,Arroz Envasado:Parboiled 5KG Dos Hermanos.,6 / 11lbs,5.0,40.5,202.5,3356932.82999998,Branded Rice,Lisset Limpio -020,RETAIL SEDANOS,1384558,Aug
2024-08-21,Sedanos Supermarkets #26,Invoice,008-03582,Arroz Envasado:Parboiled 5KG Dos Hermanos.,6 / 11lbs,5.0,40.5,202.5,3357135.32999998,Branded Rice,Lisset Limpio -020,RETAIL SEDANOS,1384559,Aug
2024-08-21,Sedanos Supermarkets #26,Invoice,008-03582,,Discount,,,-4.05,3357131.27999998,,Lisset Limpio -020,RETAIL SEDANOS,1384560,Aug
2024-08-21,Sedanos Supermarkets #22,Invoice,008-03583,Arroz a Granel:Parboiled 50 LB -Bolsa Dos Hermanos.,,4.0,28.25,113.0,3357244.27999998,Bulk Rice,Lisset Limpio -020,RETAIL SEDANOS,1384561,Aug
2024-08-21,Sedanos Supermarkets #22,Invoice,008-03583,,Discount,,,-2.26,3357242.01999998,,Lisset Limpio -020,RETAIL SEDANOS,1384562,Aug
2024-08-21,Los Mejores Tamales de Miami,Invoice,008-03584,Arroz a Granel:Parboiled 50 LB -Bolsa Dos Hermanos.,,5.0,28.25,141.25,3357383.26999998,Bulk Rice,Lisset Limpio -020,CAFETERIA y RESTAURANTS,1384563,Aug
2024-08-21,El Palacio de los jugos / Delicias Criollas (DIAGO FOOD_MILLER),Invoice,008-03585,Liquids:AS White Vinegar,4/1 Gl.,1.0,10.5,10.5,3357393.76999998,American Spice,Lisset Limpio -020,Cafeteria,1384564,Aug
2024-08-21,El Palacio de los jugos / Delicias Criollas (DIAGO FOOD_MILLER),Invoice,008-03585,Arroz a Granel:Parboiled 50 LB -Bolsa Dos Hermanos.,,11.0,27.75,305.25,3357699.01999998,Bulk Rice,Lisset Limpio -020,Cafeteria,1384565,Aug
2024-08-21,El Palacio de los jugos / Delicias Criollas (DIAGO FOOD_MILLER),Invoice,008-03585,Arroz a Granel:Parboiled 50 LB -Bolsa Dos Hermanos.,,1.0,27.75,27.75,3357726.76999998,Bulk Rice,Lisset Limpio -020,Cafeteria,1384566,Aug
2024-08-21,Sedanos Supermarkets #16,Invoice,008-03586,Arroz a Granel:Parboiled 50 LB -Bolsa Dos Hermanos.,,4.0,28.25,113.0,3357839.76999998,Bulk Rice,Lisset Limpio -020,RETAIL SEDANOS,1384567,Aug
2024-08-21,Sedanos Supermarkets #16,Invoice,008-03586,,Discount,,,-2.26,3357837.50999998,,Lisset Limpio -020,RETAIL SEDANOS,1384568,Aug
2024-08-21,Los paraditos chinesse,Invoice,008-03587,Arroz a Granel:Parboiled 50 LB -Bolsa Dos Hermanos.,,10.0,28.25,282.5,3358120.00999998,Bulk Rice,Lisset Limpio -020,CAFETERIA y RESTAURANTS,1384569,Aug
2024-08-21,"Soriano Brothers Diaz Food Service,Inc",Invoice,008-03588,Arroz a Granel:Largo Fino 50 LB -Bolsa Dos Hermanos.,,30.0,27.85,835.5,3358955.50999998,Bulk Rice,Lisset Limpio -020,CAFETERIA y RESTAURANTS,1384570,Aug
2024-08-21,"Soriano Brothers Diaz Food Service,Inc",Invoice,008-03588,Arroz a Granel:Parboiled 50 LB -Bolsa Dos Hermanos.,,33.0,27.75,915.75,3359871.25999998,Bulk Rice,Lisset Limpio -020,CAFETERIA y RESTAURANTS,1384571,Aug
2024-08-21,"Soriano Brothers Diaz Food Service,Inc",Invoice,008-03588,Arroz a Granel:Parboiled 50 LB -Bolsa Dos Hermanos.,,3.0,27.75,83.25,3359954.50999998,Bulk Rice,Lisset Limpio -020,CAFETERIA y RESTAURANTS,1384572,Aug
2024-08-21,Ideal Food Basket Davie Cafeteria,Invoice,008-03589,Arroz a Granel:Largo Fino 50 LB -Bolsa Dos Hermanos.,,10.0,27.85,278.5,3360233.00999998,Bulk Rice,Keila Alfaro-Visvikis,CAFETERIA y RESTAURANTS,1384573,Aug
2024-08-21,Sedanos Supermarkets #26,Credit Memo,008-03673,Varios:Promotional Allowance,,-5.0,40.5,-202.5,3360030.50999998,Branded Rice,Lisset Limpio -020,RETAIL SEDANOS,1384574,Aug
2024-08-21,El Palacio de los jugos / Delicias Criollas (DIAGO FOOD_MILLER),Credit Memo,008-03674,Varios:Promotional Allowance,,-1.0,27.75,-27.75,3360002.75999998,Bulk Rice,Lisset Limpio -020,Cafeteria,1384575,Aug
2024-08-21,"Soriano Brothers Diaz Food Service,Inc",Credit Memo,008-03675,Varios:Promotional Allowance,,-3.0,27.75,-83.25,3359919.50999998,Bulk Rice,Lisset Limpio -020,CAFETERIA y RESTAURANTS,1384576,Aug
2024-08-23,Aries Supermarket & Cafeteria,Invoice,008-03590,Arroz a Granel:Parboiled 50 LB -Bolsa Dos Hermanos.,,10.0,28.25,282.5,3360202.00999998,Bulk Rice,Armando Carpio - 017,CAFETERIA y RESTAURANTS,1384577,Aug
2024-08-23,El Palacio de los jugos / Lita Foods Inc.,Invoice,008-03591,Arroz a Granel:Parboiled 50 LB -Bolsa Dos Hermanos.,,11.0,27.75,305.25,3360507.25999998,Bulk Rice,Lisset Limpio -020,Cafeteria,1384578,Aug
2024-08-23,El Palacio de los jugos / Lita Foods Inc.,Invoice,008-03591,Dry Beans:Dry Beans - Black Beans 50,Dry Black Beans 50 lb,1.0,45.7,45.7,3360552.95999998,Dry Beans,Lisset Limpio -020,Cafeteria,1384579,Aug
2024-08-23,El Palacio de los jugos / Lita Foods Inc.,Invoice,008-03591,Arroz a Granel:Parboiled 50 LB -Bolsa Dos Hermanos.,,1.0,27.75,27.75,3360580.70999998,Bulk Rice,Lisset Limpio -020,Cafeteria,1384580,Aug
2024-08-23,Sedanos Supermarkets #38,Invoice,008-03592,Arroz Envasado:Parboiled 5KG Dos Hermanos.,6 / 11lbs,10.0,40.5,405.0,3360985.70999998,Branded Rice,Lisset Limpio -020,RETAIL SEDANOS,1384581,Aug
2024-08-23,Sedanos Supermarkets #38,Invoice,008-03592,Arroz Envasado:Parboiled 5KG Dos Hermanos.,6 / 11lbs,10.0,40.5,405.0,3361390.70999998,Branded Rice,Lisset Limpio -020,RETAIL SEDANOS,1384582,Aug
2024-08-23,Sedanos Supermarkets #38,Invoice,008-03592,,Discount,,,-8.1,3361382.60999998,,Lisset Limpio -020,RETAIL SEDANOS,1384583,Aug
2024-08-23,El Palacio de los jugos /  Nanos Latin Foods,Invoice,008-03593,Arroz a Granel:Parboiled 50 LB -Bolsa Dos Hermanos.,,11.0,27.75,305.25,3361687.85999998,Bulk Rice,Lisset Limpio -020,Cafeteria,1384584,Aug
2024-08-23,El Palacio de los jugos /  Nanos Latin Foods,Invoice,008-03593,Arroz a Granel:Parboiled 50 LB -Bolsa Dos Hermanos.,,1.0,27.75,27.75,3361715.60999998,Bulk Rice,Lisset Limpio -020,Cafeteria,1384585,Aug
2024-08-23,El Palacio de los jugos /  Nanos Latin Foods,Invoice,008-03593,Dry Beans:Dry Beans - Black Beans 50,Dry Black Beans 50 lb,1.0,45.7,45.7,3361761.30999998,Dry Beans,Lisset Limpio -020,Cafeteria,1384586,Aug
2024-08-23,El Palacio de los jugos /  Nanos Latin Foods,Invoice,008-03593,Spices:AS Sazon (for all),1 / 30 lb (box or pail),1.0,59.0,59.0,3361820.30999998,American Spice,Lisset Limpio -020,Cafeteria,1384587,Aug
2024-08-23,ALS Foods,Invoice,008-03594,Liquids:AS White Vinegar,4/1 Gl.,1.0,10.5,10.5,3361830.80999998,American Spice,Lisset Limpio -020,CAFETERIA y RESTAURANTS,1384588,Aug
2024-08-23,ALS Foods,Invoice,008-03594,Dry Beans:Dry Beans - Black Beans 50,Dry Black Beans 50 lb,1.0,45.7,45.7,3361876.50999998,Dry Beans,Lisset Limpio -020,CAFETERIA y RESTAURANTS,1384589,Aug
2024-08-23,ALS Foods,Invoice,008-03594,Arroz a Granel:Parboiled 50 LB -Bolsa Dos Hermanos.,,11.0,27.75,305.25,3362181.75999998,Bulk Rice,Lisset Limpio -020,CAFETERIA y RESTAURANTS,1384590,Aug
2024-08-23,ALS Foods,Invoice,008-03594,Arroz a Granel:Parboiled 50 LB -Bolsa Dos Hermanos.,,1.0,27.75,27.75,3362209.50999998,Bulk Rice,Lisset Limpio -020,CAFETERIA y RESTAURANTS,1384591,Aug
2024-08-23,Fritanga Momotombo,Invoice,008-03595,Arroz a Granel:Largo Fino 50 LB -Bolsa Dos Hermanos.,,5.0,27.85,139.25,3362348.75999998,Bulk Rice,Lisset Limpio -020,CAFETERIA y RESTAURANTS,1384592,Aug
2024-08-23,El Palacio de Los Jugos / Casa mía Food Restaurant inc,Invoice,008-03596,Dry Beans:Dry Beans - Black Beans 50,Dry Black Beans 50 lb,1.0,45.7,45.7,3362394.45999998,Dry Beans,Lisset Limpio -020,Cafeteria,1384593,Aug
2024-08-23,El Palacio de Los Jugos / Casa mía Food Restaurant inc,Invoice,008-03596,Arroz a Granel:Parboiled 50 LB -Bolsa Dos Hermanos.,,11.0,27.75,305.25,3362699.70999998,Bulk Rice,Lisset Limpio -020,Cafeteria,1384594,Aug
2024-08-23,El Palacio de Los Jugos / Casa mía Food Restaurant inc,Invoice,008-03596,Arroz a Granel:Parboiled 50 LB -Bolsa Dos Hermanos.,,1.0,27.75,27.75,3362727.45999998,Bulk Rice,Lisset Limpio -020,Cafeteria,1384595,Aug
2024-08-23,Sedanos Supermarkets #31,Invoice,008-03597,Arroz a Granel:Largo Fino 50 LB -Bolsa Dos Hermanos.,,2.0,27.85,55.7,3362783.15999998,Bulk Rice,Lisset Limpio -020,RETAIL SEDANOS,1384596,Aug
2024-08-23,Sedanos Supermarkets #31,Invoice,008-03597,Arroz a Granel:Parboiled 50 LB -Bolsa Dos Hermanos.,,5.0,28.25,141.25,3362924.40999998,Bulk Rice,Lisset Limpio -020,RETAIL SEDANOS,1384597,Aug
2024-08-23,Sedanos Supermarkets #31,Invoice,008-03597,,Discount,,,-3.94,3362920.46999998,,Lisset Limpio -020,RETAIL SEDANOS,1384598,Aug
2024-08-23,El Palacio de los jugos / Lita Foods Inc.,Credit Memo,008-03676,Varios:Promotional Allowance,,-1.0,27.75,-27.75,3362892.71999998,Bulk Rice,Lisset Limpio -020,Cafeteria,1384599,Aug
2024-08-23,Sedanos Supermarkets #38,Credit Memo,008-03677,Varios:Promotional Allowance,,-10.0,40.5,-405.0,3362487.71999998,Branded Rice,Lisset Limpio -020,RETAIL SEDANOS,1384600,Aug
2024-08-23,El Palacio de los jugos /  Nanos Latin Foods,Credit Memo,008-03678,Varios:Promotional Allowance,,-1.0,27.75,-27.75,3362459.96999998,Bulk Rice,Lisset Limpio -020,Cafeteria,1384601,Aug
2024-08-23,ALS Foods,Credit Memo,008-03679,Varios:Promotional Allowance,,-1.0,27.75,-27.75,3362432.21999998,Bulk Rice,Lisset Limpio -020,CAFETERIA y RESTAURANTS,1384602,Aug
2024-08-23,El Palacio de Los Jugos / Casa mía Food Restaurant inc,Credit Memo,008-03680,Varios:Promotional Allowance,,-1.0,27.75,-27.75,3362404.46999998,Bulk Rice,Lisset Limpio -020,Cafeteria,1384603,Aug
2024-08-25,JMN Dely Corp,Invoice,008-03598,Dry Beans:Dry Beans - Black Beans 50,Dry Black Beans 50 lb,1.0,45.7,45.7,3362450.16999998,Dry Beans,Keila Alfaro-Visvikis,CAFETERIA y RESTAURANTS,1384604,Aug
2024-08-25,JMN Dely Corp,Invoice,008-03598,Arroz a Granel:Largo Fino 50 LB -Bolsa Dos Hermanos.,,5.0,27.85,139.25,3362589.41999998,Bulk Rice,Keila Alfaro-Visvikis,CAFETERIA y RESTAURANTS,1384605,Aug
2024-08-25,JMN Dely Corp,Invoice,008-03598,Arroz a Granel:Parboiled 50 LB -Bolsa Dos Hermanos.,,2.0,28.25,56.5,3362645.91999998,Bulk Rice,Keila Alfaro-Visvikis,CAFETERIA y RESTAURANTS,1384606,Aug
2024-08-25,Aries Supermarket & Cafeteria,Invoice,008-03599,Dry Beans:Dry Beans - Black Beans 50,Dry Black Beans 50 lb,10.0,39.5,395.0,3363040.91999998,Dry Beans,Armando Carpio - 017,CAFETERIA y RESTAURANTS,1384607,Aug
2024-08-25,Panda Depot,Invoice,008-03600,Arroz a Granel:Parboiled 50 LB -Bolsa Dos Hermanos.,,275.0,25.0,6875.0,3369915.91999998,Bulk Rice,Lisset Limpio -020,WHOLESALER,1384608,Aug
2024-08-25,Sedanos Supermarkets #20,Invoice,008-03601,Rice Snack:Rice Snack Ham Flavored DOS HERMANOS,,1.0,19.9,19.9,3369935.81999998,Puffed Products,Keila Alfaro-Visvikis,RETAIL SEDANOS,1384609,Aug
2024-08-25,Sedanos Supermarkets #20,Invoice,008-03601,Rice Snack:Rice Snack Salami Flavored DOS HERMANOS,,1.0,19.9,19.9,3369955.71999998,Puffed Products,Keila Alfaro-Visvikis,RETAIL SEDANOS,1384610,Aug
2024-08-25,Sedanos Supermarkets #20,Invoice,008-03601,"Rice Snack:Rice Snack, Pizza DH",,1.0,19.9,19.9,3369975.61999998,Puffed Products,Keila Alfaro-Visvikis,RETAIL SEDANOS,1384611,Aug
2024-08-25,Sedanos Supermarkets #20,Invoice,008-03601,Rice Snack:Rice Snack Ham Flavored DOS HERMANOS,,1.0,19.9,19.9,3369995.51999998,Puffed Products,Keila Alfaro-Visvikis,RETAIL SEDANOS,1384612,Aug
2024-08-25,Sedanos Supermarkets #20,Invoice,008-03601,,Discount,,,-1.19,3369994.32999998,,Keila Alfaro-Visvikis,RETAIL SEDANOS,1384613,Aug
2024-08-25,Sedanos Supermarkets #42,Invoice,008-03602,Arroz a Granel:Parboiled 50 LB -Bolsa Dos Hermanos.,,5.0,28.25,141.25,3370135.57999998,Bulk Rice,Lisset Limpio -020,RETAIL SEDANOS,1384614,Aug
2024-08-25,Sedanos Supermarkets #42,Invoice,008-03602,,Discount,,,-2.83,3370132.74999998,,Lisset Limpio -020,RETAIL SEDANOS,1384615,Aug
2024-08-25,Sedanos Supermarkets #36,Invoice,008-03603,Rice Snack:Rice Snack Ham Flavored DOS HERMANOS,,0.0,,0.0,3370132.74999998,Puffed Products,Keila Alfaro-Visvikis,RETAIL SEDANOS,1384616,Aug
2024-08-25,Sedanos Supermarkets #36,Invoice,008-03603,Rice Snack:Rice Snack Salami Flavored DOS HERMANOS,,0.0,,0.0,3370132.74999998,Puffed Products,Keila Alfaro-Visvikis,RETAIL SEDANOS,1384617,Aug
2024-08-25,Sedanos Supermarkets #36,Invoice,008-03603,"Rice Snack:Rice Snack, Pizza DH",,0.0,,0.0,3370132.74999998,Puffed Products,Keila Alfaro-Visvikis,RETAIL SEDANOS,1384618,Aug
2024-08-25,Sedanos Supermarkets #36,Invoice,008-03603,Rice Snack:Rice Snack Ham Flavored DOS HERMANOS,,0.0,0.0,0.0,3370132.74999998,Puffed Products,Keila Alfaro-Visvikis,RETAIL SEDANOS,1384619,Aug
2024-08-25,Sedanos Supermarkets #17,Invoice,008-03604,Arroz Envasado:Parboiled 5KG Dos Hermanos.,6 / 11lbs,2.0,40.5,81.0,3370213.74999998,Branded Rice,Lisset Limpio -020,RETAIL SEDANOS,1384620,Aug
2024-08-25,Sedanos Supermarkets #17,Invoice,008-03604,Rice Snack:Rice Snack Ham Flavored DOS HERMANOS,,2.0,19.9,39.8,3370253.54999998,Puffed Products,Lisset Limpio -020,RETAIL SEDANOS,1384621,Aug
2024-08-25,Sedanos Supermarkets #17,Invoice,008-03604,Rice Snack:Rice Snack Salami Flavored DOS HERMANOS,,2.0,19.9,39.8,3370293.34999998,Puffed Products,Lisset Limpio -020,RETAIL SEDANOS,1384622,Aug
2024-08-25,Sedanos Supermarkets #17,Invoice,008-03604,Arroz Envasado:Parboiled 5KG Dos Hermanos.,6 / 11lbs,2.0,40.5,81.0,3370374.34999998,Branded Rice,Lisset Limpio -020,RETAIL SEDANOS,1384623,Aug
2024-08-25,Sedanos Supermarkets #17,Invoice,008-03604,,Discount,,,-3.21,3370371.13999998,,Lisset Limpio -020,RETAIL SEDANOS,1384624,Aug
2024-08-25,Price Choice Food Market # 6,Invoice,008-03605,Arroz a Granel:Parboiled 50 LB -Bolsa Dos Hermanos.,,20.0,28.25,565.0,3370936.13999998,Bulk Rice,Lisset Limpio -020,RETAIL  DSD,1384625,Aug
2024-08-25,Price Choice 5 YNTO Food Corp.,Invoice,008-03606,Arroz Envasado:Largo Fino 1kg (Long grain rice) Dos Hermanos,,3.0,17.0,51.0,3370987.13999998,Branded Rice,Keila Alfaro-Visvikis,RETAIL  DSD,1384626,Aug
2024-08-25,Price Choice 5 YNTO Food Corp.,Invoice,008-03606,Arroz Envasado:Parboiled 1kg Bolsa Dos Hermanos.,.,2.0,19.9,39.8,3371026.93999998,Branded Rice,Keila Alfaro-Visvikis,RETAIL  DSD,1384627,Aug
2024-08-25,Price Choice 5 YNTO Food Corp.,Invoice,008-03606,Arroz Envasado:Largo Fino 1kg (Long grain rice) Dos Hermanos,,1.0,17.0,17.0,3371043.93999998,Branded Rice,Keila Alfaro-Visvikis,RETAIL  DSD,1384628,Aug
2024-08-25,Sedanos Supermarkets #20,Credit Memo,008-03681,Varios:Promotional Allowance,,-1.0,19.9,-19.9,3371024.03999998,Puffed Products,Keila Alfaro-Visvikis,RETAIL SEDANOS,1384629,Aug
2024-08-25,Sedanos Supermarkets #17,Credit Memo,008-03682,Varios:Promotional Allowance,,-2.0,40.5,-81.0,3370943.03999998,Branded Rice,Lisset Limpio -020,RETAIL SEDANOS,1384630,Aug
2024-08-25,Price Choice 5 YNTO Food Corp.,Credit Memo,008-03683,Varios:Promotional Allowance,LF 1KG,-1.0,17.0,-17.0,3370926.03999998,Branded Rice,Keila Alfaro-Visvikis,RETAIL  DSD,1384631,Aug
2024-08-26,Sedanos Supermarkets #34,Invoice,008-03607,Arroz Envasado:Parboiled 5KG Dos Hermanos.,6 / 11lbs,2.0,40.5,81.0,3371007.03999998,Branded Rice,Keila Alfaro-Visvikis,RETAIL SEDANOS,1384632,Aug
2024-08-26,Sedanos Supermarkets #34,Invoice,008-03607,Arroz Envasado:Parboiled 5KG Dos Hermanos.,6 / 11lbs,2.0,40.5,81.0,3371088.03999998,Branded Rice,Keila Alfaro-Visvikis,RETAIL SEDANOS,1384633,Aug
2024-08-26,Sedanos Supermarkets #34,Invoice,008-03607,,Discount,,,-1.62,3371086.41999998,,Keila Alfaro-Visvikis,RETAIL SEDANOS,1384634,Aug
2024-08-26,La Ranchera Meat Market #3,Invoice,008-03608,Arroz a Granel:Largo Fino 50 LB -Bolsa Dos Hermanos.,,10.0,27.85,278.5,3371364.91999998,Bulk Rice,Keila Alfaro-Visvikis,CAFETERIA y RESTAURANTS,1384635,Aug
2024-08-26,El Palacio de los jugos /  Nanos Latin Foods,Invoice,008-03609,Arroz a Granel:Parboiled 50 LB -Bolsa Dos Hermanos.,,11.0,27.75,305.25,3371670.16999998,Bulk Rice,Lisset Limpio -020,Cafeteria,1384636,Aug
2024-08-26,El Palacio de los jugos /  Nanos Latin Foods,Invoice,008-03609,Arroz a Granel:Parboiled 50 LB -Bolsa Dos Hermanos.,,1.0,27.75,27.75,3371697.91999998,Bulk Rice,Lisset Limpio -020,Cafeteria,1384637,Aug
2024-08-26,El Palacio de los jugos /  Nanos Latin Foods,Invoice,008-03609,Dry Beans:Dry Beans - Black Beans 50,Dry Black Beans 50 lb,1.0,45.7,45.7,3371743.61999998,Dry Beans,Lisset Limpio -020,Cafeteria,1384638,Aug
2024-08-26,Gala Fresh Farms - Lake worth,Invoice,008-03610,Arroz Envasado:Parboiled 5KG Dos Hermanos.,6 / 11lbs,15.0,46.5,697.5,3372441.11999998,Branded Rice,Keila Alfaro-Visvikis,RETAIL  DSD,1384639,Aug
2024-08-26,Gala Fresh Farms - Lake worth,Invoice,008-03610,Arroz Envasado:Largo Fino 1kg (Long grain rice) Dos Hermanos,,2.0,17.0,34.0,3372475.11999998,Branded Rice,Keila Alfaro-Visvikis,RETAIL  DSD,1384640,Aug
2024-08-26,Gala Fresh Farms - Lake worth,Invoice,008-03610,Arroz Envasado:Parboiled 1kg Bolsa Dos Hermanos.,.,3.0,19.9,59.7,3372534.81999998,Branded Rice,Keila Alfaro-Visvikis,RETAIL  DSD,1384641,Aug
2024-08-26,Gala Fresh Farms - Lake worth,Invoice,008-03610,Rice Snack:Rice Snack Ham Flavored DOS HERMANOS,,1.0,19.9,19.9,3372554.71999998,Puffed Products,Keila Alfaro-Visvikis,RETAIL  DSD,1384642,Aug
2024-08-26,Gala Fresh Farms - Lake worth,Invoice,008-03610,Rice Snack:Rice Snack Salami Flavored DOS HERMANOS,,1.0,19.9,19.9,3372574.61999998,Puffed Products,Keila Alfaro-Visvikis,RETAIL  DSD,1384643,Aug
2024-08-26,Gala Fresh Farms - Lake worth,Invoice,008-03610,"Rice Snack:Rice Snack, Pizza DH",,1.0,19.9,19.9,3372594.51999998,Puffed Products,Keila Alfaro-Visvikis,RETAIL  DSD,1384644,Aug
2024-08-26,Gala Fresh Farms - Lake worth,Invoice,008-03610,Arroz Envasado:Sushi Rice Dos Hermanos.,.,1.0,20.0,20.0,3372614.51999998,Branded Rice,Keila Alfaro-Visvikis,RETAIL  DSD,1384645,Aug
2024-08-26,Gala Fresh Farms - Lake worth,Invoice,008-03610,Arroz Envasado:Carnaroli Dos Hermanos,.,1.0,30.5,30.5,3372645.01999998,Branded Rice,Keila Alfaro-Visvikis,RETAIL  DSD,1384646,Aug
2024-08-26,Gala Fresh Farms - Lake worth,Invoice,008-03610,Arroz Envasado:Organico LF Dos Hermanos,.,1.0,24.0,24.0,3372669.01999998,Branded Rice,Keila Alfaro-Visvikis,RETAIL  DSD,1384647,Aug
2024-08-26,Gala Fresh Farms - Lake worth,Invoice,008-03610,Arroz Envasado:Aromatic Type Rice Dos Hermanos.,.,1.0,20.0,20.0,3372689.01999998,Branded Rice,Keila Alfaro-Visvikis,RETAIL  DSD,1384648,Aug
2024-08-26,Gala Fresh Farms - Lake worth,Invoice,008-03610,Arroz Envasado:Parboiled 5KG Dos Hermanos.,6 / 11lbs,1.0,46.5,46.5,3372735.51999998,Branded Rice,Keila Alfaro-Visvikis,RETAIL  DSD,1384649,Aug
2024-08-26,Gala Fresh Farms - Lake worth,Invoice,008-03610,Arroz Envasado:Largo Fino 1kg (Long grain rice) Dos Hermanos,,1.0,17.0,17.0,3372752.51999998,Branded Rice,Keila Alfaro-Visvikis,RETAIL  DSD,1384650,Aug
2024-08-26,Gala Fresh Farms - Lake worth,Invoice,008-03610,Rice Snack:Rice Snack Salami Flavored DOS HERMANOS,,1.0,19.9,19.9,3372772.41999998,Puffed Products,Keila Alfaro-Visvikis,RETAIL  DSD,1384651,Aug
2024-08-26,Sedanos Supermarkets #34,Invoice,008-03611,Arroz a Granel:Parboiled 50 LB -Bolsa Dos Hermanos.,,6.0,27.75,166.5,3372938.91999998,Bulk Rice,Keila Alfaro-Visvikis,RETAIL SEDANOS,1384652,Aug
2024-08-26,Sedanos Supermarkets #34,Invoice,008-03611,,Discount,,,-3.33,3372935.58999998,,Keila Alfaro-Visvikis,RETAIL SEDANOS,1384653,Aug
2024-08-26,Gala Fresh Farms - Boca Ratón,Invoice,008-03612,Arroz Envasado:Largo Fino 1kg (Long grain rice) Dos Hermanos,,2.0,17.0,34.0,3372969.58999998,Branded Rice,Keila Alfaro-Visvikis,RETAIL  DSD,1384654,Aug
2024-08-26,Gala Fresh Farms - Boca Ratón,Invoice,008-03612,Arroz Envasado:Parboiled 1kg Bolsa Dos Hermanos.,.,3.0,19.9,59.7,3373029.28999998,Branded Rice,Keila Alfaro-Visvikis,RETAIL  DSD,1384655,Aug
2024-08-26,Gala Fresh Farms - Boca Ratón,Invoice,008-03612,Rice Snack:Rice Snack Ham Flavored DOS HERMANOS,,1.0,19.9,19.9,3373049.18999998,Puffed Products,Keila Alfaro-Visvikis,RETAIL  DSD,1384656,Aug
2024-08-26,Gala Fresh Farms - Boca Ratón,Invoice,008-03612,Rice Snack:Rice Snack Salami Flavored DOS HERMANOS,,1.0,19.9,19.9,3373069.08999998,Puffed Products,Keila Alfaro-Visvikis,RETAIL  DSD,1384657,Aug
2024-08-26,Gala Fresh Farms - Boca Ratón,Invoice,008-03612,"Rice Snack:Rice Snack, Pizza DH",,1.0,19.9,19.9,3373088.98999998,Puffed Products,Keila Alfaro-Visvikis,RETAIL  DSD,1384658,Aug
2024-08-26,Gala Fresh Farms - Boca Ratón,Invoice,008-03612,Arroz Envasado:Sushi Rice Dos Hermanos.,.,1.0,20.0,20.0,3373108.98999998,Branded Rice,Keila Alfaro-Visvikis,RETAIL  DSD,1384659,Aug
2024-08-26,Gala Fresh Farms - Boca Ratón,Invoice,008-03612,Rice Cakes:Rice Cake Un Salty DH,,1.0,19.9,19.9,3373128.88999998,Puffed Products,Keila Alfaro-Visvikis,RETAIL  DSD,1384660,Aug
2024-08-26,Gala Fresh Farms - Boca Ratón,Invoice,008-03612,Rice Cakes:Rice Cakes Sweet DH,,1.0,19.9,19.9,3373148.78999998,Puffed Products,Keila Alfaro-Visvikis,RETAIL  DSD,1384661,Aug
2024-08-26,Gala Fresh Farms - Boca Ratón,Invoice,008-03612,Rice Cakes:Rice Cakes salty DH,,1.0,19.9,19.9,3373168.68999998,Puffed Products,Keila Alfaro-Visvikis,RETAIL  DSD,1384662,Aug
2024-08-26,Gala Fresh Farms - Boca Ratón,Invoice,008-03612,Rice Snack:Rice Snack Salami Flavored DOS HERMANOS,,1.0,19.9,19.9,3373188.58999998,Puffed Products,Keila Alfaro-Visvikis,RETAIL  DSD,1384663,Aug
2024-08-26,Gala Fresh Farms - Boca Ratón,Invoice,008-03612,Rice Cakes:Rice Cake Un Salty DH,,1.0,19.9,19.9,3373208.48999998,Puffed Products,Keila Alfaro-Visvikis,RETAIL  DSD,1384664,Aug
2024-08-26,Ideal Food Basket Davie Cafeteria,Invoice,008-03613,Arroz a Granel:Largo Fino 50 LB -Bolsa Dos Hermanos.,,10.0,27.85,278.5,3373486.98999998,Bulk Rice,Keila Alfaro-Visvikis,CAFETERIA y RESTAURANTS,1384665,Aug
2024-08-26,Sedanos Supermarkets #34,Credit Memo,008-03684,Varios:Promotional Allowance,,-2.0,40.5,-81.0,3373405.98999998,Branded Rice,Keila Alfaro-Visvikis,RETAIL SEDANOS,1384666,Aug
2024-08-26,El Palacio de los jugos /  Nanos Latin Foods,Credit Memo,008-03685,Varios:Promotional Allowance,,-1.0,27.75,-27.75,3373378.23999998,Bulk Rice,Lisset Limpio -020,Cafeteria,1384667,Aug
2024-08-26,Gala Fresh Farms - Lake worth,Credit Memo,008-03686,Varios:Promotional Allowance,5KG PARBO,-1.0,46.5,-46.5,3373331.73999998,Branded Rice,Keila Alfaro-Visvikis,RETAIL  DSD,1384668,Aug
2024-08-26,Gala Fresh Farms - Lake worth,Credit Memo,008-03686,Varios:Promotional Allowance,LF 1KG,-1.0,17.0,-17.0,3373314.73999998,Branded Rice,Keila Alfaro-Visvikis,RETAIL  DSD,1384669,Aug
2024-08-26,Gala Fresh Farms - Lake worth,Credit Memo,008-03686,Varios:Promotional Allowance,SALAMI,-1.0,19.9,-19.9,3373294.83999998,Branded Rice,Keila Alfaro-Visvikis,RETAIL  DSD,1384670,Aug
2024-08-26,Gala Fresh Farms - Boca Ratón,Credit Memo,008-03687,Varios:Promotional Allowance,SNACK,-1.0,19.9,-19.9,3373274.93999998,Puffed Products,Keila Alfaro-Visvikis,RETAIL  DSD,1384671,Aug
2024-08-26,Gala Fresh Farms - Boca Ratón,Credit Memo,008-03687,Varios:Promotional Allowance,TOSTADAS,-1.0,19.9,-19.9,3373255.03999998,Puffed Products,Keila Alfaro-Visvikis,RETAIL  DSD,1384672,Aug
2024-08-27,Panda Depot,Credit Memo,008-03614,Arroz a Granel:Parboiled 50 LB -Bolsa Dos Hermanos.,,-5.0,25.0,-125.0,3373130.03999998,Bulk Rice,Lisset Limpio -020,WHOLESALER,1384673,Aug
2024-08-27,Soriano Brothers PB,Invoice,008-03615,Arroz a Granel:Largo Fino 50 LB -Bolsa Dos Hermanos.,,10.0,27.85,278.5,3373408.53999998,Bulk Rice,Lisset Limpio -020,CAFETERIA y RESTAURANTS,1384674,Aug
2024-08-27,Soriano Brothers PB,Invoice,008-03615,Spices:AS Sazon (for all),1 / 30 lb (box or pail),1.0,59.0,59.0,3373467.53999998,American Spice,Lisset Limpio -020,CAFETERIA y RESTAURANTS,1384675,Aug
2024-08-29,Bravo   Francisco Diaz,Invoice,008-03616,Liquids:AS Cooking Wine,4/1 Gl.,1.0,17.5,17.5,3373485.03999998,American Spice,Lisset Limpio -020,RETAIL  DSD,1384676,Aug
2024-08-29,Bravo   Francisco Diaz,Invoice,008-03616,Liquids:AS White Vinegar,4/1 Gl.,1.0,10.0,10.0,3373495.03999998,American Spice,Lisset Limpio -020,RETAIL  DSD,1384677,Aug
2024-08-29,Bravo   Francisco Diaz,Invoice,008-03616,Arroz a Granel:Largo Fino 50 LB -Bolsa Dos Hermanos.,,4.0,27.85,111.4,3373606.43999998,Bulk Rice,Lisset Limpio -020,RETAIL  DSD,1384678,Aug
2024-08-29,Vitos Meat and Provisions,Invoice,008-03617,Arroz a Granel:Parboiled 50 LB -Bolsa Dos Hermanos.,,30.0,27.75,832.5,3374438.93999998,Bulk Rice,Keila Alfaro-Visvikis,WHOLESALER,1384679,Aug
2024-08-29,El Palacio de Los Jugos / Casa mía Food Restaurant inc,Invoice,008-03618,Arroz a Granel:Parboiled 50 LB -Bolsa Dos Hermanos.,,11.0,27.75,305.25,3374744.18999998,Bulk Rice,Lisset Limpio -020,Cafeteria,1384680,Aug
2024-08-29,El Palacio de Los Jugos / Casa mía Food Restaurant inc,Invoice,008-03618,Dry Beans:Dry Beans - Black Beans 50,Dry Black Beans 50 lb,1.0,45.7,45.7,3374789.88999998,Dry Beans,Lisset Limpio -020,Cafeteria,1384681,Aug
2024-08-29,El Palacio de Los Jugos / Casa mía Food Restaurant inc,Invoice,008-03618,Arroz a Granel:Parboiled 50 LB -Bolsa Dos Hermanos.,,1.0,27.75,27.75,3374817.63999998,Bulk Rice,Lisset Limpio -020,Cafeteria,1384682,Aug
2024-08-29,El Palacio de los jugos / Lita Foods Inc.,Invoice,008-03619,Arroz a Granel:Parboiled 50 LB -Bolsa Dos Hermanos.,,11.0,27.75,305.25,3375122.88999998,Bulk Rice,Lisset Limpio -020,Cafeteria,1384683,Aug
2024-08-29,El Palacio de los jugos / Lita Foods Inc.,Invoice,008-03619,Dry Beans:Dry Beans - Black Beans 50,Dry Black Beans 50 lb,1.0,45.7,45.7,3375168.58999998,Dry Beans,Lisset Limpio -020,Cafeteria,1384684,Aug
2024-08-29,El Palacio de los jugos / Lita Foods Inc.,Invoice,008-03619,Arroz a Granel:Parboiled 50 LB -Bolsa Dos Hermanos.,,1.0,27.75,27.75,3375196.33999998,Bulk Rice,Lisset Limpio -020,Cafeteria,1384685,Aug
2024-08-29,Pacifico Chinese Restaurant,Invoice,008-03620,Arroz a Granel:Parboiled 50 LB -Bolsa Dos Hermanos.,,10.0,28.25,282.5,3375478.83999998,Bulk Rice,Lisset Limpio -020,CAFETERIA y RESTAURANTS,1384686,Aug
2024-08-29,Sedanos Supermarkets #16,Invoice,008-03621,Arroz a Granel:Parboiled 50 LB -Bolsa Dos Hermanos.,,4.0,28.25,113.0,3375591.83999998,Bulk Rice,Lisset Limpio -020,RETAIL SEDANOS,1384687,Aug
2024-08-29,Sedanos Supermarkets #16,Invoice,008-03621,,Discount,,,-2.26,3375589.57999998,,Lisset Limpio -020,RETAIL SEDANOS,1384688,Aug
2024-08-29,Los Caringas Latin America  Foods,Invoice,008-03622,Arroz a Granel:Largo Fino 50 LB -Bolsa Dos Hermanos.,,3.0,27.85,83.55,3375673.12999998,Bulk Rice,Lisset Limpio -020,CAFETERIA y RESTAURANTS,1384689,Aug
2024-08-29,Los Caringas Latin America  Foods,Invoice,008-03622,Arroz a Granel:Parboiled 50 LB -Bolsa Dos Hermanos.,,3.0,28.25,84.75,3375757.87999998,Bulk Rice,Lisset Limpio -020,CAFETERIA y RESTAURANTS,1384690,Aug
2024-08-29,Sedanos Supermarkets #8,Invoice,008-03623,Arroz Envasado:Parboiled 5KG Dos Hermanos.,6 / 11lbs,5.0,40.5,202.5,3375960.37999998,Branded Rice,Lisset Limpio -020,RETAIL SEDANOS,1384691,Aug
2024-08-29,Sedanos Supermarkets #8,Invoice,008-03623,Arroz Envasado:Parboiled 5KG Dos Hermanos.,6 / 11lbs,5.0,40.5,202.5,3376162.87999998,Branded Rice,Lisset Limpio -020,RETAIL SEDANOS,1384692,Aug
2024-08-29,Sedanos Supermarkets #8,Invoice,008-03623,,Discount,,,-4.05,3376158.82999998,,Lisset Limpio -020,RETAIL SEDANOS,1384693,Aug
2024-08-29,Sedanos Supermarkets #32,Invoice,008-03624,Arroz a Granel:Parboiled 50 LB -Bolsa Dos Hermanos.,,5.0,28.25,141.25,3376300.07999998,Bulk Rice,Lisset Limpio -020,RETAIL SEDANOS,1384694,Aug
2024-08-29,Sedanos Supermarkets #32,Invoice,008-03624,,Discount,,,-2.83,3376297.24999998,,Lisset Limpio -020,RETAIL SEDANOS,1384695,Aug
2024-08-29,El Palacio de los jugos /  Mires Restaurants,Invoice,008-03625,Liquids:AS Marinating Sauce (Mojo),,1.0,18.5,18.5,3376315.74999998,American Spice,Lisset Limpio -020,Cafeteria,1384696,Aug
2024-08-29,El Palacio de los jugos /  Mires Restaurants,Invoice,008-03625,Arroz a Granel:Parboiled 50 LB -Bolsa Dos Hermanos.,,11.0,27.75,305.25,3376620.99999998,Bulk Rice,Lisset Limpio -020,Cafeteria,1384697,Aug
2024-08-29,El Palacio de los jugos /  Mires Restaurants,Invoice,008-03625,Arroz a Granel:Parboiled 50 LB -Bolsa Dos Hermanos.,,1.0,27.75,27.75,3376648.74999998,Bulk Rice,Lisset Limpio -020,Cafeteria,1384698,Aug
2024-08-29,El Palacio de los jugos / Delicias Criollas (DIAGO FOOD_MILLER),Invoice,008-03626,Arroz a Granel:Parboiled 50 LB -Bolsa Dos Hermanos.,,11.0,27.75,305.25,3376953.99999998,Bulk Rice,Lisset Limpio -020,Cafeteria,1384699,Aug
2024-08-29,El Palacio de los jugos / Delicias Criollas (DIAGO FOOD_MILLER),Invoice,008-03626,Liquids:AS Lemon Juice 4/1 Gl,,1.0,14.95,14.95,3376968.94999998,American Spice,Lisset Limpio -020,Cafeteria,1384700,Aug
2024-08-29,El Palacio de los jugos / Delicias Criollas (DIAGO FOOD_MILLER),Invoice,008-03626,Arroz a Granel:Parboiled 50 LB -Bolsa Dos Hermanos.,,1.0,27.75,27.75,3376996.69999998,Bulk Rice,Lisset Limpio -020,Cafeteria,1384701,Aug
2024-08-29,Sedanos Supermarkets #18,Invoice,008-03627,Arroz a Granel:Parboiled 50 LB -Bolsa Dos Hermanos.,,10.0,28.25,282.5,3377279.19999998,Bulk Rice,Lisset Limpio -020,RETAIL SEDANOS,1384702,Aug
2024-08-29,Sedanos Supermarkets #18,Invoice,008-03627,,Discount,,,-5.65,3377273.54999998,,Lisset Limpio -020,RETAIL SEDANOS,1384703,Aug
2024-08-29,El Gallego Supermarket,Invoice,008-03628,Dry Beans:Dry Beans - Black Beans 50,Dry Black Beans 50 lb,2.0,45.7,91.4,3377364.94999998,Dry Beans,Lisset Limpio -020,RETAIL  DSD,1384704,Aug
2024-08-29,El Gallego Supermarket,Invoice,008-03628,Arroz a Granel:Parboiled 50 LB -Bolsa Dos Hermanos.,,5.0,28.25,141.25,3377506.19999998,Bulk Rice,Lisset Limpio -020,RETAIL  DSD,1384705,Aug
2024-08-29,Sedanos Supermarkets #5,Invoice,008-03629,Arroz Envasado:Parboiled 5KG Dos Hermanos.,6 / 11lbs,5.0,40.5,202.5,3377708.69999998,Branded Rice,Lisset Limpio -020,RETAIL SEDANOS,1384706,Aug
2024-08-29,Sedanos Supermarkets #5,Invoice,008-03629,Arroz Envasado:Parboiled 5KG Dos Hermanos.,6 / 11lbs,5.0,40.5,202.5,3377911.19999998,Branded Rice,Lisset Limpio -020,RETAIL SEDANOS,1384707,Aug
2024-08-29,Sedanos Supermarkets #5,Invoice,008-03629,,Discount,,,-4.05,3377907.14999998,,Lisset Limpio -020,RETAIL SEDANOS,1384708,Aug
2024-08-29,Be Your Will LLC,Invoice,008-03630,Liquids:AS Cooking Wine,4/1 Gl.,2.0,17.5,35.0,3377942.14999998,American Spice,Lisset Limpio -020,CAFETERIA y RESTAURANTS,1384709,Aug
2024-08-29,Be Your Will LLC,Invoice,008-03630,Dry Beans:Dry Beans - Black Beans 50,Dry Black Beans 50 lb,1.0,45.7,45.7,3377987.84999998,Dry Beans,Lisset Limpio -020,CAFETERIA y RESTAURANTS,1384710,Aug
2024-08-29,Be Your Will LLC,Invoice,008-03630,Arroz a Granel:Parboiled 50 LB -Bolsa Dos Hermanos.,,11.0,27.75,305.25,3378293.09999998,Bulk Rice,Lisset Limpio -020,CAFETERIA y RESTAURANTS,1384711,Aug
2024-08-29,Be Your Will LLC,Invoice,008-03630,Arroz a Granel:Parboiled 50 LB -Bolsa Dos Hermanos.,,1.0,27.75,27.75,3378320.84999998,Bulk Rice,Lisset Limpio -020,CAFETERIA y RESTAURANTS,1384712,Aug
2024-08-29,El Palacio de Los Jugos / Casa mía Food Restaurant inc,Credit Memo,008-03688,Varios:Promotional Allowance,,-1.0,27.75,-27.75,3378293.09999998,Bulk Rice,Lisset Limpio -020,Cafeteria,1384713,Aug
2024-08-29,El Palacio de los jugos / Lita Foods Inc.,Credit Memo,008-03689,Varios:Promotional Allowance,,-1.0,27.75,-27.75,3378265.34999998,Bulk Rice,Lisset Limpio -020,Cafeteria,1384714,Aug
2024-08-29,Sedanos Supermarkets #8,Credit Memo,008-03690,Varios:Promotional Allowance,,-5.0,40.5,-202.5,3378062.84999998,Branded Rice,Lisset Limpio -020,RETAIL SEDANOS,1384715,Aug
2024-08-29,El Palacio de los jugos /  Mires Restaurants,Credit Memo,008-03691,Varios:Promotional Allowance,,-1.0,27.75,-27.75,3378035.09999998,Bulk Rice,Lisset Limpio -020,Cafeteria,1384716,Aug
2024-08-29,El Palacio de los jugos / Delicias Criollas (DIAGO FOOD_MILLER),Credit Memo,008-03692,Varios:Promotional Allowance,,-1.0,27.75,-27.75,3378007.34999998,Bulk Rice,Lisset Limpio -020,Cafeteria,1384717,Aug
2024-08-29,Sedanos Supermarkets #5,Credit Memo,008-03693,Varios:Promotional Allowance,,-5.0,40.5,-202.5,3377804.84999998,Bulk Rice,Lisset Limpio -020,RETAIL SEDANOS,1384718,Aug
2024-08-29,Be Your Will LLC,Credit Memo,008-03694,Varios:Promotional Allowance,,-1.0,27.75,-27.75,3377777.09999998,Bulk Rice,Lisset Limpio -020,CAFETERIA y RESTAURANTS,1384719,Aug
2024-08-30,Los Mejores Tamales de Miami,Credit Memo,008-03631,Varios:Producto vencido/deteriorado (no impacta en inventario),GORGOJOS,-1.0,28.65,-28.65,3377748.44999998,,Lisset Limpio -020,CAFETERIA y RESTAURANTS,1384720,Aug
2024-08-30,"Soriano Brothers Diaz Food Service,Inc",Credit Memo,008-03632,Varios:Producto vencido/deteriorado (no impacta en inventario),PRESENCIA DE GORGOJOS,-1.0,71.5,-71.5,3377676.94999998,,Lisset Limpio -020,CAFETERIA y RESTAURANTS,1384721,Aug
2024-08-31,Bravo   Francisco Diaz,Credit Memo,008-03706,Varios:Producto vencido/deteriorado (no impacta en inventario),ajuste,-1.0,0.75,-0.75,3377676.19999998,,Lisset Limpio -020,RETAIL  DSD,1384722,Aug
2024-08-31,Busy Bee Latin America Food Market,Credit Memo,008-03707,Varios:Producto vencido/deteriorado (no impacta en inventario),ajuste,-1.0,640.9,-640.9,3377035.29999998,,Keila Alfaro-Visvikis,RETAIL  DSD,1384723,Aug
2024-08-31,Los Mejores Tamales de Miami,Credit Memo,008-03708,Varios:Producto vencido/deteriorado (no impacta en inventario),ajuste,-1.0,83.55,-83.55,3376951.74999998,,Lisset Limpio -020,CAFETERIA y RESTAURANTS,1384724,Aug
2024-08-31,Price Choice Food Market # 2,Credit Memo,008-03709,Varios:Producto vencido/deteriorado (no impacta en inventario),ajuste,-1.0,10.0,-10.0,3376941.74999998,,Keila Alfaro-Visvikis,RETAIL  DSD,1384725,Aug
2024-08-31,Rey Chavez Distributor Corp,Credit Memo,008-03710,Varios:Producto vencido/deteriorado (no impacta en inventario),ajuste,-1.0,110.0,-110.0,3376831.74999998,,Lisset Limpio -020,WHOLESALER,1384726,Aug
2024-08-31,Super Economic,Credit Memo,008-03712,Varios:Producto vencido/deteriorado (no impacta en inventario),ajuste,-1.0,112.0,-112.0,3376719.74999998,,Lisset Limpio -020,RETAIL  DSD,1384727,Aug
2024-09-03,El Palacio de los jugos / Delicias Criollas (DIAGO FOOD_MILLER),Invoice,008-03695,Arroz a Granel:Parboiled 50 LB -Bolsa Dos Hermanos.,,22.0,27.75,610.5,3377330.24999998,Bulk Rice,Lisset Limpio -020,Cafeteria,1384728,Sep
2024-09-03,El Palacio de los jugos / Delicias Criollas (DIAGO FOOD_MILLER),Invoice,008-03695,Arroz a Granel:Parboiled 50 LB -Bolsa Dos Hermanos.,,2.0,27.75,55.5,3377385.74999998,Bulk Rice,Lisset Limpio -020,Cafeteria,1384729,Sep
2024-09-03,El Palacio de los jugos / Delicias Criollas (DIAGO FOOD_MILLER),Invoice,008-03695,Liquids:AS Bitter Orange,,1.0,15.9,15.9,3377401.64999998,American Spice,Lisset Limpio -020,Cafeteria,1384730,Sep
2024-09-03,Los Mejores Tamales de Miami,Invoice,008-03696,Arroz a Granel:Parboiled 50 LB -Bolsa Dos Hermanos.,,4.0,28.25,113.0,3377514.64999998,Bulk Rice,Lisset Limpio -020,CAFETERIA y RESTAURANTS,1384731,Sep
2024-09-03,Hings Chinese,Invoice,008-03697,Arroz a Granel:Parboiled 50 LB -Bolsa Dos Hermanos.,,5.0,28.25,141.25,3377655.89999998,Bulk Rice,Lisset Limpio -020,CAFETERIA y RESTAURANTS,1384732,Sep
2024-09-03,El Palacio de Los Jugos / Casa mía Food Restaurant inc,Invoice,008-03698,Dry Beans:Dry Beans - Black Beans 50,Dry Black Beans 50 lb,1.0,45.7,45.7,3377701.59999998,Dry Beans,Lisset Limpio -020,Cafeteria,1384733,Sep
2024-09-03,El Palacio de Los Jugos / Casa mía Food Restaurant inc,Invoice,008-03698,Arroz a Granel:Parboiled 50 LB -Bolsa Dos Hermanos.,,11.0,27.75,305.25,3378006.84999998,Bulk Rice,Lisset Limpio -020,Cafeteria,1384734,Sep
2024-09-03,El Palacio de Los Jugos / Casa mía Food Restaurant inc,Invoice,008-03698,Arroz a Granel:Parboiled 50 LB -Bolsa Dos Hermanos.,,1.0,27.75,27.75,3378034.59999998,Bulk Rice,Lisset Limpio -020,Cafeteria,1384735,Sep
2024-09-03,Aries Supermarket & Cafeteria,Invoice,008-03699,Arroz a Granel:Parboiled 50 LB -Bolsa Dos Hermanos.,,10.0,28.25,282.5,3378317.09999998,Bulk Rice,Keila Alfaro-Visvikis,CAFETERIA y RESTAURANTS,1384736,Sep
2024-09-03,El Palacio de los jugos /  Nanos Latin Foods,Invoice,008-03700,Dry Beans:Dry Beans - Black Beans 50,Dry Black Beans 50 lb,1.0,45.7,45.7,3378362.79999998,Dry Beans,Lisset Limpio -020,Cafeteria,1384737,Sep
2024-09-03,El Palacio de los jugos /  Nanos Latin Foods,Invoice,008-03700,Arroz a Granel:Parboiled 50 LB -Bolsa Dos Hermanos.,,11.0,27.75,305.25,3378668.04999998,Bulk Rice,Lisset Limpio -020,Cafeteria,1384738,Sep
2024-09-03,El Palacio de los jugos /  Nanos Latin Foods,Invoice,008-03700,Arroz a Granel:Parboiled 50 LB -Bolsa Dos Hermanos.,,1.0,27.75,27.75,3378695.79999998,Bulk Rice,Lisset Limpio -020,Cafeteria,1384739,Sep
2024-09-03,"El Toro Loco Meat Distribution, LLC",Invoice,008-03701,Dry Beans:Dry Beans - Black Beans 50,Dry Black Beans 50 lb,55.0,42.5,2337.5,3381033.29999998,Dry Beans,Lisset Limpio -020,CAFETERIA y RESTAURANTS,1384740,Sep
2024-09-03,Fritanga Momotombo,Invoice,008-03702,Arroz a Granel:Largo Fino 50 LB -Bolsa Dos Hermanos.,,6.0,27.85,167.1,3381200.39999998,Bulk Rice,Lisset Limpio -020,CAFETERIA y RESTAURANTS,1384741,Sep
2024-09-03,Sedanos Supermarkets #36,Credit Memo,008-03703,Varios:Producto vencido/deteriorado (no impacta en inventario),7 unidades mixed de Snacks a $1.49,-1.0,10.43,-10.43,3381189.96999998,Puffed Products,Keila Alfaro-Visvikis,RETAIL SEDANOS,1384742,Sep
2024-09-03,Neighbors Food Market / Luis Diaz,Invoice,008-03704,Arroz Envasado:Largo Fino 1kg (Long grain rice) Dos Hermanos,,1.0,17.0,17.0,3381206.96999998,Branded Rice,Keila Alfaro-Visvikis,RETAIL  DSD,1384743,Sep
2024-09-03,Neighbors Food Market / Luis Diaz,Invoice,008-03704,Arroz Envasado:Parboiled 1kg Bolsa Dos Hermanos.,.,1.0,19.9,19.9,3381226.86999998,Branded Rice,Keila Alfaro-Visvikis,RETAIL  DSD,1384744,Sep
2024-09-03,Neighbors Food Market / Luis Diaz,Invoice,008-03704,Arroz Envasado:Parboiled 5KG Dos Hermanos.,6 / 11lbs,1.0,46.5,46.5,3381273.36999998,Branded Rice,Keila Alfaro-Visvikis,RETAIL  DSD,1384745,Sep
2024-09-03,Neighbors Food Market / Luis Diaz,Invoice,008-03704,Arroz Envasado:Largo Fino 1kg (Long grain rice) Dos Hermanos,,1.0,17.0,17.0,3381290.36999998,Branded Rice,Keila Alfaro-Visvikis,RETAIL  DSD,1384746,Sep
2024-09-03,Sedanos Supermarkets #36,Invoice,008-03705,"Rice Snack:Rice Snack, Pizza DH",,1.0,19.9,19.9,3381310.26999998,Puffed Products,Keila Alfaro-Visvikis,RETAIL SEDANOS,1384747,Sep
2024-09-03,Sedanos Supermarkets #36,Invoice,008-03705,Rice Snack:Rice Snack Salami Flavored DOS HERMANOS,,1.0,19.9,19.9,3381330.16999998,Puffed Products,Keila Alfaro-Visvikis,RETAIL SEDANOS,1384748,Sep
2024-09-03,Sedanos Supermarkets #36,Invoice,008-03705,Rice Snack:Rice Snack Ham Flavored DOS HERMANOS,,2.0,19.9,39.8,3381369.96999998,Puffed Products,Keila Alfaro-Visvikis,RETAIL SEDANOS,1384749,Sep
2024-09-03,Sedanos Supermarkets #36,Invoice,008-03705,,Discount,,,-1.19,3381368.77999998,,Keila Alfaro-Visvikis,RETAIL SEDANOS,1384750,Sep
2024-09-03,Sedanos Supermarkets #22,Credit Memo,008-03724,Varios:Producto vencido/deteriorado (no impacta en inventario),20 unidades snack,-20.0,1.49,-29.8,3381338.97999998,,Lisset Limpio -020,RETAIL SEDANOS,1384751,Sep
2024-09-03,El Palacio de los jugos / Delicias Criollas (DIAGO FOOD_MILLER),Credit Memo,008-03838,Varios:Promotional Allowance,50lb,-2.0,27.75,-55.5,3381283.47999998,Puffed Products,Lisset Limpio -020,Cafeteria,1384752,Sep
2024-09-03,El Palacio de Los Jugos / Casa mía Food Restaurant inc,Credit Memo,008-03839,Varios:Promotional Allowance,50lb p,-1.0,27.75,-27.75,3381255.72999998,Bulk Rice,Lisset Limpio -020,Cafeteria,1384753,Sep
2024-09-03,El Palacio de los jugos /  Nanos Latin Foods,Credit Memo,008-03840,Varios:Promotional Allowance,1 50LB parbo,-1.0,27.75,-27.75,3381227.97999998,Bulk Rice,Lisset Limpio -020,Cafeteria,1384754,Sep
2024-09-03,Neighbors Food Market / Luis Diaz,Credit Memo,008-03841,Varios:Promotional Allowance,1 lf 1kg,-1.0,17.0,-17.0,3381210.97999998,Branded Rice,Keila Alfaro-Visvikis,RETAIL  DSD,1384755,Sep
2024-09-03,Sedanos Supermarkets #36,Credit Memo,008-03842,Varios:Promotional Allowance,snackpizza,-1.0,19.9,-19.9,3381191.07999998,Puffed Products,Keila Alfaro-Visvikis,RETAIL SEDANOS,1384756,Sep
2024-09-04,Sedanos Supermarkets #36,Credit Memo,008-03713,Arroz Envasado:Parboiled 5KG Dos Hermanos.,18 units en 1X1,-3.0,20.25,-60.75,3381130.32999998,Branded Rice,Keila Alfaro-Visvikis,RETAIL SEDANOS,1384757,Sep
2024-09-04,Sedanos Supermarkets #36,Invoice,008-03714,Arroz Envasado:Parboiled 5KG Dos Hermanos.,6 / 11lbs,3.0,40.5,121.5,3381251.82999998,Branded Rice,Keila Alfaro-Visvikis,RETAIL SEDANOS,1384758,Sep
2024-09-04,Sedanos Supermarkets #36,Invoice,008-03714,Arroz Envasado:Parboiled 5KG Dos Hermanos.,6 / 11lbs,3.0,40.5,121.5,3381373.32999998,Branded Rice,Keila Alfaro-Visvikis,RETAIL SEDANOS,1384759,Sep
2024-09-04,Sedanos Supermarkets #36,Invoice,008-03714,,Discount,,,-2.43,3381370.89999998,,Keila Alfaro-Visvikis,RETAIL SEDANOS,1384760,Sep
2024-09-04,Rey Chavez Distributor #2,Invoice,008-03715,Arroz a Granel:Parboiled 50 LB -Bolsa Dos Hermanos.,,30.0,28.8,864.0,3382234.89999998,Bulk Rice,Lisset Limpio -020,WHOLESALER,1384761,Sep
2024-09-04,Sedanos Supermarkets #27,Invoice,008-03716,Arroz a Granel:Parboiled 50 LB -Bolsa Dos Hermanos.,,6.0,28.25,169.5,3382404.39999998,Bulk Rice,Keila Alfaro-Visvikis,RETAIL SEDANOS,1384762,Sep
2024-09-04,Sedanos Supermarkets #27,Invoice,008-03716,,Discount,,,-3.39,3382401.00999998,,Keila Alfaro-Visvikis,RETAIL SEDANOS,1384763,Sep
2024-09-04,JMN Dely Corp,Invoice,008-03717,Dry Beans:Dry Beans - Black Beans 50,Dry Black Beans 50 lb,2.0,45.7,91.4,3382492.40999998,Dry Beans,Keila Alfaro-Visvikis,CAFETERIA y RESTAURANTS,1384764,Sep
2024-09-04,JMN Dely Corp,Invoice,008-03717,Arroz a Granel:Parboiled 50 LB -Bolsa Dos Hermanos.,,3.0,27.75,83.25,3382575.65999998,Bulk Rice,Keila Alfaro-Visvikis,CAFETERIA y RESTAURANTS,1384765,Sep
2024-09-04,JMN Dely Corp,Invoice,008-03717,Arroz a Granel:Largo Fino 50 LB -Bolsa Dos Hermanos.,,4.0,27.85,111.4,3382687.05999998,Bulk Rice,Keila Alfaro-Visvikis,CAFETERIA y RESTAURANTS,1384766,Sep
2024-09-04,Key Food Weston,Invoice,008-03718,Arroz Envasado:Largo Fino 1kg (Long grain rice) Dos Hermanos,,2.0,17.0,34.0,3382721.05999998,Branded Rice,Lisset Limpio -020,RETAIL  DSD,1384767,Sep
2024-09-04,Key Food Weston,Invoice,008-03718,Arroz Envasado:Parboiled 1kg Bolsa Dos Hermanos.,.,3.0,19.9,59.7,3382780.75999998,Branded Rice,Lisset Limpio -020,RETAIL  DSD,1384768,Sep
2024-09-04,Key Food Weston,Invoice,008-03718,Arroz Envasado:Largo Fino 1kg (Long grain rice) Dos Hermanos,,1.0,17.0,17.0,3382797.75999998,Branded Rice,Lisset Limpio -020,RETAIL  DSD,1384769,Sep
2024-09-04,Ideal Food Basket Davie Grocery,Invoice,008-03719,Arroz Envasado:Largo Fino 1kg (Long grain rice) Dos Hermanos,,2.0,17.0,34.0,3382831.75999998,Branded Rice,Keila Alfaro-Visvikis,RETAIL  DSD,1384770,Sep
2024-09-04,Ideal Food Basket Davie Grocery,Invoice,008-03719,Arroz Envasado:Parboiled 1kg Bolsa Dos Hermanos.,.,3.0,19.9,59.7,3382891.45999998,Branded Rice,Keila Alfaro-Visvikis,RETAIL  DSD,1384771,Sep
2024-09-04,Ideal Food Basket Davie Grocery,Invoice,008-03719,Arroz Envasado:Largo Fino 1kg (Long grain rice) Dos Hermanos,,1.0,17.0,17.0,3382908.45999998,Branded Rice,Keila Alfaro-Visvikis,RETAIL  DSD,1384772,Sep
2024-09-04,Ideal Food Basket Davie Cafeteria,Invoice,008-03720,Arroz a Granel:Largo Fino 50 LB -Bolsa Dos Hermanos.,,10.0,27.85,278.5,3383186.95999998,Bulk Rice,Keila Alfaro-Visvikis,CAFETERIA y RESTAURANTS,1384773,Sep
2024-09-04,Sedanos Supermarkets #24,Invoice,008-03721,Arroz a Granel:Parboiled 50 LB -Bolsa Dos Hermanos.,,2.0,28.25,56.5,3383243.45999998,Bulk Rice,Keila Alfaro-Visvikis,RETAIL SEDANOS,1384774,Sep
2024-09-04,Sedanos Supermarkets #24,Invoice,008-03721,Arroz Envasado:Parboiled 5KG Dos Hermanos.,6 / 11lbs,1.0,40.5,40.5,3383283.95999998,Branded Rice,Keila Alfaro-Visvikis,RETAIL SEDANOS,1384775,Sep
2024-09-04,Sedanos Supermarkets #24,Invoice,008-03721,,Discount,,,-9.89,3383274.06999998,,Keila Alfaro-Visvikis,RETAIL SEDANOS,1384776,Sep
2024-09-04,Bravo 5851 Lake Worth Road,Invoice,008-03722,Arroz Envasado:Parboiled 5KG Dos Hermanos.,6 / 11lbs,20.0,46.5,930.0,3384204.06999998,Branded Rice,Keila Alfaro-Visvikis,RETAIL  DSD,1384777,Sep
2024-09-04,Bravo 5851 Lake Worth Road,Invoice,008-03722,Arroz Envasado:Parboiled 1kg Bolsa Dos Hermanos.,.,3.0,19.9,59.7,3384263.76999998,Branded Rice,Keila Alfaro-Visvikis,RETAIL  DSD,1384778,Sep
2024-09-04,Bravo 5851 Lake Worth Road,Invoice,008-03722,Arroz Envasado:Largo Fino 1kg (Long grain rice) Dos Hermanos,,2.0,17.0,34.0,3384297.76999998,Branded Rice,Keila Alfaro-Visvikis,RETAIL  DSD,1384779,Sep
2024-09-04,Bravo 5851 Lake Worth Road,Invoice,008-03722,Arroz Envasado:Largo Fino 1kg (Long grain rice) Dos Hermanos,,1.0,17.0,17.0,3384314.76999998,Branded Rice,Keila Alfaro-Visvikis,RETAIL  DSD,1384780,Sep
2024-09-04,Bravo 5851 Lake Worth Road,Invoice,008-03722,Arroz Envasado:Parboiled 5KG Dos Hermanos.,6 / 11lbs,20.0,46.5,930.0,3385244.76999998,Branded Rice,Keila Alfaro-Visvikis,RETAIL  DSD,1384781,Sep
2024-09-04,Sedanos Supermarkets #24,Credit Memo,008-03723,Varios:Producto vencido/deteriorado (no impacta en inventario),2 units snack,-2.0,1.49,-2.98,3385241.78999998,,Keila Alfaro-Visvikis,RETAIL SEDANOS,1384782,Sep
2024-09-04,Key Food Weston,Credit Memo,008-03843,Varios:Promotional Allowance,1 lf 1kg,-1.0,17.0,-17.0,3385224.78999998,Branded Rice,Lisset Limpio -020,RETAIL  DSD,1384783,Sep
2024-09-04,Ideal Food Basket Davie Grocery,Credit Memo,008-03844,Varios:Promotional Allowance,1kg lf,-1.0,17.0,-17.0,3385207.78999998,Branded Rice,Keila Alfaro-Visvikis,RETAIL  DSD,1384784,Sep
2024-09-04,Bravo 5851 Lake Worth Road,Credit Memo,008-03845,Varios:Promotional Allowance,kg lf,-1.0,17.0,-17.0,3385190.78999998,Branded Rice,Keila Alfaro-Visvikis,RETAIL  DSD,1384785,Sep
2024-09-04,Bravo 5851 Lake Worth Road,Credit Memo,008-03845,Varios:Promotional Allowance,parbo 5kg,-20.0,46.5,-930.0,3384260.78999998,Branded Rice,Keila Alfaro-Visvikis,RETAIL  DSD,1384786,Sep
2024-09-04,Sedanos Supermarkets #36,Credit Memo,008-03846,Varios:Promotional Allowance,5kg,-3.0,40.5,-121.5,3384139.28999998,Branded Rice,Keila Alfaro-Visvikis,RETAIL SEDANOS,1384787,Sep
2024-09-05,Sedanos Supermarkets #16,Invoice,008-03725,Arroz a Granel:Parboiled 50 LB -Bolsa Dos Hermanos.,,3.0,28.25,84.75,3384224.03999998,Bulk Rice,Lisset Limpio -020,RETAIL SEDANOS,1384788,Sep
2024-09-05,Sedanos Supermarkets #16,Invoice,008-03725,,Discount,,,-1.7,3384222.33999998,,Lisset Limpio -020,RETAIL SEDANOS,1384789,Sep
2024-09-05,Sedanos Supermarkets #43,Invoice,008-03726,Arroz a Granel:Parboiled 50 LB -Bolsa Dos Hermanos.,,5.0,28.25,141.25,3384363.58999998,Bulk Rice,Lisset Limpio -020,RETAIL SEDANOS,1384790,Sep
2024-09-05,Sedanos Supermarkets #43,Invoice,008-03726,,Discount,,,-2.83,3384360.75999998,,Lisset Limpio -020,RETAIL SEDANOS,1384791,Sep
2024-09-05,Sedanos Supermarkets #22,Invoice,008-03727,Arroz a Granel:Parboiled 50 LB -Bolsa Dos Hermanos.,,4.0,28.25,113.0,3384473.75999998,Bulk Rice,Lisset Limpio -020,RETAIL SEDANOS,1384792,Sep
2024-09-05,Sedanos Supermarkets #22,Invoice,008-03727,Rice Snack:Rice Snack Ham Flavored DOS HERMANOS,,2.0,19.9,39.8,3384513.55999998,Puffed Products,Lisset Limpio -020,RETAIL SEDANOS,1384793,Sep
2024-09-05,Bravo   Francisco Diaz,Invoice,008-03728,Arroz a Granel:Largo Fino 50 LB -Bolsa Dos Hermanos.,,6.0,27.85,167.1,3384680.65999998,Bulk Rice,Lisset Limpio -020,RETAIL  DSD,1384794,Sep
2024-09-05,El Palacio de los jugos / Lita Foods Inc.,Invoice,008-03729,Arroz a Granel:Parboiled 50 LB -Bolsa Dos Hermanos.,,11.0,27.75,305.25,3384985.90999998,Bulk Rice,Lisset Limpio -020,Cafeteria,1384795,Sep
2024-09-05,El Palacio de los jugos / Lita Foods Inc.,Invoice,008-03729,Dry Beans:Dry Beans - Black Beans 50,Dry Black Beans 50 lb,1.0,45.7,45.7,3385031.60999998,Dry Beans,Lisset Limpio -020,Cafeteria,1384796,Sep
2024-09-05,El Palacio de los jugos / Lita Foods Inc.,Invoice,008-03729,Arroz a Granel:Parboiled 50 LB -Bolsa Dos Hermanos.,,1.0,27.75,27.75,3385059.35999998,Bulk Rice,Lisset Limpio -020,Cafeteria,1384797,Sep
2024-09-05,Soriano Brothers PB,Invoice,008-03730,Dry Beans:Dry Beans - Black Beans 50,Dry Black Beans 50 lb,2.0,45.7,91.4,3385150.75999998,Dry Beans,Lisset Limpio -020,CAFETERIA y RESTAURANTS,1384798,Sep
2024-09-05,Soriano Brothers PB,Invoice,008-03730,Arroz a Granel:Largo Fino 50 LB -Bolsa Dos Hermanos.,,15.0,27.85,417.75,3385568.50999998,Bulk Rice,Lisset Limpio -020,CAFETERIA y RESTAURANTS,1384799,Sep
2024-09-05,Soriano Brothers PB,Invoice,008-03730,Arroz a Granel:Parboiled 50 LB -Bolsa Dos Hermanos.,,11.0,27.75,305.25,3385873.75999998,Bulk Rice,Lisset Limpio -020,CAFETERIA y RESTAURANTS,1384800,Sep
2024-09-05,Soriano Brothers PB,Invoice,008-03730,Arroz a Granel:Parboiled 50 LB -Bolsa Dos Hermanos.,,1.0,27.75,27.75,3385901.50999998,Bulk Rice,Lisset Limpio -020,CAFETERIA y RESTAURANTS,1384801,Sep
2024-09-05,ALS Foods,Invoice,008-03731,Arroz a Granel:Parboiled 50 LB -Bolsa Dos Hermanos.,,11.0,27.75,305.25,3386206.75999998,Bulk Rice,Lisset Limpio -020,CAFETERIA y RESTAURANTS,1384802,Sep
2024-09-05,ALS Foods,Invoice,008-03731,Arroz a Granel:Parboiled 50 LB -Bolsa Dos Hermanos.,,1.0,27.25,27.25,3386234.00999998,Bulk Rice,Lisset Limpio -020,CAFETERIA y RESTAURANTS,1384803,Sep
2024-09-05,Sedanos Supermarkets #1,Invoice,008-03732,Rice Snack:Rice Snack Ham Flavored DOS HERMANOS,,2.0,19.9,39.8,3386273.80999998,Puffed Products,Lisset Limpio -020,RETAIL SEDANOS,1384804,Sep
2024-09-05,Sedanos Supermarkets #1,Invoice,008-03732,Rice Snack:Rice Snack Salami Flavored DOS HERMANOS,,1.0,19.9,19.9,3386293.70999998,Puffed Products,Lisset Limpio -020,RETAIL SEDANOS,1384805,Sep
2024-09-05,Sedanos Supermarkets #1,Invoice,008-03732,Rice Snack:Rice Snack Salami Flavored DOS HERMANOS,,1.0,19.9,19.9,3386313.60999998,Puffed Products,Lisset Limpio -020,RETAIL SEDANOS,1384806,Sep
2024-09-05,Sedanos Supermarkets #1,Invoice,008-03732,,Discount,,,-1.19,3386312.41999998,,Lisset Limpio -020,RETAIL SEDANOS,1384807,Sep
2024-09-05,Sedanos Supermarkets  #11,Invoice,008-03733,Arroz Envasado:Parboiled 5KG Dos Hermanos.,6 / 11lbs,2.0,40.5,81.0,3386393.41999998,Branded Rice,Lisset Limpio -020,RETAIL SEDANOS,1384808,Sep
2024-09-05,Sedanos Supermarkets  #11,Invoice,008-03733,Varios:Promotional Allowance,6/11lbs,2.0,-11.15,-22.3,3386371.11999998,Branded Rice,Lisset Limpio -020,RETAIL SEDANOS,1384809,Sep
2024-09-05,Sedanos Supermarkets  #11,Invoice,008-03733,,Discount,,,-1.17,3386369.94999998,,Lisset Limpio -020,RETAIL SEDANOS,1384810,Sep
2024-09-05,El Palacio de Los Jugos / Casa mía Food Restaurant inc,Invoice,008-03734,Arroz a Granel:Parboiled 50 LB -Bolsa Dos Hermanos.,,11.0,27.75,305.25,3386675.19999998,Bulk Rice,Lisset Limpio -020,Cafeteria,1384811,Sep
2024-09-05,El Palacio de Los Jugos / Casa mía Food Restaurant inc,Invoice,008-03734,Dry Beans:Dry Beans - Black Beans 50,Dry Black Beans 50 lb,1.0,45.7,45.7,3386720.89999998,Dry Beans,Lisset Limpio -020,Cafeteria,1384812,Sep
2024-09-05,El Palacio de Los Jugos / Casa mía Food Restaurant inc,Invoice,008-03734,Arroz a Granel:Parboiled 50 LB -Bolsa Dos Hermanos.,,1.0,27.75,27.75,3386748.64999998,Bulk Rice,Lisset Limpio -020,Cafeteria,1384813,Sep
2024-09-05,Sedanos Supermarkets #31,Invoice,008-03735,Arroz a Granel:Parboiled 50 LB -Bolsa Dos Hermanos.,,4.0,28.25,113.0,3386861.64999998,Bulk Rice,Lisset Limpio -020,RETAIL SEDANOS,1384814,Sep
2024-09-05,Sedanos Supermarkets #31,Invoice,008-03735,,Discount,,,-2.26,3386859.38999998,,Lisset Limpio -020,RETAIL SEDANOS,1384815,Sep
2024-09-05,Mei Chang,Invoice,008-03736,Arroz a Granel:Parboiled 50 LB -Bolsa Dos Hermanos.,,7.0,28.25,197.75,3387057.13999998,Bulk Rice,Lisset Limpio -020,CAFETERIA y RESTAURANTS,1384816,Sep
2024-09-05,Sedanos Supermarkets #33,Invoice,008-03737,Rice Snack:Rice Snack Ham Flavored DOS HERMANOS,,2.0,19.9,39.8,3387096.93999998,Puffed Products,Lisset Limpio -020,RETAIL SEDANOS,1384817,Sep
2024-09-05,Sedanos Supermarkets #33,Invoice,008-03737,Rice Snack:Rice Snack Salami Flavored DOS HERMANOS,,1.0,19.9,19.9,3387116.83999998,Puffed Products,Lisset Limpio -020,RETAIL SEDANOS,1384818,Sep
2024-09-05,Sedanos Supermarkets #33,Invoice,008-03737,Rice Snack:Rice Snack Salami Flavored DOS HERMANOS,,1.0,19.9,19.9,3387136.73999998,Puffed Products,Lisset Limpio -020,RETAIL SEDANOS,1384819,Sep
2024-09-05,Sedanos Supermarkets #33,Invoice,008-03737,,Discount,,,-1.19,3387135.54999998,,Lisset Limpio -020,RETAIL SEDANOS,1384820,Sep
2024-09-05,Sedanos Supermarkets #31,Invoice,008-03738,Arroz Envasado:Parboiled 5KG Dos Hermanos.,6 / 11lbs,20.0,40.5,810.0,3387945.54999998,Branded Rice,Lisset Limpio -020,RETAIL SEDANOS,1384821,Sep
2024-09-05,Sedanos Supermarkets #31,Invoice,008-03738,Arroz Envasado:Parboiled 5KG Dos Hermanos.,6 / 11lbs,20.0,40.5,810.0,3388755.54999998,Branded Rice,Lisset Limpio -020,RETAIL SEDANOS,1384822,Sep
2024-09-05,Sedanos Supermarkets #31,Invoice,008-03738,,Discount,,,-16.2,3388739.34999998,,Lisset Limpio -020,RETAIL SEDANOS,1384823,Sep
2024-09-05,ALS Foods,Credit Memo,008-03847,Varios:Promotional Allowance,50lb p,-1.0,27.75,-27.75,3388711.59999998,Bulk Rice,Lisset Limpio -020,CAFETERIA y RESTAURANTS,1384824,Sep
2024-09-05,Soriano Brothers PB,Credit Memo,008-03848,Varios:Promotional Allowance,50lb p,-1.0,27.75,-27.75,3388683.84999998,Bulk Rice,Lisset Limpio -020,CAFETERIA y RESTAURANTS,1384825,Sep
2024-09-05,El Palacio de los jugos / Lita Foods Inc.,Credit Memo,008-03849,Varios:Promotional Allowance,50lb p,-1.0,27.75,-27.75,3388656.09999998,Bulk Rice,Lisset Limpio -020,Cafeteria,1384826,Sep
2024-09-05,Sedanos Supermarkets #1,Credit Memo,008-03850,Varios:Promotional Allowance,salami,-1.0,19.9,-19.9,3388636.19999998,Puffed Products,Lisset Limpio -020,RETAIL SEDANOS,1384827,Sep
2024-09-05,El Palacio de Los Jugos / Casa mía Food Restaurant inc,Credit Memo,008-03851,Varios:Promotional Allowance,,-1.0,27.75,-27.75,3388608.44999998,Bulk Rice,Lisset Limpio -020,Cafeteria,1384828,Sep
2024-09-05,Sedanos Supermarkets #33,Credit Memo,008-03852,Varios:Promotional Allowance,salami,-1.0,19.9,-19.9,3388588.54999998,Puffed Products,Lisset Limpio -020,RETAIL SEDANOS,1384829,Sep
2024-09-05,Sedanos Supermarkets #31,Credit Memo,008-03853,Varios:Promotional Allowance,5kg p,-20.0,40.5,-810.0,3387778.54999998,Branded Rice,Lisset Limpio -020,RETAIL SEDANOS,1384830,Sep
2024-09-09,JMN Dely Corp,Invoice,008-03739,Dry Beans:Dry Beans - Black Beans 50,Dry Black Beans 50 lb,1.0,45.7,45.7,3387824.24999998,Dry Beans,Keila Alfaro-Visvikis,CAFETERIA y RESTAURANTS,1384831,Sep
2024-09-09,JMN Dely Corp,Invoice,008-03739,Arroz a Granel:Largo Fino 50 LB -Bolsa Dos Hermanos.,,4.0,27.85,111.4,3387935.64999998,Bulk Rice,Keila Alfaro-Visvikis,CAFETERIA y RESTAURANTS,1384832,Sep
2024-09-09,JMN Dely Corp,Invoice,008-03739,Arroz a Granel:Parboiled 50 LB -Bolsa Dos Hermanos.,,2.0,27.75,55.5,3387991.14999998,Bulk Rice,Keila Alfaro-Visvikis,CAFETERIA y RESTAURANTS,1384833,Sep
2024-09-09,Sabor Tropical Supermarket #4,Invoice,008-03740,Arroz a Granel:Parboiled 50 LB -Bolsa Dos Hermanos.,,20.0,28.25,565.0,3388556.14999998,Bulk Rice,Keila Alfaro-Visvikis,RETAIL  DSD,1384834,Sep
2024-09-09,El Palacio de los jugos / Lita Foods Inc.,Invoice,008-03741,Arroz a Granel:Parboiled 50 LB -Bolsa Dos Hermanos.,,11.0,27.75,305.25,3388861.39999998,Bulk Rice,Lisset Limpio -020,Cafeteria,1384835,Sep
2024-09-09,El Palacio de los jugos / Lita Foods Inc.,Invoice,008-03741,Dry Beans:Dry Beans - Black Beans 50,Dry Black Beans 50 lb,1.0,45.7,45.7,3388907.09999998,Dry Beans,Lisset Limpio -020,Cafeteria,1384836,Sep
2024-09-09,El Palacio de los jugos / Lita Foods Inc.,Invoice,008-03741,Arroz a Granel:Parboiled 50 LB -Bolsa Dos Hermanos.,,1.0,27.75,27.75,3388934.84999998,Bulk Rice,Lisset Limpio -020,Cafeteria,1384837,Sep
2024-09-09,Los paraditos chinesse,Invoice,008-03742,Arroz a Granel:Parboiled 50 LB -Bolsa Dos Hermanos.,,10.0,28.25,282.5,3389217.34999998,Bulk Rice,Lisset Limpio -020,CAFETERIA y RESTAURANTS,1384838,Sep
2024-09-09,Be Your Will LLC,Invoice,008-03743,Liquids:AS Bitter Orange,,1.0,14.0,14.0,3389231.34999998,American Spice,Lisset Limpio -020,CAFETERIA y RESTAURANTS,1384839,Sep
2024-09-09,Be Your Will LLC,Invoice,008-03743,Arroz a Granel:Parboiled 50 LB -Bolsa Dos Hermanos.,,11.0,27.75,305.25,3389536.59999998,Bulk Rice,Lisset Limpio -020,CAFETERIA y RESTAURANTS,1384840,Sep
2024-09-09,Be Your Will LLC,Invoice,008-03743,Liquids:AS Lemon Juice 4/1 Gl,,1.0,14.95,14.95,3389551.54999998,American Spice,Lisset Limpio -020,CAFETERIA y RESTAURANTS,1384841,Sep
2024-09-09,Be Your Will LLC,Invoice,008-03743,Arroz a Granel:Parboiled 50 LB -Bolsa Dos Hermanos.,,1.0,27.75,27.75,3389579.29999998,Bulk Rice,Lisset Limpio -020,CAFETERIA y RESTAURANTS,1384842,Sep
2024-09-09,Sedanos Supermarkets #23,Invoice,008-03744,Arroz Envasado:Parboiled 5KG Dos Hermanos.,6 / 11lbs,5.0,40.5,202.5,3389781.79999998,Branded Rice,Lisset Limpio -020,RETAIL SEDANOS,1384843,Sep
2024-09-09,Sedanos Supermarkets #23,Invoice,008-03744,Arroz Envasado:Parboiled 5KG Dos Hermanos.,6 / 11lbs,5.0,40.5,202.5,3389984.29999998,Branded Rice,Lisset Limpio -020,RETAIL SEDANOS,1384844,Sep
2024-09-09,Sedanos Supermarkets #23,Invoice,008-03744,Rice Snack:Rice Snack Salami Flavored DOS HERMANOS,,1.0,19.9,19.9,3390004.19999998,Puffed Products,Lisset Limpio -020,RETAIL SEDANOS,1384845,Sep
2024-09-09,Sedanos Supermarkets #23,Invoice,008-03744,,Discount,,,-4.05,3390000.14999998,,Lisset Limpio -020,RETAIL SEDANOS,1384846,Sep
2024-09-09,Sedanos Supermarkets  #4,Invoice,008-03745,Rice Snack:Rice Snack Ham Flavored DOS HERMANOS,,1.0,19.9,19.9,3390020.04999998,Puffed Products,Lisset Limpio -020,RETAIL SEDANOS,1384847,Sep
2024-09-09,Sedanos Supermarkets  #4,Invoice,008-03745,Rice Snack:Rice Snack Salami Flavored DOS HERMANOS,,2.0,19.9,39.8,3390059.84999998,Puffed Products,Lisset Limpio -020,RETAIL SEDANOS,1384848,Sep
2024-09-09,Sedanos Supermarkets  #4,Invoice,008-03745,Rice Snack:Rice Snack Ham Flavored DOS HERMANOS,,1.0,19.9,19.9,3390079.74999998,Puffed Products,Lisset Limpio -020,RETAIL SEDANOS,1384849,Sep
2024-09-09,Sedanos Supermarkets  #4,Invoice,008-03745,,Discount,,,-1.19,3390078.55999998,,Lisset Limpio -020,RETAIL SEDANOS,1384850,Sep
2024-09-09,Sedanos Supermarkets #16,Invoice,008-03746,Arroz Envasado:Parboiled 5KG Dos Hermanos.,6 / 11lbs,10.0,40.5,405.0,3390483.55999998,Branded Rice,Lisset Limpio -020,RETAIL SEDANOS,1384851,Sep
2024-09-09,Sedanos Supermarkets #16,Invoice,008-03746,Rice Snack:Rice Snack Ham Flavored DOS HERMANOS,,2.0,19.9,39.8,3390523.35999998,Puffed Products,Lisset Limpio -020,RETAIL SEDANOS,1384852,Sep
2024-09-09,Sedanos Supermarkets #16,Invoice,008-03746,Rice Snack:Rice Snack Salami Flavored DOS HERMANOS,,1.0,19.9,19.9,3390543.25999998,Puffed Products,Lisset Limpio -020,RETAIL SEDANOS,1384853,Sep
2024-09-09,Sedanos Supermarkets #16,Invoice,008-03746,Arroz Envasado:Parboiled 5KG Dos Hermanos.,6 / 11lbs,10.0,40.5,405.0,3390948.25999998,Branded Rice,Lisset Limpio -020,RETAIL SEDANOS,1384854,Sep
2024-09-09,Sedanos Supermarkets #16,Invoice,008-03746,Rice Snack:Rice Snack Salami Flavored DOS HERMANOS,,1.0,19.9,19.9,3390968.15999998,Puffed Products,Lisset Limpio -020,RETAIL SEDANOS,1384855,Sep
2024-09-09,Sedanos Supermarkets #16,Invoice,008-03746,,Discount,,,-9.29,3390958.86999998,,Lisset Limpio -020,RETAIL SEDANOS,1384856,Sep
2024-09-09,El Palacio de los jugos / Lita Foods Inc.,Credit Memo,008-03854,Varios:Sales,parbo 50lb,-1.0,27.75,-27.75,3390931.11999998,Bulk Rice,Lisset Limpio -020,Cafeteria,1384857,Sep
2024-09-09,Be Your Will LLC,Credit Memo,008-03855,Varios:Promotional Allowance,,-1.0,27.75,-27.75,3390903.36999998,Bulk Rice,Lisset Limpio -020,CAFETERIA y RESTAURANTS,1384858,Sep
2024-09-09,Sedanos Supermarkets  #4,Credit Memo,008-03856,Varios:Promotional Allowance,salami,-1.0,19.9,-19.9,3390883.46999998,Puffed Products,Lisset Limpio -020,RETAIL SEDANOS,1384859,Sep
2024-09-09,Sedanos Supermarkets #16,Credit Memo,008-03857,Varios:Promotional Allowance,5kg,-10.0,40.5,-405.0,3390478.46999998,Branded Rice,Lisset Limpio -020,RETAIL SEDANOS,1384860,Sep
2024-09-09,Sedanos Supermarkets #16,Credit Memo,008-03857,Varios:Promotional Allowance,salami,-1.0,19.9,-19.9,3390458.56999998,Puffed Products,Lisset Limpio -020,RETAIL SEDANOS,1384861,Sep
2024-09-09,Sedanos Supermarkets #23,Credit Memo,008-03858,Varios:Promotional Allowance,5kg,-5.0,40.5,-202.5,3390256.06999998,Branded Rice,Lisset Limpio -020,RETAIL SEDANOS,1384862,Sep
2024-09-09,Sedanos Supermarkets #23,Credit Memo,008-03858,Varios:Promotional Allowance,salami,-1.0,19.9,-19.9,3390236.16999998,Puffed Products,Lisset Limpio -020,RETAIL SEDANOS,1384863,Sep
2024-09-10,Sedanos Supermarkets #34,Credit Memo,008-03747,Varios:Producto vencido/deteriorado (no impacta en inventario),crédito por 15 unidades snack fuera de fecha.,-15.0,1.49,-22.35,3390213.81999998,,Keila Alfaro-Visvikis,RETAIL SEDANOS,1384864,Sep
2024-09-10,"Soriano Brothers Diaz Food Service,Inc",Invoice,008-03748,Dry Beans:Dry Beans - Black Beans 50,Dry Black Beans 50 lb,10.0,45.7,457.0,3390670.81999998,Dry Beans,Lisset Limpio -020,CAFETERIA y RESTAURANTS,1384865,Sep
2024-09-10,"Soriano Brothers Diaz Food Service,Inc",Invoice,008-03748,Dry Beans:Dry Beans - Small Red Beans 50 lbs.,Small Red Beans 50 lbs,4.0,46.85,187.4,3390858.21999998,Dry Beans,Lisset Limpio -020,CAFETERIA y RESTAURANTS,1384866,Sep
2024-09-12,Sedanos Supermarkets #34,Invoice,008-03749,Arroz a Granel:Parboiled 50 LB -Bolsa Dos Hermanos.,,6.0,28.25,169.5,3391027.71999998,Bulk Rice,Keila Alfaro-Visvikis,RETAIL SEDANOS,1384867,Sep
2024-09-12,Sedanos Supermarkets #34,Invoice,008-03749,,Discount,,,-2.94,3391024.77999998,,Keila Alfaro-Visvikis,RETAIL SEDANOS,1384868,Sep
2024-09-12,Ideal Food Basket Davie Cafeteria,Invoice,008-03750,Arroz a Granel:Largo Fino 50 LB -Bolsa Dos Hermanos.,,8.0,27.85,222.8,3391247.57999998,Bulk Rice,Keila Alfaro-Visvikis,CAFETERIA y RESTAURANTS,1384869,Sep
2024-09-12,Sedanos Supermarkets #34,Invoice,008-03751,"Rice Snack:Rice Snack, Pizza DH",,1.0,19.9,19.9,3391267.47999998,Puffed Products,Keila Alfaro-Visvikis,RETAIL SEDANOS,1384870,Sep
2024-09-12,Sedanos Supermarkets #34,Invoice,008-03751,Rice Snack:Rice Snack Salami Flavored DOS HERMANOS,,1.0,19.9,19.9,3391287.37999998,Puffed Products,Keila Alfaro-Visvikis,RETAIL SEDANOS,1384871,Sep
2024-09-12,Sedanos Supermarkets #34,Invoice,008-03751,Rice Snack:Rice Snack Ham Flavored DOS HERMANOS,,2.0,19.9,39.8,3391327.17999998,Puffed Products,Keila Alfaro-Visvikis,RETAIL SEDANOS,1384872,Sep
2024-09-12,Sedanos Supermarkets #34,Invoice,008-03751,,Discount,,,-1.19,3391325.98999998,,Keila Alfaro-Visvikis,RETAIL SEDANOS,1384873,Sep
2024-09-12,El Gallego Supermarket,Invoice,008-03752,Dry Beans:Dry Beans - Black Beans 50,Dry Black Beans 50 lb,2.0,45.7,91.4,3391417.38999998,Dry Beans,Lisset Limpio -020,RETAIL  DSD,1384874,Sep
2024-09-12,El Gallego Supermarket,Invoice,008-03752,Arroz Envasado:Largo Fino 1kg (Long grain rice) Dos Hermanos,,1.0,17.0,17.0,3391434.38999998,Branded Rice,Lisset Limpio -020,RETAIL  DSD,1384875,Sep
2024-09-12,El Gallego Supermarket,Invoice,008-03752,Arroz a Granel:Parboiled 50 LB -Bolsa Dos Hermanos.,,5.0,28.25,141.25,3391575.63999998,Bulk Rice,Lisset Limpio -020,RETAIL  DSD,1384876,Sep
2024-09-12,Bravo   Francisco Diaz,Invoice,008-03753,Arroz a Granel:Largo Fino 50 LB -Bolsa Dos Hermanos.,,5.0,27.85,139.25,3391714.88999998,Bulk Rice,Lisset Limpio -020,RETAIL  DSD,1384877,Sep
2024-09-12,Max Food Distributors,Invoice,008-03754,Arroz a Granel:Parboiled 50 LB -Bolsa Dos Hermanos.,,25.0,27.75,693.75,3392408.63999998,Bulk Rice,Lisset Limpio -020,WHOLESALER,1384878,Sep
2024-09-12,El Palacio de Los Jugos / Casa mía Food Restaurant inc,Invoice,008-03755,Dry Beans:Dry Beans - Black Beans 50,Dry Black Beans 50 lb,1.0,45.7,45.7,3392454.33999998,Dry Beans,Lisset Limpio -020,Cafeteria,1384879,Sep
2024-09-12,El Palacio de Los Jugos / Casa mía Food Restaurant inc,Invoice,008-03755,Arroz a Granel:Parboiled 50 LB -Bolsa Dos Hermanos.,,11.0,27.75,305.25,3392759.58999998,Bulk Rice,Lisset Limpio -020,Cafeteria,1384880,Sep
2024-09-12,El Palacio de Los Jugos / Casa mía Food Restaurant inc,Invoice,008-03755,Arroz a Granel:Parboiled 50 LB -Bolsa Dos Hermanos.,,1.0,27.75,27.75,3392787.33999998,Bulk Rice,Lisset Limpio -020,Cafeteria,1384881,Sep
2024-09-12,Price Choice Food Market # 6,Invoice,008-03756,Arroz a Granel:Parboiled 50 LB -Bolsa Dos Hermanos.,,20.0,28.25,565.0,3393352.33999998,Bulk Rice,Lisset Limpio -020,RETAIL  DSD,1384882,Sep
2024-09-12,Sedanos Supermarkets #18,Invoice,008-03757,Arroz a Granel:Parboiled 50 LB -Bolsa Dos Hermanos.,,5.0,28.25,141.25,3393493.58999998,Bulk Rice,Lisset Limpio -020,RETAIL SEDANOS,1384883,Sep
2024-09-12,Sedanos Supermarkets #18,Invoice,008-03757,Arroz Envasado:Parboiled 5KG Dos Hermanos.,6 / 11lbs,6.0,40.5,243.0,3393736.58999998,Branded Rice,Lisset Limpio -020,RETAIL SEDANOS,1384884,Sep
2024-09-12,Sedanos Supermarkets #18,Invoice,008-03757,Rice Snack:Rice Snack Ham Flavored DOS HERMANOS,,1.0,19.9,19.9,3393756.48999998,Puffed Products,Lisset Limpio -020,RETAIL SEDANOS,1384885,Sep
2024-09-12,Sedanos Supermarkets #18,Invoice,008-03757,Varios:Promotional Allowance,,6.0,-11.15,-66.9,3393689.58999998,Branded Rice,Lisset Limpio -020,RETAIL SEDANOS,1384886,Sep
2024-09-12,Sedanos Supermarkets #18,Invoice,008-03757,,Discount,,,-6.75,3393682.83999998,,Lisset Limpio -020,RETAIL SEDANOS,1384887,Sep
2024-09-12,Sedanos Supermarkets #32,Invoice,008-03758,Arroz a Granel:Parboiled 50 LB -Bolsa Dos Hermanos.,,5.0,28.25,141.25,3393824.08999998,Bulk Rice,Lisset Limpio -020,RETAIL SEDANOS,1384888,Sep
2024-09-12,Sedanos Supermarkets #32,Invoice,008-03758,,Discount,,,-2.83,3393821.25999998,,Lisset Limpio -020,RETAIL SEDANOS,1384889,Sep
2024-09-12,"Criollos Food USA, LLC",Invoice,008-03759,Arroz a Granel:Parboiled 50 LB -Bolsa Dos Hermanos.,,55.0,28.25,1553.75,3395375.00999998,Bulk Rice,Armando Carpio - 017,WHOLESALER,1384890,Sep
2024-09-12,Fritanga Momotombo,Invoice,008-03760,Arroz a Granel:Largo Fino 50 LB -Bolsa Dos Hermanos.,,6.0,27.85,167.1,3395542.10999998,Bulk Rice,Lisset Limpio -020,CAFETERIA y RESTAURANTS,1384891,Sep
2024-09-12,Sedanos Supermarkets #42,Invoice,008-03761,Arroz a Granel:Parboiled 50 LB -Bolsa Dos Hermanos.,,4.0,28.25,113.0,3395655.10999998,Bulk Rice,Lisset Limpio -020,RETAIL SEDANOS,1384892,Sep
2024-09-12,Sedanos Supermarkets #42,Invoice,008-03761,,Discount,,,-2.26,3395652.84999998,,Lisset Limpio -020,RETAIL SEDANOS,1384893,Sep
2024-09-12,Sedanos Supermarkets #16,Invoice,008-03762,Arroz a Granel:Parboiled 50 LB -Bolsa Dos Hermanos.,,4.0,28.25,113.0,3395765.84999998,Bulk Rice,Lisset Limpio -020,RETAIL SEDANOS,1384894,Sep
2024-09-12,Sedanos Supermarkets #16,Invoice,008-03762,,Discount,,,-2.26,3395763.58999998,,Lisset Limpio -020,RETAIL SEDANOS,1384895,Sep
2024-09-12,Sedanos Supermarkets #26,Invoice,008-03763,Arroz a Granel:Parboiled 50 LB -Bolsa Dos Hermanos.,,4.0,28.25,113.0,3395876.58999998,Bulk Rice,Lisset Limpio -020,RETAIL SEDANOS,1384896,Sep
2024-09-12,Sedanos Supermarkets #26,Invoice,008-03763,,Discount,,,-2.26,3395874.32999998,,Lisset Limpio -020,RETAIL SEDANOS,1384897,Sep
2024-09-12,Bay supermarket,Invoice,008-03764,Arroz Envasado:Largo Fino 1kg (Long grain rice) Dos Hermanos,,5.0,17.0,85.0,3395959.32999998,Branded Rice,Keila Alfaro-Visvikis,RETAIL  DSD,1384898,Sep
2024-09-12,Bay supermarket,Invoice,008-03764,Arroz Envasado:Largo Fino 1kg (Long grain rice) Dos Hermanos,,1.0,17.0,17.0,3395976.32999998,Branded Rice,Keila Alfaro-Visvikis,RETAIL  DSD,1384899,Sep
2024-09-12,Sedanos Supermarkets #42,Invoice,008-03765,Arroz Envasado:Parboiled 5KG Dos Hermanos.,6 / 11lbs,10.0,40.5,405.0,3396381.32999998,Branded Rice,Lisset Limpio -020,RETAIL SEDANOS,1384900,Sep
2024-09-12,Sedanos Supermarkets #42,Invoice,008-03765,Arroz Envasado:Parboiled 5KG Dos Hermanos.,6 / 11lbs,10.0,-11.15,-111.5,3396269.82999998,Branded Rice,Lisset Limpio -020,RETAIL SEDANOS,1384901,Sep
2024-09-12,Sedanos Supermarkets #42,Invoice,008-03765,,Discount,,,-5.87,3396263.95999998,,Lisset Limpio -020,RETAIL SEDANOS,1384902,Sep
2024-09-12,ALS Foods,Invoice,008-03766,Dry Beans:Dry Beans - Black Beans 50,Dry Black Beans 50 lb,1.0,45.7,45.7,3396309.65999998,Dry Beans,Lisset Limpio -020,CAFETERIA y RESTAURANTS,1384903,Sep
2024-09-12,ALS Foods,Invoice,008-03766,Arroz a Granel:Parboiled 50 LB -Bolsa Dos Hermanos.,,11.0,27.75,305.25,3396614.90999998,Bulk Rice,Lisset Limpio -020,CAFETERIA y RESTAURANTS,1384904,Sep
2024-09-12,ALS Foods,Invoice,008-03766,Arroz a Granel:Parboiled 50 LB -Bolsa Dos Hermanos.,,1.0,27.75,27.75,3396642.65999998,Bulk Rice,Lisset Limpio -020,CAFETERIA y RESTAURANTS,1384905,Sep
2024-09-12,Sedanos Supermarkets #34,Credit Memo,008-03859,Varios:Promotional Allowance,pizza,-1.0,19.9,-19.9,3396622.75999998,Puffed Products,Keila Alfaro-Visvikis,RETAIL SEDANOS,1384906,Sep
2024-09-12,El Palacio de Los Jugos / Casa mía Food Restaurant inc,Credit Memo,008-03860,Varios:Promotional Allowance,50lb,-1.0,27.75,-27.75,3396595.00999998,Bulk Rice,Lisset Limpio -020,Cafeteria,1384907,Sep
2024-09-12,Bay supermarket,Credit Memo,008-03861,Varios:Promotional Allowance,lf 1 kg,-1.0,17.0,-17.0,3396578.00999998,Branded Rice,Keila Alfaro-Visvikis,RETAIL  DSD,1384908,Sep
2024-09-12,ALS Foods,Credit Memo,008-03862,Varios:Promotional Allowance,,-1.0,27.75,-27.75,3396550.25999998,Bulk Rice,Lisset Limpio -020,CAFETERIA y RESTAURANTS,1384909,Sep
2024-09-16,El Palacio de los jugos / Lita Foods Inc.,Invoice,008-03767,Dry Beans:Dry Beans - Black Beans 50,Dry Black Beans 50 lb,1.0,45.7,45.7,3396595.95999998,Dry Beans,Lisset Limpio -020,Cafeteria,1384910,Sep
2024-09-16,El Palacio de los jugos / Lita Foods Inc.,Invoice,008-03767,Arroz a Granel:Parboiled 50 LB -Bolsa Dos Hermanos.,,11.0,27.75,305.25,3396901.20999998,Bulk Rice,Lisset Limpio -020,Cafeteria,1384911,Sep
2024-09-16,El Palacio de los jugos / Lita Foods Inc.,Invoice,008-03767,Arroz a Granel:Parboiled 50 LB -Bolsa Dos Hermanos.,,1.0,27.75,27.75,3396928.95999998,Bulk Rice,Lisset Limpio -020,Cafeteria,1384912,Sep
2024-09-16,Los Caringas Latin America  Foods,Invoice,008-03768,Arroz a Granel:Largo Fino 50 LB -Bolsa Dos Hermanos.,,3.0,27.85,83.55,3397012.50999998,Bulk Rice,Lisset Limpio -020,CAFETERIA y RESTAURANTS,1384913,Sep
2024-09-16,Los Caringas Latin America  Foods,Invoice,008-03768,Arroz a Granel:Parboiled 50 LB -Bolsa Dos Hermanos.,,2.0,28.25,56.5,3397069.00999998,Bulk Rice,Lisset Limpio -020,CAFETERIA y RESTAURANTS,1384914,Sep
2024-09-16,VIÑA & SONS FOOD DIST.CORP,Invoice,008-03769,Arroz Envasado:Parboiled 1kg Bolsa Dos Hermanos.,.,2.0,16.0,32.0,3397101.00999998,Branded Rice,Keila Alfaro-Visvikis,CAFETERIA y RESTAURANTS,1384915,Sep
2024-09-16,VIÑA & SONS FOOD DIST.CORP,Invoice,008-03769,Arroz Envasado:Largo Fino 1kg (Long grain rice) Dos Hermanos,,2.0,14.0,28.0,3397129.00999998,Branded Rice,Keila Alfaro-Visvikis,CAFETERIA y RESTAURANTS,1384916,Sep
2024-09-16,VIÑA & SONS FOOD DIST.CORP,Invoice,008-03769,Arroz Envasado:Parboiled 5KG Dos Hermanos.,6 / 11lbs,2.0,41.5,83.0,3397212.00999998,Branded Rice,Keila Alfaro-Visvikis,CAFETERIA y RESTAURANTS,1384917,Sep
2024-09-16,VIÑA & SONS FOOD DIST.CORP,Invoice,008-03769,Arroz a Granel:Parboiled 50 LB -Bolsa Dos Hermanos.,,2.0,27.75,55.5,3397267.50999998,Bulk Rice,Keila Alfaro-Visvikis,CAFETERIA y RESTAURANTS,1384918,Sep
2024-09-16,Aries Supermarket & Cafeteria,Invoice,008-03770,Arroz a Granel:Parboiled 50 LB -Bolsa Dos Hermanos.,,10.0,28.25,282.5,3397550.00999998,Bulk Rice,Keila Alfaro-Visvikis,CAFETERIA y RESTAURANTS,1384919,Sep
2024-09-16,Panda Depot,Invoice,008-03771,Arroz a Granel:Largo Fino 50 LB -Bolsa Dos Hermanos.,,220.0,24.5,5390.0,3402940.00999998,Bulk Rice,Lisset Limpio -020,WHOLESALER,1384920,Sep
2024-09-16,Panda Depot,Invoice,008-03771,Arroz a Granel:Parboiled 50 LB -Bolsa Dos Hermanos.,,110.0,25.0,2750.0,3405690.00999998,Bulk Rice,Lisset Limpio -020,WHOLESALER,1384921,Sep
2024-09-16,Sabor Tropical Supermarket #4,Invoice,008-03772,Arroz Envasado:Parboiled 5KG Dos Hermanos.,6 / 11lbs,5.0,46.5,232.5,3405922.50999998,Branded Rice,Keila Alfaro-Visvikis,RETAIL  DSD,1384922,Sep
2024-09-16,Sabor Tropical Supermarket #4,Invoice,008-03772,Arroz Envasado:Parboiled 5KG Dos Hermanos.,6 / 11lbs,1.0,46.5,46.5,3405969.00999998,Branded Rice,Keila Alfaro-Visvikis,RETAIL  DSD,1384923,Sep
2024-09-16,Soriano Brothers PB,Invoice,008-03773,Arroz a Granel:Largo Fino 50 LB -Bolsa Dos Hermanos.,,15.0,27.85,417.75,3406386.75999998,Bulk Rice,Lisset Limpio -020,CAFETERIA y RESTAURANTS,1384924,Sep
2024-09-16,Soriano Brothers PB,Invoice,008-03773,Arroz a Granel:Parboiled 50 LB -Bolsa Dos Hermanos.,,11.0,27.75,305.25,3406692.00999998,Bulk Rice,Lisset Limpio -020,CAFETERIA y RESTAURANTS,1384925,Sep
2024-09-16,Soriano Brothers PB,Invoice,008-03773,Dry Beans:Dry Beans - Black Beans 50,Dry Black Beans 50 lb,2.0,45.7,91.4,3406783.40999998,Dry Beans,Lisset Limpio -020,CAFETERIA y RESTAURANTS,1384926,Sep
2024-09-16,Soriano Brothers PB,Invoice,008-03773,Spices:AS Sazon (for all),1 / 30 lb (box or pail),1.0,59.0,59.0,3406842.40999998,American Spice,Lisset Limpio -020,CAFETERIA y RESTAURANTS,1384927,Sep
2024-09-16,Soriano Brothers PB,Invoice,008-03773,Arroz a Granel:Parboiled 50 LB -Bolsa Dos Hermanos.,,1.0,27.75,27.75,3406870.15999998,Bulk Rice,Lisset Limpio -020,CAFETERIA y RESTAURANTS,1384928,Sep
2024-09-16,Sedanos Supermarkets #31,Invoice,008-03774,Arroz a Granel:Parboiled 50 LB -Bolsa Dos Hermanos.,,5.0,28.25,141.25,3407011.40999998,Bulk Rice,Lisset Limpio -020,RETAIL SEDANOS,1384929,Sep
2024-09-16,Sedanos Supermarkets #31,Invoice,008-03774,,Discount,,,-2.83,3407008.57999998,,Lisset Limpio -020,RETAIL SEDANOS,1384930,Sep
2024-09-16,JMN Dely Corp,Invoice,008-03775,Arroz a Granel:Parboiled 50 LB -Bolsa Dos Hermanos.,,2.0,27.75,55.5,3407064.07999998,Bulk Rice,Keila Alfaro-Visvikis,CAFETERIA y RESTAURANTS,1384931,Sep
2024-09-16,JMN Dely Corp,Invoice,008-03775,Arroz a Granel:Largo Fino 50 LB -Bolsa Dos Hermanos.,,4.0,27.85,111.4,3407175.47999998,Bulk Rice,Keila Alfaro-Visvikis,CAFETERIA y RESTAURANTS,1384932,Sep
2024-09-16,JMN Dely Corp,Invoice,008-03775,Dry Beans:Dry Beans - Black Beans 50,Dry Black Beans 50 lb,1.0,45.7,45.7,3407221.17999998,Dry Beans,Keila Alfaro-Visvikis,CAFETERIA y RESTAURANTS,1384933,Sep
2024-09-16,"Soriano Brothers Diaz Food Service,Inc",Invoice,008-03776,Arroz a Granel:Largo Fino 50 LB -Bolsa Dos Hermanos.,,30.0,27.85,835.5,3408056.67999998,Bulk Rice,Lisset Limpio -020,CAFETERIA y RESTAURANTS,1384934,Sep
2024-09-16,"Soriano Brothers Diaz Food Service,Inc",Invoice,008-03776,Arroz a Granel:Parboiled 50 LB -Bolsa Dos Hermanos.,,33.0,27.75,915.75,3408972.42999998,Bulk Rice,Lisset Limpio -020,CAFETERIA y RESTAURANTS,1384935,Sep
2024-09-16,"Soriano Brothers Diaz Food Service,Inc",Invoice,008-03776,Arroz a Granel:Parboiled 50 LB -Bolsa Dos Hermanos.,,3.0,27.75,83.25,3409055.67999998,Bulk Rice,Lisset Limpio -020,CAFETERIA y RESTAURANTS,1384936,Sep
2024-09-16,Los Mejores Tamales de Miami,Invoice,008-03777,Arroz a Granel:Parboiled 50 LB -Bolsa Dos Hermanos.,,3.0,28.25,84.75,3409140.42999998,Bulk Rice,Lisset Limpio -020,CAFETERIA y RESTAURANTS,1384937,Sep
2024-09-16,El Palacio de los jugos / Delicias Criollas (DIAGO FOOD_MILLER),Invoice,008-03778,Arroz a Granel:Parboiled 50 LB -Bolsa Dos Hermanos.,,11.0,27.75,305.25,3409445.67999998,Bulk Rice,Lisset Limpio -020,Cafeteria,1384938,Sep
2024-09-16,El Palacio de los jugos / Delicias Criollas (DIAGO FOOD_MILLER),Invoice,008-03778,Arroz a Granel:Parboiled 50 LB -Bolsa Dos Hermanos.,,1.0,27.75,27.75,3409473.42999998,Bulk Rice,Lisset Limpio -020,Cafeteria,1384939,Sep
2024-09-16,El Palacio de los jugos / Delicias Criollas (DIAGO FOOD_MILLER),Invoice,008-03778,Liquids:AS White Vinegar,4/1 Gl.,1.0,10.5,10.5,3409483.92999998,American Spice,Lisset Limpio -020,Cafeteria,1384940,Sep
2024-09-16,El Palacio de Los Jugos / Casa mía Food Restaurant inc,Invoice,008-03779,Dry Beans:Dry Beans - Black Beans 50,Dry Black Beans 50 lb,1.0,45.7,45.7,3409529.62999998,Dry Beans,Lisset Limpio -020,Cafeteria,1384941,Sep
2024-09-16,El Palacio de Los Jugos / Casa mía Food Restaurant inc,Invoice,008-03779,Arroz a Granel:Parboiled 50 LB -Bolsa Dos Hermanos.,,11.0,27.75,305.25,3409834.87999998,Bulk Rice,Lisset Limpio -020,Cafeteria,1384942,Sep
2024-09-16,El Palacio de Los Jugos / Casa mía Food Restaurant inc,Invoice,008-03779,Arroz a Granel:Parboiled 50 LB -Bolsa Dos Hermanos.,,1.0,27.75,27.75,3409862.62999998,Bulk Rice,Lisset Limpio -020,Cafeteria,1384943,Sep
2024-09-16,Sabor Tropical Supermarket #4,Credit Memo,008-03863,Varios:Promotional Allowance,,-1.0,46.5,-46.5,3409816.12999998,Branded Rice,Keila Alfaro-Visvikis,RETAIL  DSD,1384944,Sep
2024-09-16,VIÑA & SONS FOOD DIST.CORP,Credit Memo,008-03864,Varios:Promotional Allowance,50lb parbo,-2.0,27.75,-55.5,3409760.62999998,Bulk Rice,Keila Alfaro-Visvikis,CAFETERIA y RESTAURANTS,1384945,Sep
2024-09-16,El Palacio de los jugos / Lita Foods Inc.,Credit Memo,008-03865,Varios:Promotional Allowance,,-1.0,27.75,-27.75,3409732.87999998,Bulk Rice,Lisset Limpio -020,Cafeteria,1384946,Sep
2024-09-16,Soriano Brothers PB,Credit Memo,008-03866,Varios:Promotional Allowance,,-1.0,27.75,-27.75,3409705.12999998,Bulk Rice,Lisset Limpio -020,CAFETERIA y RESTAURANTS,1384947,Sep
2024-09-16,"Soriano Brothers Diaz Food Service,Inc",Credit Memo,008-03867,Varios:Sales,,-3.0,27.75,-83.25,3409621.87999998,Bulk Rice,Lisset Limpio -020,CAFETERIA y RESTAURANTS,1384948,Sep
2024-09-16,El Palacio de los jugos / Delicias Criollas (DIAGO FOOD_MILLER),Credit Memo,008-03868,Varios:Promotional Allowance,,-1.0,27.75,-27.75,3409594.12999998,Bulk Rice,Lisset Limpio -020,Cafeteria,1384949,Sep
2024-09-16,El Palacio de Los Jugos / Casa mía Food Restaurant inc,Credit Memo,008-03869,Varios:Promotional Allowance,,-1.0,27.75,-27.75,3409566.37999998,Bulk Rice,Lisset Limpio -020,Cafeteria,1384950,Sep
2024-09-18,Ideal Food Basket Pompano,Invoice,008-03780,Arroz Envasado:Largo Fino 1kg (Long grain rice) Dos Hermanos,,2.0,17.0,34.0,3409600.37999998,Branded Rice,Keila Alfaro-Visvikis,RETAIL  DSD,1384951,Sep
2024-09-18,Ideal Food Basket Pompano,Invoice,008-03780,Arroz Envasado:Parboiled 1kg Bolsa Dos Hermanos.,.,3.0,19.9,59.7,3409660.07999998,Branded Rice,Keila Alfaro-Visvikis,RETAIL  DSD,1384952,Sep
2024-09-18,Ideal Food Basket Pompano,Invoice,008-03780,Arroz Envasado:Parboiled 5KG Dos Hermanos.,6 / 11lbs,15.0,46.5,697.5,3410357.57999998,Branded Rice,Keila Alfaro-Visvikis,RETAIL  DSD,1384953,Sep
2024-09-18,Ideal Food Basket Pompano,Invoice,008-03780,Arroz Envasado:Parboiled 5KG Dos Hermanos.,6 / 11lbs,2.0,46.5,93.0,3410450.57999998,Branded Rice,Keila Alfaro-Visvikis,RETAIL  DSD,1384954,Sep
2024-09-18,Ideal Food Basket Pompano,Invoice,008-03780,Arroz Envasado:Largo Fino 1kg (Long grain rice) Dos Hermanos,,1.0,17.0,17.0,3410467.57999998,Branded Rice,Keila Alfaro-Visvikis,RETAIL  DSD,1384955,Sep
2024-09-18,BRAVO Pompano Beach,Invoice,008-03781,Arroz Envasado:Largo Fino 1kg (Long grain rice) Dos Hermanos,,2.0,17.0,34.0,3410501.57999998,Branded Rice,Keila Alfaro-Visvikis,RETAIL  DSD,1384956,Sep
2024-09-18,BRAVO Pompano Beach,Invoice,008-03781,Arroz Envasado:Parboiled 1kg Bolsa Dos Hermanos.,.,3.0,19.9,59.7,3410561.27999998,Branded Rice,Keila Alfaro-Visvikis,RETAIL  DSD,1384957,Sep
2024-09-18,BRAVO Pompano Beach,Invoice,008-03781,Arroz Envasado:Largo Fino 1kg (Long grain rice) Dos Hermanos,,1.0,17.0,17.0,3410578.27999998,Branded Rice,Keila Alfaro-Visvikis,RETAIL  DSD,1384958,Sep
2024-09-18,Aries Supermarket & Cafeteria,Invoice,008-03782,Arroz Envasado:Parboiled 1kg Bolsa Dos Hermanos.,.,3.0,19.9,59.7,3410637.97999998,Branded Rice,Keila Alfaro-Visvikis,CAFETERIA y RESTAURANTS,1384959,Sep
2024-09-18,Aries Supermarket & Cafeteria,Invoice,008-03782,Arroz Envasado:Largo Fino 1kg (Long grain rice) Dos Hermanos,,2.0,17.0,34.0,3410671.97999998,Branded Rice,Keila Alfaro-Visvikis,CAFETERIA y RESTAURANTS,1384960,Sep
2024-09-18,Aries Supermarket & Cafeteria,Invoice,008-03782,Arroz Envasado:Parboiled 5KG Dos Hermanos.,6 / 11lbs,5.0,46.5,232.5,3410904.47999998,Branded Rice,Keila Alfaro-Visvikis,CAFETERIA y RESTAURANTS,1384961,Sep
2024-09-18,Aries Supermarket & Cafeteria,Invoice,008-03782,Arroz Envasado:Parboiled 5KG Dos Hermanos.,6 / 11lbs,1.0,46.5,46.5,3410950.97999998,Branded Rice,Keila Alfaro-Visvikis,CAFETERIA y RESTAURANTS,1384962,Sep
2024-09-18,Aries Supermarket & Cafeteria,Invoice,008-03782,Arroz Envasado:Largo Fino 1kg (Long grain rice) Dos Hermanos,,1.0,17.0,17.0,3410967.97999998,Branded Rice,Keila Alfaro-Visvikis,CAFETERIA y RESTAURANTS,1384963,Sep
2024-09-18,Ideal Food Basket Davie Cafeteria,Invoice,008-03783,Arroz a Granel:Largo Fino 50 LB -Bolsa Dos Hermanos.,,10.0,27.85,278.5,3411246.47999998,Bulk Rice,Keila Alfaro-Visvikis,CAFETERIA y RESTAURANTS,1384964,Sep
2024-09-18,Sedanos Supermarkets #27,Invoice,008-03784,Arroz a Granel:Parboiled 50 LB -Bolsa Dos Hermanos.,,6.0,28.25,169.5,3411415.97999998,Bulk Rice,Keila Alfaro-Visvikis,RETAIL SEDANOS,1384965,Sep
2024-09-18,Sedanos Supermarkets #27,Invoice,008-03784,Rice Snack:Rice Snack Salami Flavored DOS HERMANOS,,1.0,19.9,19.9,3411435.87999998,Puffed Products,Keila Alfaro-Visvikis,RETAIL SEDANOS,1384966,Sep
2024-09-18,Sedanos Supermarkets #27,Invoice,008-03784,,Discount,,,-3.79,3411432.08999998,,Keila Alfaro-Visvikis,RETAIL SEDANOS,1384967,Sep
2024-09-18,Sedanos Supermarkets #24,Invoice,008-03785,Arroz a Granel:Parboiled 50 LB -Bolsa Dos Hermanos.,,6.0,28.25,169.5,3411601.58999998,Bulk Rice,Keila Alfaro-Visvikis,RETAIL SEDANOS,1384968,Sep
2024-09-18,Sedanos Supermarkets #24,Invoice,008-03785,,Discount,,,-3.39,3411598.19999998,,Keila Alfaro-Visvikis,RETAIL SEDANOS,1384969,Sep
2024-09-18,Key Food Coconut,Invoice,008-03786,Arroz Envasado:Organico LF Dos Hermanos,.,1.0,24.0,24.0,3411622.19999998,Branded Rice,Keila Alfaro-Visvikis,RETAIL  DSD,1384970,Sep
2024-09-18,Key Food Coconut,Invoice,008-03786,Arroz Envasado:Largo Fino 1kg (Long grain rice) Dos Hermanos,,2.0,17.0,34.0,3411656.19999998,Branded Rice,Keila Alfaro-Visvikis,RETAIL  DSD,1384971,Sep
2024-09-18,Key Food Coconut,Invoice,008-03786,Arroz Envasado:Parboiled 1kg Bolsa Dos Hermanos.,.,3.0,19.9,59.7,3411715.89999998,Branded Rice,Keila Alfaro-Visvikis,RETAIL  DSD,1384972,Sep
2024-09-18,Key Food Coconut,Invoice,008-03786,Arroz Envasado:Largo Fino 1kg (Long grain rice) Dos Hermanos,,1.0,17.0,17.0,3411732.89999998,Branded Rice,Keila Alfaro-Visvikis,RETAIL  DSD,1384973,Sep
2024-09-18,Sedanos Supermarkets #28,Invoice,008-03787,Arroz Envasado:Parboiled 5KG Dos Hermanos.,6 / 11lbs,20.0,40.5,810.0,3412542.89999998,Branded Rice,Lisset Limpio -020,RETAIL SEDANOS,1384974,Sep
2024-09-18,Sedanos Supermarkets #28,Invoice,008-03787,Varios:Promotional Allowance,,20.0,-11.15,-223.0,3412319.89999998,Branded Rice,Lisset Limpio -020,RETAIL SEDANOS,1384975,Sep
2024-09-18,Sedanos Supermarkets #28,Invoice,008-03787,,Discount,,,-11.74,3412308.15999998,,Lisset Limpio -020,RETAIL SEDANOS,1384976,Sep
2024-09-18,Sedanos Supermarkets #1,Invoice,008-03788,Arroz Envasado:Parboiled 5KG Dos Hermanos.,6 / 11lbs,6.0,40.5,243.0,3412551.15999998,Branded Rice,Lisset Limpio -020,RETAIL SEDANOS,1384977,Sep
2024-09-18,Sedanos Supermarkets #1,Invoice,008-03788,Varios:Promotional Allowance,,6.0,-11.15,-66.9,3412484.25999998,Branded Rice,Lisset Limpio -020,RETAIL SEDANOS,1384978,Sep
2024-09-18,Sedanos Supermarkets #1,Invoice,008-03788,,Discount,,,-3.52,3412480.73999998,,Lisset Limpio -020,RETAIL SEDANOS,1384979,Sep
2024-09-18,Sedanos Supermarkets #43,Invoice,008-03789,Arroz a Granel:Parboiled 50 LB -Bolsa Dos Hermanos.,,5.0,28.25,141.25,3412621.98999998,Bulk Rice,Lisset Limpio -020,RETAIL SEDANOS,1384980,Sep
2024-09-18,Sedanos Supermarkets #43,Invoice,008-03789,,Discount,,,-2.83,3412619.15999998,,Lisset Limpio -020,RETAIL SEDANOS,1384981,Sep
2024-09-18,Ideal Food Basket Pompano,Credit Memo,008-03870,Varios:Promotional Allowance,5k,-2.0,46.5,-93.0,3412526.15999998,Branded Rice,Keila Alfaro-Visvikis,RETAIL  DSD,1384982,Sep
2024-09-18,Ideal Food Basket Pompano,Credit Memo,008-03870,Varios:Promotional Allowance,lf 1k,-1.0,17.0,-17.0,3412509.15999998,Branded Rice,Keila Alfaro-Visvikis,RETAIL  DSD,1384983,Sep
2024-09-18,BRAVO Pompano Beach,Credit Memo,008-03871,Varios:Promotional Allowance,,-1.0,17.0,-17.0,3412492.15999998,Branded Rice,Keila Alfaro-Visvikis,RETAIL  DSD,1384984,Sep
2024-09-18,Aries Supermarket & Cafeteria,Credit Memo,008-03872,Varios:Promotional Allowance,5k,-1.0,46.5,-46.5,3412445.65999998,Branded Rice,Keila Alfaro-Visvikis,CAFETERIA y RESTAURANTS,1384985,Sep
2024-09-18,Aries Supermarket & Cafeteria,Credit Memo,008-03872,Varios:Promotional Allowance,1k lf,-1.0,17.0,-17.0,3412428.65999998,Branded Rice,Keila Alfaro-Visvikis,CAFETERIA y RESTAURANTS,1384986,Sep
2024-09-18,Key Food Coconut,Credit Memo,008-03873,Varios:Sales,,-1.0,17.0,-17.0,3412411.65999998,Branded Rice,Keila Alfaro-Visvikis,RETAIL  DSD,1384987,Sep
2024-09-19,Sedanos Supermarkets #43,Invoice,008-03790,"Rice Snack:Rice Snack, Pizza DH",,1.0,19.9,19.9,3412431.55999998,Puffed Products,Lisset Limpio -020,RETAIL SEDANOS,1384988,Sep
2024-09-19,Sedanos Supermarkets #43,Invoice,008-03790,Rice Snack:Rice Snack Salami Flavored DOS HERMANOS,,1.0,19.9,19.9,3412451.45999998,Puffed Products,Lisset Limpio -020,RETAIL SEDANOS,1384989,Sep
2024-09-19,Sedanos Supermarkets #43,Invoice,008-03790,Rice Snack:Rice Snack Ham Flavored DOS HERMANOS,,2.0,19.9,39.8,3412491.25999998,Puffed Products,Lisset Limpio -020,RETAIL SEDANOS,1384990,Sep
2024-09-19,Sedanos Supermarkets #43,Invoice,008-03790,,Discount,,,-1.19,3412490.06999998,,Lisset Limpio -020,RETAIL SEDANOS,1384991,Sep
2024-09-19,Cash Sales,Invoice,008-03791,Arroz a Granel:Largo Fino 50 LB -Bolsa Dos Hermanos.,,1.0,28.0,28.0,3412518.06999998,Bulk Rice,Armando Carpio - 017,CAFETERIA y RESTAURANTS,1384992,Sep
2024-09-19,El Palacio de los jugos /  Mires Restaurants,Invoice,008-03792,Liquids:AS Marinating Sauce (Mojo),,1.0,18.5,18.5,3412536.56999998,American Spice,Lisset Limpio -020,Cafeteria,1384993,Sep
2024-09-19,El Palacio de los jugos /  Mires Restaurants,Invoice,008-03792,Arroz a Granel:Parboiled 50 LB -Bolsa Dos Hermanos.,,11.0,27.75,305.25,3412841.81999998,Bulk Rice,Lisset Limpio -020,Cafeteria,1384994,Sep
2024-09-19,El Palacio de los jugos /  Mires Restaurants,Invoice,008-03792,Arroz a Granel:Parboiled 50 LB -Bolsa Dos Hermanos.,,1.0,27.75,27.75,3412869.56999998,Bulk Rice,Lisset Limpio -020,Cafeteria,1384995,Sep
2024-09-19,El Palacio de Los Jugos / Casa mía Food Restaurant inc,Invoice,008-03793,Dry Beans:Dry Beans - Black Beans 50,Dry Black Beans 50 lb,1.0,45.7,45.7,3412915.26999998,Dry Beans,Lisset Limpio -020,Cafeteria,1384996,Sep
2024-09-19,El Palacio de Los Jugos / Casa mía Food Restaurant inc,Invoice,008-03793,Arroz a Granel:Parboiled 50 LB -Bolsa Dos Hermanos.,,11.0,27.75,305.25,3413220.51999998,Bulk Rice,Lisset Limpio -020,Cafeteria,1384997,Sep
2024-09-19,El Palacio de Los Jugos / Casa mía Food Restaurant inc,Invoice,008-03793,Arroz a Granel:Parboiled 50 LB -Bolsa Dos Hermanos.,,1.0,27.75,27.75,3413248.26999998,Bulk Rice,Lisset Limpio -020,Cafeteria,1384998,Sep
2024-09-19,Aries Supermarket & Cafeteria,Invoice,008-03794,Dry Beans:Dry Beans - Black Beans 50,Dry Black Beans 50 lb,8.0,39.75,318.0,3413566.26999998,Dry Beans,Keila Alfaro-Visvikis,CAFETERIA y RESTAURANTS,1384999,Sep
2024-09-19,Bravo   Francisco Diaz,Invoice,008-03795,Arroz a Granel:Largo Fino 50 LB -Bolsa Dos Hermanos.,,5.0,27.85,139.25,3413705.51999998,Bulk Rice,Lisset Limpio -020,RETAIL  DSD,1385000,Sep
2024-09-19,ALS Foods,Invoice,008-03796,Liquids:AS Cooking Wine,4/1 Gl.,2.0,17.5,35.0,3413740.51999998,American Spice,Lisset Limpio -020,CAFETERIA y RESTAURANTS,1385001,Sep
2024-09-19,ALS Foods,Invoice,008-03796,Arroz a Granel:Parboiled 50 LB -Bolsa Dos Hermanos.,,11.0,27.75,305.25,3414045.76999998,Bulk Rice,Lisset Limpio -020,CAFETERIA y RESTAURANTS,1385002,Sep
2024-09-19,ALS Foods,Invoice,008-03796,Arroz a Granel:Parboiled 50 LB -Bolsa Dos Hermanos.,,1.0,27.75,27.75,3414073.51999998,Bulk Rice,Lisset Limpio -020,CAFETERIA y RESTAURANTS,1385003,Sep
2024-09-19,El Palacio de los jugos / Lita Foods Inc.,Invoice,008-03797,Arroz a Granel:Parboiled 50 LB -Bolsa Dos Hermanos.,,11.0,27.75,305.25,3414378.76999998,Bulk Rice,Lisset Limpio -020,Cafeteria,1385004,Sep
2024-09-19,El Palacio de los jugos / Lita Foods Inc.,Invoice,008-03797,Dry Beans:Dry Beans - Black Beans 50,Dry Black Beans 50 lb,1.0,45.7,45.7,3414424.46999998,Dry Beans,Lisset Limpio -020,Cafeteria,1385005,Sep
2024-09-19,El Palacio de los jugos / Lita Foods Inc.,Invoice,008-03797,Arroz a Granel:Parboiled 50 LB -Bolsa Dos Hermanos.,,1.0,27.75,27.75,3414452.21999998,Bulk Rice,Lisset Limpio -020,Cafeteria,1385006,Sep
2024-09-19,Hings Chinese,Invoice,008-03798,Arroz a Granel:Parboiled 50 LB -Bolsa Dos Hermanos.,,5.0,28.25,141.25,3414593.46999998,Bulk Rice,Lisset Limpio -020,CAFETERIA y RESTAURANTS,1385007,Sep
2024-09-19,Sedanos Supermarkets #16,Invoice,008-03799,Arroz a Granel:Parboiled 50 LB -Bolsa Dos Hermanos.,,4.0,28.25,113.0,3414706.46999998,Bulk Rice,Lisset Limpio -020,RETAIL SEDANOS,1385008,Sep
2024-09-19,Sedanos Supermarkets #16,Invoice,008-03799,,Discount,,,-2.26,3414704.20999998,,Lisset Limpio -020,RETAIL SEDANOS,1385009,Sep
2024-09-19,Sedanos Supermarkets #38,Invoice,008-03800,Arroz Envasado:Parboiled 5KG Dos Hermanos.,6 / 11lbs,25.0,40.5,1012.5,3415716.70999998,Branded Rice,Lisset Limpio -020,RETAIL SEDANOS,1385010,Sep
2024-09-19,Sedanos Supermarkets #38,Invoice,008-03800,Varios:Promotional Allowance,,25.0,-11.15,-278.75,3415437.95999998,Branded Rice,Lisset Limpio -020,RETAIL SEDANOS,1385011,Sep
2024-09-19,Sedanos Supermarkets #38,Invoice,008-03800,,Discount,,,-14.68,3415423.27999998,,Lisset Limpio -020,RETAIL SEDANOS,1385012,Sep
2024-09-19,ALS Foods,Credit Memo,008-03874,Varios:Promotional Allowance,,-1.0,27.75,-27.75,3415395.52999998,Bulk Rice,Lisset Limpio -020,CAFETERIA y RESTAURANTS,1385013,Sep
2024-09-19,Sedanos Supermarkets #43,Credit Memo,008-03875,Varios:Promotional Allowance,pizza,-1.0,19.9,-19.9,3415375.62999998,Puffed Products,Lisset Limpio -020,RETAIL SEDANOS,1385014,Sep
2024-09-19,El Palacio de los jugos /  Mires Restaurants,Credit Memo,008-03876,Varios:Promotional Allowance,,-1.0,27.75,-27.75,3415347.87999998,Bulk Rice,Lisset Limpio -020,Cafeteria,1385015,Sep
2024-09-19,El Palacio de Los Jugos / Casa mía Food Restaurant inc,Credit Memo,008-03877,Varios:Promotional Allowance,,-1.0,27.75,-27.75,3415320.12999998,Bulk Rice,Lisset Limpio -020,Cafeteria,1385016,Sep
2024-09-19,El Palacio de los jugos / Lita Foods Inc.,Credit Memo,008-03878,Varios:Promotional Allowance,,-1.0,27.75,-27.75,3415292.37999998,Bulk Rice,Lisset Limpio -020,Cafeteria,1385017,Sep
2024-09-23,Sedanos Supermarkets #33,Invoice,008-03801,Arroz Envasado:Parboiled 5KG Dos Hermanos.,6 / 11lbs,2.0,40.5,81.0,3415373.37999998,Branded Rice,Lisset Limpio -020,RETAIL SEDANOS,1385018,Sep
2024-09-23,Sedanos Supermarkets #33,Invoice,008-03801,Varios:Promotional Allowance,,2.0,-11.15,-22.3,3415351.07999998,Branded Rice,Lisset Limpio -020,RETAIL SEDANOS,1385019,Sep
2024-09-23,Sedanos Supermarkets #33,Invoice,008-03801,,Discount,,,-1.17,3415349.90999998,,Lisset Limpio -020,RETAIL SEDANOS,1385020,Sep
2024-09-23,Rey Chavez Distributor Corp,Invoice,008-03802,Arroz a Granel:Parboiled 50 LB -Bolsa Dos Hermanos.,,55.0,28.8,1584.0,3416933.90999998,Bulk Rice,Lisset Limpio -020,WHOLESALER,1385021,Sep
2024-09-23,JMN Dely Corp,Invoice,008-03803,Arroz a Granel:Largo Fino 50 LB -Bolsa Dos Hermanos.,,5.0,27.85,139.25,3417073.15999998,Bulk Rice,Keila Alfaro-Visvikis,CAFETERIA y RESTAURANTS,1385022,Sep
2024-09-23,JMN Dely Corp,Invoice,008-03803,Dry Beans:Dry Beans - Black Beans 50,Dry Black Beans 50 lb,1.0,45.7,45.7,3417118.85999999,Dry Beans,Keila Alfaro-Visvikis,CAFETERIA y RESTAURANTS,1385023,Sep
2024-09-23,JMN Dely Corp,Invoice,008-03803,Arroz a Granel:Parboiled 50 LB -Bolsa Dos Hermanos.,,2.0,27.75,55.5,3417174.35999999,Bulk Rice,Keila Alfaro-Visvikis,CAFETERIA y RESTAURANTS,1385024,Sep
2024-09-23,Los paraditos chinesse,Invoice,008-03804,Arroz a Granel:Parboiled 50 LB -Bolsa Dos Hermanos.,,10.0,28.25,282.5,3417456.85999999,Bulk Rice,Lisset Limpio -020,CAFETERIA y RESTAURANTS,1385025,Sep
2024-09-23,El Palacio de los jugos / Delicias Criollas (DIAGO FOOD_MILLER),Invoice,008-03805,Arroz a Granel:Parboiled 50 LB -Bolsa Dos Hermanos.,,11.0,27.75,305.25,3417762.10999999,Bulk Rice,Lisset Limpio -020,Cafeteria,1385026,Sep
2024-09-23,El Palacio de los jugos / Delicias Criollas (DIAGO FOOD_MILLER),Invoice,008-03805,Arroz a Granel:Parboiled 50 LB -Bolsa Dos Hermanos.,,1.0,27.75,27.75,3417789.85999999,Bulk Rice,Lisset Limpio -020,Cafeteria,1385027,Sep
2024-09-23,El Palacio de los jugos / Delicias Criollas (DIAGO FOOD_MILLER),Invoice,008-03805,Liquids:AS Lemon Juice 4/1 Gl,,1.0,14.95,14.95,3417804.80999999,American Spice,Lisset Limpio -020,Cafeteria,1385028,Sep
2024-09-23,El Gallego Supermarket,Invoice,008-03806,Arroz a Granel:Parboiled 50 LB -Bolsa Dos Hermanos.,,5.0,28.25,141.25,3417946.05999999,Bulk Rice,Lisset Limpio -020,RETAIL  DSD,1385029,Sep
2024-09-23,El Gallego Supermarket,Invoice,008-03806,Dry Beans:Dry Beans - Black Beans 50,Dry Black Beans 50 lb,2.0,45.7,91.4,3418037.45999999,Dry Beans,Lisset Limpio -020,RETAIL  DSD,1385030,Sep
2024-09-23,Seabra Foods / A&J Supermarkets,Invoice,008-03807,Rice Snack:Rice Snack Ham Flavored DOS HERMANOS,,1.0,19.9,19.9,3418057.35999999,Puffed Products,Keila Alfaro-Visvikis,RETAIL  DSD,1385031,Sep
2024-09-23,Seabra Foods / A&J Supermarkets,Invoice,008-03807,Rice Snack:Rice Snack Salami Flavored DOS HERMANOS,,1.0,19.9,19.9,3418077.25999999,Puffed Products,Keila Alfaro-Visvikis,RETAIL  DSD,1385032,Sep
2024-09-23,Seabra Foods / A&J Supermarkets,Invoice,008-03807,"Rice Snack:Rice Snack, Pizza DH",,1.0,19.9,19.9,3418097.15999998,Puffed Products,Keila Alfaro-Visvikis,RETAIL  DSD,1385033,Sep
2024-09-23,Seabra Foods / A&J Supermarkets,Invoice,008-03807,Arroz Envasado:Largo Fino 1kg (Long grain rice) Dos Hermanos,,1.0,17.0,17.0,3418114.15999998,Branded Rice,Keila Alfaro-Visvikis,RETAIL  DSD,1385034,Sep
2024-09-23,Seabra Foods / A&J Supermarkets,Invoice,008-03807,Arroz Envasado:Parboiled 1kg Bolsa Dos Hermanos.,.,1.0,19.9,19.9,3418134.05999998,Branded Rice,Keila Alfaro-Visvikis,RETAIL  DSD,1385035,Sep
2024-09-23,Seabra Foods / A&J Supermarkets,Invoice,008-03807,Arroz Envasado:Parboiled 5KG Dos Hermanos.,6 / 11lbs,1.0,46.5,46.5,3418180.55999998,Branded Rice,Keila Alfaro-Visvikis,RETAIL  DSD,1385036,Sep
2024-09-23,Seabra Foods / A&J Supermarkets,Invoice,008-03807,Arroz Envasado:Aromatic Type Rice Dos Hermanos.,.,1.0,20.0,20.0,3418200.55999998,Branded Rice,Keila Alfaro-Visvikis,RETAIL  DSD,1385037,Sep
2024-09-23,Seabra Foods / A&J Supermarkets,Invoice,008-03807,Arroz Envasado:Organico LF Dos Hermanos,.,1.0,24.0,24.0,3418224.55999998,Branded Rice,Keila Alfaro-Visvikis,RETAIL  DSD,1385038,Sep
2024-09-23,Seabra Foods / A&J Supermarkets,Invoice,008-03807,Arroz Envasado:Sushi Rice Dos Hermanos.,.,1.0,20.0,20.0,3418244.55999998,Branded Rice,Keila Alfaro-Visvikis,RETAIL  DSD,1385039,Sep
2024-09-23,Seabra Foods / A&J Supermarkets,Invoice,008-03807,Tostadas de Arroz:Tostadas de Arroz Dulce DH 120Gr.,iF/iB/iA/i16,1.0,19.9,19.9,3418264.45999998,Puffed Products,Keila Alfaro-Visvikis,RETAIL  DSD,1385040,Sep
2024-09-23,Seabra Foods / A&J Supermarkets,Invoice,008-03807,Tostadas de Arroz:Tostadas de Arroz Saladas 120gr,iC/ii/iD/i16,1.0,19.9,19.9,3418284.35999998,Puffed Products,Keila Alfaro-Visvikis,RETAIL  DSD,1385041,Sep
2024-09-23,Seabra Foods / A&J Supermarkets,Invoice,008-03807,Tostadas de Arroz:Tostadas de Arroz Sin Sal 120gr,iE/iG/iH/i24/,1.0,19.9,19.9,3418304.25999998,Puffed Products,Keila Alfaro-Visvikis,RETAIL  DSD,1385042,Sep
2024-09-23,El Palacio de los jugos / Delicias Criollas (DIAGO FOOD_MILLER),Credit Memo,008-03879,Varios:Sales,,-1.0,27.75,-27.75,3418276.50999998,Bulk Rice,Lisset Limpio -020,Cafeteria,1385043,Sep
2024-09-24,Ideal Food Basket Deerfield,Invoice,008-03808,Arroz Envasado:Largo Fino 1kg (Long grain rice) Dos Hermanos,,2.0,17.0,34.0,3418310.50999998,Branded Rice,Keila Alfaro-Visvikis,RETAIL  DSD,1385044,Sep
2024-09-24,Ideal Food Basket Deerfield,Invoice,008-03808,Arroz Envasado:Parboiled 1kg Bolsa Dos Hermanos.,.,3.0,19.9,59.7,3418370.20999998,Branded Rice,Keila Alfaro-Visvikis,RETAIL  DSD,1385045,Sep
2024-09-24,Ideal Food Basket Deerfield,Invoice,008-03808,Arroz Envasado:Parboiled 5KG Dos Hermanos.,6 / 11lbs,1.0,46.5,46.5,3418416.70999998,Branded Rice,Keila Alfaro-Visvikis,RETAIL  DSD,1385046,Sep
2024-09-24,Ideal Food Basket Deerfield,Invoice,008-03808,Rice Snack:Rice Snack Ham Flavored DOS HERMANOS,,1.0,19.9,19.9,3418436.60999998,Puffed Products,Keila Alfaro-Visvikis,RETAIL  DSD,1385047,Sep
2024-09-24,Ideal Food Basket Deerfield,Invoice,008-03808,Rice Snack:Rice Snack Salami Flavored DOS HERMANOS,,1.0,19.9,19.9,3418456.50999998,Puffed Products,Keila Alfaro-Visvikis,RETAIL  DSD,1385048,Sep
2024-09-24,Ideal Food Basket Deerfield,Invoice,008-03808,"Rice Snack:Rice Snack, Pizza DH",,1.0,19.9,19.9,3418476.40999998,Puffed Products,Keila Alfaro-Visvikis,RETAIL  DSD,1385049,Sep
2024-09-25,Sedanos Supermarkets #27,Invoice,008-03809,Arroz a Granel:Parboiled 50 LB -Bolsa Dos Hermanos.,,6.0,28.25,169.5,3418645.90999998,Bulk Rice,Keila Alfaro-Visvikis,RETAIL SEDANOS,1385050,Sep
2024-09-25,Sedanos Supermarkets #27,Invoice,008-03809,Arroz Envasado:Parboiled 5KG Dos Hermanos.,6 / 11lbs,3.0,40.5,121.5,3418767.40999998,Branded Rice,Keila Alfaro-Visvikis,RETAIL SEDANOS,1385051,Sep
2024-09-25,Sedanos Supermarkets #27,Invoice,008-03809,Varios:Promotional Allowance,,3.0,-11.15,-33.45,3418733.95999998,Branded Rice,Keila Alfaro-Visvikis,RETAIL SEDANOS,1385052,Sep
2024-09-25,Sedanos Supermarkets #27,Invoice,008-03809,,Discount,,,-5.15,3418728.80999998,,Keila Alfaro-Visvikis,RETAIL SEDANOS,1385053,Sep
2024-09-25,Sedanos Supermarkets #34,Invoice,008-03810,Arroz a Granel:Parboiled 50 LB -Bolsa Dos Hermanos.,,6.0,28.25,169.5,3418898.30999998,Bulk Rice,Keila Alfaro-Visvikis,RETAIL SEDANOS,1385054,Sep
2024-09-25,Sedanos Supermarkets #34,Invoice,008-03810,,Discount,,,-3.39,3418894.91999998,,Keila Alfaro-Visvikis,RETAIL SEDANOS,1385055,Sep
2024-09-25,Sedanos Supermarkets #24,Invoice,008-03811,Arroz a Granel:Parboiled 50 LB -Bolsa Dos Hermanos.,,6.0,28.25,169.5,3419064.41999998,Bulk Rice,Keila Alfaro-Visvikis,RETAIL SEDANOS,1385056,Sep
2024-09-25,Sedanos Supermarkets #24,Invoice,008-03811,,Discount,,,-3.39,3419061.02999998,,Keila Alfaro-Visvikis,RETAIL SEDANOS,1385057,Sep
2024-09-25,Ideal Food Basket Deerfield,Invoice,008-03812,Arroz Envasado:Largo Fino 1kg (Long grain rice) Dos Hermanos,,1.0,17.0,17.0,3419078.02999998,Branded Rice,Keila Alfaro-Visvikis,RETAIL  DSD,1385058,Sep
2024-09-25,Ideal Food Basket Deerfield,Invoice,008-03812,"Rice Snack:Rice Snack, Pizza DH",,1.0,19.9,19.9,3419097.92999998,Puffed Products,Keila Alfaro-Visvikis,RETAIL  DSD,1385059,Sep
2024-09-25,Ideal Food Basket Deerfield,Invoice,008-03812,Tostadas de Arroz:Tostadas de Arroz Saladas 120gr,iC/ii/iD/i16,1.0,19.9,19.9,3419117.82999998,Puffed Products,Keila Alfaro-Visvikis,RETAIL  DSD,1385060,Sep
2024-09-25,Ideal Food Basket Deerfield,Credit Memo,008-03880,Varios:Promotional Allowance,,-1.0,17.0,-17.0,3419100.82999998,Branded Rice,Keila Alfaro-Visvikis,RETAIL  DSD,1385061,Sep
2024-09-25,Ideal Food Basket Deerfield,Credit Memo,008-03880,Varios:Promotional Allowance,,-1.0,19.9,-19.9,3419080.92999998,Puffed Products,Keila Alfaro-Visvikis,RETAIL  DSD,1385062,Sep
2024-09-25,Ideal Food Basket Deerfield,Credit Memo,008-03880,Varios:Promotional Allowance,,-1.0,19.9,-19.9,3419061.02999998,Puffed Products,Keila Alfaro-Visvikis,RETAIL  DSD,1385063,Sep
2024-09-26,Vitos Meat and Provisions,Invoice,008-03813,Arroz a Granel:Parboiled 50 LB -Bolsa Dos Hermanos.,,30.0,27.75,832.5,3419893.52999998,Bulk Rice,Keila Alfaro-Visvikis,WHOLESALER,1385064,Sep
2024-09-26,Sedanos Supermarkets #14,Invoice,008-03814,Arroz Envasado:Parboiled 5KG Dos Hermanos.,6 / 11lbs,5.0,40.5,202.5,3420096.02999998,Branded Rice,Lisset Limpio -020,RETAIL SEDANOS,1385065,Sep
2024-09-26,Sedanos Supermarkets #14,Invoice,008-03814,Arroz Envasado:Parboiled 5KG Dos Hermanos.,6 / 11lbs,5.0,-11.15,-55.75,3420040.27999998,Branded Rice,Lisset Limpio -020,RETAIL SEDANOS,1385066,Sep
2024-09-26,Sedanos Supermarkets #14,Invoice,008-03814,,Discount,,,-2.94,3420037.33999998,,Lisset Limpio -020,RETAIL SEDANOS,1385067,Sep
2024-09-26,Mei Chang,Invoice,008-03815,Arroz a Granel:Parboiled 50 LB -Bolsa Dos Hermanos.,,7.0,28.25,197.75,3420235.08999998,Bulk Rice,Lisset Limpio -020,CAFETERIA y RESTAURANTS,1385068,Sep
2024-09-26,Sedanos Supermarkets #7,Invoice,008-03816,Rice Snack:Rice Snack Ham Flavored DOS HERMANOS,,2.0,19.9,39.8,3420274.88999998,Puffed Products,Lisset Limpio -020,RETAIL SEDANOS,1385069,Sep
2024-09-26,Sedanos Supermarkets #7,Invoice,008-03816,,Discount,,,-0.8,3420274.08999998,,Lisset Limpio -020,RETAIL SEDANOS,1385070,Sep
2024-09-26,Los Mejores Tamales de Miami,Invoice,008-03817,Arroz a Granel:Parboiled 50 LB -Bolsa Dos Hermanos.,,3.0,28.25,84.75,3420358.83999998,Bulk Rice,Lisset Limpio -020,CAFETERIA y RESTAURANTS,1385071,Sep
2024-09-26,Fritanga Momotombo,Invoice,008-03818,Arroz a Granel:Largo Fino 50 LB -Bolsa Dos Hermanos.,,6.0,27.85,167.1,3420525.93999998,Bulk Rice,Lisset Limpio -020,CAFETERIA y RESTAURANTS,1385072,Sep
2024-09-26,Be Your Will LLC,Invoice,008-03819,Liquids:AS Cooking Wine,4/1 Gl.,2.0,17.5,35.0,3420560.93999998,American Spice,Lisset Limpio -020,CAFETERIA y RESTAURANTS,1385073,Sep
2024-09-26,Be Your Will LLC,Invoice,008-03819,Arroz a Granel:Parboiled 50 LB -Bolsa Dos Hermanos.,,11.0,27.75,305.25,3420866.18999998,Bulk Rice,Lisset Limpio -020,CAFETERIA y RESTAURANTS,1385074,Sep
2024-09-26,Be Your Will LLC,Invoice,008-03819,Arroz a Granel:Parboiled 50 LB -Bolsa Dos Hermanos.,,1.0,27.75,27.75,3420893.93999998,Bulk Rice,Lisset Limpio -020,CAFETERIA y RESTAURANTS,1385075,Sep
2024-09-26,Bravo   Francisco Diaz,Invoice,008-03820,Spices:AS Chicken Base,1 / 30 lb. (box or pail),1.0,39.5,39.5,3420933.43999998,American Spice,Lisset Limpio -020,RETAIL  DSD,1385076,Sep
2024-09-26,Bravo   Francisco Diaz,Invoice,008-03820,Liquids:AS Cooking Wine,4/1 Gl.,2.0,17.5,35.0,3420968.43999998,American Spice,Lisset Limpio -020,RETAIL  DSD,1385077,Sep
2024-09-26,Bravo   Francisco Diaz,Invoice,008-03820,Arroz a Granel:Largo Fino 50 LB -Bolsa Dos Hermanos.,,4.0,27.85,111.4,3421079.83999998,Bulk Rice,Lisset Limpio -020,RETAIL  DSD,1385078,Sep
2024-09-26,El Palacio de los jugos /  Nanos Latin Foods,Invoice,008-03821,Dry Beans:Dry Beans - Black Beans 50,Dry Black Beans 50 lb,1.0,45.7,45.7,3421125.53999998,Dry Beans,Lisset Limpio -020,Cafeteria,1385079,Sep
2024-09-26,El Palacio de los jugos /  Nanos Latin Foods,Invoice,008-03821,Arroz a Granel:Parboiled 50 LB -Bolsa Dos Hermanos.,,11.0,27.75,305.25,3421430.78999998,Bulk Rice,Lisset Limpio -020,Cafeteria,1385080,Sep
2024-09-26,El Palacio de los jugos /  Nanos Latin Foods,Invoice,008-03821,Arroz a Granel:Parboiled 50 LB -Bolsa Dos Hermanos.,,1.0,27.75,27.75,3421458.53999998,Bulk Rice,Lisset Limpio -020,Cafeteria,1385081,Sep
2024-09-26,El Palacio de los jugos / Lita Foods Inc.,Invoice,008-03822,Arroz a Granel:Parboiled 50 LB -Bolsa Dos Hermanos.,,11.0,27.75,305.25,3421763.78999998,Bulk Rice,Lisset Limpio -020,Cafeteria,1385082,Sep
2024-09-26,El Palacio de los jugos / Lita Foods Inc.,Invoice,008-03822,Dry Beans:Dry Beans - Black Beans 50,Dry Black Beans 50 lb,1.0,45.7,45.7,3421809.48999998,Dry Beans,Lisset Limpio -020,Cafeteria,1385083,Sep
2024-09-26,El Palacio de los jugos / Lita Foods Inc.,Invoice,008-03822,Arroz a Granel:Parboiled 50 LB -Bolsa Dos Hermanos.,,1.0,27.75,27.75,3421837.23999998,Bulk Rice,Lisset Limpio -020,Cafeteria,1385084,Sep
2024-09-26,Sedanos Supermarkets #32,Invoice,008-03823,Arroz a Granel:Parboiled 50 LB -Bolsa Dos Hermanos.,,6.0,28.25,169.5,3422006.73999998,Bulk Rice,Lisset Limpio -020,RETAIL SEDANOS,1385085,Sep
2024-09-26,Sedanos Supermarkets #32,Invoice,008-03823,,Discount,,,-3.39,3422003.34999998,,Lisset Limpio -020,RETAIL SEDANOS,1385086,Sep
2024-09-26,Sedanos Supermarkets #17,Invoice,008-03824,Arroz a Granel:Parboiled 50 LB -Bolsa Dos Hermanos.,,0.0,,0.0,3422003.34999998,Bulk Rice,Lisset Limpio -020,RETAIL SEDANOS,1385087,Sep
2024-09-26,"El Toro Loco Meat Distribution, LLC",Invoice,008-03825,Arroz a Granel:Largo Fino 50 LB -Bolsa Dos Hermanos.,,55.0,27.85,1531.75,3423535.09999998,Bulk Rice,Lisset Limpio -020,CAFETERIA y RESTAURANTS,1385088,Sep
2024-09-26,Sedanos Supermarkets #31,Invoice,008-03826,Arroz a Granel:Parboiled 50 LB -Bolsa Dos Hermanos.,,4.0,28.25,113.0,3423648.09999998,Bulk Rice,Lisset Limpio -020,RETAIL SEDANOS,1385089,Sep
2024-09-26,Sedanos Supermarkets #31,Invoice,008-03826,,Discount,,,-2.26,3423645.83999998,,Lisset Limpio -020,RETAIL SEDANOS,1385090,Sep
2024-09-26,Sedanos Supermarkets #18,Invoice,008-03827,Arroz a Granel:Parboiled 50 LB -Bolsa Dos Hermanos.,,10.0,28.25,282.5,3423928.33999998,Bulk Rice,Lisset Limpio -020,RETAIL SEDANOS,1385091,Sep
2024-09-26,Sedanos Supermarkets #18,Invoice,008-03827,,Discount,,,-8.65,3423919.68999998,,Lisset Limpio -020,RETAIL SEDANOS,1385092,Sep
2024-09-26,Ideal Food Basket Davie Cafeteria,Invoice,008-03828,Arroz a Granel:Largo Fino 50 LB -Bolsa Dos Hermanos.,,10.0,27.85,278.5,3424198.18999998,Bulk Rice,Keila Alfaro-Visvikis,CAFETERIA y RESTAURANTS,1385093,Sep
2024-09-26,Soriano Brothers PB,Invoice,008-03829,Arroz a Granel:Largo Fino 50 LB -Bolsa Dos Hermanos.,,12.0,27.85,334.2,3424532.38999998,Bulk Rice,Lisset Limpio -020,CAFETERIA y RESTAURANTS,1385094,Sep
2024-09-26,Soriano Brothers PB,Invoice,008-03829,Arroz a Granel:Parboiled 50 LB -Bolsa Dos Hermanos.,,22.0,27.75,610.5,3425142.88999998,Bulk Rice,Lisset Limpio -020,CAFETERIA y RESTAURANTS,1385095,Sep
2024-09-26,Soriano Brothers PB,Invoice,008-03829,Spices:AS Sazon (for all),1 / 30 lb (box or pail),2.0,59.0,118.0,3425260.88999998,American Spice,Lisset Limpio -020,CAFETERIA y RESTAURANTS,1385096,Sep
2024-09-26,Soriano Brothers PB,Invoice,008-03829,Dry Beans:Dry Beans - Black Beans 50,Dry Black Beans 50 lb,2.0,45.7,91.4,3425352.28999998,Dry Beans,Lisset Limpio -020,CAFETERIA y RESTAURANTS,1385097,Sep
2024-09-26,Soriano Brothers PB,Invoice,008-03829,Arroz a Granel:Parboiled 50 LB -Bolsa Dos Hermanos.,,2.0,27.75,55.5,3425407.78999998,Bulk Rice,Lisset Limpio -020,CAFETERIA y RESTAURANTS,1385098,Sep
2024-09-26,Soriano Brothers PB,Credit Memo,008-03881,Varios:Promotional Allowance,,-2.0,27.75,-55.5,3425352.28999998,Bulk Rice,Lisset Limpio -020,CAFETERIA y RESTAURANTS,1385099,Sep
2024-09-26,El Palacio de los jugos /  Nanos Latin Foods,Credit Memo,008-03882,Varios:Promotional Allowance,,-1.0,27.75,-27.75,3425324.53999998,Bulk Rice,Lisset Limpio -020,Cafeteria,1385100,Sep
2024-09-26,El Palacio de los jugos / Lita Foods Inc.,Credit Memo,008-03883,Varios:Promotional Allowance,,-1.0,27.75,-27.75,3425296.78999998,Bulk Rice,Lisset Limpio -020,Cafeteria,1385101,Sep
2024-09-26,Be Your Will LLC,Credit Memo,008-03884,Varios:Promotional Allowance,,-1.0,27.75,-27.75,3425269.03999998,Bulk Rice,Lisset Limpio -020,CAFETERIA y RESTAURANTS,1385102,Sep
2024-09-26,El Palacio de los jugos / Delicias Criollas (DIAGO FOOD_MILLER),Credit Memo,008-03885,Varios:Promotional Allowance,,-1.0,27.75,-27.75,3425241.28999998,Bulk Rice,Lisset Limpio -020,Cafeteria,1385103,Sep
2024-09-27,Cash Sales,Invoice,008-03830,Varios:PALLETS,PALLET USADOS,1.0,68.0,68.0,3425309.28999998,,Armando Carpio - 017,CAFETERIA y RESTAURANTS,1385104,Sep
2024-09-30,El Palacio de los jugos / Delicias Criollas (DIAGO FOOD_MILLER),Invoice,008-03831,Dry Beans:Dry Beans - Black Beans 50,Dry Black Beans 50 lb,1.0,45.7,45.7,3425354.98999999,Dry Beans,Lisset Limpio -020,Cafeteria,1385105,Sep
2024-09-30,El Palacio de los jugos / Delicias Criollas (DIAGO FOOD_MILLER),Invoice,008-03831,Arroz a Granel:Parboiled 50 LB -Bolsa Dos Hermanos.,,11.0,27.75,305.25,3425660.23999999,Bulk Rice,Lisset Limpio -020,Cafeteria,1385106,Sep
2024-09-30,El Palacio de los jugos / Delicias Criollas (DIAGO FOOD_MILLER),Invoice,008-03831,Arroz a Granel:Parboiled 50 LB -Bolsa Dos Hermanos.,,1.0,27.75,27.75,3425687.98999999,Bulk Rice,Lisset Limpio -020,Cafeteria,1385107,Sep
2024-09-30,El Palacio de los jugos / Lita Foods Inc.,Invoice,008-03832,Dry Beans:Dry Beans - Black Beans 50,Dry Black Beans 50 lb,1.0,45.7,45.7,3425733.68999999,Dry Beans,Lisset Limpio -020,Cafeteria,1385108,Sep
2024-09-30,El Palacio de los jugos / Lita Foods Inc.,Invoice,008-03832,Arroz a Granel:Parboiled 50 LB -Bolsa Dos Hermanos.,,11.0,27.75,305.25,3426038.93999999,Bulk Rice,Lisset Limpio -020,Cafeteria,1385109,Sep
2024-09-30,El Palacio de los jugos / Lita Foods Inc.,Invoice,008-03832,Arroz a Granel:Parboiled 50 LB -Bolsa Dos Hermanos.,,1.0,27.75,27.75,3426066.68999999,Bulk Rice,Lisset Limpio -020,Cafeteria,1385110,Sep
2024-09-30,El Palacio de Los Jugos / Casa mía Food Restaurant inc,Invoice,008-03833,Dry Beans:Dry Beans - Black Beans 50,Dry Black Beans 50 lb,1.0,45.7,45.7,3426112.38999999,Dry Beans,Lisset Limpio -020,Cafeteria,1385111,Sep
2024-09-30,El Palacio de Los Jugos / Casa mía Food Restaurant inc,Invoice,008-03833,Arroz a Granel:Parboiled 50 LB -Bolsa Dos Hermanos.,,11.0,27.75,305.25,3426417.63999999,Bulk Rice,Lisset Limpio -020,Cafeteria,1385112,Sep
2024-09-30,El Palacio de Los Jugos / Casa mía Food Restaurant inc,Invoice,008-03833,Arroz a Granel:Parboiled 50 LB -Bolsa Dos Hermanos.,,1.0,27.75,27.75,3426445.38999999,Bulk Rice,Lisset Limpio -020,Cafeteria,1385113,Sep
2024-09-30,Lissete Limpio,Invoice,008-03834,Arroz Envasado:Parboiled 1kg Bolsa Dos Hermanos.,.,1.0,19.0,19.0,3426464.38999999,Branded Rice,Lisset Limpio -020,OTHER,1385114,Sep
2024-09-30,Lissete Limpio,Invoice,008-03834,Arroz Envasado:Largo Fino 1kg (Long grain rice) Dos Hermanos,,1.0,17.0,17.0,3426481.38999999,Branded Rice,Lisset Limpio -020,OTHER,1385115,Sep
2024-09-30,Sedanos Supermarkets #16,Invoice,008-03835,Arroz a Granel:Parboiled 50 LB -Bolsa Dos Hermanos.,,3.0,28.25,84.75,3426566.13999999,Bulk Rice,Lisset Limpio -020,RETAIL SEDANOS,1385116,Sep
2024-09-30,Sedanos Supermarkets #16,Invoice,008-03835,,Discount,,,-1.7,3426564.43999999,,Lisset Limpio -020,RETAIL SEDANOS,1385117,Sep
2024-09-30,Soriano Brothers,Invoice,008-03836,Arroz a Granel:Parboiled 50 LB -Bolsa Dos Hermanos.,,55.0,26.5,1457.5,3428021.93999999,Bulk Rice,Lisset Limpio -020,CAFETERIA y RESTAURANTS,1385118,Sep
2024-09-30,"Key Food - Kabfra, LLC",Invoice,008-03837,Arroz Envasado:Largo Fino 1kg (Long grain rice) Dos Hermanos,,2.0,17.0,34.0,3428055.93999999,Branded Rice,Keila Alfaro-Visvikis,RETAIL  DSD,1385119,Sep
2024-09-30,"Key Food - Kabfra, LLC",Invoice,008-03837,Arroz Envasado:Parboiled 1kg Bolsa Dos Hermanos.,.,3.0,19.9,59.7,3428115.63999999,Branded Rice,Keila Alfaro-Visvikis,RETAIL  DSD,1385120,Sep
2024-09-30,"Key Food - Kabfra, LLC",Invoice,008-03837,Arroz a Granel:Parboiled 50 LB -Bolsa Dos Hermanos.,,1.0,28.25,28.25,3428143.88999999,Bulk Rice,Keila Alfaro-Visvikis,RETAIL  DSD,1385121,Sep
2024-09-30,"Key Food - Kabfra, LLC",Invoice,008-03837,Arroz Envasado:Largo Fino 1kg (Long grain rice) Dos Hermanos,,1.0,17.0,17.0,3428160.88999999,Branded Rice,Keila Alfaro-Visvikis,RETAIL  DSD,1385122,Sep
2024-09-30,El Palacio de los jugos / Lita Foods Inc.,Credit Memo,008-03886,Varios:Promotional Allowance,,-1.0,27.75,-27.75,3428133.13999999,Bulk Rice,Lisset Limpio -020,Cafeteria,1385123,Sep
2024-09-30,El Palacio de Los Jugos / Casa mía Food Restaurant inc,Credit Memo,008-03887,Varios:Promotional Allowance,,-1.0,27.75,-27.75,3428105.38999999,Bulk Rice,Lisset Limpio -020,Cafeteria,1385124,Sep
2024-09-30,Lissete Limpio,Credit Memo,008-03888,Varios:Promotional Allowance,parbo,-1.0,19.0,-19.0,3428086.38999999,Branded Rice,Lisset Limpio -020,OTHER,1385125,Sep
2024-09-30,Lissete Limpio,Credit Memo,008-03888,Varios:Promotional Allowance,lf,-1.0,17.0,-17.0,3428069.38999999,Branded Rice,Lisset Limpio -020,OTHER,1385126,Sep
2024-09-30,"Key Food - Kabfra, LLC",Credit Memo,008-03889,Varios:Promotional Allowance,lf,-1.0,17.0,-17.0,3428052.38999999,Branded Rice,Keila Alfaro-Visvikis,RETAIL  DSD,1385127,Sep
2024-10-01,Sabor Tropical Supermarket #5,Invoice,008-03890,Arroz Envasado:Parboiled 5KG Dos Hermanos.,6 / 11lbs,1.0,46.5,46.5,3428098.88999999,Branded Rice,Keila Alfaro-Visvikis,RETAIL  DSD,1385128,Oct
2024-10-01,Sabor Tropical Supermarket #5,Invoice,008-03890,Varios:Promotional Allowance,,1.0,-11.15,-11.15,3428087.73999999,Branded Rice,Keila Alfaro-Visvikis,RETAIL  DSD,1385129,Oct
2024-10-01,Sabor Tropical Supermarket #5,Invoice,008-03890,Arroz Envasado:Largo Fino 1kg (Long grain rice) Dos Hermanos,,2.0,17.0,34.0,3428121.73999999,Branded Rice,Keila Alfaro-Visvikis,RETAIL  DSD,1385130,Oct
2024-10-01,Sabor Tropical Supermarket #5,Invoice,008-03890,Arroz Envasado:Largo Fino 1kg (Long grain rice) Dos Hermanos,,1.0,17.0,17.0,3428138.73999999,Branded Rice,Keila Alfaro-Visvikis,RETAIL  DSD,1385131,Oct
2024-10-01,Sabor Tropical Supermarket #5,Invoice,008-03890,Arroz Envasado:Parboiled 1kg Bolsa Dos Hermanos.,.,3.0,19.9,59.7,3428198.43999999,Branded Rice,Keila Alfaro-Visvikis,RETAIL  DSD,1385132,Oct
2024-10-01,Aries Supermarket & Cafeteria,Invoice,008-03891,Arroz a Granel:Parboiled 50 LB -Bolsa Dos Hermanos.,,10.0,28.25,282.5,3428480.93999999,Bulk Rice,Keila Alfaro-Visvikis,CAFETERIA y RESTAURANTS,1385133,Oct
2024-10-01,Los Caringas Latin America  Foods,Invoice,008-03892,Arroz a Granel:Largo Fino 50 LB -Bolsa Dos Hermanos.,,3.0,27.85,83.55,3428564.48999999,Bulk Rice,Lisset Limpio -020,CAFETERIA y RESTAURANTS,1385134,Oct
2024-10-01,Los Caringas Latin America  Foods,Invoice,008-03892,Arroz a Granel:Parboiled 50 LB -Bolsa Dos Hermanos.,,3.0,28.25,84.75,3428649.23999999,Bulk Rice,Lisset Limpio -020,CAFETERIA y RESTAURANTS,1385135,Oct
2024-10-01,Sedanos Supermarkets #34,Invoice,008-03893,Arroz Envasado:Parboiled 5KG Dos Hermanos.,6 / 11lbs,3.0,40.5,121.5,3428770.73999999,Branded Rice,Keila Alfaro-Visvikis,RETAIL SEDANOS,1385136,Oct
2024-10-01,Sedanos Supermarkets #34,Invoice,008-03893,Varios:Promotional Allowance,,3.0,-11.15,-33.45,3428737.28999999,Branded Rice,Keila Alfaro-Visvikis,RETAIL SEDANOS,1385137,Oct
2024-10-01,Sedanos Supermarkets #34,Invoice,008-03893,,Discount,,,-1.81,3428735.47999999,,Keila Alfaro-Visvikis,RETAIL SEDANOS,1385138,Oct
2024-10-01,Sedanos Supermarkets #29,Invoice,008-03894,Arroz Envasado:Parboiled 5KG Dos Hermanos.,6 / 11lbs,25.0,40.5,1012.5,3429747.97999999,Branded Rice,Lisset Limpio -020,RETAIL SEDANOS,1385139,Oct
2024-10-01,Sedanos Supermarkets #29,Invoice,008-03894,Varios:Promotional Allowance,,25.0,-11.15,-278.75,3429469.22999999,Branded Rice,Lisset Limpio -020,RETAIL SEDANOS,1385140,Oct
2024-10-01,Sedanos Supermarkets #29,Invoice,008-03894,,Discount,,,-14.68,3429454.54999999,,Lisset Limpio -020,RETAIL SEDANOS,1385141,Oct
2024-10-01,ALS Foods,Invoice,008-03895,Liquids:AS Cooking Wine,4/1 Gl.,1.0,17.5,17.5,3429472.04999999,American Spice,Lisset Limpio -020,CAFETERIA y RESTAURANTS,1385142,Oct
2024-10-01,ALS Foods,Invoice,008-03895,Arroz a Granel:Parboiled 50 LB -Bolsa Dos Hermanos.,,11.0,27.75,305.25,3429777.29999999,Bulk Rice,Lisset Limpio -020,CAFETERIA y RESTAURANTS,1385143,Oct
2024-10-01,ALS Foods,Invoice,008-03895,Arroz a Granel:Parboiled 50 LB -Bolsa Dos Hermanos.,,1.0,27.75,27.75,3429805.04999999,Bulk Rice,Lisset Limpio -020,CAFETERIA y RESTAURANTS,1385144,Oct
2024-10-01,Sedanos Supermarkets #27,Invoice,008-03896,Arroz Envasado:Parboiled 5KG Dos Hermanos.,6 / 11lbs,3.0,40.5,121.5,3429926.54999999,Branded Rice,Keila Alfaro-Visvikis,RETAIL SEDANOS,1385145,Oct
2024-10-01,Sedanos Supermarkets #27,Invoice,008-03896,Rice Snack:Rice Snack Ham Flavored DOS HERMANOS,,1.0,19.9,19.9,3429946.44999998,Puffed Products,Keila Alfaro-Visvikis,RETAIL SEDANOS,1385146,Oct
2024-10-01,Sedanos Supermarkets #27,Invoice,008-03896,Varios:Promotional Allowance,,3.0,-11.15,-33.45,3429912.99999998,Branded Rice,Keila Alfaro-Visvikis,RETAIL SEDANOS,1385147,Oct
2024-10-01,Sedanos Supermarkets #27,Invoice,008-03896,,Discount,,,-2.16,3429910.83999998,,Keila Alfaro-Visvikis,RETAIL SEDANOS,1385148,Oct
2024-10-01,Sedanos Supermarkets #24,Invoice,008-03897,Arroz a Granel:Parboiled 50 LB -Bolsa Dos Hermanos.,,6.0,28.25,169.5,3430080.33999998,Bulk Rice,Keila Alfaro-Visvikis,RETAIL SEDANOS,1385149,Oct
2024-10-01,Sedanos Supermarkets #24,Invoice,008-03897,,Discount,,,-3.39,3430076.94999998,,Keila Alfaro-Visvikis,RETAIL SEDANOS,1385150,Oct
2024-10-01,Sedanos Supermarkets #22,Invoice,008-03898,Spices:AS Chicken Base 4/5lb,4/5lb,2.0,40.5,81.0,3430157.94999998,American Spice,Lisset Limpio -020,RETAIL SEDANOS,1385151,Oct
2024-10-01,Sedanos Supermarkets #22,Invoice,008-03898,Arroz a Granel:Parboiled 50 LB -Bolsa Dos Hermanos.,,4.0,28.25,113.0,3430270.94999998,Bulk Rice,Lisset Limpio -020,RETAIL SEDANOS,1385152,Oct
2024-10-01,Sedanos Supermarkets #22,Invoice,008-03898,,Discount,,,-3.88,3430267.06999998,,Lisset Limpio -020,RETAIL SEDANOS,1385153,Oct
2024-10-01,Pacifico Chinese Restaurant,Invoice,008-03899,Arroz a Granel:Parboiled 50 LB -Bolsa Dos Hermanos.,,10.0,28.25,282.5,3430549.56999998,Bulk Rice,Lisset Limpio -020,CAFETERIA y RESTAURANTS,1385154,Oct
2024-10-01,JMN Dely Corp,Invoice,008-03900,Arroz a Granel:Parboiled 50 LB -Bolsa Dos Hermanos.,,3.0,28.2,84.6,3430634.16999998,Bulk Rice,Keila Alfaro-Visvikis,CAFETERIA y RESTAURANTS,1385155,Oct
2024-10-01,JMN Dely Corp,Invoice,008-03900,Arroz a Granel:Largo Fino 50 LB -Bolsa Dos Hermanos.,,4.0,27.85,111.4,3430745.56999998,Bulk Rice,Keila Alfaro-Visvikis,CAFETERIA y RESTAURANTS,1385156,Oct
2024-10-01,JMN Dely Corp,Invoice,008-03900,Dry Beans:Dry Beans - Black Beans 50,Dry Black Beans 50 lb,1.0,45.7,45.7,3430791.26999998,Dry Beans,Keila Alfaro-Visvikis,CAFETERIA y RESTAURANTS,1385157,Oct
2024-10-01,ALS Foods,Credit Memo,008-03978,Varios:Promotional Allowance,50lb PARBO,-1.0,27.75,-27.75,3430763.51999998,Bulk Rice,Lisset Limpio -020,CAFETERIA y RESTAURANTS,1385158,Oct
2024-10-01,Sabor Tropical Supermarket #5,Credit Memo,008-03979,Varios:Promotional Allowance,1kg LF,-1.0,17.0,-17.0,3430746.51999998,Branded Rice,Keila Alfaro-Visvikis,RETAIL  DSD,1385159,Oct
2024-10-03,El Palacio de los jugos /  Mires Restaurants,Invoice,008-03901,Liquids:AS Marinating Sauce (Mojo),,1.0,18.5,18.5,3430765.01999998,American Spice,Lisset Limpio -020,Cafeteria,1385160,Oct
2024-10-03,El Palacio de los jugos /  Mires Restaurants,Invoice,008-03901,Arroz a Granel:Parboiled 50 LB -Bolsa Dos Hermanos.,,11.0,27.75,305.25,3431070.26999998,Bulk Rice,Lisset Limpio -020,Cafeteria,1385161,Oct
2024-10-03,El Palacio de los jugos /  Mires Restaurants,Invoice,008-03901,Arroz a Granel:Parboiled 50 LB -Bolsa Dos Hermanos.,,1.0,27.75,27.75,3431098.01999998,Bulk Rice,Lisset Limpio -020,Cafeteria,1385162,Oct
2024-10-03,El Palacio de Los Jugos / Casa mía Food Restaurant inc,Invoice,008-03902,Dry Beans:Dry Beans - Black Beans 50,Dry Black Beans 50 lb,1.0,45.7,45.7,3431143.71999998,Dry Beans,Lisset Limpio -020,Cafeteria,1385163,Oct
2024-10-03,El Palacio de Los Jugos / Casa mía Food Restaurant inc,Invoice,008-03902,Arroz a Granel:Parboiled 50 LB -Bolsa Dos Hermanos.,,11.0,27.75,305.25,3431448.96999998,Bulk Rice,Lisset Limpio -020,Cafeteria,1385164,Oct
2024-10-03,El Palacio de Los Jugos / Casa mía Food Restaurant inc,Invoice,008-03902,Arroz a Granel:Parboiled 50 LB -Bolsa Dos Hermanos.,,1.0,27.75,27.75,3431476.71999998,Bulk Rice,Lisset Limpio -020,Cafeteria,1385165,Oct
2024-10-03,Latin American Restaurant #2,Invoice,008-03903,Arroz a Granel:Parboiled 50 LB -Bolsa Dos Hermanos.,,1.0,28.25,28.25,3431504.96999998,Bulk Rice,Keila Alfaro-Visvikis,CAFETERIA y RESTAURANTS,1385166,Oct
2024-10-03,Key Food 40th. cafeteria,Invoice,008-03904,Arroz a Granel:Parboiled 50 LB -Bolsa Dos Hermanos.,,1.0,28.25,28.25,3431533.21999998,Bulk Rice,Keila Alfaro-Visvikis,CAFETERIA y RESTAURANTS,1385167,Oct
2024-10-03,Key Foods 40 St,Invoice,008-03905,Arroz Envasado:Largo Fino 1kg (Long grain rice) Dos Hermanos,,2.0,17.0,34.0,3431567.21999998,Branded Rice,Keila Alfaro-Visvikis,RETAIL  DSD,1385168,Oct
2024-10-03,Key Foods 40 St,Invoice,008-03905,Arroz Envasado:Parboiled 1kg Bolsa Dos Hermanos.,.,3.0,19.9,59.7,3431626.91999999,Branded Rice,Keila Alfaro-Visvikis,RETAIL  DSD,1385169,Oct
2024-10-03,Key Foods 40 St,Invoice,008-03905,Arroz Envasado:Largo Fino 1kg (Long grain rice) Dos Hermanos,,1.0,17.0,17.0,3431643.91999999,Branded Rice,Keila Alfaro-Visvikis,RETAIL  DSD,1385170,Oct
2024-10-03,Be Your Will LLC,Invoice,008-03906,Liquids:AS Cooking Wine,4/1 Gl.,1.0,17.5,17.5,3431661.41999999,American Spice,Lisset Limpio -020,CAFETERIA y RESTAURANTS,1385171,Oct
2024-10-03,Be Your Will LLC,Invoice,008-03906,Arroz a Granel:Parboiled 50 LB -Bolsa Dos Hermanos.,,11.0,27.75,305.25,3431966.66999999,Bulk Rice,Lisset Limpio -020,CAFETERIA y RESTAURANTS,1385172,Oct
2024-10-03,Be Your Will LLC,Invoice,008-03906,Arroz a Granel:Parboiled 50 LB -Bolsa Dos Hermanos.,,1.0,27.75,27.75,3431994.41999999,Bulk Rice,Lisset Limpio -020,CAFETERIA y RESTAURANTS,1385173,Oct
2024-10-03,Albert Deli #2,Invoice,008-03907,Dry Beans:Dry Beans - Black Beans 50,Dry Black Beans 50 lb,1.0,45.7,45.7,3432040.11999999,Dry Beans,Keila Alfaro-Visvikis,CAFETERIA y RESTAURANTS,1385174,Oct
2024-10-03,Albert Deli #2,Invoice,008-03907,Dry Beans:Dry Beans - Small Red Beans 50 lbs.,Small Red Beans 50 lbs,1.0,46.85,46.85,3432086.96999999,Dry Beans,Keila Alfaro-Visvikis,CAFETERIA y RESTAURANTS,1385175,Oct
2024-10-03,Albert Deli #2,Invoice,008-03907,Arroz a Granel:Largo Fino 50 LB -Bolsa Dos Hermanos.,,5.0,27.85,139.25,3432226.21999999,Bulk Rice,Keila Alfaro-Visvikis,CAFETERIA y RESTAURANTS,1385176,Oct
2024-10-03,Albert Deli #2,Invoice,008-03907,Arroz a Granel:Parboiled 50 LB -Bolsa Dos Hermanos.,,2.0,28.25,56.5,3432282.71999999,Bulk Rice,Keila Alfaro-Visvikis,CAFETERIA y RESTAURANTS,1385177,Oct
2024-10-03,Extra Supermarket,Invoice,008-03908,Arroz Envasado:Parboiled 5KG Dos Hermanos.,6 / 11lbs,15.0,46.5,697.5,3432980.21999999,Branded Rice,Keila Alfaro-Visvikis,RETAIL  DSD,1385178,Oct
2024-10-03,Extra Supermarket,Invoice,008-03908,Arroz Envasado:Parboiled 5KG Dos Hermanos.,6 / 11lbs,2.0,46.5,93.0,3433073.21999999,Branded Rice,Keila Alfaro-Visvikis,RETAIL  DSD,1385179,Oct
2024-10-03,Sedanos Supermarkets  #11,Invoice,008-03909,Arroz Envasado:Parboiled 5KG Dos Hermanos.,6 / 11lbs,2.0,40.5,81.0,3433154.21999999,Branded Rice,Keila Alfaro-Visvikis,RETAIL SEDANOS,1385180,Oct
2024-10-03,Sedanos Supermarkets  #11,Invoice,008-03909,,Discount,,,-1.62,3433152.59999999,,Keila Alfaro-Visvikis,RETAIL SEDANOS,1385181,Oct
2024-10-03,Rey Chavez Distributor #2,Invoice,008-03910,Arroz a Granel:Parboiled 50 LB -Bolsa Dos Hermanos.,,25.0,28.8,720.0,3433872.59999999,Bulk Rice,Lisset Limpio -020,WHOLESALER,1385182,Oct
2024-10-03,Sedanos Supermarkets #42,Invoice,008-03911,Arroz a Granel:Parboiled 50 LB -Bolsa Dos Hermanos.,,4.0,28.25,113.0,3433985.59999999,Bulk Rice,Lisset Limpio -020,RETAIL SEDANOS,1385183,Oct
2024-10-03,Sedanos Supermarkets #42,Invoice,008-03911,,Discount,,,-2.26,3433983.33999999,,Lisset Limpio -020,RETAIL SEDANOS,1385184,Oct
2024-10-03,El Palacio de los jugos / Sahilys Cafe,Invoice,008-03912,Arroz a Granel:Parboiled 50 LB -Bolsa Dos Hermanos.,,1.0,27.75,27.75,3434011.08999999,Bulk Rice,Lisset Limpio -020,Cafeteria,1385185,Oct
2024-10-03,Sedanos Supermarkets #32,Invoice,008-03913,Rice Snack:Rice Snack Ham Flavored DOS HERMANOS,,2.0,19.9,39.8,3434050.88999999,Puffed Products,Lisset Limpio -020,RETAIL SEDANOS,1385186,Oct
2024-10-03,Sedanos Supermarkets #32,Invoice,008-03913,,Discount,,,-0.8,3434050.08999999,,Lisset Limpio -020,RETAIL SEDANOS,1385187,Oct
2024-10-03,Sedanos Supermarkets  #37,Invoice,008-03914,Arroz a Granel:Largo Fino 50 LB -Bolsa Dos Hermanos.,,5.0,27.85,139.25,3434189.33999999,Bulk Rice,Lisset Limpio -020,RETAIL SEDANOS,1385188,Oct
2024-10-03,Sedanos Supermarkets  #37,Invoice,008-03914,Arroz a Granel:Parboiled 50 LB -Bolsa Dos Hermanos.,,5.0,28.25,141.25,3434330.58999999,Bulk Rice,Lisset Limpio -020,RETAIL SEDANOS,1385189,Oct
2024-10-03,Sedanos Supermarkets  #37,Invoice,008-03914,,Discount,,,-5.61,3434324.97999999,,Lisset Limpio -020,RETAIL SEDANOS,1385190,Oct
2024-10-03,Panda Depot,Invoice,008-03915,Arroz a Granel:Parboiled 50 LB -Bolsa Dos Hermanos.,,275.0,25.0,6875.0,3441199.97999999,Bulk Rice,Lisset Limpio -020,WHOLESALER,1385191,Oct
2024-10-03,El Palacio de los jugos /  Mires Restaurants,Credit Memo,008-03980,Varios:Promotional Allowance,50lb parbo,-1.0,27.75,-27.75,3441172.22999999,Bulk Rice,Lisset Limpio -020,Cafeteria,1385192,Oct
2024-10-03,Extra Supermarket,Credit Memo,008-03981,Varios:Promotional Allowance,5kg parbo,-2.0,46.5,-93.0,3441079.22999999,Branded Rice,Keila Alfaro-Visvikis,RETAIL  DSD,1385193,Oct
2024-10-03,Be Your Will LLC,Credit Memo,008-03982,Varios:Promotional Allowance,50 lb parbo,-1.0,27.75,-27.75,3441051.47999999,Bulk Rice,Lisset Limpio -020,CAFETERIA y RESTAURANTS,1385194,Oct
2024-10-03,Key Foods 40 St,Credit Memo,008-03983,Varios:Promotional Allowance,lf 1kg,-1.0,17.0,-17.0,3441034.47999999,Branded Rice,Keila Alfaro-Visvikis,RETAIL  DSD,1385195,Oct
2024-10-03,El Palacio de Los Jugos / Casa mía Food Restaurant inc,Credit Memo,008-03984,Varios:Promotional Allowance,50lb parbo,-1.0,27.75,-27.75,3441006.72999999,Bulk Rice,Lisset Limpio -020,Cafeteria,1385196,Oct
2024-10-04,El Palacio de los jugos /  Nanos Latin Foods,Invoice,008-03916,Arroz a Granel:Parboiled 50 LB -Bolsa Dos Hermanos.,,10.0,26.5,265.0,3441271.72999999,Bulk Rice,Lisset Limpio -020,Cafeteria,1385197,Oct
2024-10-07,Los Mejores Tamales de Miami,Invoice,008-03917,Arroz a Granel:Parboiled 50 LB -Bolsa Dos Hermanos.,,4.0,28.25,113.0,3441384.72999999,Bulk Rice,Lisset Limpio -020,CAFETERIA y RESTAURANTS,1385198,Oct
2024-10-07,El Palacio de los jugos / Delicias Criollas (DIAGO FOOD_MILLER),Invoice,008-03918,Dry Beans:Dry Beans - Black Beans 50,Dry Black Beans 50 lb,1.0,45.7,45.7,3441430.42999999,Dry Beans,Lisset Limpio -020,Cafeteria,1385199,Oct
2024-10-07,El Palacio de los jugos / Delicias Criollas (DIAGO FOOD_MILLER),Invoice,008-03918,Arroz a Granel:Parboiled 50 LB -Bolsa Dos Hermanos.,,11.0,27.75,305.25,3441735.67999999,Bulk Rice,Lisset Limpio -020,Cafeteria,1385200,Oct
2024-10-07,El Palacio de los jugos / Delicias Criollas (DIAGO FOOD_MILLER),Invoice,008-03918,Arroz a Granel:Parboiled 50 LB -Bolsa Dos Hermanos.,,1.0,27.75,27.75,3441763.42999999,Bulk Rice,Lisset Limpio -020,Cafeteria,1385201,Oct
2024-10-07,El Palacio de los jugos / Lita Foods Inc.,Invoice,008-03919,Dry Beans:Dry Beans - Black Beans 50,Dry Black Beans 50 lb,1.0,45.7,45.7,3441809.12999999,Dry Beans,Lisset Limpio -020,Cafeteria,1385202,Oct
2024-10-07,El Palacio de los jugos / Lita Foods Inc.,Invoice,008-03919,Arroz a Granel:Parboiled 50 LB -Bolsa Dos Hermanos.,,11.0,27.75,305.25,3442114.37999999,Bulk Rice,Lisset Limpio -020,Cafeteria,1385203,Oct
2024-10-07,El Palacio de los jugos / Lita Foods Inc.,Invoice,008-03919,Arroz a Granel:Parboiled 50 LB -Bolsa Dos Hermanos.,,1.0,27.75,27.75,3442142.12999999,Bulk Rice,Lisset Limpio -020,Cafeteria,1385204,Oct
2024-10-07,Fritanga Momotombo,Invoice,008-03920,Arroz a Granel:Largo Fino 50 LB -Bolsa Dos Hermanos.,,5.0,27.85,139.25,3442281.37999999,Bulk Rice,Lisset Limpio -020,CAFETERIA y RESTAURANTS,1385205,Oct
2024-10-07,Price Choice Food Market # 6,Invoice,008-03921,Arroz a Granel:Parboiled 50 LB -Bolsa Dos Hermanos.,,20.0,28.25,565.0,3442846.37999999,Bulk Rice,Lisset Limpio -020,RETAIL  DSD,1385206,Oct
2024-10-07,Price Choice 5 YNTO Food Corp.,Invoice,008-03922,Arroz Envasado:Largo Fino 1kg (Long grain rice) Dos Hermanos,,3.0,17.0,51.0,3442897.37999999,Branded Rice,Keila Alfaro-Visvikis,RETAIL  DSD,1385207,Oct
2024-10-07,Price Choice 5 YNTO Food Corp.,Invoice,008-03922,Arroz Envasado:Parboiled 1kg Bolsa Dos Hermanos.,.,2.0,19.9,39.8,3442937.17999999,Branded Rice,Keila Alfaro-Visvikis,RETAIL  DSD,1385208,Oct
2024-10-07,Price Choice 5 YNTO Food Corp.,Invoice,008-03922,Rice Snack:Rice Snack Ham Flavored DOS HERMANOS,,1.0,19.9,19.9,3442957.07999999,Puffed Products,Keila Alfaro-Visvikis,RETAIL  DSD,1385209,Oct
2024-10-07,Price Choice 5 YNTO Food Corp.,Invoice,008-03922,Rice Snack:Rice Snack Salami Flavored DOS HERMANOS,,1.0,19.9,19.9,3442976.97999999,Puffed Products,Keila Alfaro-Visvikis,RETAIL  DSD,1385210,Oct
2024-10-07,Price Choice 5 YNTO Food Corp.,Invoice,008-03922,Arroz Envasado:Largo Fino 1kg (Long grain rice) Dos Hermanos,,1.0,17.0,17.0,3442993.97999999,Branded Rice,Keila Alfaro-Visvikis,RETAIL  DSD,1385211,Oct
2024-10-07,JMN Dely Corp,Invoice,008-03923,Arroz a Granel:Largo Fino 50 LB -Bolsa Dos Hermanos.,,5.0,27.85,139.25,3443133.22999999,Bulk Rice,Keila Alfaro-Visvikis,CAFETERIA y RESTAURANTS,1385212,Oct
2024-10-07,JMN Dely Corp,Invoice,008-03923,Arroz a Granel:Parboiled 50 LB -Bolsa Dos Hermanos.,,2.0,27.75,55.5,3443188.72999999,Bulk Rice,Keila Alfaro-Visvikis,CAFETERIA y RESTAURANTS,1385213,Oct
2024-10-07,JMN Dely Corp,Invoice,008-03923,Dry Beans:Dry Beans - Black Beans 50,Dry Black Beans 50 lb,1.0,45.7,45.7,3443234.42999999,Dry Beans,Keila Alfaro-Visvikis,CAFETERIA y RESTAURANTS,1385214,Oct
2024-10-07,Brito Family Corp.,Invoice,008-03924,Arroz a Granel:Largo Fino 50 LB -Bolsa Dos Hermanos.,,55.0,27.85,1531.75,3444766.17999999,Bulk Rice,Lisset Limpio -020,CAFETERIA y RESTAURANTS,1385215,Oct
2024-10-07,Bravo   Francisco Diaz,Invoice,008-03925,Liquids:AS Cooking Wine,4/1 Gl.,3.0,17.5,52.5,3444818.67999999,American Spice,Lisset Limpio -020,RETAIL  DSD,1385216,Oct
2024-10-07,Bravo   Francisco Diaz,Invoice,008-03925,Arroz a Granel:Largo Fino 50 LB -Bolsa Dos Hermanos.,,5.0,27.85,139.25,3444957.92999999,Bulk Rice,Lisset Limpio -020,RETAIL  DSD,1385217,Oct
2024-10-07,El Palacio de los jugos / Lita Foods Inc.,Credit Memo,008-03985,Varios:Promotional Allowance,50lb parbo,-1.0,27.75,-27.75,3444930.17999999,Bulk Rice,Lisset Limpio -020,Cafeteria,1385218,Oct
2024-10-07,El Palacio de los jugos / Delicias Criollas (DIAGO FOOD_MILLER),Credit Memo,008-03986,Varios:Promotional Allowance,50lb,-1.0,27.75,-27.75,3444902.42999999,Bulk Rice,Lisset Limpio -020,Cafeteria,1385219,Oct
2024-10-07,Price Choice 5 YNTO Food Corp.,Credit Memo,008-03987,Varios:Promotional Allowance,lf 1kg,-1.0,17.0,-17.0,3444885.42999999,Branded Rice,Keila Alfaro-Visvikis,RETAIL  DSD,1385220,Oct
2024-10-08,Soriano Brothers PB,Invoice,008-03926,Arroz a Granel:Parboiled 50 LB -Bolsa Dos Hermanos.,,22.0,27.75,610.5,3445495.92999999,Bulk Rice,Lisset Limpio -020,CAFETERIA y RESTAURANTS,1385221,Oct
2024-10-08,Soriano Brothers PB,Invoice,008-03926,Arroz a Granel:Largo Fino 50 LB -Bolsa Dos Hermanos.,,15.0,27.85,417.75,3445913.67999999,Bulk Rice,Lisset Limpio -020,CAFETERIA y RESTAURANTS,1385222,Oct
2024-10-08,Soriano Brothers PB,Invoice,008-03926,Dry Beans:Dry Beans - Black Beans 50,Dry Black Beans 50 lb,2.0,45.7,91.4,3446005.07999999,Dry Beans,Lisset Limpio -020,CAFETERIA y RESTAURANTS,1385223,Oct
2024-10-08,Soriano Brothers PB,Invoice,008-03926,Spices:AS Complete Seasoning,4/4 lb,2.0,49.5,99.0,3446104.07999999,American Spice,Lisset Limpio -020,CAFETERIA y RESTAURANTS,1385224,Oct
2024-10-08,Soriano Brothers PB,Invoice,008-03926,Arroz a Granel:Parboiled 50 LB -Bolsa Dos Hermanos.,,2.0,27.75,55.5,3446159.57999999,Bulk Rice,Lisset Limpio -020,CAFETERIA y RESTAURANTS,1385225,Oct
2024-10-08,Soriano Brothers PB,Credit Memo,008-03988,Varios:Promotional Allowance,parbo 50 lb,-2.0,27.75,-55.5,3446104.07999999,Bulk Rice,Lisset Limpio -020,CAFETERIA y RESTAURANTS,1385226,Oct
2024-10-10,Aries Supermarket & Cafeteria,Invoice,008-03927,Dry Beans:Dry Beans - Black Beans 50,Dry Black Beans 50 lb,7.0,39.75,278.25,3446382.32999999,Dry Beans,Keila Alfaro-Visvikis,CAFETERIA y RESTAURANTS,1385227,Oct
2024-10-10,Aries Supermarket & Cafeteria,Invoice,008-03927,Arroz a Granel:Parboiled 50 LB -Bolsa Dos Hermanos.,,7.0,28.25,197.75,3446580.07999999,Bulk Rice,Keila Alfaro-Visvikis,CAFETERIA y RESTAURANTS,1385228,Oct
2024-10-10,Sedanos Supermarkets #42,Invoice,008-03928,Arroz a Granel:Parboiled 50 LB -Bolsa Dos Hermanos.,,5.0,28.25,141.25,3446721.32999999,Bulk Rice,Lisset Limpio -020,RETAIL SEDANOS,1385229,Oct
2024-10-10,Sedanos Supermarkets #42,Invoice,008-03928,,Discount,,,-2.83,3446718.49999999,,Lisset Limpio -020,RETAIL SEDANOS,1385230,Oct
2024-10-10,Los paraditos chinesse,Invoice,008-03929,Arroz a Granel:Parboiled 50 LB -Bolsa Dos Hermanos.,,5.0,28.25,141.25,3446859.74999999,Bulk Rice,Lisset Limpio -020,CAFETERIA y RESTAURANTS,1385231,Oct
2024-10-10,Sedanos Supermarkets #43,Invoice,008-03930,Arroz a Granel:Parboiled 50 LB -Bolsa Dos Hermanos.,,5.0,28.25,141.25,3447000.99999999,Bulk Rice,Keila Alfaro-Visvikis,RETAIL SEDANOS,1385232,Oct
2024-10-10,Sedanos Supermarkets #43,Invoice,008-03930,,Discount,,,-2.83,3446998.16999999,,Keila Alfaro-Visvikis,RETAIL SEDANOS,1385233,Oct
2024-10-10,Sedanos Supermarkets #16,Invoice,008-03931,Arroz a Granel:Parboiled 50 LB -Bolsa Dos Hermanos.,,3.0,28.25,84.75,3447082.91999999,Bulk Rice,Keila Alfaro-Visvikis,RETAIL SEDANOS,1385234,Oct
2024-10-10,Sedanos Supermarkets #16,Invoice,008-03931,,Discount,,,-1.7,3447081.21999999,,Keila Alfaro-Visvikis,RETAIL SEDANOS,1385235,Oct
2024-10-10,Sedanos Supermarkets #26,Invoice,008-03932,Arroz a Granel:Parboiled 50 LB -Bolsa Dos Hermanos.,,0.0,,0.0,3447081.21999999,Bulk Rice,Keila Alfaro-Visvikis,RETAIL SEDANOS,1385236,Oct
2024-10-10,Rey Chavez Distributor Corp,Invoice,008-03933,Arroz a Granel:Parboiled 50 LB -Bolsa Dos Hermanos.,,110.0,28.8,3168.0,3450249.21999999,Bulk Rice,Lisset Limpio -020,WHOLESALER,1385237,Oct
2024-10-10,Mei Chang,Invoice,008-03934,Arroz a Granel:Parboiled 50 LB -Bolsa Dos Hermanos.,,10.0,28.25,282.5,3450531.71999999,Bulk Rice,Lisset Limpio -020,CAFETERIA y RESTAURANTS,1385238,Oct
2024-10-10,Sedanos Supermarkets #26,Invoice,008-03935,Arroz a Granel:Parboiled 50 LB -Bolsa Dos Hermanos.,,3.0,28.25,84.75,3450616.46999999,Bulk Rice,Keila Alfaro-Visvikis,RETAIL SEDANOS,1385239,Oct
2024-10-10,Sedanos Supermarkets #26,Invoice,008-03935,,Discount,,,-1.7,3450614.76999999,,Keila Alfaro-Visvikis,RETAIL SEDANOS,1385240,Oct
2024-10-10,Sedanos Supermarkets #31,Invoice,008-03936,Arroz a Granel:Parboiled 50 LB -Bolsa Dos Hermanos.,,5.0,28.25,141.25,3450756.01999999,Bulk Rice,Lisset Limpio -020,RETAIL SEDANOS,1385241,Oct
2024-10-10,Sedanos Supermarkets #31,Invoice,008-03936,,Discount,,,-2.83,3450753.18999999,,Lisset Limpio -020,RETAIL SEDANOS,1385242,Oct
2024-10-10,Sedanos Supermarkets #34,Invoice,008-03937,Arroz a Granel:Parboiled 50 LB -Bolsa Dos Hermanos.,,4.0,28.25,113.0,3450866.18999999,Bulk Rice,Keila Alfaro-Visvikis,RETAIL SEDANOS,1385243,Oct
2024-10-10,Sedanos Supermarkets #34,Invoice,008-03937,,Discount,,,-2.26,3450863.92999999,,Keila Alfaro-Visvikis,RETAIL SEDANOS,1385244,Oct
2024-10-10,Sedanos Supermarkets #24,Invoice,008-03938,Arroz a Granel:Parboiled 50 LB -Bolsa Dos Hermanos.,,4.0,28.25,113.0,3450976.92999999,Bulk Rice,Keila Alfaro-Visvikis,RETAIL SEDANOS,1385245,Oct
2024-10-10,Sedanos Supermarkets #24,Invoice,008-03938,,Discount,,,-2.26,3450974.66999999,,Keila Alfaro-Visvikis,RETAIL SEDANOS,1385246,Oct
2024-10-10,Sedanos Supermarkets #27,Invoice,008-03939,Arroz a Granel:Parboiled 50 LB -Bolsa Dos Hermanos.,,6.0,28.25,169.5,3451144.16999999,Bulk Rice,Keila Alfaro-Visvikis,RETAIL SEDANOS,1385247,Oct
2024-10-10,Sedanos Supermarkets #27,Invoice,008-03939,,Discount,,,-3.39,3451140.77999999,,Keila Alfaro-Visvikis,RETAIL SEDANOS,1385248,Oct
2024-10-10,Sabor Tropical Supermarket #4,Invoice,008-03940,Arroz Envasado:Largo Fino 1kg (Long grain rice) Dos Hermanos,,3.0,17.0,51.0,3451191.77999999,Branded Rice,Keila Alfaro-Visvikis,RETAIL  DSD,1385249,Oct
2024-10-10,Sabor Tropical Supermarket #4,Invoice,008-03940,Arroz Envasado:Parboiled 1kg Bolsa Dos Hermanos.,.,2.0,19.9,39.8,3451231.57999999,Branded Rice,Keila Alfaro-Visvikis,RETAIL  DSD,1385250,Oct
2024-10-10,Sabor Tropical Supermarket #4,Invoice,008-03940,Arroz Envasado:Largo Fino 1kg (Long grain rice) Dos Hermanos,,1.0,17.0,17.0,3451248.57999999,Branded Rice,Keila Alfaro-Visvikis,RETAIL  DSD,1385251,Oct
2024-10-10,Ideal Food Basket Davie Cafeteria,Invoice,008-03941,Arroz a Granel:Largo Fino 50 LB -Bolsa Dos Hermanos.,,12.0,27.85,334.2,3451582.77999999,Bulk Rice,Keila Alfaro-Visvikis,CAFETERIA y RESTAURANTS,1385252,Oct
2024-10-10,Armando Carpio,Invoice,008-03942,Arroz Envasado:Largo Fino 1kg (Long grain rice) Dos Hermanos,,1.0,17.0,17.0,3451599.77999999,Branded Rice,Armando Carpio - 017,OTHER,1385253,Oct
2024-10-10,Armando Carpio,Invoice,008-03942,Arroz Envasado:Parboiled 5KG Dos Hermanos.,6 / 11lbs,1.0,46.5,46.5,3451646.27999999,Branded Rice,Armando Carpio - 017,OTHER,1385254,Oct
2024-10-10,Armando Carpio,Invoice,008-03942,Arroz a Granel:Parboiled 50 LB -Bolsa Dos Hermanos.,Samples Keila,2.0,28.25,56.5,3451702.77999999,Bulk Rice,Armando Carpio - 017,OTHER,1385255,Oct
2024-10-10,Sabor Tropical Supermarket #4,Credit Memo,008-03989,Varios:Promotional Allowance,,-1.0,17.0,-17.0,3451685.77999999,Branded Rice,Keila Alfaro-Visvikis,RETAIL  DSD,1385256,Oct
2024-10-10,Armando Carpio,Credit Memo,008-04124,Varios:Promotional Allowance,1kg,-1.0,17.0,-17.0,3451668.77999999,Branded Rice,Armando Carpio - 017,OTHER,1385257,Oct
2024-10-10,Armando Carpio,Credit Memo,008-04124,Varios:Promotional Allowance,5kg,-1.0,46.5,-46.5,3451622.27999999,Branded Rice,Armando Carpio - 017,OTHER,1385258,Oct
2024-10-10,Armando Carpio,Credit Memo,008-04124,Varios:Promotional Allowance,50LB,-2.0,28.25,-56.5,3451565.77999999,Bulk Rice,Armando Carpio - 017,OTHER,1385259,Oct
2024-10-11,El Gallego Supermarket,Invoice,008-03943,Arroz a Granel:Parboiled 50 LB -Bolsa Dos Hermanos.,,5.0,28.25,141.25,3451707.02999999,Bulk Rice,Lisset Limpio -020,RETAIL  DSD,1385260,Oct
2024-10-11,El Gallego Supermarket,Invoice,008-03943,Dry Beans:Dry Beans - Black Beans 50,Dry Black Beans 50 lb,2.0,45.7,91.4,3451798.42999999,Dry Beans,Lisset Limpio -020,RETAIL  DSD,1385261,Oct
2024-10-11,Sedanos Supermarkets #32,Invoice,008-03944,Arroz a Granel:Parboiled 50 LB -Bolsa Dos Hermanos.,,7.0,28.25,197.75,3451996.17999999,Bulk Rice,Lisset Limpio -020,RETAIL SEDANOS,1385262,Oct
2024-10-11,Sedanos Supermarkets #32,Invoice,008-03944,,Discount,,,-3.96,3451992.21999999,,Lisset Limpio -020,RETAIL SEDANOS,1385263,Oct
2024-10-11,Sedanos Supermarkets #18,Invoice,008-03945,Arroz a Granel:Parboiled 50 LB -Bolsa Dos Hermanos.,,8.0,28.25,226.0,3452218.21999999,Bulk Rice,Lisset Limpio -020,RETAIL SEDANOS,1385264,Oct
2024-10-11,Sedanos Supermarkets #18,Invoice,008-03945,,Discount,,,-4.52,3452213.69999999,,Lisset Limpio -020,RETAIL SEDANOS,1385265,Oct
2024-10-11,El Palacio de los jugos /  Nanos Latin Foods,Invoice,008-03946,Arroz a Granel:Parboiled 50 LB -Bolsa Dos Hermanos.,,5.0,26.5,132.5,3452346.19999999,Bulk Rice,Lisset Limpio -020,Cafeteria,1385266,Oct
2024-10-11,ALS Foods,Invoice,008-03947,Liquids:AS Cooking Wine,4/1 Gl.,2.0,17.5,35.0,3452381.19999999,American Spice,Lisset Limpio -020,CAFETERIA y RESTAURANTS,1385267,Oct
2024-10-11,ALS Foods,Invoice,008-03947,Arroz a Granel:Parboiled 50 LB -Bolsa Dos Hermanos.,,8.0,27.75,222.0,3452603.19999999,Bulk Rice,Lisset Limpio -020,CAFETERIA y RESTAURANTS,1385268,Oct
2024-10-11,ALS Foods,Invoice,008-03947,Arroz a Granel:Largo Fino 50 LB -Bolsa Dos Hermanos.,,6.0,27.85,167.1,3452770.29999999,Bulk Rice,Lisset Limpio -020,CAFETERIA y RESTAURANTS,1385269,Oct
2024-10-11,Los paraditos chinesse,Invoice,008-03948,Arroz a Granel:Parboiled 50 LB -Bolsa Dos Hermanos.,,5.0,28.25,141.25,3452911.54999999,Bulk Rice,Lisset Limpio -020,CAFETERIA y RESTAURANTS,1385270,Oct
2024-10-11,El Palacio de los jugos / Lita Foods Inc.,Invoice,008-03949,Dry Beans:Dry Beans - Black Beans 50,Dry Black Beans 50 lb,1.0,45.7,45.7,3452957.24999999,Dry Beans,Lisset Limpio -020,Cafeteria,1385271,Oct
2024-10-11,El Palacio de los jugos / Lita Foods Inc.,Invoice,008-03949,Arroz a Granel:Parboiled 50 LB -Bolsa Dos Hermanos.,,11.0,27.75,305.25,3453262.49999999,Bulk Rice,Lisset Limpio -020,Cafeteria,1385272,Oct
2024-10-11,El Palacio de los jugos / Lita Foods Inc.,Invoice,008-03949,Arroz a Granel:Parboiled 50 LB -Bolsa Dos Hermanos.,,1.0,28.25,28.25,3453290.74999999,Bulk Rice,Lisset Limpio -020,Cafeteria,1385273,Oct
2024-10-11,El Palacio de Los Jugos / Casa mía Food Restaurant inc,Invoice,008-03950,Arroz a Granel:Parboiled 50 LB -Bolsa Dos Hermanos.,,11.0,27.75,305.25,3453595.99999999,Bulk Rice,Lisset Limpio -020,Cafeteria,1385274,Oct
2024-10-11,El Palacio de Los Jugos / Casa mía Food Restaurant inc,Invoice,008-03950,Dry Beans:Dry Beans - Black Beans 50,Dry Black Beans 50 lb,1.0,45.7,45.7,3453641.69999999,Dry Beans,Lisset Limpio -020,Cafeteria,1385275,Oct
2024-10-11,El Palacio de Los Jugos / Casa mía Food Restaurant inc,Invoice,008-03950,Arroz a Granel:Parboiled 50 LB -Bolsa Dos Hermanos.,,1.0,27.75,27.75,3453669.44999999,Bulk Rice,Lisset Limpio -020,Cafeteria,1385276,Oct
2024-10-11,El Palacio de Los Jugos / Casa mía Food Restaurant inc,Credit Memo,008-03990,Varios:Promotional Allowance,50lb,-1.0,27.75,-27.75,3453641.69999999,Bulk Rice,Lisset Limpio -020,Cafeteria,1385277,Oct
2024-10-14,Bravo   Francisco Diaz,Invoice,008-03951,Liquids:AS Cooking Wine,4/1 Gl.,3.0,17.5,52.5,3453694.19999999,American Spice,Lisset Limpio -020,RETAIL  DSD,1385278,Oct
2024-10-14,Bravo   Francisco Diaz,Invoice,008-03951,Liquids:AS Marinating Sauce (Mojo),,2.0,18.5,37.0,3453731.19999999,American Spice,Lisset Limpio -020,RETAIL  DSD,1385279,Oct
2024-10-14,Bravo   Francisco Diaz,Invoice,008-03951,Arroz a Granel:Largo Fino 50 LB -Bolsa Dos Hermanos.,,5.0,27.85,139.25,3453870.44999999,Bulk Rice,Lisset Limpio -020,RETAIL  DSD,1385280,Oct
2024-10-14,Bravo   Francisco Diaz,Invoice,008-03951,Liquids:AS White Vinegar,4/1 Gl.,1.0,10.0,10.0,3453880.44999999,American Spice,Lisset Limpio -020,RETAIL  DSD,1385281,Oct
2024-10-14,Bravo   Francisco Diaz,Invoice,008-03951,Spices:AS Chicken Base,1 / 30 lb. (box or pail),1.0,20.5,20.5,3453900.94999999,American Spice,Lisset Limpio -020,RETAIL  DSD,1385282,Oct
2024-10-14,Bravo   Francisco Diaz,Invoice,008-03951,Spices:AS Complete Seasoning,4/4 lb,1.0,49.5,49.5,3453950.44999999,American Spice,Lisset Limpio -020,RETAIL  DSD,1385283,Oct
2024-10-14,El Palacio de Los Jugos / Casa mía Food Restaurant inc,Invoice,008-03952,Dry Beans:Dry Beans - Black Beans 50,Dry Black Beans 50 lb,1.0,45.7,45.7,3453996.14999999,Dry Beans,Lisset Limpio -020,Cafeteria,1385284,Oct
2024-10-14,El Palacio de Los Jugos / Casa mía Food Restaurant inc,Invoice,008-03952,Arroz a Granel:Parboiled 50 LB -Bolsa Dos Hermanos.,,11.0,27.75,305.25,3454301.39999999,Bulk Rice,Lisset Limpio -020,Cafeteria,1385285,Oct
2024-10-14,El Palacio de Los Jugos / Casa mía Food Restaurant inc,Invoice,008-03952,Arroz a Granel:Parboiled 50 LB -Bolsa Dos Hermanos.,,1.0,27.75,27.75,3454329.14999999,Bulk Rice,Lisset Limpio -020,Cafeteria,1385286,Oct
2024-10-14,El Palacio de los jugos / Delicias Criollas (DIAGO FOOD_MILLER),Invoice,008-03953,Arroz a Granel:Parboiled 50 LB -Bolsa Dos Hermanos.,,11.0,27.75,305.25,3454634.39999999,Bulk Rice,Lisset Limpio -020,Cafeteria,1385287,Oct
2024-10-14,El Palacio de los jugos / Delicias Criollas (DIAGO FOOD_MILLER),Invoice,008-03953,Arroz a Granel:Parboiled 50 LB -Bolsa Dos Hermanos.,,1.0,27.75,27.75,3454662.14999999,Bulk Rice,Lisset Limpio -020,Cafeteria,1385288,Oct
2024-10-14,El Palacio de los jugos / Delicias Criollas (DIAGO FOOD_MILLER),Invoice,008-03953,Liquids:AS Cooking Wine,4/1 Gl.,1.0,17.5,17.5,3454679.64999999,American Spice,Lisset Limpio -020,Cafeteria,1385289,Oct
2024-10-14,Sabor Tropical Supermarket #5,Invoice,008-03954,Arroz Envasado:Parboiled 5KG Dos Hermanos.,6 / 11lbs,2.0,46.5,93.0,3454772.64999999,Branded Rice,Keila Alfaro-Visvikis,RETAIL  DSD,1385290,Oct
2024-10-14,Sabor Tropical Supermarket #5,Invoice,008-03954,Varios:Promotional Allowance,,2.0,-11.15,-22.3,3454750.34999999,Branded Rice,Keila Alfaro-Visvikis,RETAIL  DSD,1385291,Oct
2024-10-14,VIÑA & SONS FOOD DIST.CORP,Invoice,008-03955,Arroz a Granel:Parboiled 50 LB -Bolsa Dos Hermanos.,,10.0,27.75,277.5,3455027.84999999,Bulk Rice,Keila Alfaro-Visvikis,CAFETERIA y RESTAURANTS,1385292,Oct
2024-10-14,JMN Dely Corp,Invoice,008-03956,Arroz a Granel:Largo Fino 50 LB -Bolsa Dos Hermanos.,,4.0,27.85,111.4,3455139.24999999,Bulk Rice,Keila Alfaro-Visvikis,CAFETERIA y RESTAURANTS,1385293,Oct
2024-10-14,JMN Dely Corp,Invoice,008-03956,Arroz a Granel:Parboiled 50 LB -Bolsa Dos Hermanos.,,2.0,28.25,56.5,3455195.74999999,Bulk Rice,Keila Alfaro-Visvikis,CAFETERIA y RESTAURANTS,1385294,Oct
2024-10-14,JMN Dely Corp,Invoice,008-03956,Dry Beans:Dry Beans - Black Beans 50,Dry Black Beans 50 lb,1.0,45.7,45.7,3455241.44999999,Dry Beans,Keila Alfaro-Visvikis,CAFETERIA y RESTAURANTS,1385295,Oct
2024-10-14,Total Food supermarket,Invoice,008-03957,Arroz a Granel:Parboiled 50 LB -Bolsa Dos Hermanos.,,5.0,28.25,141.25,3455382.69999999,Bulk Rice,Keila Alfaro-Visvikis,RETAIL  DSD,1385296,Oct
2024-10-14,Total Food supermarket,Invoice,008-03957,Arroz Envasado:Largo Fino 1kg (Long grain rice) Dos Hermanos,,5.0,17.0,85.0,3455467.69999999,Branded Rice,Keila Alfaro-Visvikis,RETAIL  DSD,1385297,Oct
2024-10-14,Total Food supermarket,Invoice,008-03957,Arroz Envasado:Largo Fino 1kg (Long grain rice) Dos Hermanos,,1.0,17.0,17.0,3455484.69999999,Branded Rice,Keila Alfaro-Visvikis,RETAIL  DSD,1385298,Oct
2024-10-14,Key Foods 40 St,Invoice,008-03958,Arroz Envasado:Parboiled 5KG Dos Hermanos.,6 / 11lbs,14.0,46.5,651.0,3456135.69999999,Branded Rice,Keila Alfaro-Visvikis,RETAIL  DSD,1385299,Oct
2024-10-14,Key Foods 40 St,Invoice,008-03958,Arroz Envasado:Parboiled 5KG Dos Hermanos.,6 / 11lbs,2.0,46.5,93.0,3456228.69999999,Branded Rice,Keila Alfaro-Visvikis,RETAIL  DSD,1385300,Oct
2024-10-14,"Virtue Distributor, Inc",Invoice,008-03959,Arroz a Granel:Parboiled 50 LB -Bolsa Dos Hermanos.,,55.0,27.75,1526.25,3457754.94999999,Bulk Rice,Armando Carpio - 017,Distributor,1385301,Oct
2024-10-14,"Virtue Distributor, Inc",Invoice,008-03959,Arroz a Granel:Largo Fino 50 LB -Bolsa Dos Hermanos.,,55.0,27.85,1531.75,3459286.69999999,Bulk Rice,Armando Carpio - 017,Distributor,1385302,Oct
2024-10-14,El Palacio de Los Jugos / Casa mía Food Restaurant inc,Credit Memo,008-03991,Varios:Promotional Allowance,50lb,-1.0,27.75,-27.75,3459258.94999999,Bulk Rice,Lisset Limpio -020,Cafeteria,1385303,Oct
2024-10-14,El Palacio de los jugos / Delicias Criollas (DIAGO FOOD_MILLER),Credit Memo,008-03992,Varios:Promotional Allowance,,-1.0,27.75,-27.75,3459231.19999999,Bulk Rice,Lisset Limpio -020,Cafeteria,1385304,Oct
2024-10-14,Total Food supermarket,Credit Memo,008-03993,Varios:Promotional Allowance,1kg lf,-1.0,17.0,-17.0,3459214.19999999,Branded Rice,Keila Alfaro-Visvikis,RETAIL  DSD,1385305,Oct
2024-10-14,Key Foods 40 St,Credit Memo,008-03994,Varios:Promotional Allowance,5kg,-2.0,46.5,-93.0,3459121.19999999,Branded Rice,Keila Alfaro-Visvikis,RETAIL  DSD,1385306,Oct
2024-10-15,Be Your Will LLC,Invoice,008-03960,Liquids:AS Cooking Wine,4/1 Gl.,2.0,17.5,35.0,3459156.19999999,American Spice,Lisset Limpio -020,CAFETERIA y RESTAURANTS,1385307,Oct
2024-10-15,Be Your Will LLC,Invoice,008-03960,Arroz a Granel:Largo Fino 50 LB -Bolsa Dos Hermanos.,,5.0,27.85,139.25,3459295.44999999,Bulk Rice,Lisset Limpio -020,CAFETERIA y RESTAURANTS,1385308,Oct
2024-10-15,Be Your Will LLC,Invoice,008-03960,Arroz a Granel:Parboiled 50 LB -Bolsa Dos Hermanos.,,11.0,27.75,305.25,3459600.69999999,Bulk Rice,Lisset Limpio -020,CAFETERIA y RESTAURANTS,1385309,Oct
2024-10-15,Be Your Will LLC,Invoice,008-03960,Arroz a Granel:Parboiled 50 LB -Bolsa Dos Hermanos.,,1.0,27.75,27.75,3459628.44999999,Bulk Rice,Lisset Limpio -020,CAFETERIA y RESTAURANTS,1385310,Oct
2024-10-15,Bravo   Francisco Diaz,Invoice,008-03961,Spices:AS Chicken Base,1 / 30 lb. (box or pail),1.0,39.0,39.0,3459667.44999999,American Spice,Lisset Limpio -020,RETAIL  DSD,1385311,Oct
2024-10-15,Bravo   Francisco Diaz,Invoice,008-03961,Liquids:AS Marinating Sauce (Mojo),,2.0,18.5,37.0,3459704.44999999,American Spice,Lisset Limpio -020,RETAIL  DSD,1385312,Oct
2024-10-15,Bravo   Francisco Diaz,Invoice,008-03961,Liquids:AS White Vinegar,4/1 Gl.,1.0,10.0,10.0,3459714.44999999,American Spice,Lisset Limpio -020,RETAIL  DSD,1385313,Oct
2024-10-15,El Palacio de los jugos / Lita Foods Inc.,Invoice,008-03962,Dry Beans:Dry Beans - Black Beans 50,Dry Black Beans 50 lb,1.0,45.7,45.7,3459760.14999999,Dry Beans,Lisset Limpio -020,Cafeteria,1385314,Oct
2024-10-15,El Palacio de los jugos / Lita Foods Inc.,Invoice,008-03962,Arroz a Granel:Parboiled 50 LB -Bolsa Dos Hermanos.,,11.0,27.75,305.25,3460065.39999999,Bulk Rice,Lisset Limpio -020,Cafeteria,1385315,Oct
2024-10-15,El Palacio de los jugos / Lita Foods Inc.,Invoice,008-03962,Arroz a Granel:Parboiled 50 LB -Bolsa Dos Hermanos.,,1.0,28.25,28.25,3460093.64999999,Bulk Rice,Lisset Limpio -020,Cafeteria,1385316,Oct
2024-10-15,"Soriano Brothers Diaz Food Service,Inc",Invoice,008-03963,Dry Beans:Dry Beans - Black Beans 50,Dry Black Beans 50 lb,10.0,45.7,457.0,3460550.64999999,Dry Beans,Lisset Limpio -020,CAFETERIA y RESTAURANTS,1385317,Oct
2024-10-15,"Soriano Brothers Diaz Food Service,Inc",Invoice,008-03963,Dry Beans:Dry Beans - Small Red Beans 50 lbs.,Small Red Beans 50 lbs,1.0,46.85,46.85,3460597.49999999,Dry Beans,Lisset Limpio -020,CAFETERIA y RESTAURANTS,1385318,Oct
2024-10-15,"Soriano Brothers Diaz Food Service,Inc",Invoice,008-03963,Arroz a Granel:Parboiled 50 LB -Bolsa Dos Hermanos.,,54.0,27.75,1498.5,3462095.99999999,Bulk Rice,Lisset Limpio -020,CAFETERIA y RESTAURANTS,1385319,Oct
2024-10-15,"Soriano Brothers Diaz Food Service,Inc",Invoice,008-03963,Arroz a Granel:Parboiled 50 LB -Bolsa Dos Hermanos.,,5.0,27.75,138.75,3462234.74999999,Bulk Rice,Lisset Limpio -020,CAFETERIA y RESTAURANTS,1385320,Oct
2024-10-15,Sedanos Supermarkets #16,Invoice,008-03964,Arroz a Granel:Parboiled 50 LB -Bolsa Dos Hermanos.,,4.0,26.5,106.0,3462340.74999999,Bulk Rice,Keila Alfaro-Visvikis,RETAIL SEDANOS,1385321,Oct
2024-10-15,Sedanos Supermarkets #16,Invoice,008-03964,,Discount,,,-2.12,3462338.62999999,,Keila Alfaro-Visvikis,RETAIL SEDANOS,1385322,Oct
2024-10-15,Sedanos Supermarkets #22,Invoice,008-03965,Arroz a Granel:Parboiled 50 LB -Bolsa Dos Hermanos.,,5.0,26.5,132.5,3462471.12999999,Bulk Rice,Keila Alfaro-Visvikis,RETAIL SEDANOS,1385323,Oct
2024-10-15,Sedanos Supermarkets #22,Invoice,008-03965,,Discount,,,-2.65,3462468.47999999,,Keila Alfaro-Visvikis,RETAIL SEDANOS,1385324,Oct
2024-10-15,Sedanos Supermarkets #26,Invoice,008-03966,Arroz a Granel:Parboiled 50 LB -Bolsa Dos Hermanos.,,3.0,26.5,79.5,3462547.97999999,Bulk Rice,Keila Alfaro-Visvikis,RETAIL SEDANOS,1385325,Oct
2024-10-15,Sedanos Supermarkets #26,Invoice,008-03966,,Discount,,,-1.59,3462546.38999999,,Keila Alfaro-Visvikis,RETAIL SEDANOS,1385326,Oct
2024-10-15,Key Foods  / Ivan,Credit Memo,008-03968,Varios:Producto vencido/deteriorado (no impacta en inventario),"1 caja salami, 1 caja pizza y 1 caja jamon",-3.0,19.9,-59.7,3462486.68999999,Puffed Products,Keila Alfaro-Visvikis,RETAIL  DSD,1385327,Oct
2024-10-15,Sedanos Supermarkets #9,Credit Memo,008-03969,Varios:Producto vencido/deteriorado (no impacta en inventario),AJUSTE SALDOS VIEJOS,-1.0,25.43,-25.43,3462461.25999999,,Keila Alfaro-Visvikis,RETAIL SEDANOS,1385328,Oct
2024-10-15,Sedanos Supermarkets #29,Credit Memo,008-03970,Varios:Producto vencido/deteriorado (no impacta en inventario),AJUSTE SALDOS VIEJOS,-1.0,29.0,-29.0,3462432.25999999,,Lisset Limpio -020,RETAIL SEDANOS,1385329,Oct
2024-10-15,Sedanos Supermarkets #21,Credit Memo,008-03971,Varios:Producto vencido/deteriorado (no impacta en inventario),AJUSTE SALDOS VIEJOS,-1.0,43.5,-43.5,3462388.75999999,,Lisset Limpio -020,RETAIL SEDANOS,1385330,Oct
2024-10-15,Sedanos Supermarkets #42,Credit Memo,008-03972,Varios:Producto vencido/deteriorado (no impacta en inventario),CIERRE SALDOS VIEJOS,-1.0,19.62,-19.62,3462369.13999999,,Lisset Limpio -020,RETAIL SEDANOS,1385331,Oct
2024-10-15,Sedanos Supermarkets #1,Credit Memo,008-03973,Varios:Producto vencido/deteriorado (no impacta en inventario),AJUSTE SALDOS VIEJOS,-1.0,59.28,-59.28,3462309.85999999,,Keila Alfaro-Visvikis,RETAIL SEDANOS,1385332,Oct
2024-10-15,Sedanos Supermarkets #43,Credit Memo,008-03974,Varios:Producto vencido/deteriorado (no impacta en inventario),AJUSTE SALDOS VIEJOS,-1.0,125.6,-125.6,3462184.25999999,,Keila Alfaro-Visvikis,RETAIL SEDANOS,1385333,Oct
2024-10-15,Sedanos Supermarkets #8,Credit Memo,008-03975,Varios:Producto vencido/deteriorado (no impacta en inventario),CIERRE SALDOS VIEJOS,-1.0,122.25,-122.25,3462062.00999999,,Keila Alfaro-Visvikis,RETAIL SEDANOS,1385334,Oct
2024-10-15,Los Caringas Latin America  Foods,Credit Memo,008-03976,Varios:Producto vencido/deteriorado (no impacta en inventario),,-1.0,0.75,-0.75,3462061.25999999,,Lisset Limpio -020,CAFETERIA y RESTAURANTS,1385335,Oct
2024-10-15,Sedanos Supermarkets #36,Credit Memo,008-03977,Varios:Producto vencido/deteriorado (no impacta en inventario),CIERRE SALDOS VIEJOS,-1.0,11.24,-11.24,3462050.01999999,,Keila Alfaro-Visvikis,RETAIL SEDANOS,1385336,Oct
2024-10-15,Be Your Will LLC,Credit Memo,008-03995,Varios:Promotional Allowance,50lb,-1.0,27.75,-27.75,3462022.26999999,Bulk Rice,Lisset Limpio -020,CAFETERIA y RESTAURANTS,1385337,Oct
2024-10-15,"Soriano Brothers Diaz Food Service,Inc",Credit Memo,008-03996,Varios:Promotional Allowance,,-5.0,27.75,-138.75,3461883.51999999,Bulk Rice,Lisset Limpio -020,CAFETERIA y RESTAURANTS,1385338,Oct
2024-10-16,Soriano Brothers,Invoice,008-03997,Arroz a Granel:Parboiled 50 LB -Bolsa Dos Hermanos.,,55.0,26.5,1457.5,3463341.01999999,Bulk Rice,Lisset Limpio -020,CAFETERIA y RESTAURANTS,1385339,Oct
2024-10-16,Sedanos Supermarkets #33,Invoice,008-03998,Arroz a Granel:Parboiled 50 LB -Bolsa Dos Hermanos.,,4.0,26.5,106.0,3463447.01999999,Bulk Rice,Keila Alfaro-Visvikis,RETAIL SEDANOS,1385340,Oct
2024-10-16,Sedanos Supermarkets #33,Invoice,008-03998,,Discount,,,-2.12,3463444.89999999,,Keila Alfaro-Visvikis,RETAIL SEDANOS,1385341,Oct
2024-10-16,Key Foods  / Ivan,Invoice,008-03999,Arroz Envasado:Parboiled 5KG Dos Hermanos.,6 / 11lbs,15.0,46.5,697.5,3464142.39999999,Branded Rice,Keila Alfaro-Visvikis,RETAIL  DSD,1385342,Oct
2024-10-16,Key Foods  / Ivan,Invoice,008-03999,Arroz Envasado:Largo Fino 1kg (Long grain rice) Dos Hermanos,,5.0,17.0,85.0,3464227.39999999,Branded Rice,Keila Alfaro-Visvikis,RETAIL  DSD,1385343,Oct
2024-10-16,Key Foods  / Ivan,Invoice,008-03999,Arroz Envasado:Parboiled 5KG Dos Hermanos.,6 / 11lbs,2.0,46.5,93.0,3464320.39999999,Branded Rice,Keila Alfaro-Visvikis,RETAIL  DSD,1385344,Oct
2024-10-16,Key Foods  / Ivan,Invoice,008-03999,Arroz Envasado:Largo Fino 1kg (Long grain rice) Dos Hermanos,,1.0,17.0,17.0,3464337.39999999,Branded Rice,Keila Alfaro-Visvikis,RETAIL  DSD,1385345,Oct
2024-10-16,Los Mejores Tamales de Miami,Invoice,008-04000,Arroz a Granel:Parboiled 50 LB -Bolsa Dos Hermanos.,,4.0,28.25,113.0,3464450.39999999,Bulk Rice,Lisset Limpio -020,CAFETERIA y RESTAURANTS,1385346,Oct
2024-10-16,Sedanos Supermarkets #14,Invoice,008-04001,Arroz a Granel:Parboiled 50 LB -Bolsa Dos Hermanos.,,4.0,26.5,106.0,3464556.39999999,Bulk Rice,Lisset Limpio -020,RETAIL SEDANOS,1385347,Oct
2024-10-16,Sedanos Supermarkets #14,Invoice,008-04001,,Discount,,,-2.12,3464554.27999999,,Lisset Limpio -020,RETAIL SEDANOS,1385348,Oct
2024-10-16,Neighbors Food Market / Luis Diaz,Invoice,008-04002,Arroz Envasado:Largo Fino 1kg (Long grain rice) Dos Hermanos,,5.0,17.0,85.0,3464639.27999999,Branded Rice,Keila Alfaro-Visvikis,RETAIL  DSD,1385349,Oct
2024-10-16,Neighbors Food Market / Luis Diaz,Invoice,008-04002,Arroz Envasado:Largo Fino 1kg (Long grain rice) Dos Hermanos,,1.0,17.0,17.0,3464656.27999999,Branded Rice,Keila Alfaro-Visvikis,RETAIL  DSD,1385350,Oct
2024-10-16,Ideal Food Basket Davie Cafeteria,Invoice,008-04003,Arroz a Granel:Largo Fino 50 LB -Bolsa Dos Hermanos.,,10.0,27.85,278.5,3464934.77999999,Bulk Rice,Keila Alfaro-Visvikis,CAFETERIA y RESTAURANTS,1385351,Oct
2024-10-16,Sedanos Supermarkets #24,Invoice,008-04004,Arroz a Granel:Parboiled 50 LB -Bolsa Dos Hermanos.,,4.0,26.5,106.0,3465040.77999999,Bulk Rice,Keila Alfaro-Visvikis,RETAIL SEDANOS,1385352,Oct
2024-10-16,Sedanos Supermarkets #24,Invoice,008-04004,,Discount,,,-2.12,3465038.65999999,,Keila Alfaro-Visvikis,RETAIL SEDANOS,1385353,Oct
2024-10-17,Soriano Brothers PB,Invoice,008-04005,Arroz a Granel:Parboiled 50 LB -Bolsa Dos Hermanos.,,11.0,27.75,305.25,3465343.90999999,Bulk Rice,Lisset Limpio -020,CAFETERIA y RESTAURANTS,1385354,Oct
2024-10-17,Soriano Brothers PB,Invoice,008-04005,Arroz a Granel:Largo Fino 50 LB -Bolsa Dos Hermanos.,,25.0,27.85,696.25,3466040.15999999,Bulk Rice,Lisset Limpio -020,CAFETERIA y RESTAURANTS,1385355,Oct
2024-10-17,Soriano Brothers PB,Invoice,008-04005,Dry Beans:Dry Beans - Small Red Beans 50 lbs.,Small Red Beans 50 lbs,2.0,46.85,93.7,3466133.85999999,Dry Beans,Lisset Limpio -020,CAFETERIA y RESTAURANTS,1385356,Oct
2024-10-17,Soriano Brothers PB,Invoice,008-04005,Dry Beans:Dry Beans - Black Beans 50,Dry Black Beans 50 lb,3.0,45.7,137.1,3466270.95999999,Dry Beans,Lisset Limpio -020,CAFETERIA y RESTAURANTS,1385357,Oct
2024-10-17,Soriano Brothers PB,Invoice,008-04005,Spices:AS Complete Seasoning,4/6 lb,2.0,49.5,99.0,3466369.95999999,American Spice,Lisset Limpio -020,CAFETERIA y RESTAURANTS,1385358,Oct
2024-10-17,Soriano Brothers PB,Invoice,008-04005,Arroz a Granel:Parboiled 50 LB -Bolsa Dos Hermanos.,,1.0,27.75,27.75,3466397.70999999,Bulk Rice,Lisset Limpio -020,CAFETERIA y RESTAURANTS,1385359,Oct
2024-10-17,Sedanos Supermarkets #38,Invoice,008-04006,Arroz Envasado:Parboiled 5KG Dos Hermanos.,6 / 11lbs,30.0,40.5,1215.0,3467612.70999999,Branded Rice,Lisset Limpio -020,RETAIL SEDANOS,1385360,Oct
2024-10-17,Sedanos Supermarkets #38,Invoice,008-04006,Arroz Envasado:Parboiled 5KG Dos Hermanos.,6 / 11lbs,11.0,40.5,445.5,3468058.20999999,Branded Rice,Lisset Limpio -020,RETAIL SEDANOS,1385361,Oct
2024-10-17,Sedanos Supermarkets #38,Invoice,008-04006,Rice Snack:Rice Snack Ham Flavored DOS HERMANOS,,3.0,19.9,59.7,3468117.90999999,Puffed Products,Lisset Limpio -020,RETAIL SEDANOS,1385362,Oct
2024-10-17,Sedanos Supermarkets #38,Invoice,008-04006,Rice Snack:Rice Snack Salami Flavored DOS HERMANOS,,3.0,19.9,59.7,3468177.60999999,Puffed Products,Lisset Limpio -020,RETAIL SEDANOS,1385363,Oct
2024-10-17,Sedanos Supermarkets #38,Invoice,008-04006,Rice Snack:Rice Snack Ham Flavored DOS HERMANOS,,1.0,19.9,19.9,3468197.50999999,Puffed Products,Lisset Limpio -020,RETAIL SEDANOS,1385364,Oct
2024-10-17,Sedanos Supermarkets #38,Invoice,008-04006,Rice Snack:Rice Snack Salami Flavored DOS HERMANOS,,1.0,19.9,19.9,3468217.40999999,Puffed Products,Lisset Limpio -020,RETAIL SEDANOS,1385365,Oct
2024-10-17,Sedanos Supermarkets #38,Invoice,008-04006,,Discount,,,-26.69,3468190.71999999,,Lisset Limpio -020,RETAIL SEDANOS,1385366,Oct
2024-10-17,Los Caringas Latin America  Foods,Invoice,008-04007,Arroz a Granel:Largo Fino 50 LB -Bolsa Dos Hermanos.,,3.0,27.85,83.55,3468274.26999999,Bulk Rice,Lisset Limpio -020,CAFETERIA y RESTAURANTS,1385367,Oct
2024-10-17,Los Caringas Latin America  Foods,Invoice,008-04007,Arroz a Granel:Parboiled 50 LB -Bolsa Dos Hermanos.,,3.0,28.25,84.75,3468359.01999999,Bulk Rice,Lisset Limpio -020,CAFETERIA y RESTAURANTS,1385368,Oct
2024-10-17,Sabor Tropical #1 - Cafeteria,Invoice,008-04008,Arroz a Granel:Parboiled 50 LB -Bolsa Dos Hermanos.,,5.0,27.75,138.75,3468497.76999999,Bulk Rice,Keila Alfaro-Visvikis,CAFETERIA y RESTAURANTS,1385369,Oct
2024-10-17,Sabor Tropical #1 - Cafeteria,Invoice,008-04008,Arroz Envasado:Parboiled 1kg Bolsa Dos Hermanos.,.,1.0,19.0,19.0,3468516.76999999,Branded Rice,Keila Alfaro-Visvikis,CAFETERIA y RESTAURANTS,1385370,Oct
2024-10-17,Sabor Tropical #1 - Cafeteria,Invoice,008-04008,Arroz Envasado:Largo Fino 1kg (Long grain rice) Dos Hermanos,,1.0,17.0,17.0,3468533.76999999,Branded Rice,Keila Alfaro-Visvikis,CAFETERIA y RESTAURANTS,1385371,Oct
2024-10-17,Sabor Tropical #1 - Cafeteria,Invoice,008-04008,Arroz Envasado:Parboiled 5KG Dos Hermanos.,6 / 11lbs,1.0,46.5,46.5,3468580.26999999,Branded Rice,Keila Alfaro-Visvikis,CAFETERIA y RESTAURANTS,1385372,Oct
2024-10-17,Sabor Tropical #1 - Cafeteria,Invoice,008-04008,Varios:Promotional Allowance,6/11 lbs,1.0,11.15,11.15,3468591.41999999,Branded Rice,Keila Alfaro-Visvikis,CAFETERIA y RESTAURANTS,1385373,Oct
2024-10-17,Key Food 40th. cafeteria,Invoice,008-04009,Arroz a Granel:Parboiled 50 LB -Bolsa Dos Hermanos.,,0.0,,0.0,3468591.41999999,Bulk Rice,Keila Alfaro-Visvikis,CAFETERIA y RESTAURANTS,1385374,Oct
2024-10-17,Sedanos Supermarkets #21,Invoice,008-04010,Arroz Envasado:Parboiled 5KG Dos Hermanos.,6 / 11lbs,5.0,40.5,202.5,3468793.91999999,Branded Rice,Lisset Limpio -020,RETAIL SEDANOS,1385375,Oct
2024-10-17,Sedanos Supermarkets #21,Invoice,008-04010,,Discount,,,-4.05,3468789.86999999,,Lisset Limpio -020,RETAIL SEDANOS,1385376,Oct
2024-10-17,El Palacio de los jugos /  Nanos Latin Foods,Invoice,008-04011,Arroz a Granel:Parboiled 50 LB -Bolsa Dos Hermanos.,,10.0,26.5,265.0,3469054.86999999,Bulk Rice,Lisset Limpio -020,Cafeteria,1385377,Oct
2024-10-17,Fritanga Momotombo,Invoice,008-04012,Arroz a Granel:Largo Fino 50 LB -Bolsa Dos Hermanos.,,5.0,27.85,139.25,3469194.11999999,Bulk Rice,Lisset Limpio -020,CAFETERIA y RESTAURANTS,1385378,Oct
2024-10-17,Key Foods  / Ivan,Credit Memo,008-04073,Varios:Promotional Allowance,Arroz Envasado:Parboiled 5KG Dos Hermanos.,-2.0,46.5,-93.0,3469101.11999999,Branded Rice,Keila Alfaro-Visvikis,RETAIL  DSD,1385379,Oct
2024-10-17,Key Foods  / Ivan,Credit Memo,008-04073,Varios:Promotional Allowance,Arroz Envasado:Largo Fino 1kg (Long grain rice) Dos Hermanos,-1.0,17.0,-17.0,3469084.11999999,Branded Rice,Keila Alfaro-Visvikis,RETAIL  DSD,1385380,Oct
2024-10-17,Sedanos Supermarkets #38,Credit Memo,008-04074,Varios:Promotional Allowance,Rice Snack:Rice Snack Ham Flavored DOS HERMANOS,-1.0,19.9,-19.9,3469064.21999999,Puffed Products,Lisset Limpio -020,RETAIL SEDANOS,1385381,Oct
2024-10-17,Sedanos Supermarkets #38,Credit Memo,008-04074,Varios:Promotional Allowance,Rice Snack:Rice Snack Salami Flavored DOS HERMANOS,-1.0,19.9,-19.9,3469044.31999999,Puffed Products,Lisset Limpio -020,RETAIL SEDANOS,1385382,Oct
2024-10-17,Sedanos Supermarkets #38,Credit Memo,008-04074,Varios:Promotional Allowance,Arroz Envasado:Parboiled 5KG Dos Hermanos.,-11.0,40.5,-445.5,3468598.81999999,Branded Rice,Lisset Limpio -020,RETAIL SEDANOS,1385383,Oct
2024-10-17,Neighbors Food Market / Luis Diaz,Credit Memo,008-04076,Varios:Promotional Allowance,1lf 1kg,-1.0,17.0,-17.0,3468581.81999999,Branded Rice,Keila Alfaro-Visvikis,RETAIL  DSD,1385384,Oct
2024-10-18,Latin American Coral Way,Invoice,008-04013,Arroz a Granel:Largo Fino 50 LB -Bolsa Dos Hermanos.,,1.0,27.5,27.5,3468609.31999999,Bulk Rice,Keila Alfaro-Visvikis,CAFETERIA y RESTAURANTS,1385385,Oct
2024-10-18,Latin American Coral Way,Invoice,008-04013,Arroz a Granel:Parboiled 50 LB -Bolsa Dos Hermanos.,,1.0,28.25,28.25,3468637.56999999,Bulk Rice,Keila Alfaro-Visvikis,CAFETERIA y RESTAURANTS,1385386,Oct
2024-10-18,Sedanos Supermarkets #40,Invoice,008-04014,Arroz Envasado:Parboiled 5KG Dos Hermanos.,6 / 11lbs,26.0,40.5,1053.0,3469690.56999999,Branded Rice,Armando Carpio - 017,RETAIL SEDANOS,1385387,Oct
2024-10-18,Sedanos Supermarkets #40,Invoice,008-04014,Arroz Envasado:Parboiled 5KG Dos Hermanos.,6 / 11lbs,15.0,40.5,607.5,3470298.06999999,Branded Rice,Armando Carpio - 017,RETAIL SEDANOS,1385388,Oct
2024-10-18,Sedanos Supermarkets #40,Invoice,008-04014,,Discount,,,-21.06,3470277.00999999,,Armando Carpio - 017,RETAIL SEDANOS,1385389,Oct
2024-10-18,Sedanos Supermarkets #41,Invoice,008-04015,Arroz Envasado:Parboiled 5KG Dos Hermanos.,6 / 11lbs,26.0,40.5,1053.0,3471330.00999999,Branded Rice,Armando Carpio - 017,RETAIL SEDANOS,1385390,Oct
2024-10-18,Sedanos Supermarkets #41,Invoice,008-04015,Arroz a Granel:Parboiled 50 LB -Bolsa Dos Hermanos.,,10.0,26.5,265.0,3471595.00999999,Bulk Rice,Armando Carpio - 017,RETAIL SEDANOS,1385391,Oct
2024-10-18,Sedanos Supermarkets #41,Invoice,008-04015,Arroz Envasado:Parboiled 5KG Dos Hermanos.,6 / 11lbs,15.0,40.5,607.5,3472202.50999999,Branded Rice,Armando Carpio - 017,RETAIL SEDANOS,1385392,Oct
2024-10-18,Sedanos Supermarkets #41,Invoice,008-04015,,Discount,,,-26.36,3472176.14999999,,Armando Carpio - 017,RETAIL SEDANOS,1385393,Oct
2024-10-18,Hialed Tomatoes Market And Distributors,Invoice,008-04016,Arroz Envasado:Largo Fino 1kg (Long grain rice) Dos Hermanos,,5.0,17.0,85.0,3472261.14999999,Branded Rice,Keila Alfaro-Visvikis,Distributor,1385394,Oct
2024-10-18,Hialed Tomatoes Market And Distributors,Invoice,008-04016,Arroz Envasado:Parboiled 1kg Bolsa Dos Hermanos.,.,5.0,19.0,95.0,3472356.14999999,Branded Rice,Keila Alfaro-Visvikis,Distributor,1385395,Oct
2024-10-18,Hialed Tomatoes Market And Distributors,Invoice,008-04016,Arroz Envasado:Parboiled 5KG Dos Hermanos.,6 / 11lbs,30.0,46.5,1395.0,3473751.14999999,Branded Rice,Keila Alfaro-Visvikis,Distributor,1385396,Oct
2024-10-18,Hialed Tomatoes Market And Distributors,Invoice,008-04016,Rice Snack:Rice Snack Ham Flavored DOS HERMANOS,,1.0,19.9,19.9,3473771.04999999,Puffed Products,Keila Alfaro-Visvikis,Distributor,1385397,Oct
2024-10-18,Hialed Tomatoes Market And Distributors,Invoice,008-04016,Rice Snack:Rice Snack Salami Flavored DOS HERMANOS,,1.0,19.9,19.9,3473790.94999999,Puffed Products,Keila Alfaro-Visvikis,Distributor,1385398,Oct
2024-10-18,Hialed Tomatoes Market And Distributors,Invoice,008-04016,Arroz Envasado:Parboiled 5KG Dos Hermanos.,6 / 11lbs,11.0,46.5,511.5,3474302.44999999,Branded Rice,Keila Alfaro-Visvikis,Distributor,1385399,Oct
2024-10-18,Hialed Tomatoes Market And Distributors,Invoice,008-04016,Arroz Envasado:Largo Fino 1kg (Long grain rice) Dos Hermanos,,1.0,17.0,17.0,3474319.44999999,Branded Rice,Keila Alfaro-Visvikis,Distributor,1385400,Oct
2024-10-18,Hialed Tomatoes Market And Distributors,Invoice,008-04016,Arroz Envasado:Parboiled 1kg Bolsa Dos Hermanos.,.,1.0,19.0,19.0,3474338.44999999,Branded Rice,Keila Alfaro-Visvikis,Distributor,1385401,Oct
2024-10-18,Vitos Meat and Provisions,Invoice,008-04017,Arroz a Granel:Parboiled 50 LB -Bolsa Dos Hermanos.,,30.0,27.75,832.5,3475170.94999999,Bulk Rice,Keila Alfaro-Visvikis,WHOLESALER,1385402,Oct
2024-10-18,Sabor Tropical #1 - Cafeteria,Credit Memo,008-04075,Varios:Promotional Allowance,Arroz Envasado:Largo Fino 1kg (Long grain rice) Dos Hermanos,-1.0,17.0,-17.0,3475153.94999999,Branded Rice,Keila Alfaro-Visvikis,CAFETERIA y RESTAURANTS,1385403,Oct
2024-10-18,Sedanos Supermarkets #40,Credit Memo,008-04078,Varios:Promotional Allowance,5kg,-15.0,40.5,-607.5,3474546.44999999,Branded Rice,Armando Carpio - 017,RETAIL SEDANOS,1385404,Oct
2024-10-18,Sedanos Supermarkets #41,Credit Memo,008-04079,Varios:Promotional Allowance,5kg,-15.0,40.5,-607.5,3473938.94999999,Branded Rice,Armando Carpio - 017,RETAIL SEDANOS,1385405,Oct
2024-10-18,Soriano Brothers PB,Credit Memo,008-04103,Varios:Promotional Allowance,50lb parbo,-1.0,27.75,-27.75,3473911.19999999,Bulk Rice,Lisset Limpio -020,CAFETERIA y RESTAURANTS,1385406,Oct
2024-10-21,ALS Foods,Invoice,008-04018,Liquids:AS Cooking Wine,4/1 Gl.,1.0,17.5,17.5,3473928.69999999,American Spice,Lisset Limpio -020,CAFETERIA y RESTAURANTS,1385407,Oct
2024-10-21,ALS Foods,Invoice,008-04018,Arroz a Granel:Largo Fino 50 LB -Bolsa Dos Hermanos.,,6.0,27.85,167.1,3474095.79999999,Bulk Rice,Lisset Limpio -020,CAFETERIA y RESTAURANTS,1385408,Oct
2024-10-21,ALS Foods,Invoice,008-04018,Arroz a Granel:Parboiled 50 LB -Bolsa Dos Hermanos.,,11.0,27.75,305.25,3474401.04999999,Bulk Rice,Lisset Limpio -020,CAFETERIA y RESTAURANTS,1385409,Oct
2024-10-21,ALS Foods,Invoice,008-04018,Arroz a Granel:Parboiled 50 LB -Bolsa Dos Hermanos.,,1.0,27.75,27.75,3474428.79999999,Bulk Rice,Lisset Limpio -020,CAFETERIA y RESTAURANTS,1385410,Oct
2024-10-21,Los paraditos chinesse,Invoice,008-04019,Arroz a Granel:Parboiled 50 LB -Bolsa Dos Hermanos.,,10.0,28.25,282.5,3474711.29999999,Bulk Rice,Lisset Limpio -020,CAFETERIA y RESTAURANTS,1385411,Oct
2024-10-21,Aries Supermarket & Cafeteria,Invoice,008-04020,Arroz a Granel:Parboiled 50 LB -Bolsa Dos Hermanos.,,8.0,28.25,226.0,3474937.29999999,Bulk Rice,Keila Alfaro-Visvikis,CAFETERIA y RESTAURANTS,1385412,Oct
2024-10-21,Aries Supermarket & Cafeteria,Invoice,008-04020,Dry Beans:Dry Beans - Black Beans 50,Dry Black Beans 50 lb,8.0,39.75,318.0,3475255.29999999,Dry Beans,Keila Alfaro-Visvikis,CAFETERIA y RESTAURANTS,1385413,Oct
2024-10-21,El Palacio de los jugos / Lita Foods Inc.,Invoice,008-04021,Dry Beans:Dry Beans - Black Beans 50,Dry Black Beans 50 lb,1.0,45.7,45.7,3475300.99999999,Dry Beans,Lisset Limpio -020,Cafeteria,1385414,Oct
2024-10-21,El Palacio de los jugos / Lita Foods Inc.,Invoice,008-04021,Arroz a Granel:Parboiled 50 LB -Bolsa Dos Hermanos.,,11.0,27.75,305.25,3475606.24999999,Bulk Rice,Lisset Limpio -020,Cafeteria,1385415,Oct
2024-10-21,El Palacio de los jugos / Lita Foods Inc.,Invoice,008-04021,Arroz a Granel:Parboiled 50 LB -Bolsa Dos Hermanos.,,1.0,27.75,27.75,3475633.99999999,Bulk Rice,Lisset Limpio -020,Cafeteria,1385416,Oct
2024-10-21,El Palacio de Los Jugos / Casa mía Food Restaurant inc,Invoice,008-04022,Dry Beans:Dry Beans - Black Beans 50,Dry Black Beans 50 lb,1.0,45.7,45.7,3475679.69999999,Dry Beans,Lisset Limpio -020,Cafeteria,1385417,Oct
2024-10-21,El Palacio de Los Jugos / Casa mía Food Restaurant inc,Invoice,008-04022,Arroz a Granel:Parboiled 50 LB -Bolsa Dos Hermanos.,,11.0,27.75,305.25,3475984.94999999,Bulk Rice,Lisset Limpio -020,Cafeteria,1385418,Oct
2024-10-21,El Palacio de Los Jugos / Casa mía Food Restaurant inc,Invoice,008-04022,Arroz a Granel:Parboiled 50 LB -Bolsa Dos Hermanos.,,1.0,27.75,27.75,3476012.69999999,Bulk Rice,Lisset Limpio -020,Cafeteria,1385419,Oct
2024-10-21,El Palacio de los jugos / Delicias Criollas (DIAGO FOOD_MILLER),Invoice,008-04023,Arroz a Granel:Parboiled 50 LB -Bolsa Dos Hermanos.,,11.0,27.75,305.25,3476317.94999999,Bulk Rice,Lisset Limpio -020,Cafeteria,1385420,Oct
2024-10-21,El Palacio de los jugos / Delicias Criollas (DIAGO FOOD_MILLER),Invoice,008-04023,Arroz a Granel:Parboiled 50 LB -Bolsa Dos Hermanos.,,1.0,27.75,27.75,3476345.69999999,Bulk Rice,Lisset Limpio -020,Cafeteria,1385421,Oct
2024-10-21,El Palacio de los jugos / Delicias Criollas (DIAGO FOOD_MILLER),Invoice,008-04023,Liquids:AS Cooking Wine,4/1 Gl.,1.0,17.5,17.5,3476363.19999999,American Spice,Lisset Limpio -020,Cafeteria,1385422,Oct
2024-10-21,Sedanos Supermarkets  #37,Invoice,008-04024,Arroz a Granel:Largo Fino 50 LB -Bolsa Dos Hermanos.,,4.0,27.85,111.4,3476474.59999999,Bulk Rice,Lisset Limpio -020,RETAIL SEDANOS,1385423,Oct
2024-10-21,Sedanos Supermarkets  #37,Invoice,008-04024,Arroz a Granel:Parboiled 50 LB -Bolsa Dos Hermanos.,,4.0,28.25,113.0,3476587.59999999,Bulk Rice,Lisset Limpio -020,RETAIL SEDANOS,1385424,Oct
2024-10-21,Sedanos Supermarkets  #37,Invoice,008-04024,,Discount,,,-4.49,3476583.10999999,,Lisset Limpio -020,RETAIL SEDANOS,1385425,Oct
2024-10-21,JMN Dely Corp,Invoice,008-04025,Arroz a Granel:Parboiled 50 LB -Bolsa Dos Hermanos.,,3.0,28.25,84.75,3476667.85999999,Bulk Rice,Keila Alfaro-Visvikis,CAFETERIA y RESTAURANTS,1385426,Oct
2024-10-21,JMN Dely Corp,Invoice,008-04025,Dry Beans:Dry Beans - Black Beans 50,Dry Black Beans 50 lb,1.0,45.7,45.7,3476713.55999999,Dry Beans,Keila Alfaro-Visvikis,CAFETERIA y RESTAURANTS,1385427,Oct
2024-10-21,ALBERT DELI CORP #1,Invoice,008-04026,Dry Beans:Dry Beans - Black Beans 50,Dry Black Beans 50 lb,1.0,45.7,45.7,3476759.25999999,Dry Beans,Keila Alfaro-Visvikis,CAFETERIA y RESTAURANTS,1385428,Oct
2024-10-21,ALBERT DELI CORP #1,Invoice,008-04026,Arroz a Granel:Largo Fino 50 LB -Bolsa Dos Hermanos.,,6.0,27.5,165.0,3476924.25999999,Bulk Rice,Keila Alfaro-Visvikis,CAFETERIA y RESTAURANTS,1385429,Oct
2024-10-21,ALBERT DELI CORP #1,Invoice,008-04026,Arroz a Granel:Parboiled 50 LB -Bolsa Dos Hermanos.,,6.0,28.25,169.5,3477093.75999999,Bulk Rice,Keila Alfaro-Visvikis,CAFETERIA y RESTAURANTS,1385430,Oct
2024-10-21,Hialed Tomatoes Market And Distributors,Credit Memo,008-04077,Varios:Promotional Allowance,Arroz Envasado:Parboiled 5KG Dos Hermanos.,-11.0,46.5,-511.5,3476582.25999999,Branded Rice,Keila Alfaro-Visvikis,Distributor,1385431,Oct
2024-10-21,Hialed Tomatoes Market And Distributors,Credit Memo,008-04077,Varios:Promotional Allowance,Arroz Envasado:Largo Fino 1kg (Long grain rice) Dos Hermanos,-1.0,17.0,-17.0,3476565.25999999,Branded Rice,Keila Alfaro-Visvikis,Distributor,1385432,Oct
2024-10-21,Hialed Tomatoes Market And Distributors,Credit Memo,008-04077,Varios:Promotional Allowance,Arroz Envasado:parbo 1kg,-1.0,19.0,-19.0,3476546.25999999,Branded Rice,Keila Alfaro-Visvikis,Distributor,1385433,Oct
2024-10-21,El Palacio de los jugos / Delicias Criollas (DIAGO FOOD_MILLER),Credit Memo,008-04080,Varios:Promotional Allowance,5kg parbo,-1.0,27.75,-27.75,3476518.50999999,Branded Rice,Lisset Limpio -020,Cafeteria,1385434,Oct
2024-10-21,El Palacio de los jugos / Delicias Criollas (DIAGO FOOD_MILLER),Credit Memo,008-04080,Varios:Promotional Allowance,1 vino seco,-1.0,17.5,-17.5,3476501.00999999,American Spice,Lisset Limpio -020,Cafeteria,1385435,Oct
2024-10-21,El Palacio de los jugos / Lita Foods Inc.,Credit Memo,008-04081,Varios:Promotional Allowance,550lb parbo,-1.0,27.75,-27.75,3476473.25999999,Bulk Rice,Lisset Limpio -020,Cafeteria,1385436,Oct
2024-10-21,El Palacio de Los Jugos / Casa mía Food Restaurant inc,Credit Memo,008-04082,Varios:Promotional Allowance,parbo 50lb,-1.0,27.75,-27.75,3476445.50999999,Bulk Rice,Lisset Limpio -020,Cafeteria,1385437,Oct
2024-10-21,ALS Foods,Credit Memo,008-04098,Varios:Promotional Allowance,Arroz a Granel:Parboiled 50 LB -Bolsa Dos Hermanos.,-1.0,27.75,-27.75,3476417.75999999,Bulk Rice,Lisset Limpio -020,CAFETERIA y RESTAURANTS,1385438,Oct
2024-10-23,Sedanos Supermarkets #42,Invoice,008-04027,Dry Beans:Dry Beans - Black Beans 50,Dry Black Beans 50 lb,1.0,45.7,45.7,3476463.45999999,Dry Beans,Lisset Limpio -020,RETAIL SEDANOS,1385439,Oct
2024-10-23,Sedanos Supermarkets #42,Invoice,008-04027,Arroz a Granel:Parboiled 50 LB -Bolsa Dos Hermanos.,,5.0,28.25,141.25,3476604.70999999,Bulk Rice,Lisset Limpio -020,RETAIL SEDANOS,1385440,Oct
2024-10-23,Sedanos Supermarkets #42,Invoice,008-04027,,Discount,,,-2.83,3476601.87999999,,Lisset Limpio -020,RETAIL SEDANOS,1385441,Oct
2024-10-23,Sedanos Supermarkets #43,Invoice,008-04028,Arroz a Granel:Parboiled 50 LB -Bolsa Dos Hermanos.,,5.0,28.25,141.25,3476743.12999999,Bulk Rice,Keila Alfaro-Visvikis,RETAIL SEDANOS,1385442,Oct
2024-10-23,Sedanos Supermarkets #43,Invoice,008-04028,,Discount,,,-2.83,3476740.29999999,,Keila Alfaro-Visvikis,RETAIL SEDANOS,1385443,Oct
2024-10-23,Sedanos Supermarkets #28,Invoice,008-04029,Arroz Envasado:Parboiled 5KG Dos Hermanos.,6 / 11lbs,10.0,40.5,405.0,3477145.29999999,Branded Rice,Keila Alfaro-Visvikis,RETAIL SEDANOS,1385444,Oct
2024-10-23,Sedanos Supermarkets #28,Invoice,008-04029,,Discount,,,-8.1,3477137.19999999,,Keila Alfaro-Visvikis,RETAIL SEDANOS,1385445,Oct
2024-10-23,Key Food Pembroke,Invoice,008-04030,Arroz Envasado:Parboiled 5KG Dos Hermanos.,6 / 11lbs,10.0,46.5,465.0,3477602.19999999,Branded Rice,Keila Alfaro-Visvikis,RETAIL  DSD,1385446,Oct
2024-10-23,Key Food Pembroke,Invoice,008-04030,Arroz Envasado:Parboiled 5KG Dos Hermanos.,6 / 11lbs,3.0,46.5,139.5,3477741.69999999,Branded Rice,Keila Alfaro-Visvikis,RETAIL  DSD,1385447,Oct
2024-10-23,Sedanos Supermarkets #24,Invoice,008-04031,Arroz a Granel:Parboiled 50 LB -Bolsa Dos Hermanos.,,6.0,28.25,169.5,3477911.19999999,Bulk Rice,Keila Alfaro-Visvikis,RETAIL SEDANOS,1385448,Oct
2024-10-23,Sedanos Supermarkets #24,Invoice,008-04031,,Discount,,,-3.39,3477907.80999999,,Keila Alfaro-Visvikis,RETAIL SEDANOS,1385449,Oct
2024-10-23,Key Food Pembroke,Credit Memo,008-04031,Varios:Producto vencido/deteriorado (no impacta en inventario),,-2.0,27.0,-54.0,3477853.80999999,,Keila Alfaro-Visvikis,RETAIL  DSD,1385450,Oct
2024-10-23,Sedanos Supermarkets #27,Invoice,008-04032,Arroz a Granel:Parboiled 50 LB -Bolsa Dos Hermanos.,,6.0,28.25,169.5,3478023.30999999,Bulk Rice,Keila Alfaro-Visvikis,RETAIL SEDANOS,1385451,Oct
2024-10-23,Sedanos Supermarkets #27,Invoice,008-04032,Arroz Envasado:Parboiled 5KG Dos Hermanos.,6 / 11lbs,3.0,40.5,121.5,3478144.80999999,Branded Rice,Keila Alfaro-Visvikis,RETAIL SEDANOS,1385452,Oct
2024-10-23,Sedanos Supermarkets #27,Invoice,008-04032,,Discount,,,-5.82,3478138.98999999,,Keila Alfaro-Visvikis,RETAIL SEDANOS,1385453,Oct
2024-10-23,Sedanos Supermarkets #34,Invoice,008-04033,Arroz a Granel:Parboiled 50 LB -Bolsa Dos Hermanos.,,6.0,28.25,169.5,3478308.48999999,Bulk Rice,Keila Alfaro-Visvikis,RETAIL SEDANOS,1385454,Oct
2024-10-23,Sedanos Supermarkets #34,Invoice,008-04033,,Discount,,,-3.39,3478305.09999999,,Keila Alfaro-Visvikis,RETAIL SEDANOS,1385455,Oct
2024-10-23,Chavez Distributors Inc.,Invoice,008-04034,Arroz a Granel:Parboiled 50 LB -Bolsa Dos Hermanos.,,55.0,27.75,1526.25,3479831.34999999,Bulk Rice,Keila Alfaro-Visvikis,WHOLESALER,1385456,Oct
2024-10-23,Ideal Food Basket Davie Cafeteria,Invoice,008-04035,Arroz a Granel:Largo Fino 50 LB -Bolsa Dos Hermanos.,,10.0,27.85,278.5,3480109.84999999,Bulk Rice,Keila Alfaro-Visvikis,CAFETERIA y RESTAURANTS,1385457,Oct
2024-10-23,Mango Tree Supermarket,Invoice,008-04036,Arroz Envasado:Largo Fino 1kg (Long grain rice) Dos Hermanos,,1.0,17.5,17.5,3480127.34999999,Branded Rice,Keila Alfaro-Visvikis,RETAIL  DSD,1385458,Oct
2024-10-23,Mango Tree Supermarket,Invoice,008-04036,Arroz Envasado:Parboiled 1kg Bolsa Dos Hermanos.,.,1.0,19.9,19.9,3480147.24999999,Branded Rice,Keila Alfaro-Visvikis,RETAIL  DSD,1385459,Oct
2024-10-23,Mango Tree Supermarket,Invoice,008-04036,Arroz Envasado:Largo Fino 1kg (Long grain rice) Dos Hermanos,,1.0,17.5,17.5,3480164.74999999,Branded Rice,Keila Alfaro-Visvikis,RETAIL  DSD,1385460,Oct
2024-10-23,Key Food Pembroke,Credit Memo,008-04083,Varios:Promotional Allowance,5kg parbo,-3.0,46.5,-139.5,3480025.24999999,Bulk Rice,Keila Alfaro-Visvikis,RETAIL  DSD,1385461,Oct
2024-10-23,Mango Tree Supermarket,Credit Memo,008-04099,Varios:Promotional Allowance,Arroz Envasado:Largo Fino 1kg (Long grain rice) Dos Hermanos,-1.0,17.5,-17.5,3480007.74999999,Branded Rice,Keila Alfaro-Visvikis,RETAIL  DSD,1385462,Oct
2024-10-25,El Gallego Supermarket,Invoice,008-04037,Dry Beans:Dry Beans - Black Beans 50,Dry Black Beans 50 lb,2.0,45.7,91.4,3480099.14999999,Dry Beans,Lisset Limpio -020,RETAIL  DSD,1385463,Oct
2024-10-25,El Gallego Supermarket,Invoice,008-04037,Arroz a Granel:Parboiled 50 LB -Bolsa Dos Hermanos.,,5.0,28.25,141.25,3480240.39999999,Bulk Rice,Lisset Limpio -020,RETAIL  DSD,1385464,Oct
2024-10-25,Soriano Brothers PB,Invoice,008-04038,Spices:AS Sazon (for all),1 / 30 lb (box or pail),3.0,46.75,140.25,3480380.64999999,American Spice,Lisset Limpio -020,CAFETERIA y RESTAURANTS,1385465,Oct
2024-10-25,Soriano Brothers PB,Invoice,008-04038,Dry Beans:Dry Beans - Small Red Beans 50 lbs.,Small Red Beans 50 lbs,1.0,46.85,46.85,3480427.49999999,Dry Beans,Lisset Limpio -020,CAFETERIA y RESTAURANTS,1385466,Oct
2024-10-25,Soriano Brothers PB,Invoice,008-04038,Dry Beans:Dry Beans - Black Beans 50,Dry Black Beans 50 lb,1.0,45.7,45.7,3480473.19999999,Dry Beans,Lisset Limpio -020,CAFETERIA y RESTAURANTS,1385467,Oct
2024-10-25,El Palacio de los jugos /  Mires Restaurants,Invoice,008-04039,Liquids:AS Marinating Sauce (Mojo),,1.0,18.5,18.5,3480491.69999999,American Spice,Lisset Limpio -020,Cafeteria,1385468,Oct
2024-10-25,El Palacio de los jugos /  Mires Restaurants,Invoice,008-04039,Arroz a Granel:Parboiled 50 LB -Bolsa Dos Hermanos.,,11.0,27.75,305.25,3480796.94999999,Bulk Rice,Lisset Limpio -020,Cafeteria,1385469,Oct
2024-10-25,El Palacio de los jugos /  Mires Restaurants,Invoice,008-04039,Arroz a Granel:Parboiled 50 LB -Bolsa Dos Hermanos.,,1.0,27.75,27.75,3480824.69999999,Bulk Rice,Lisset Limpio -020,Cafeteria,1385470,Oct
2024-10-25,El Palacio de los jugos /  Nanos Latin Foods,Invoice,008-04040,Arroz a Granel:Parboiled 50 LB -Bolsa Dos Hermanos.,,10.0,26.5,265.0,3481089.69999999,Bulk Rice,Lisset Limpio -020,Cafeteria,1385471,Oct
2024-10-25,Be Your Will LLC,Invoice,008-04041,Liquids:AS Cooking Wine,4/1 Gl.,1.0,17.5,17.5,3481107.19999999,American Spice,Lisset Limpio -020,CAFETERIA y RESTAURANTS,1385472,Oct
2024-10-25,Be Your Will LLC,Invoice,008-04041,Arroz a Granel:Parboiled 50 LB -Bolsa Dos Hermanos.,,11.0,27.75,305.25,3481412.44999999,Bulk Rice,Lisset Limpio -020,CAFETERIA y RESTAURANTS,1385473,Oct
2024-10-25,Be Your Will LLC,Invoice,008-04041,Arroz a Granel:Largo Fino 50 LB -Bolsa Dos Hermanos.,,7.0,27.85,194.95,3481607.39999999,Bulk Rice,Lisset Limpio -020,CAFETERIA y RESTAURANTS,1385474,Oct
2024-10-25,Be Your Will LLC,Invoice,008-04041,Arroz a Granel:Parboiled 50 LB -Bolsa Dos Hermanos.,,1.0,27.75,27.75,3481635.14999999,Bulk Rice,Lisset Limpio -020,CAFETERIA y RESTAURANTS,1385475,Oct
2024-10-25,Bravo   Francisco Diaz,Invoice,008-04042,Liquids:AS Cooking Wine,4/1 Gl.,2.0,17.5,35.0,3481670.14999999,American Spice,Lisset Limpio -020,RETAIL  DSD,1385476,Oct
2024-10-25,Bravo   Francisco Diaz,Invoice,008-04042,Liquids:AS Marinating Sauce (Mojo),,2.0,18.5,37.0,3481707.14999999,American Spice,Lisset Limpio -020,RETAIL  DSD,1385477,Oct
2024-10-25,Bravo   Francisco Diaz,Invoice,008-04042,Liquids:AS White Vinegar,4/1 Gl.,1.0,10.0,10.0,3481717.14999999,American Spice,Lisset Limpio -020,RETAIL  DSD,1385478,Oct
2024-10-25,Bravo   Francisco Diaz,Invoice,008-04042,Arroz a Granel:Largo Fino 50 LB -Bolsa Dos Hermanos.,,5.0,27.85,139.25,3481856.39999999,Bulk Rice,Lisset Limpio -020,RETAIL  DSD,1385479,Oct
2024-10-25,Sedanos Supermarkets  #11,Invoice,008-04043,Arroz a Granel:Parboiled 50 LB -Bolsa Dos Hermanos.,,3.0,28.25,84.75,3481941.14999999,Bulk Rice,Keila Alfaro-Visvikis,RETAIL SEDANOS,1385480,Oct
2024-10-25,Sedanos Supermarkets  #11,Invoice,008-04043,,Discount,,,-1.7,3481939.44999999,,Keila Alfaro-Visvikis,RETAIL SEDANOS,1385481,Oct
2024-10-25,Sedanos Supermarkets #16,Invoice,008-04044,Arroz a Granel:Parboiled 50 LB -Bolsa Dos Hermanos.,,4.0,28.25,113.0,3482052.44999999,Bulk Rice,Keila Alfaro-Visvikis,RETAIL SEDANOS,1385482,Oct
2024-10-25,Sedanos Supermarkets #16,Invoice,008-04044,,Discount,,,-2.26,3482050.18999999,,Keila Alfaro-Visvikis,RETAIL SEDANOS,1385483,Oct
2024-10-25,Sedanos Supermarkets #18,Invoice,008-04045,Arroz a Granel:Parboiled 50 LB -Bolsa Dos Hermanos.,,8.0,28.25,226.0,3482276.18999999,Bulk Rice,Lisset Limpio -020,RETAIL SEDANOS,1385484,Oct
2024-10-25,Sedanos Supermarkets #18,Invoice,008-04045,,Discount,,,-4.52,3482271.66999999,,Lisset Limpio -020,RETAIL SEDANOS,1385485,Oct
2024-10-25,Pacifico Chinese Restaurant,Invoice,008-04046,Arroz a Granel:Parboiled 50 LB -Bolsa Dos Hermanos.,,10.0,28.25,282.5,3482554.16999999,Bulk Rice,Lisset Limpio -020,CAFETERIA y RESTAURANTS,1385486,Oct
2024-10-25,Sedanos Supermarkets #32,Invoice,008-04047,Arroz a Granel:Parboiled 50 LB -Bolsa Dos Hermanos.,,5.0,28.25,141.25,3482695.41999999,Bulk Rice,Lisset Limpio -020,RETAIL SEDANOS,1385487,Oct
2024-10-25,Sedanos Supermarkets #32,Invoice,008-04047,,Discount,,,-2.83,3482692.58999999,,Lisset Limpio -020,RETAIL SEDANOS,1385488,Oct
2024-10-25,Sedanos Supermarkets #5,Invoice,008-04048,Arroz Envasado:Parboiled 5KG Dos Hermanos.,6 / 11lbs,25.0,40.5,1012.5,3483705.08999999,Branded Rice,Lisset Limpio -020,RETAIL SEDANOS,1385489,Oct
2024-10-25,Sedanos Supermarkets #5,Invoice,008-04048,Arroz Envasado:Parboiled 5KG Dos Hermanos.,6 / 11lbs,10.0,40.5,405.0,3484110.08999999,Branded Rice,Lisset Limpio -020,RETAIL SEDANOS,1385490,Oct
2024-10-25,Sedanos Supermarkets #5,Invoice,008-04048,,Discount,,,-20.25,3484089.83999999,,Lisset Limpio -020,RETAIL SEDANOS,1385491,Oct
2024-10-25,Promo Idea,Invoice,008-04049,"Rice Snack:Rice Snack, Pizza DH",,5.0,19.9,99.5,3484189.33999999,Puffed Products,Armando Carpio - 017,OTHER,1385492,Oct
2024-10-25,Promo Idea,Invoice,008-04049,Rice Snack:Rice Snack Salami Flavored DOS HERMANOS,,5.0,19.9,99.5,3484288.83999999,Puffed Products,Armando Carpio - 017,OTHER,1385493,Oct
2024-10-25,Promo Idea,Invoice,008-04049,Rice Snack:Rice Snack Ham Flavored DOS HERMANOS,,5.0,19.9,99.5,3484388.33999999,Puffed Products,Armando Carpio - 017,OTHER,1385494,Oct
2024-10-25,Be Your Will LLC,Credit Memo,008-04100,Varios:Promotional Allowance,50 lb,-1.0,27.75,-27.75,3484360.58999999,Bulk Rice,Lisset Limpio -020,CAFETERIA y RESTAURANTS,1385495,Oct
2024-10-25,Promo Idea,Credit Memo,008-04101,Varios:Promotional Allowance,"snacks salami, jamon y pizza",-15.0,19.9,-298.5,3484062.08999999,Puffed Products,Armando Carpio - 017,OTHER,1385496,Oct
2024-10-25,Sedanos Supermarkets #5,Credit Memo,008-04102,Varios:Promotional Allowance,5 kg parbo,-10.0,40.5,-405.0,3483657.08999999,Branded Rice,Lisset Limpio -020,RETAIL SEDANOS,1385497,Oct
2024-10-25,El Palacio de los jugos /  Mires Restaurants,Credit Memo,008-04104,Varios:Promotional Allowance,50lb,-1.0,27.75,-27.75,3483629.33999999,Bulk Rice,Lisset Limpio -020,Cafeteria,1385498,Oct
2024-10-28,JMN Dely Corp,Invoice,008-04050,Dry Beans:Dry Beans - Black Beans 50,Dry Black Beans 50 lb,1.0,45.7,45.7,3483675.03999999,Dry Beans,Keila Alfaro-Visvikis,CAFETERIA y RESTAURANTS,1385499,Oct
2024-10-28,JMN Dely Corp,Invoice,008-04050,Arroz a Granel:Parboiled 50 LB -Bolsa Dos Hermanos.,,3.0,28.25,84.75,3483759.78999999,Bulk Rice,Keila Alfaro-Visvikis,CAFETERIA y RESTAURANTS,1385500,Oct
2024-10-28,El Palacio de Los Jugos / Casa mía Food Restaurant inc,Invoice,008-04051,Dry Beans:Dry Beans - Black Beans 50,Dry Black Beans 50 lb,1.0,45.7,45.7,3483805.48999999,Dry Beans,Lisset Limpio -020,Cafeteria,1385501,Oct
2024-10-28,El Palacio de Los Jugos / Casa mía Food Restaurant inc,Invoice,008-04051,Arroz a Granel:Parboiled 50 LB -Bolsa Dos Hermanos.,,11.0,27.75,305.25,3484110.73999999,Bulk Rice,Lisset Limpio -020,Cafeteria,1385502,Oct
2024-10-28,El Palacio de Los Jugos / Casa mía Food Restaurant inc,Invoice,008-04051,Arroz a Granel:Parboiled 50 LB -Bolsa Dos Hermanos.,,1.0,27.75,27.75,3484138.48999999,Bulk Rice,Lisset Limpio -020,Cafeteria,1385503,Oct
2024-10-28,El Palacio de los jugos / Delicias Criollas (DIAGO FOOD_MILLER),Invoice,008-04052,Arroz a Granel:Parboiled 50 LB -Bolsa Dos Hermanos.,,22.0,27.75,610.5,3484748.98999999,Bulk Rice,Lisset Limpio -020,Cafeteria,1385504,Oct
2024-10-28,El Palacio de los jugos / Delicias Criollas (DIAGO FOOD_MILLER),Invoice,008-04052,Liquids:AS Cooking Wine,4/1 Gl.,1.0,17.5,17.5,3484766.48999999,American Spice,Lisset Limpio -020,Cafeteria,1385505,Oct
2024-10-28,El Palacio de los jugos / Delicias Criollas (DIAGO FOOD_MILLER),Invoice,008-04052,Liquids:AS Bitter Orange,,1.0,15.9,15.9,3484782.38999999,American Spice,Lisset Limpio -020,Cafeteria,1385506,Oct
2024-10-28,El Palacio de los jugos / Delicias Criollas (DIAGO FOOD_MILLER),Invoice,008-04052,Arroz a Granel:Parboiled 50 LB -Bolsa Dos Hermanos.,,2.0,27.75,55.5,3484837.88999999,Bulk Rice,Lisset Limpio -020,Cafeteria,1385507,Oct
2024-10-28,El Palacio de los jugos / Lita Foods Inc.,Invoice,008-04053,Dry Beans:Dry Beans - Black Beans 50,Dry Black Beans 50 lb,1.0,45.7,45.7,3484883.58999999,Dry Beans,Lisset Limpio -020,Cafeteria,1385508,Oct
2024-10-28,El Palacio de los jugos / Lita Foods Inc.,Invoice,008-04053,Arroz a Granel:Parboiled 50 LB -Bolsa Dos Hermanos.,,11.0,27.75,305.25,3485188.83999999,Bulk Rice,Lisset Limpio -020,Cafeteria,1385509,Oct
2024-10-28,El Palacio de los jugos / Lita Foods Inc.,Invoice,008-04053,Arroz a Granel:Parboiled 50 LB -Bolsa Dos Hermanos.,,1.0,27.75,27.75,3485216.58999999,Bulk Rice,Lisset Limpio -020,Cafeteria,1385510,Oct
2024-10-28,Rey Chavez Distributor #2,Invoice,008-04054,Arroz a Granel:Parboiled 50 LB -Bolsa Dos Hermanos.,,25.0,28.8,720.0,3485936.58999999,Bulk Rice,Lisset Limpio -020,WHOLESALER,1385511,Oct
2024-10-28,Festival Supermarket Margate,Invoice,008-04055,Arroz Envasado:Largo Fino 1kg (Long grain rice) Dos Hermanos,,2.0,17.5,35.0,3485971.58999999,Branded Rice,Keila Alfaro-Visvikis,RETAIL  DSD,1385512,Oct
2024-10-28,Festival Supermarket Margate,Invoice,008-04055,Arroz Envasado:Parboiled 5KG Dos Hermanos.,6 / 11lbs,8.0,46.5,372.0,3486343.58999999,Branded Rice,Keila Alfaro-Visvikis,RETAIL  DSD,1385513,Oct
2024-10-28,Festival Supermarket Margate,Invoice,008-04055,Arroz Envasado:Parboiled 1kg Bolsa Dos Hermanos.,.,3.0,19.9,59.7,3486403.28999999,Branded Rice,Keila Alfaro-Visvikis,RETAIL  DSD,1385514,Oct
2024-10-28,Festival Supermarket Margate,Invoice,008-04055,Arroz Envasado:Parboiled 5KG Dos Hermanos.,6 / 11lbs,2.0,46.5,93.0,3486496.28999999,Branded Rice,Keila Alfaro-Visvikis,RETAIL  DSD,1385515,Oct
2024-10-28,Festival Supermarket Margate,Invoice,008-04055,Arroz Envasado:Largo Fino 1kg (Long grain rice) Dos Hermanos,,1.0,17.5,17.5,3486513.78999999,Branded Rice,Keila Alfaro-Visvikis,RETAIL  DSD,1385516,Oct
2024-10-28,Gala Fresh Farms - Boca Ratón,Invoice,008-04056,Rice Snack:Rice Snack Ham Flavored DOS HERMANOS,,1.0,19.9,19.9,3486533.68999999,Puffed Products,Keila Alfaro-Visvikis,RETAIL  DSD,1385517,Oct
2024-10-28,Gala Fresh Farms - Boca Ratón,Invoice,008-04056,Rice Snack:Rice Snack Salami Flavored DOS HERMANOS,,1.0,19.9,19.9,3486553.58999999,Puffed Products,Keila Alfaro-Visvikis,RETAIL  DSD,1385518,Oct
2024-10-28,Gala Fresh Farms - Boca Ratón,Invoice,008-04056,"Rice Snack:Rice Snack, Pizza DH",,1.0,19.9,19.9,3486573.48999999,Puffed Products,Keila Alfaro-Visvikis,RETAIL  DSD,1385519,Oct
2024-10-28,Gala Fresh Farms - Boca Ratón,Invoice,008-04056,Arroz Envasado:Sushi Rice Dos Hermanos.,.,1.0,20.0,20.0,3486593.48999999,Branded Rice,Keila Alfaro-Visvikis,RETAIL  DSD,1385520,Oct
2024-10-28,Gala Fresh Farms - Boca Ratón,Invoice,008-04056,Arroz Envasado:Organico LF Dos Hermanos,.,1.0,20.0,20.0,3486613.48999999,Branded Rice,Keila Alfaro-Visvikis,RETAIL  DSD,1385521,Oct
2024-10-28,Gala Fresh Farms - Boca Ratón,Invoice,008-04056,"Rice Snack:Rice Snack, Pizza DH",,1.0,19.9,19.9,3486633.38999999,Puffed Products,Keila Alfaro-Visvikis,RETAIL  DSD,1385522,Oct
2024-10-28,Gala Fresh Farms - Boca Ratón,Credit Memo,008-04105,Varios:Promotional Allowance,1 pizza,-1.0,19.9,-19.9,3486613.48999999,Puffed Products,Keila Alfaro-Visvikis,RETAIL  DSD,1385523,Oct
2024-10-28,El Palacio de Los Jugos / Casa mía Food Restaurant inc,Credit Memo,008-04106,Varios:Promotional Allowance,50lb parbo,-1.0,27.75,-27.75,3486585.73999999,Bulk Rice,Lisset Limpio -020,Cafeteria,1385524,Oct
2024-10-28,El Palacio de los jugos / Lita Foods Inc.,Credit Memo,008-04107,Varios:Promotional Allowance,50lb parbo,-1.0,27.75,-27.75,3486557.98999999,Bulk Rice,Lisset Limpio -020,Cafeteria,1385525,Oct
2024-10-28,El Palacio de los jugos / Delicias Criollas (DIAGO FOOD_MILLER),Credit Memo,008-04108,Varios:Promotional Allowance,50lb parbo,-2.0,27.75,-55.5,3486502.48999999,Bulk Rice,Lisset Limpio -020,Cafeteria,1385526,Oct
2024-10-28,Festival Supermarket Margate,Credit Memo,008-04114,Varios:Promotional Allowance,5kg,-2.0,46.5,-93.0,3486409.48999999,Branded Rice,Keila Alfaro-Visvikis,RETAIL  DSD,1385527,Oct
2024-10-28,Festival Supermarket Margate,Credit Memo,008-04114,Varios:Promotional Allowance,1kg lf,-1.0,17.5,-17.5,3486391.98999999,Branded Rice,Keila Alfaro-Visvikis,RETAIL  DSD,1385528,Oct
2024-10-29,SOY GUAJIRO CUBAN RESTAURANT,Invoice,008-04057,Arroz a Granel:Parboiled 50 LB -Bolsa Dos Hermanos.,,4.0,28.25,113.0,3486504.98999999,Bulk Rice,Keila Alfaro-Visvikis,CAFETERIA y RESTAURANTS,1385529,Oct
2024-10-29,SOY GUAJIRO CUBAN RESTAURANT,Invoice,008-04057,Arroz a Granel:Largo Fino 50 LB -Bolsa Dos Hermanos.,,2.0,27.85,55.7,3486560.68999999,Bulk Rice,Keila Alfaro-Visvikis,CAFETERIA y RESTAURANTS,1385530,Oct
2024-10-29,SOY GUAJIRO CUBAN RESTAURANT,Invoice,008-04057,Dry Beans:Dry Beans - Black Beans 50,Dry Black Beans 50 lb,1.0,45.7,45.7,3486606.38999999,Dry Beans,Keila Alfaro-Visvikis,CAFETERIA y RESTAURANTS,1385531,Oct
2024-10-29,Sedanos Supermarkets #26,Invoice,008-04058,Arroz a Granel:Parboiled 50 LB -Bolsa Dos Hermanos.,,3.0,28.25,84.75,3486691.13999999,Bulk Rice,Keila Alfaro-Visvikis,RETAIL SEDANOS,1385532,Oct
2024-10-29,Sedanos Supermarkets #26,Invoice,008-04058,,Discount,,,-1.7,3486689.43999999,,Keila Alfaro-Visvikis,RETAIL SEDANOS,1385533,Oct
2024-10-29,Sedanos Supermarkets #43,Invoice,008-04059,Arroz a Granel:Parboiled 50 LB -Bolsa Dos Hermanos.,,5.0,28.25,141.25,3486830.68999999,Bulk Rice,Keila Alfaro-Visvikis,RETAIL SEDANOS,1385534,Oct
2024-10-29,Sedanos Supermarkets #43,Invoice,008-04059,,Discount,,,-2.83,3486827.85999999,,Keila Alfaro-Visvikis,RETAIL SEDANOS,1385535,Oct
2024-10-30,Mama ‘s Kitchen F.D.CORP,Invoice,008-04060,Spices:AS Chicken Base,1 / 30 lb. (box or pail),2.0,39.0,78.0,3486905.85999999,American Spice,Keila Alfaro-Visvikis,CAFETERIA y RESTAURANTS,1385536,Oct
2024-10-30,Mama ‘s Kitchen F.D.CORP,Invoice,008-04060,Liquids:AS Marinating Sauce (Mojo),,2.0,18.5,37.0,3486942.85999999,American Spice,Keila Alfaro-Visvikis,CAFETERIA y RESTAURANTS,1385537,Oct
2024-10-30,Mama ‘s Kitchen F.D.CORP,Invoice,008-04060,Liquids:AS Cooking Wine,4/1 Gl.,2.0,17.5,35.0,3486977.85999999,American Spice,Keila Alfaro-Visvikis,CAFETERIA y RESTAURANTS,1385538,Oct
2024-10-30,Mama ‘s Kitchen F.D.CORP,Invoice,008-04060,Dry Beans:Dry Beans - Black Beans 50,Dry Black Beans 50 lb,1.0,39.75,39.75,3487017.60999999,Dry Beans,Keila Alfaro-Visvikis,CAFETERIA y RESTAURANTS,1385539,Oct
2024-10-30,Mama ‘s Kitchen F.D.CORP,Invoice,008-04060,Arroz a Granel:Parboiled 50 LB -Bolsa Dos Hermanos.,,1.0,28.25,28.25,3487045.85999999,Bulk Rice,Keila Alfaro-Visvikis,CAFETERIA y RESTAURANTS,1385540,Oct
2024-10-30,Mama ‘s Kitchen F.D.CORP,Invoice,008-04060,Liquids:AS Bitter Orange,,1.0,15.9,15.9,3487061.75999999,American Spice,Keila Alfaro-Visvikis,CAFETERIA y RESTAURANTS,1385541,Oct
2024-10-30,Albert Deli #2,Invoice,008-04061,Dry Beans:Dry Beans - Black Beans 50,Dry Black Beans 50 lb,1.0,45.7,45.7,3487107.45999999,Dry Beans,Keila Alfaro-Visvikis,CAFETERIA y RESTAURANTS,1385542,Oct
2024-10-30,Albert Deli #2,Invoice,008-04061,Dry Beans:Dry Beans - Small Red Beans 50 lbs.,Small Red Beans 50 lbs,1.0,46.85,46.85,3487154.30999999,Dry Beans,Keila Alfaro-Visvikis,CAFETERIA y RESTAURANTS,1385543,Oct
2024-10-30,Albert Deli #2,Invoice,008-04061,Arroz a Granel:Largo Fino 50 LB -Bolsa Dos Hermanos.,,2.0,27.85,55.7,3487210.00999999,Bulk Rice,Keila Alfaro-Visvikis,CAFETERIA y RESTAURANTS,1385544,Oct
2024-10-30,Albert Deli #2,Invoice,008-04061,Arroz a Granel:Parboiled 50 LB -Bolsa Dos Hermanos.,,2.0,28.25,56.5,3487266.50999999,Bulk Rice,Keila Alfaro-Visvikis,CAFETERIA y RESTAURANTS,1385545,Oct
2024-10-30,Sedanos Supermarkets #17,Invoice,008-04062,Rice Snack:Rice Snack Ham Flavored DOS HERMANOS,,3.0,19.9,59.7,3487326.20999999,Puffed Products,Lisset Limpio -020,RETAIL SEDANOS,1385546,Oct
2024-10-30,Sedanos Supermarkets #17,Invoice,008-04062,Rice Snack:Rice Snack Salami Flavored DOS HERMANOS,,1.0,19.9,19.9,3487346.10999999,Puffed Products,Lisset Limpio -020,RETAIL SEDANOS,1385547,Oct
2024-10-30,Sedanos Supermarkets #17,Invoice,008-04062,,Discount,,,-1.19,3487344.91999999,,Lisset Limpio -020,RETAIL SEDANOS,1385548,Oct
2024-10-30,Sedanos Supermarkets #24,Invoice,008-04063,Arroz Envasado:Largo Fino 1kg (Long grain rice) Dos Hermanos,,2.0,17.5,35.0,3487379.91999999,Branded Rice,Keila Alfaro-Visvikis,RETAIL SEDANOS,1385549,Oct
2024-10-30,Sedanos Supermarkets #24,Invoice,008-04063,Arroz Envasado:Parboiled 1kg Bolsa Dos Hermanos.,.,3.0,19.9,59.7,3487439.61999999,Branded Rice,Keila Alfaro-Visvikis,RETAIL SEDANOS,1385550,Oct
2024-10-30,Sedanos Supermarkets #24,Invoice,008-04063,Rice Snack:Rice Snack Ham Flavored DOS HERMANOS,,1.0,19.9,19.9,3487459.51999999,Puffed Products,Keila Alfaro-Visvikis,RETAIL SEDANOS,1385551,Oct
2024-10-30,Sedanos Supermarkets #24,Invoice,008-04063,Rice Snack:Rice Snack Salami Flavored DOS HERMANOS,,1.0,19.9,19.9,3487479.41999999,Puffed Products,Keila Alfaro-Visvikis,RETAIL SEDANOS,1385552,Oct
2024-10-30,Sedanos Supermarkets #24,Invoice,008-04063,"Rice Snack:Rice Snack, Pizza DH",,1.0,19.9,19.9,3487499.31999999,Puffed Products,Keila Alfaro-Visvikis,RETAIL SEDANOS,1385553,Oct
2024-10-30,Sedanos Supermarkets #24,Invoice,008-04063,Arroz a Granel:Parboiled 50 LB -Bolsa Dos Hermanos.,,2.0,28.25,56.5,3487555.81999999,Bulk Rice,Keila Alfaro-Visvikis,RETAIL SEDANOS,1385554,Oct
2024-10-30,Sedanos Supermarkets #24,Invoice,008-04063,Arroz Envasado:Largo Fino 1kg (Long grain rice) Dos Hermanos,,1.0,17.5,17.5,3487573.31999999,Branded Rice,Keila Alfaro-Visvikis,RETAIL SEDANOS,1385555,Oct
2024-10-30,Sedanos Supermarkets #24,Invoice,008-04063,Rice Snack:Rice Snack Ham Flavored DOS HERMANOS,,1.0,19.9,19.9,3487593.21999999,Puffed Products,Keila Alfaro-Visvikis,RETAIL SEDANOS,1385556,Oct
2024-10-30,Sedanos Supermarkets #24,Invoice,008-04063,,Discount,,,-4.22,3487588.99999999,,Keila Alfaro-Visvikis,RETAIL SEDANOS,1385557,Oct
2024-10-30,Sedanos Supermarkets #7,Invoice,008-04064,Rice Snack:Rice Snack Ham Flavored DOS HERMANOS,,2.0,19.9,39.8,3487628.79999999,Puffed Products,Lisset Limpio -020,RETAIL SEDANOS,1385558,Oct
2024-10-30,Sedanos Supermarkets #7,Invoice,008-04064,Rice Snack:Rice Snack Salami Flavored DOS HERMANOS,,1.0,19.9,19.9,3487648.69999999,Puffed Products,Lisset Limpio -020,RETAIL SEDANOS,1385559,Oct
2024-10-30,Sedanos Supermarkets #7,Invoice,008-04064,Rice Snack:Rice Snack Salami Flavored DOS HERMANOS,,1.0,19.9,19.9,3487668.59999999,Puffed Products,Lisset Limpio -020,RETAIL SEDANOS,1385560,Oct
2024-10-30,Sedanos Supermarkets #7,Invoice,008-04064,,Discount,,,-1.19,3487667.40999999,,Lisset Limpio -020,RETAIL SEDANOS,1385561,Oct
2024-10-30,Sedanos Supermarkets #34,Invoice,008-04065,Arroz Envasado:Parboiled 5KG Dos Hermanos.,6 / 11lbs,10.0,40.5,405.0,3488072.40999999,Branded Rice,Keila Alfaro-Visvikis,RETAIL SEDANOS,1385562,Oct
2024-10-30,Sedanos Supermarkets #34,Invoice,008-04065,Arroz a Granel:Parboiled 50 LB -Bolsa Dos Hermanos.,,4.0,28.25,113.0,3488185.40999999,Bulk Rice,Keila Alfaro-Visvikis,RETAIL SEDANOS,1385563,Oct
2024-10-30,Sedanos Supermarkets #34,Invoice,008-04065,Arroz Envasado:Parboiled 5KG Dos Hermanos.,6 / 11lbs,4.0,40.5,162.0,3488347.40999999,Branded Rice,Keila Alfaro-Visvikis,RETAIL SEDANOS,1385564,Oct
2024-10-30,Sedanos Supermarkets #34,Invoice,008-04065,,Discount,,,-10.36,3488337.04999999,,Keila Alfaro-Visvikis,RETAIL SEDANOS,1385565,Oct
2024-10-30,Sedanos Supermarkets  #4,Invoice,008-04066,Rice Snack:Rice Snack Salami Flavored DOS HERMANOS,,2.0,19.9,39.8,3488376.84999999,Puffed Products,Lisset Limpio -020,RETAIL SEDANOS,1385566,Oct
2024-10-30,Sedanos Supermarkets  #4,Invoice,008-04066,Rice Snack:Rice Snack Ham Flavored DOS HERMANOS,,1.0,19.9,19.9,3488396.74999999,Puffed Products,Lisset Limpio -020,RETAIL SEDANOS,1385567,Oct
2024-10-30,Sedanos Supermarkets  #4,Invoice,008-04066,Rice Snack:Rice Snack Ham Flavored DOS HERMANOS,,1.0,19.9,19.9,3488416.64999999,Puffed Products,Lisset Limpio -020,RETAIL SEDANOS,1385568,Oct
2024-10-30,Sedanos Supermarkets  #4,Invoice,008-04066,,Discount,,,-1.19,3488415.45999999,,Lisset Limpio -020,RETAIL SEDANOS,1385569,Oct
2024-10-30,Ideal Food Basket Davie Cafeteria,Invoice,008-04067,Arroz a Granel:Largo Fino 50 LB -Bolsa Dos Hermanos.,,8.0,27.85,222.8,3488638.25999999,Bulk Rice,Keila Alfaro-Visvikis,CAFETERIA y RESTAURANTS,1385570,Oct
2024-10-30,Sedanos Supermarkets #27,Invoice,008-04068,Arroz Envasado:Parboiled 5KG Dos Hermanos.,6 / 11lbs,10.0,40.5,405.0,3489043.25999999,Branded Rice,Keila Alfaro-Visvikis,RETAIL SEDANOS,1385571,Oct
2024-10-30,Sedanos Supermarkets #27,Invoice,008-04068,Arroz Envasado:Parboiled 5KG Dos Hermanos.,6 / 11lbs,4.0,40.5,162.0,3489205.25999999,Branded Rice,Keila Alfaro-Visvikis,RETAIL SEDANOS,1385572,Oct
2024-10-30,Sedanos Supermarkets #27,Invoice,008-04068,,Discount,,,-8.1,3489197.15999999,,Keila Alfaro-Visvikis,RETAIL SEDANOS,1385573,Oct
2024-10-30,La Ranchera Meat Market #3,Invoice,008-04069,Arroz a Granel:Largo Fino 50 LB -Bolsa Dos Hermanos.,,10.0,27.85,278.5,3489475.65999999,Bulk Rice,Keila Alfaro-Visvikis,CAFETERIA y RESTAURANTS,1385574,Oct
2024-10-30,La Ranchera Meat Market #3,Invoice,008-04069,Arroz Envasado:Largo Fino 1kg (Long grain rice) Dos Hermanos,,5.0,17.5,87.5,3489563.15999999,Branded Rice,Keila Alfaro-Visvikis,CAFETERIA y RESTAURANTS,1385575,Oct
2024-10-30,La Ranchera Meat Market #3,Invoice,008-04069,Arroz Envasado:Largo Fino 1kg (Long grain rice) Dos Hermanos,,1.0,17.5,17.5,3489580.65999999,Branded Rice,Keila Alfaro-Visvikis,CAFETERIA y RESTAURANTS,1385576,Oct
2024-10-30,Key Food Kimberly Blvd.,Invoice,008-04070,Arroz a Granel:Parboiled 50 LB -Bolsa Dos Hermanos.,,10.0,27.75,277.5,3489858.15999999,Bulk Rice,Keila Alfaro-Visvikis,RETAIL  DSD,1385577,Oct
2024-10-30,Key Food Kimberly Blvd.,Invoice,008-04070,Arroz a Granel:Parboiled 50 LB -Bolsa Dos Hermanos.,EXCHANGE,2.0,27.75,55.5,3489913.65999999,Bulk Rice,Keila Alfaro-Visvikis,RETAIL  DSD,1385578,Oct
2024-10-30,Price Choice Food Market # 6,Invoice,008-04071,Arroz a Granel:Parboiled 50 LB -Bolsa Dos Hermanos.,,20.0,28.25,565.0,3490478.65999999,Bulk Rice,Lisset Limpio -020,RETAIL  DSD,1385579,Oct
2024-10-30,Los Mejores Tamales de Miami,Invoice,008-04072,Arroz a Granel:Parboiled 50 LB -Bolsa Dos Hermanos.,,4.0,28.25,113.0,3490591.65999999,Bulk Rice,Lisset Limpio -020,CAFETERIA y RESTAURANTS,1385580,Oct
2024-10-30,Sedanos Supermarkets #17,Credit Memo,008-04109,Varios:Promotional Allowance,salami,-1.0,19.9,-19.9,3490571.75999999,Puffed Products,Lisset Limpio -020,RETAIL SEDANOS,1385581,Oct
2024-10-30,Sedanos Supermarkets #24,Credit Memo,008-04110,Varios:Promotional Allowance,lf 1kg,-1.0,17.5,-17.5,3490554.25999999,Branded Rice,Keila Alfaro-Visvikis,RETAIL SEDANOS,1385582,Oct
2024-10-30,Sedanos Supermarkets #24,Credit Memo,008-04110,Varios:Promotional Allowance,ham,-1.0,19.9,-19.9,3490534.35999999,Puffed Products,Keila Alfaro-Visvikis,RETAIL SEDANOS,1385583,Oct
2024-10-30,Sedanos Supermarkets #7,Credit Memo,008-04111,Varios:Promotional Allowance,ham,-1.0,19.9,-19.9,3490514.45999999,Puffed Products,Lisset Limpio -020,RETAIL SEDANOS,1385584,Oct
2024-10-30,Sedanos Supermarkets #34,Credit Memo,008-04112,Varios:Promotional Allowance,5kg,-4.0,40.5,-162.0,3490352.45999999,Branded Rice,Keila Alfaro-Visvikis,RETAIL SEDANOS,1385585,Oct
2024-10-30,Sedanos Supermarkets  #4,Credit Memo,008-04113,Varios:Promotional Allowance,ham,-1.0,19.9,-19.9,3490332.55999999,Puffed Products,Lisset Limpio -020,RETAIL SEDANOS,1385586,Oct
2024-10-30,Key Food Kimberly Blvd.,Credit Memo,008-04115,Varios:Promotional Allowance,cambio 2 parbo,-2.0,27.75,-55.5,3490277.05999999,Bulk Rice,Keila Alfaro-Visvikis,RETAIL  DSD,1385587,Oct
2024-10-30,Sedanos Supermarkets #27,Credit Memo,008-04116,Varios:Promotional Allowance,parbo 5k,-4.0,40.5,-162.0,3490115.05999999,Branded Rice,Keila Alfaro-Visvikis,RETAIL SEDANOS,1385588,Oct
2024-10-31,El Palacio de los jugos /  EMMA FOOD CORP,Invoice,008-04084,Arroz a Granel:Parboiled 50 LB -Bolsa Dos Hermanos.,,8.0,26.75,214.0,3490329.05999999,Bulk Rice,Lisset Limpio -020,Cafeteria,1385589,Oct
2024-10-31,ALS Foods,Invoice,008-04085,Liquids:AS Cooking Wine,4/1 Gl.,1.0,17.5,17.5,3490346.55999999,American Spice,Lisset Limpio -020,CAFETERIA y RESTAURANTS,1385590,Oct
2024-10-31,ALS Foods,Invoice,008-04085,Arroz a Granel:Largo Fino 50 LB -Bolsa Dos Hermanos.,,6.0,27.85,167.1,3490513.65999999,Bulk Rice,Lisset Limpio -020,CAFETERIA y RESTAURANTS,1385591,Oct
2024-10-31,ALS Foods,Invoice,008-04085,Arroz a Granel:Parboiled 50 LB -Bolsa Dos Hermanos.,,11.0,27.75,305.25,3490818.90999999,Bulk Rice,Lisset Limpio -020,CAFETERIA y RESTAURANTS,1385592,Oct
2024-10-31,ALS Foods,Invoice,008-04085,Arroz a Granel:Parboiled 50 LB -Bolsa Dos Hermanos.,,1.0,27.75,27.75,3490846.65999999,Bulk Rice,Lisset Limpio -020,CAFETERIA y RESTAURANTS,1385593,Oct
2024-10-31,Sorianos Brothers,Invoice,008-04086,Arroz a Granel:Parboiled 50 LB -Bolsa Dos Hermanos.,,25.0,26.5,662.5,3491509.15999999,Bulk Rice,Lisset Limpio -020,CAFETERIA y RESTAURANTS,1385594,Oct
2024-10-31,Soriano Brothers,Invoice,008-04087,Arroz a Granel:Parboiled 50 LB -Bolsa Dos Hermanos.,,30.0,26.5,795.0,3492304.15999999,Bulk Rice,Lisset Limpio -020,CAFETERIA y RESTAURANTS,1385595,Oct
2024-10-31,El Palacio de los jugos / Lita Foods Inc.,Invoice,008-04088,Dry Beans:Dry Beans - Black Beans 50,Dry Black Beans 50 lb,1.0,45.7,45.7,3492349.85999999,Dry Beans,Lisset Limpio -020,Cafeteria,1385596,Oct
2024-10-31,El Palacio de los jugos / Lita Foods Inc.,Invoice,008-04088,Arroz a Granel:Parboiled 50 LB -Bolsa Dos Hermanos.,,11.0,27.75,305.25,3492655.10999999,Bulk Rice,Lisset Limpio -020,Cafeteria,1385597,Oct
2024-10-31,El Palacio de los jugos / Lita Foods Inc.,Invoice,008-04088,Arroz a Granel:Parboiled 50 LB -Bolsa Dos Hermanos.,,1.0,27.75,27.75,3492682.85999999,Bulk Rice,Lisset Limpio -020,Cafeteria,1385598,Oct
2024-10-31,El Palacio de los jugos / Leti Corp.,Invoice,008-04089,Arroz a Granel:Largo Fino 50 LB -Bolsa Dos Hermanos.,,1.0,27.85,27.85,3492710.70999999,Bulk Rice,Lisset Limpio -020,Cafeteria,1385599,Oct
2024-10-31,El Palacio de los jugos / Leti Corp.,Invoice,008-04089,Arroz a Granel:Parboiled 50 LB -Bolsa Dos Hermanos.,,1.0,28.25,28.25,3492738.95999999,Bulk Rice,Lisset Limpio -020,Cafeteria,1385600,Oct
2024-10-31,El Palacio de Los Jugos / Casa mía Food Restaurant inc,Invoice,008-04090,Dry Beans:Dry Beans - Black Beans 50,Dry Black Beans 50 lb,1.0,45.7,45.7,3492784.65999999,Dry Beans,Lisset Limpio -020,Cafeteria,1385601,Oct
2024-10-31,El Palacio de Los Jugos / Casa mía Food Restaurant inc,Invoice,008-04090,Arroz a Granel:Parboiled 50 LB -Bolsa Dos Hermanos.,,11.0,27.75,305.25,3493089.90999999,Bulk Rice,Lisset Limpio -020,Cafeteria,1385602,Oct
2024-10-31,El Palacio de Los Jugos / Casa mía Food Restaurant inc,Invoice,008-04090,Arroz a Granel:Parboiled 50 LB -Bolsa Dos Hermanos.,,1.0,27.75,27.75,3493117.65999999,Bulk Rice,Lisset Limpio -020,Cafeteria,1385603,Oct
2024-10-31,Los Caringas Latin America  Foods,Invoice,008-04091,Arroz a Granel:Largo Fino 50 LB -Bolsa Dos Hermanos.,,3.0,27.85,83.55,3493201.20999999,Bulk Rice,Lisset Limpio -020,CAFETERIA y RESTAURANTS,1385604,Oct
2024-10-31,Los Caringas Latin America  Foods,Invoice,008-04091,Arroz a Granel:Parboiled 50 LB -Bolsa Dos Hermanos.,,3.0,28.25,84.75,3493285.95999999,Bulk Rice,Lisset Limpio -020,CAFETERIA y RESTAURANTS,1385605,Oct
2024-10-31,Fritanga Momotombo,Invoice,008-04092,Arroz a Granel:Largo Fino 50 LB -Bolsa Dos Hermanos.,,6.0,27.85,167.1,3493453.05999999,Bulk Rice,Lisset Limpio -020,CAFETERIA y RESTAURANTS,1385606,Oct
2024-10-31,Aries Supermarket & Cafeteria,Invoice,008-04093,Dry Beans:Dry Beans - Black Beans 50,Dry Black Beans 50 lb,8.0,39.75,318.0,3493771.05999999,Dry Beans,Keila Alfaro-Visvikis,CAFETERIA y RESTAURANTS,1385607,Oct
2024-10-31,Aries Supermarket & Cafeteria,Invoice,008-04093,Arroz a Granel:Parboiled 50 LB -Bolsa Dos Hermanos.,,10.0,28.25,282.5,3494053.55999999,Bulk Rice,Keila Alfaro-Visvikis,CAFETERIA y RESTAURANTS,1385608,Oct
2024-10-31,Sedanos Supermarkets #33,Invoice,008-04094,Rice Snack:Rice Snack Ham Flavored DOS HERMANOS,,2.0,19.9,39.8,3494093.35999999,Puffed Products,Keila Alfaro-Visvikis,RETAIL SEDANOS,1385609,Oct
2024-10-31,Sedanos Supermarkets #33,Invoice,008-04094,Rice Snack:Rice Snack Salami Flavored DOS HERMANOS,,2.0,19.9,39.8,3494133.15999999,Puffed Products,Keila Alfaro-Visvikis,RETAIL SEDANOS,1385610,Oct
2024-10-31,Sedanos Supermarkets #33,Invoice,008-04094,"Rice Snack:Rice Snack, Pizza DH",,2.0,19.9,39.8,3494172.95999999,Puffed Products,Keila Alfaro-Visvikis,RETAIL SEDANOS,1385611,Oct
2024-10-31,Sedanos Supermarkets #33,Invoice,008-04094,Rice Snack:Rice Snack Ham Flavored DOS HERMANOS,,2.0,19.9,39.8,3494212.75999999,Puffed Products,Keila Alfaro-Visvikis,RETAIL SEDANOS,1385612,Oct
2024-10-31,Sedanos Supermarkets #33,Invoice,008-04094,,Discount,,,-2.39,3494210.36999999,,Keila Alfaro-Visvikis,RETAIL SEDANOS,1385613,Oct
2024-10-31,Sabor Tropical #1 - Cafeteria,Invoice,008-04095,Arroz a Granel:Parboiled 50 LB -Bolsa Dos Hermanos.,,5.0,28.25,141.25,3494351.61999999,Bulk Rice,Keila Alfaro-Visvikis,CAFETERIA y RESTAURANTS,1385614,Oct
2024-10-31,Sedanos Supermarkets  #37,Invoice,008-04096,Arroz Envasado:Parboiled 5KG Dos Hermanos.,6 / 11lbs,30.0,40.5,1215.0,3495566.61999999,Branded Rice,Lisset Limpio -020,RETAIL SEDANOS,1385615,Oct
2024-10-31,Sedanos Supermarkets  #37,Invoice,008-04096,Rice Snack:Rice Snack Ham Flavored DOS HERMANOS,,3.0,19.9,59.7,3495626.31999999,Puffed Products,Lisset Limpio -020,RETAIL SEDANOS,1385616,Oct
2024-10-31,Sedanos Supermarkets  #37,Invoice,008-04096,Rice Snack:Rice Snack Salami Flavored DOS HERMANOS,,1.0,19.9,19.9,3495646.21999999,Puffed Products,Lisset Limpio -020,RETAIL SEDANOS,1385617,Oct
2024-10-31,Sedanos Supermarkets  #37,Invoice,008-04096,Arroz Envasado:Parboiled 5KG Dos Hermanos.,6 / 11lbs,11.0,40.5,445.5,3496091.71999999,Branded Rice,Lisset Limpio -020,RETAIL SEDANOS,1385618,Oct
2024-10-31,Sedanos Supermarkets  #37,Invoice,008-04096,,Discount,,,-25.49,3496066.22999999,,Lisset Limpio -020,RETAIL SEDANOS,1385619,Oct
2024-10-31,Sedanos Supermarkets #36,Invoice,008-04097,Rice Snack:Rice Snack Ham Flavored DOS HERMANOS,,2.0,19.9,39.8,3496106.02999999,Puffed Products,Keila Alfaro-Visvikis,RETAIL SEDANOS,1385620,Oct
2024-10-31,Sedanos Supermarkets #36,Invoice,008-04097,Rice Snack:Rice Snack Salami Flavored DOS HERMANOS,,2.0,19.9,39.8,3496145.82999999,Puffed Products,Keila Alfaro-Visvikis,RETAIL SEDANOS,1385621,Oct
2024-10-31,Sedanos Supermarkets #36,Invoice,008-04097,"Rice Snack:Rice Snack, Pizza DH",,2.0,19.9,39.8,3496185.62999999,Puffed Products,Keila Alfaro-Visvikis,RETAIL SEDANOS,1385622,Oct
2024-10-31,Sedanos Supermarkets #36,Invoice,008-04097,"Rice Snack:Rice Snack, Pizza DH",,1.0,19.9,19.9,3496205.52999999,Puffed Products,Keila Alfaro-Visvikis,RETAIL SEDANOS,1385623,Oct
2024-10-31,Sedanos Supermarkets #36,Invoice,008-04097,Rice Snack:Rice Snack Ham Flavored DOS HERMANOS,,1.0,19.9,19.9,3496225.42999999,Puffed Products,Keila Alfaro-Visvikis,RETAIL SEDANOS,1385624,Oct
2024-10-31,Sedanos Supermarkets #36,Invoice,008-04097,Varios:Exhibidor de pie DOS HERMANOS PVC -,,1.0,0.0,0.0,3496225.42999999,,Keila Alfaro-Visvikis,RETAIL SEDANOS,1385625,Oct
2024-10-31,Sedanos Supermarkets #36,Invoice,008-04097,,Discount,,,-2.39,3496223.03999999,,Keila Alfaro-Visvikis,RETAIL SEDANOS,1385626,Oct
2024-10-31,La Ranchera Meat Market #3,Credit Memo,008-04117,Varios:Promotional Allowance,lf 1kg,-1.0,17.5,-17.5,3496205.53999999,Branded Rice,Keila Alfaro-Visvikis,CAFETERIA y RESTAURANTS,1385627,Oct
2024-10-31,ALS Foods,Credit Memo,008-04118,Varios:Promotional Allowance,,-1.0,27.75,-27.75,3496177.78999999,Bulk Rice,Lisset Limpio -020,CAFETERIA y RESTAURANTS,1385628,Oct
2024-10-31,El Palacio de los jugos / Lita Foods Inc.,Credit Memo,008-04119,Varios:Promotional Allowance,,-1.0,27.75,-27.75,3496150.03999999,Bulk Rice,Lisset Limpio -020,Cafeteria,1385629,Oct
2024-10-31,El Palacio de Los Jugos / Casa mía Food Restaurant inc,Credit Memo,008-04120,Varios:Promotional Allowance,,-1.0,27.75,-27.75,3496122.28999999,Bulk Rice,Lisset Limpio -020,Cafeteria,1385630,Oct
2024-10-31,Sedanos Supermarkets #33,Credit Memo,008-04121,Varios:Promotional Allowance,2ham,-2.0,19.9,-39.8,3496082.48999999,Puffed Products,Keila Alfaro-Visvikis,RETAIL SEDANOS,1385631,Oct
2024-10-31,Sedanos Supermarkets  #37,Credit Memo,008-04122,Varios:Promotional Allowance,ham,-1.0,19.9,-19.9,3496062.58999999,Puffed Products,Lisset Limpio -020,RETAIL SEDANOS,1385632,Oct
2024-10-31,Sedanos Supermarkets  #37,Credit Memo,008-04122,Varios:Promotional Allowance,5kg parbo,-11.0,40.5,-445.5,3495617.08999999,Branded Rice,Lisset Limpio -020,RETAIL SEDANOS,1385633,Oct
2024-10-31,Sedanos Supermarkets #36,Credit Memo,008-04123,Varios:Promotional Allowance,ham y pizza,-2.0,19.9,-39.8,3495577.28999999,Puffed Products,Keila Alfaro-Visvikis,RETAIL SEDANOS,1385634,Oct
2024-11-05,Sedanos Supermarkets #29,Invoice,008-04125,Arroz Envasado:Parboiled 5KG Dos Hermanos.,6 / 11lbs,30.0,40.5,1215.0,3496792.28999999,Branded Rice,Lisset Limpio -020,RETAIL SEDANOS,1385635,Nov
2024-11-05,Sedanos Supermarkets #29,Invoice,008-04125,Arroz Envasado:Parboiled 5KG Dos Hermanos.,6 / 11lbs,11.0,40.5,445.5,3497237.78999999,Branded Rice,Lisset Limpio -020,RETAIL SEDANOS,1385636,Nov
2024-11-05,Sedanos Supermarkets #29,Invoice,008-04125,,Discount,,,-24.3,3497213.48999999,,Lisset Limpio -020,RETAIL SEDANOS,1385637,Nov
2024-11-05,Bravo   Francisco Diaz,Invoice,008-04126,Liquids:AS Cooking Wine,4/1 Gl.,4.0,17.5,70.0,3497283.48999999,American Spice,Lisset Limpio -020,RETAIL  DSD,1385638,Nov
2024-11-05,Bravo   Francisco Diaz,Invoice,008-04126,Dry Beans:Dry Beans - Black Beans 50,Dry Black Beans 50 lb,2.0,45.7,91.4,3497374.88999999,Dry Beans,Lisset Limpio -020,RETAIL  DSD,1385639,Nov
2024-11-05,Bravo   Francisco Diaz,Invoice,008-04126,Arroz a Granel:Largo Fino 50 LB -Bolsa Dos Hermanos.,,5.0,27.85,139.25,3497514.13999999,Bulk Rice,Lisset Limpio -020,RETAIL  DSD,1385640,Nov
2024-11-05,Bravo   Francisco Diaz,Invoice,008-04126,Liquids:AS White Vinegar,4/1 Gl.,2.0,10.0,20.0,3497534.13999999,American Spice,Lisset Limpio -020,RETAIL  DSD,1385641,Nov
2024-11-05,Bravo   Francisco Diaz,Invoice,008-04126,Liquids:AS Lemon Juice 4/1 Gl,,1.0,14.95,14.95,3497549.08999999,American Spice,Lisset Limpio -020,RETAIL  DSD,1385642,Nov
2024-11-05,Sedanos Supermarkets #10,Invoice,008-04127,Arroz Envasado:Largo Fino 1kg (Long grain rice) Dos Hermanos,,2.0,17.5,35.0,3497584.08999999,Branded Rice,Keila Alfaro-Visvikis,RETAIL SEDANOS,1385643,Nov
2024-11-05,Sedanos Supermarkets #10,Invoice,008-04127,Arroz Envasado:Parboiled 1kg Bolsa Dos Hermanos.,.,3.0,19.9,59.7,3497643.78999999,Branded Rice,Keila Alfaro-Visvikis,RETAIL SEDANOS,1385644,Nov
2024-11-05,Sedanos Supermarkets #10,Invoice,008-04127,Rice Snack:Rice Snack Ham Flavored DOS HERMANOS,,1.0,19.9,19.9,3497663.68999999,Puffed Products,Keila Alfaro-Visvikis,RETAIL SEDANOS,1385645,Nov
2024-11-05,Sedanos Supermarkets #10,Invoice,008-04127,Rice Snack:Rice Snack Salami Flavored DOS HERMANOS,,1.0,19.9,19.9,3497683.58999999,Puffed Products,Keila Alfaro-Visvikis,RETAIL SEDANOS,1385646,Nov
2024-11-05,Sedanos Supermarkets #10,Invoice,008-04127,"Rice Snack:Rice Snack, Pizza DH",,1.0,19.9,19.9,3497703.48999999,Puffed Products,Keila Alfaro-Visvikis,RETAIL SEDANOS,1385647,Nov
2024-11-05,Sedanos Supermarkets #10,Invoice,008-04127,Rice Snack:Rice Snack Ham Flavored DOS HERMANOS,,1.0,19.9,19.9,3497723.38999999,Puffed Products,Keila Alfaro-Visvikis,RETAIL SEDANOS,1385648,Nov
2024-11-05,Sedanos Supermarkets #10,Invoice,008-04127,,Discount,,,-3.09,3497720.29999999,,Keila Alfaro-Visvikis,RETAIL SEDANOS,1385649,Nov
2024-11-05,Sedanos Supermarkets #8,Invoice,008-04128,Arroz Envasado:Parboiled 5KG Dos Hermanos.,6 / 11lbs,5.0,40.5,202.5,3497922.79999999,Branded Rice,Keila Alfaro-Visvikis,RETAIL SEDANOS,1385650,Nov
2024-11-05,Sedanos Supermarkets #8,Invoice,008-04128,Rice Snack:Rice Snack Ham Flavored DOS HERMANOS,,1.0,19.9,19.9,3497942.69999999,Puffed Products,Keila Alfaro-Visvikis,RETAIL SEDANOS,1385651,Nov
2024-11-05,Sedanos Supermarkets #8,Invoice,008-04128,Rice Snack:Rice Snack Salami Flavored DOS HERMANOS,,1.0,19.9,19.9,3497962.59999999,Puffed Products,Keila Alfaro-Visvikis,RETAIL SEDANOS,1385652,Nov
2024-11-05,Sedanos Supermarkets #8,Invoice,008-04128,"Rice Snack:Rice Snack, Pizza DH",,1.0,19.9,19.9,3497982.49999999,Puffed Products,Keila Alfaro-Visvikis,RETAIL SEDANOS,1385653,Nov
2024-11-05,Sedanos Supermarkets #8,Invoice,008-04128,Rice Snack:Rice Snack Ham Flavored DOS HERMANOS,,1.0,19.9,19.9,3498002.39999999,Puffed Products,Keila Alfaro-Visvikis,RETAIL SEDANOS,1385654,Nov
2024-11-05,Sedanos Supermarkets #8,Invoice,008-04128,Arroz Envasado:Parboiled 5KG Dos Hermanos.,6 / 11lbs,1.0,40.5,40.5,3498042.89999999,Branded Rice,Keila Alfaro-Visvikis,RETAIL SEDANOS,1385655,Nov
2024-11-05,Sedanos Supermarkets #8,Invoice,008-04128,,Discount,,,-4.84,3498038.05999999,,Keila Alfaro-Visvikis,RETAIL SEDANOS,1385656,Nov
2024-11-05,Sedanos Supermarkets #8,Credit Memo,008-04129,Varios:Producto vencido/deteriorado (no impacta en inventario),1 caja ham,-1.0,19.9,-19.9,3498018.15999999,Puffed Products,Keila Alfaro-Visvikis,RETAIL SEDANOS,1385657,Nov
2024-11-05,Sedanos Supermarkets #9,Invoice,008-04130,Arroz Envasado:Largo Fino 1kg (Long grain rice) Dos Hermanos,,2.0,17.5,35.0,3498053.15999999,Branded Rice,Keila Alfaro-Visvikis,RETAIL SEDANOS,1385658,Nov
2024-11-05,Sedanos Supermarkets #9,Invoice,008-04130,Arroz Envasado:Parboiled 1kg Bolsa Dos Hermanos.,.,3.0,19.9,59.7,3498112.85999999,Branded Rice,Keila Alfaro-Visvikis,RETAIL SEDANOS,1385659,Nov
2024-11-05,Sedanos Supermarkets #9,Invoice,008-04130,Arroz Envasado:Largo Fino 1kg (Long grain rice) Dos Hermanos,,1.0,17.5,17.5,3498130.35999999,Branded Rice,Keila Alfaro-Visvikis,RETAIL SEDANOS,1385660,Nov
2024-11-05,Sedanos Supermarkets #9,Invoice,008-04130,,Discount,,,-1.89,3498128.46999999,,Keila Alfaro-Visvikis,RETAIL SEDANOS,1385661,Nov
2024-11-05,Sedanos Supermarkets #16,Invoice,008-04131,Arroz Envasado:Largo Fino 1kg (Long grain rice) Dos Hermanos,,3.0,17.5,52.5,3498180.96999999,Branded Rice,Keila Alfaro-Visvikis,RETAIL SEDANOS,1385662,Nov
2024-11-05,Sedanos Supermarkets #16,Invoice,008-04131,Arroz Envasado:Parboiled 1kg Bolsa Dos Hermanos.,.,2.0,19.9,39.8,3498220.76999999,Branded Rice,Keila Alfaro-Visvikis,RETAIL SEDANOS,1385663,Nov
2024-11-05,Sedanos Supermarkets #16,Invoice,008-04131,Rice Snack:Rice Snack Ham Flavored DOS HERMANOS,,1.0,19.9,19.9,3498240.66999999,Puffed Products,Keila Alfaro-Visvikis,RETAIL SEDANOS,1385664,Nov
2024-11-05,Sedanos Supermarkets #16,Invoice,008-04131,Rice Snack:Rice Snack Salami Flavored DOS HERMANOS,,1.0,19.9,19.9,3498260.56999999,Puffed Products,Keila Alfaro-Visvikis,RETAIL SEDANOS,1385665,Nov
2024-11-05,Sedanos Supermarkets #16,Invoice,008-04131,"Rice Snack:Rice Snack, Pizza DH",,1.0,19.9,19.9,3498280.46999999,Puffed Products,Keila Alfaro-Visvikis,RETAIL SEDANOS,1385666,Nov
2024-11-05,Sedanos Supermarkets #16,Invoice,008-04131,Rice Snack:Rice Snack Salami Flavored DOS HERMANOS,,1.0,19.9,19.9,3498300.36999999,Puffed Products,Keila Alfaro-Visvikis,RETAIL SEDANOS,1385667,Nov
2024-11-05,Sedanos Supermarkets #16,Invoice,008-04131,,Discount,,,-3.04,3498297.32999999,,Keila Alfaro-Visvikis,RETAIL SEDANOS,1385668,Nov
2024-11-05,Sedanos Supermarkets #22,Invoice,008-04132,Rice Snack:Rice Snack Ham Flavored DOS HERMANOS,,2.0,19.9,39.8,3498337.12999999,Puffed Products,Keila Alfaro-Visvikis,RETAIL SEDANOS,1385669,Nov
2024-11-05,Sedanos Supermarkets #22,Invoice,008-04132,Rice Snack:Rice Snack Salami Flavored DOS HERMANOS,,2.0,19.9,39.8,3498376.92999999,Puffed Products,Keila Alfaro-Visvikis,RETAIL SEDANOS,1385670,Nov
2024-11-05,Sedanos Supermarkets #22,Invoice,008-04132,"Rice Snack:Rice Snack, Pizza DH",,2.0,19.9,39.8,3498416.72999999,Puffed Products,Keila Alfaro-Visvikis,RETAIL SEDANOS,1385671,Nov
2024-11-05,Sedanos Supermarkets #22,Invoice,008-04132,Rice Snack:Rice Snack Salami Flavored DOS HERMANOS,,1.0,19.9,19.9,3498436.62999999,Puffed Products,Keila Alfaro-Visvikis,RETAIL SEDANOS,1385672,Nov
2024-11-05,Sedanos Supermarkets #22,Invoice,008-04132,Varios:Exhibidor de pie Good Rice PVC,i18,1.0,1.0,1.0,3498437.62999999,,Keila Alfaro-Visvikis,RETAIL SEDANOS,1385673,Nov
2024-11-05,Sedanos Supermarkets #22,Invoice,008-04132,,Discount,,,-2.39,3498435.23999999,,Keila Alfaro-Visvikis,RETAIL SEDANOS,1385674,Nov
2024-11-05,El Palacio de los jugos / Lita Foods Inc.,Invoice,008-04133,Arroz a Granel:Parboiled 50 LB -Bolsa Dos Hermanos.,,11.0,27.75,305.25,3498740.48999999,Bulk Rice,Lisset Limpio -020,Cafeteria,1385675,Nov
2024-11-05,El Palacio de los jugos / Lita Foods Inc.,Invoice,008-04133,Dry Beans:Dry Beans - Black Beans 50,Dry Black Beans 50 lb,1.0,45.7,45.7,3498786.18999999,Dry Beans,Lisset Limpio -020,Cafeteria,1385676,Nov
2024-11-05,El Palacio de los jugos / Lita Foods Inc.,Invoice,008-04133,Arroz a Granel:Parboiled 50 LB -Bolsa Dos Hermanos.,,1.0,27.75,27.75,3498813.93999999,Bulk Rice,Lisset Limpio -020,Cafeteria,1385677,Nov
2024-11-05,Max Food Distributors,Invoice,008-04134,Arroz a Granel:Parboiled 50 LB -Bolsa Dos Hermanos.,,25.0,27.75,693.75,3499507.68999999,Bulk Rice,Lisset Limpio -020,WHOLESALER,1385678,Nov
2024-11-05,JMN Dely Corp,Invoice,008-04135,Arroz a Granel:Largo Fino 50 LB -Bolsa Dos Hermanos.,,1.0,27.85,27.85,3499535.53999999,Bulk Rice,Keila Alfaro-Visvikis,CAFETERIA y RESTAURANTS,1385679,Nov
2024-11-05,JMN Dely Corp,Invoice,008-04135,Arroz a Granel:Parboiled 50 LB -Bolsa Dos Hermanos.,,2.0,28.25,56.5,3499592.03999999,Bulk Rice,Keila Alfaro-Visvikis,CAFETERIA y RESTAURANTS,1385680,Nov
2024-11-05,El Palacio de los jugos /  Nanos Latin Foods,Invoice,008-04136,Arroz a Granel:Parboiled 50 LB -Bolsa Dos Hermanos.,,10.0,26.75,267.5,3499859.53999999,Bulk Rice,Lisset Limpio -020,Cafeteria,1385681,Nov
2024-11-05,Food Fair Plantation Corp,Invoice,008-04137,Arroz a Granel:Parboiled 50 LB -Bolsa Dos Hermanos.,,55.0,27.75,1526.25,3501385.78999999,Bulk Rice,Keila Alfaro-Visvikis,RETAIL  DSD,1385682,Nov
2024-11-05,Food Fair Plantation Corp,Invoice,008-04137,Arroz Envasado:Parboiled 1kg Bolsa Dos Hermanos.,.,2.0,19.9,39.8,3501425.58999999,Branded Rice,Keila Alfaro-Visvikis,RETAIL  DSD,1385683,Nov
2024-11-05,Food Fair Plantation Corp,Invoice,008-04137,Arroz Envasado:Largo Fino 1kg (Long grain rice) Dos Hermanos,,3.0,17.5,52.5,3501478.08999999,Branded Rice,Keila Alfaro-Visvikis,RETAIL  DSD,1385684,Nov
2024-11-05,Food Fair Plantation Corp,Invoice,008-04137,Arroz Envasado:Largo Fino 1kg (Long grain rice) Dos Hermanos,,1.0,17.5,17.5,3501495.58999999,Branded Rice,Keila Alfaro-Visvikis,RETAIL  DSD,1385685,Nov
2024-11-05,El Palacio de los jugos /  EMMA FOOD CORP,Invoice,008-04138,Arroz a Granel:Parboiled 50 LB -Bolsa Dos Hermanos.,,10.0,26.75,267.5,3501763.08999999,Bulk Rice,Lisset Limpio -020,Cafeteria,1385686,Nov
2024-11-05,Sedanos Supermarkets #29,Credit Memo,008-04192,Varios:Promotional Allowance,5kg parbo,-11.0,40.5,-445.5,3501317.58999999,Branded Rice,Lisset Limpio -020,RETAIL SEDANOS,1385687,Nov
2024-11-05,Sedanos Supermarkets #10,Credit Memo,008-04193,Varios:Promotional Allowance,Rice Snack:Rice Snack Ham Flavored DOS HERMANOS,-1.0,19.9,-19.9,3501297.68999999,Puffed Products,Keila Alfaro-Visvikis,RETAIL SEDANOS,1385688,Nov
2024-11-05,Sedanos Supermarkets #8,Credit Memo,008-04194,Varios:Promotional Allowance,Rice Snack:Rice Snack Ham Flavored DOS HERMANOS,-1.0,19.9,-19.9,3501277.78999999,Puffed Products,Keila Alfaro-Visvikis,RETAIL SEDANOS,1385689,Nov
2024-11-05,Sedanos Supermarkets #8,Credit Memo,008-04194,Varios:Promotional Allowance,Arroz Envasado:Parboiled 5KG Dos Hermanos.,-1.0,40.5,-40.5,3501237.28999999,Branded Rice,Keila Alfaro-Visvikis,RETAIL SEDANOS,1385690,Nov
2024-11-05,Sedanos Supermarkets #16,Credit Memo,008-04195,Varios:Promotional Allowance,Rice Snack:Rice Snack Salami Flavored DOS HERMANOS,-1.0,19.9,-19.9,3501217.38999999,Puffed Products,Keila Alfaro-Visvikis,RETAIL SEDANOS,1385691,Nov
2024-11-05,Sedanos Supermarkets #9,Credit Memo,008-04196,Varios:Promotional Allowance,Arroz Envasado:Largo Fino 1kg (Long grain rice) Dos Hermanos,-1.0,17.5,-17.5,3501199.88999999,Branded Rice,Keila Alfaro-Visvikis,RETAIL SEDANOS,1385692,Nov
2024-11-05,Sedanos Supermarkets #22,Credit Memo,008-04197,Varios:Promotional Allowance,Rice Snack:Rice Snack Salami Flavored DOS HERMANOS,-1.0,19.9,-19.9,3501179.98999999,Puffed Products,Keila Alfaro-Visvikis,RETAIL SEDANOS,1385693,Nov
2024-11-05,Sedanos Supermarkets #22,Credit Memo,008-04197,Varios:Promotional Allowance,Varios:Exhibidor de pie Good Rice PVC,-1.0,1.0,-1.0,3501178.98999999,,Keila Alfaro-Visvikis,RETAIL SEDANOS,1385694,Nov
2024-11-05,El Palacio de los jugos / Lita Foods Inc.,Credit Memo,008-04198,Varios:Promotional Allowance,Arroz a Granel:Parboiled 50 LB -Bolsa Dos Hermanos.,-1.0,27.75,-27.75,3501151.23999999,Bulk Rice,Lisset Limpio -020,Cafeteria,1385695,Nov
2024-11-05,Food Fair Plantation Corp,Credit Memo,008-04199,Varios:Promotional Allowance,Arroz Envasado:Largo Fino 1kg (Long grain rice) Dos Hermanos,-1.0,17.5,-17.5,3501133.73999999,Branded Rice,Keila Alfaro-Visvikis,RETAIL  DSD,1385696,Nov
2024-11-06,Sedanos Supermarkets #36,Credit Memo,008-04139,Varios:Producto vencido/deteriorado (no impacta en inventario),ajsute saldo,-1.0,30.83,-30.83,3501102.90999999,,Keila Alfaro-Visvikis,RETAIL SEDANOS,1385697,Nov
2024-11-06,Sedanos Supermarkets #20,Credit Memo,008-04140,Varios:Producto vencido/deteriorado (no impacta en inventario),ajuste saldo viejo,-1.0,37.16,-37.16,3501065.74999999,,Keila Alfaro-Visvikis,RETAIL SEDANOS,1385698,Nov
2024-11-07,Total Food supermarket,Invoice,008-04141,Arroz a Granel:Parboiled 50 LB -Bolsa Dos Hermanos.,,10.0,28.25,282.5,3501348.24999999,Bulk Rice,Keila Alfaro-Visvikis,RETAIL  DSD,1385699,Nov
2024-11-07,Sedanos Supermarkets #32,Invoice,008-04142,Arroz a Granel:Parboiled 50 LB -Bolsa Dos Hermanos.,,6.0,28.25,169.5,3501517.74999999,Bulk Rice,Lisset Limpio -020,RETAIL SEDANOS,1385700,Nov
2024-11-07,Sedanos Supermarkets #32,Invoice,008-04142,,Discount,,,-3.39,3501514.35999999,,Lisset Limpio -020,RETAIL SEDANOS,1385701,Nov
2024-11-07,Sedanos Supermarkets #18,Invoice,008-04143,Arroz Envasado:Largo Fino 1kg (Long grain rice) Dos Hermanos,,1.0,17.5,17.5,3501531.85999999,Branded Rice,Lisset Limpio -020,RETAIL SEDANOS,1385702,Nov
2024-11-07,Sedanos Supermarkets #18,Invoice,008-04143,Arroz Envasado:Parboiled 1kg Bolsa Dos Hermanos.,.,1.0,19.9,19.9,3501551.75999999,Branded Rice,Lisset Limpio -020,RETAIL SEDANOS,1385703,Nov
2024-11-07,Sedanos Supermarkets #18,Invoice,008-04143,Arroz a Granel:Parboiled 50 LB -Bolsa Dos Hermanos.,,8.0,28.25,226.0,3501777.75999999,Bulk Rice,Lisset Limpio -020,RETAIL SEDANOS,1385704,Nov
2024-11-07,Sedanos Supermarkets #18,Invoice,008-04143,Rice Snack:Rice Snack Ham Flavored DOS HERMANOS,,1.0,19.9,19.9,3501797.65999998,Puffed Products,Lisset Limpio -020,RETAIL SEDANOS,1385705,Nov
2024-11-07,Sedanos Supermarkets #18,Invoice,008-04143,,Discount,,,-5.67,3501791.98999999,,Lisset Limpio -020,RETAIL SEDANOS,1385706,Nov
2024-11-07,Sedanos Supermarkets #26,Credit Memo,008-04144,Varios:Producto vencido/deteriorado (no impacta en inventario),8 snack salames y 6 pizzas vencidos,-1.0,20.86,-20.86,3501771.12999999,,Keila Alfaro-Visvikis,RETAIL SEDANOS,1385707,Nov
2024-11-07,Sedanos Supermarkets #20,Invoice,008-04145,Arroz Envasado:Largo Fino 1kg (Long grain rice) Dos Hermanos,,2.0,17.5,35.0,3501806.12999999,Branded Rice,Keila Alfaro-Visvikis,RETAIL SEDANOS,1385708,Nov
2024-11-07,Sedanos Supermarkets #20,Invoice,008-04145,Arroz Envasado:Parboiled 1kg Bolsa Dos Hermanos.,.,3.0,19.9,59.7,3501865.82999999,Branded Rice,Keila Alfaro-Visvikis,RETAIL SEDANOS,1385709,Nov
2024-11-07,Sedanos Supermarkets #20,Invoice,008-04145,Rice Snack:Rice Snack Ham Flavored DOS HERMANOS,,1.0,19.9,19.9,3501885.72999999,Puffed Products,Keila Alfaro-Visvikis,RETAIL SEDANOS,1385710,Nov
2024-11-07,Sedanos Supermarkets #20,Invoice,008-04145,Rice Snack:Rice Snack Salami Flavored DOS HERMANOS,,1.0,19.9,19.9,3501905.62999999,Puffed Products,Keila Alfaro-Visvikis,RETAIL SEDANOS,1385711,Nov
2024-11-07,Sedanos Supermarkets #20,Invoice,008-04145,"Rice Snack:Rice Snack, Pizza DH",,1.0,19.9,19.9,3501925.52999999,Puffed Products,Keila Alfaro-Visvikis,RETAIL SEDANOS,1385712,Nov
2024-11-07,Sedanos Supermarkets #20,Invoice,008-04145,Rice Snack:Rice Snack Ham Flavored DOS HERMANOS,,1.0,19.9,19.9,3501945.42999998,Puffed Products,Keila Alfaro-Visvikis,RETAIL SEDANOS,1385713,Nov
2024-11-07,Sedanos Supermarkets #20,Invoice,008-04145,Arroz Envasado:Largo Fino 1kg (Long grain rice) Dos Hermanos,,1.0,17.5,17.5,3501962.92999998,Branded Rice,Keila Alfaro-Visvikis,RETAIL SEDANOS,1385714,Nov
2024-11-07,Sedanos Supermarkets #20,Invoice,008-04145,,Discount,,,-3.09,3501959.83999999,,Keila Alfaro-Visvikis,RETAIL SEDANOS,1385715,Nov
2024-11-07,Sedanos Supermarkets  #37,Invoice,008-04146,Arroz a Granel:Largo Fino 50 LB -Bolsa Dos Hermanos.,,6.0,28.25,169.5,3502129.33999999,Bulk Rice,Lisset Limpio -020,RETAIL SEDANOS,1385716,Nov
2024-11-07,Sedanos Supermarkets  #37,Invoice,008-04146,,Discount,,,-3.39,3502125.94999998,,Lisset Limpio -020,RETAIL SEDANOS,1385717,Nov
2024-11-07,Sedanos Supermarkets #26,Invoice,008-04147,Arroz Envasado:Largo Fino 1kg (Long grain rice) Dos Hermanos,,2.0,17.5,35.0,3502160.94999998,Branded Rice,Keila Alfaro-Visvikis,RETAIL SEDANOS,1385718,Nov
2024-11-07,Sedanos Supermarkets #26,Invoice,008-04147,Arroz Envasado:Parboiled 1kg Bolsa Dos Hermanos.,.,3.0,19.9,59.7,3502220.64999999,Branded Rice,Keila Alfaro-Visvikis,RETAIL SEDANOS,1385719,Nov
2024-11-07,Sedanos Supermarkets #26,Invoice,008-04147,Rice Snack:Rice Snack Ham Flavored DOS HERMANOS,,1.0,19.9,19.9,3502240.54999999,Puffed Products,Keila Alfaro-Visvikis,RETAIL SEDANOS,1385720,Nov
2024-11-07,Sedanos Supermarkets #26,Invoice,008-04147,Rice Snack:Rice Snack Salami Flavored DOS HERMANOS,,1.0,19.9,19.9,3502260.44999998,Puffed Products,Keila Alfaro-Visvikis,RETAIL SEDANOS,1385721,Nov
2024-11-07,Sedanos Supermarkets #26,Invoice,008-04147,"Rice Snack:Rice Snack, Pizza DH",,1.0,19.9,19.9,3502280.34999998,Puffed Products,Keila Alfaro-Visvikis,RETAIL SEDANOS,1385722,Nov
2024-11-07,Sedanos Supermarkets #26,Invoice,008-04147,Arroz Envasado:Largo Fino 1kg (Long grain rice) Dos Hermanos,,1.0,17.5,17.5,3502297.84999998,Branded Rice,Keila Alfaro-Visvikis,RETAIL SEDANOS,1385723,Nov
2024-11-07,Sedanos Supermarkets #26,Invoice,008-04147,Rice Snack:Rice Snack Salami Flavored DOS HERMANOS,,1.0,19.9,19.9,3502317.74999998,Puffed Products,Keila Alfaro-Visvikis,RETAIL SEDANOS,1385724,Nov
2024-11-07,Sedanos Supermarkets #26,Invoice,008-04147,,Discount,,,-3.09,3502314.65999998,,Keila Alfaro-Visvikis,RETAIL SEDANOS,1385725,Nov
2024-11-07,Sedanos Supermarkets #33,Invoice,008-04148,Arroz a Granel:Parboiled 50 LB -Bolsa Dos Hermanos.,,6.0,28.25,169.5,3502484.15999998,Bulk Rice,Keila Alfaro-Visvikis,RETAIL SEDANOS,1385726,Nov
2024-11-07,Sedanos Supermarkets #33,Invoice,008-04148,,Discount,,,-3.39,3502480.76999998,,Keila Alfaro-Visvikis,RETAIL SEDANOS,1385727,Nov
2024-11-07,Sedanos Supermarkets #24,Invoice,008-04149,Arroz a Granel:Parboiled 50 LB -Bolsa Dos Hermanos.,,5.0,28.25,141.25,3502622.01999998,Bulk Rice,Keila Alfaro-Visvikis,RETAIL SEDANOS,1385728,Nov
2024-11-07,Sedanos Supermarkets #24,Invoice,008-04149,,Discount,,,-2.83,3502619.18999998,,Keila Alfaro-Visvikis,RETAIL SEDANOS,1385729,Nov
2024-11-07,El Palacio de los jugos / Delicias Criollas (DIAGO FOOD_MILLER),Invoice,008-04150,Dry Beans:Dry Beans - Black Beans 50,Dry Black Beans 50 lb,1.0,45.7,45.7,3502664.88999998,Dry Beans,Lisset Limpio -020,Cafeteria,1385730,Nov
2024-11-07,El Palacio de los jugos / Delicias Criollas (DIAGO FOOD_MILLER),Invoice,008-04150,Arroz a Granel:Parboiled 50 LB -Bolsa Dos Hermanos.,,11.0,27.75,305.25,3502970.13999998,Bulk Rice,Lisset Limpio -020,Cafeteria,1385731,Nov
2024-11-07,El Palacio de los jugos / Delicias Criollas (DIAGO FOOD_MILLER),Invoice,008-04150,Arroz Envasado:Parboiled 5KG Dos Hermanos.,6 / 11lbs,1.0,46.5,46.5,3503016.63999998,Branded Rice,Lisset Limpio -020,Cafeteria,1385732,Nov
2024-11-07,Sedanos Supermarkets #27,Invoice,008-04151,Arroz a Granel:Parboiled 50 LB -Bolsa Dos Hermanos.,,6.0,28.25,169.5,3503186.13999998,Bulk Rice,Keila Alfaro-Visvikis,RETAIL SEDANOS,1385733,Nov
2024-11-07,Sedanos Supermarkets #27,Invoice,008-04151,,Discount,,,-3.39,3503182.74999998,,Keila Alfaro-Visvikis,RETAIL SEDANOS,1385734,Nov
2024-11-07,Sedanos Supermarkets #43,Invoice,008-04152,Arroz a Granel:Parboiled 50 LB -Bolsa Dos Hermanos.,,5.0,28.25,141.25,3503323.99999998,Bulk Rice,Keila Alfaro-Visvikis,RETAIL SEDANOS,1385735,Nov
2024-11-07,Sedanos Supermarkets #43,Invoice,008-04152,,Discount,,,-2.83,3503321.16999998,,Keila Alfaro-Visvikis,RETAIL SEDANOS,1385736,Nov
2024-11-07,Sedanos Supermarkets #22,Invoice,008-04153,Spices:AS Chicken Base,1 / 30 lb. (box or pail),2.0,39.0,78.0,3503399.16999998,American Spice,Keila Alfaro-Visvikis,RETAIL SEDANOS,1385737,Nov
2024-11-07,Sedanos Supermarkets #22,Invoice,008-04153,Arroz a Granel:Parboiled 50 LB -Bolsa Dos Hermanos.,,5.0,28.25,141.25,3503540.41999998,Bulk Rice,Keila Alfaro-Visvikis,RETAIL SEDANOS,1385738,Nov
2024-11-07,Sedanos Supermarkets #22,Invoice,008-04153,,Discount,,,-4.39,3503536.02999998,,Keila Alfaro-Visvikis,RETAIL SEDANOS,1385739,Nov
2024-11-07,Sedanos Supermarkets #20,Credit Memo,008-04200,Varios:Promotional Allowance,Rice Snack:Rice Snack Ham Flavored DOS HERMANOS,-1.0,19.9,-19.9,3503516.12999998,Puffed Products,Keila Alfaro-Visvikis,RETAIL SEDANOS,1385740,Nov
2024-11-07,Sedanos Supermarkets #20,Credit Memo,008-04200,Varios:Promotional Allowance,largo fino,-1.0,17.5,-17.5,3503498.62999998,Branded Rice,Keila Alfaro-Visvikis,RETAIL SEDANOS,1385741,Nov
2024-11-07,Sedanos Supermarkets #26,Credit Memo,008-04201,Varios:Promotional Allowance,Arroz Envasado:Largo Fino 1kg (Long grain rice) Dos Hermanos,-1.0,17.5,-17.5,3503481.12999998,Branded Rice,Keila Alfaro-Visvikis,RETAIL SEDANOS,1385742,Nov
2024-11-07,Sedanos Supermarkets #26,Credit Memo,008-04201,Varios:Promotional Allowance,Rice Snack:Rice Snack Salami Flavored DOS HERMANOS,-1.0,19.9,-19.9,3503461.22999998,Puffed Products,Keila Alfaro-Visvikis,RETAIL SEDANOS,1385743,Nov
2024-11-07,El Palacio de los jugos / Delicias Criollas (DIAGO FOOD_MILLER),Credit Memo,008-04202,Varios:Promotional Allowance,Invoice 008-04150,-1.0,46.5,-46.5,3503414.72999998,Puffed Products,Lisset Limpio -020,Cafeteria,1385744,Nov
2024-11-08,Soriano Brothers PB,Invoice,008-04154,Arroz a Granel:Parboiled 50 LB -Bolsa Dos Hermanos.,,22.0,27.75,610.5,3504025.22999998,Bulk Rice,Lisset Limpio -020,CAFETERIA y RESTAURANTS,1385745,Nov
2024-11-08,Soriano Brothers PB,Invoice,008-04154,Arroz a Granel:Largo Fino 50 LB -Bolsa Dos Hermanos.,,15.0,27.85,417.75,3504442.97999998,Bulk Rice,Lisset Limpio -020,CAFETERIA y RESTAURANTS,1385746,Nov
2024-11-08,Soriano Brothers PB,Invoice,008-04154,Spices:AS Sazon (for all),1 / 30 lb (box or pail),1.0,59.0,59.0,3504501.97999998,American Spice,Lisset Limpio -020,CAFETERIA y RESTAURANTS,1385747,Nov
2024-11-08,Soriano Brothers PB,Invoice,008-04154,Arroz a Granel:Parboiled 50 LB -Bolsa Dos Hermanos.,,2.0,27.75,55.5,3504557.47999998,Bulk Rice,Lisset Limpio -020,CAFETERIA y RESTAURANTS,1385748,Nov
2024-11-08,El Palacio de los jugos /  Mires Restaurants,Invoice,008-04155,Liquids:AS Marinating Sauce (Mojo),,1.0,18.5,18.5,3504575.97999998,American Spice,Lisset Limpio -020,Cafeteria,1385749,Nov
2024-11-08,El Palacio de los jugos /  Mires Restaurants,Invoice,008-04155,Arroz a Granel:Parboiled 50 LB -Bolsa Dos Hermanos.,,11.0,27.75,305.25,3504881.22999998,Bulk Rice,Lisset Limpio -020,Cafeteria,1385750,Nov
2024-11-08,El Palacio de los jugos /  Mires Restaurants,Invoice,008-04155,Arroz a Granel:Parboiled 50 LB -Bolsa Dos Hermanos.,,1.0,27.75,27.75,3504908.97999998,Bulk Rice,Lisset Limpio -020,Cafeteria,1385751,Nov
2024-11-08,Be Your Will LLC,Invoice,008-04156,Liquids:AS Cooking Wine,4/1 Gl.,1.0,17.5,17.5,3504926.47999998,American Spice,Lisset Limpio -020,CAFETERIA y RESTAURANTS,1385752,Nov
2024-11-08,Be Your Will LLC,Invoice,008-04156,Arroz a Granel:Parboiled 50 LB -Bolsa Dos Hermanos.,,11.0,27.75,305.25,3505231.72999998,Bulk Rice,Lisset Limpio -020,CAFETERIA y RESTAURANTS,1385753,Nov
2024-11-08,Be Your Will LLC,Invoice,008-04156,Arroz a Granel:Largo Fino 50 LB -Bolsa Dos Hermanos.,,8.0,27.85,222.8,3505454.52999998,Bulk Rice,Lisset Limpio -020,CAFETERIA y RESTAURANTS,1385754,Nov
2024-11-08,El Palacio de Los Jugos / Casa mía Food Restaurant inc,Invoice,008-04157,Dry Beans:Dry Beans - Black Beans 50,Dry Black Beans 50 lb,1.0,45.7,45.7,3505500.22999998,Dry Beans,Lisset Limpio -020,Cafeteria,1385755,Nov
2024-11-08,El Palacio de Los Jugos / Casa mía Food Restaurant inc,Invoice,008-04157,Arroz a Granel:Parboiled 50 LB -Bolsa Dos Hermanos.,,11.0,27.75,305.25,3505805.47999998,Bulk Rice,Lisset Limpio -020,Cafeteria,1385756,Nov
2024-11-08,El Palacio de Los Jugos / Casa mía Food Restaurant inc,Invoice,008-04157,Arroz a Granel:Parboiled 50 LB -Bolsa Dos Hermanos.,,1.0,27.75,27.75,3505833.22999998,Bulk Rice,Lisset Limpio -020,Cafeteria,1385757,Nov
2024-11-08,Sedanos Supermarkets #9,Invoice,008-04158,Rice Snack:Rice Snack Ham Flavored DOS HERMANOS,,1.0,19.9,19.9,3505853.12999998,Puffed Products,Keila Alfaro-Visvikis,RETAIL SEDANOS,1385758,Nov
2024-11-08,Sedanos Supermarkets #9,Invoice,008-04158,Rice Snack:Rice Snack Salami Flavored DOS HERMANOS,,1.0,19.9,19.9,3505873.02999998,Puffed Products,Keila Alfaro-Visvikis,RETAIL SEDANOS,1385759,Nov
2024-11-08,Sedanos Supermarkets #9,Invoice,008-04158,"Rice Snack:Rice Snack, Pizza DH",,1.0,19.9,19.9,3505892.92999998,Puffed Products,Keila Alfaro-Visvikis,RETAIL SEDANOS,1385760,Nov
2024-11-08,Sedanos Supermarkets #9,Invoice,008-04158,Rice Snack:Rice Snack Ham Flavored DOS HERMANOS,,1.0,19.9,19.9,3505912.82999998,Puffed Products,Keila Alfaro-Visvikis,RETAIL SEDANOS,1385761,Nov
2024-11-08,Sedanos Supermarkets #9,Invoice,008-04158,,Discount,,,-1.19,3505911.63999998,,Keila Alfaro-Visvikis,RETAIL SEDANOS,1385762,Nov
2024-11-08,Bravo supermarket Coral Way 26 th,Invoice,008-04159,Arroz Envasado:Largo Fino 1kg (Long grain rice) Dos Hermanos,,5.0,17.5,87.5,3505999.13999998,Branded Rice,Keila Alfaro-Visvikis,RETAIL  DSD,1385763,Nov
2024-11-08,Bravo supermarket Coral Way 26 th,Invoice,008-04159,Arroz Envasado:Largo Fino 1kg (Long grain rice) Dos Hermanos,,1.0,17.5,17.5,3506016.63999998,Branded Rice,Keila Alfaro-Visvikis,RETAIL  DSD,1385764,Nov
2024-11-08,Hings Chinese,Invoice,008-04160,Arroz a Granel:Parboiled 50 LB -Bolsa Dos Hermanos.,,5.0,28.25,141.25,3506157.88999998,Bulk Rice,Lisset Limpio -020,CAFETERIA y RESTAURANTS,1385765,Nov
2024-11-08,Sedanos Supermarkets #42,Invoice,008-04161,Arroz a Granel:Largo Fino 50 LB -Bolsa Dos Hermanos.,,6.0,28.85,173.1,3506330.98999998,Bulk Rice,Lisset Limpio -020,RETAIL SEDANOS,1385766,Nov
2024-11-08,Sedanos Supermarkets #42,Invoice,008-04161,,Discount,,,-3.46,3506327.52999998,,Lisset Limpio -020,RETAIL SEDANOS,1385767,Nov
2024-11-08,"El Toro Loco Meat Distribution, LLC",Invoice,008-04162,Dry Beans:Dry Beans - Black Beans 50,Dry Black Beans 50 lb,43.0,45.7,1965.1,3508292.62999998,Dry Beans,Lisset Limpio -020,CAFETERIA y RESTAURANTS,1385768,Nov
2024-11-08,Ideal Food Basket Davie Cafeteria,Invoice,008-04163,Arroz a Granel:Largo Fino 50 LB -Bolsa Dos Hermanos.,,10.0,27.85,278.5,3508571.12999998,Bulk Rice,Keila Alfaro-Visvikis,CAFETERIA y RESTAURANTS,1385769,Nov
2024-11-08,Soriano Brothers PB,Credit Memo,008-04203,Varios:Promotional Allowance,Arroz a Granel:Parboiled 50 LB -Bolsa Dos Hermanos.,-2.0,27.75,-55.5,3508515.62999998,Bulk Rice,Lisset Limpio -020,CAFETERIA y RESTAURANTS,1385770,Nov
2024-11-08,El Palacio de los jugos /  Mires Restaurants,Credit Memo,008-04204,Varios:Promotional Allowance,Arroz a Granel:Parboiled 50 LB -Bolsa Dos Hermanos.,-1.0,27.75,-27.75,3508487.87999998,Bulk Rice,Lisset Limpio -020,Cafeteria,1385771,Nov
2024-11-08,El Palacio de Los Jugos / Casa mía Food Restaurant inc,Credit Memo,008-04205,Varios:Promotional Allowance,Arroz a Granel:Parboiled 50 LB -Bolsa Dos Hermanos.,-1.0,27.75,-27.75,3508460.12999998,Bulk Rice,Lisset Limpio -020,Cafeteria,1385772,Nov
2024-11-08,Sedanos Supermarkets #9,Credit Memo,008-04206,Varios:Promotional Allowance,Rice Snack:Rice Snack Ham Flavored DOS HERMANOS,-1.0,19.9,-19.9,3508440.22999998,Puffed Products,Keila Alfaro-Visvikis,RETAIL SEDANOS,1385773,Nov
2024-11-08,Bravo supermarket Coral Way 26 th,Credit Memo,008-04207,Varios:Promotional Allowance,Invoice 008-04159,-1.0,17.5,-17.5,3508422.72999998,Branded Rice,Keila Alfaro-Visvikis,RETAIL  DSD,1385774,Nov
2024-11-11,Fritanga Momotombo,Invoice,008-04164,Arroz a Granel:Largo Fino 50 LB -Bolsa Dos Hermanos.,,6.0,27.85,167.1,3508589.82999998,Bulk Rice,Lisset Limpio -020,CAFETERIA y RESTAURANTS,1385775,Nov
2024-11-11,Bravo   Francisco Diaz,Invoice,008-04165,Liquids:AS Cooking Wine,4/1 Gl.,3.0,17.5,52.5,3508642.32999998,American Spice,Lisset Limpio -020,RETAIL  DSD,1385776,Nov
2024-11-11,Bravo   Francisco Diaz,Invoice,008-04165,Arroz a Granel:Largo Fino 50 LB -Bolsa Dos Hermanos.,,5.0,27.85,139.25,3508781.57999998,Bulk Rice,Lisset Limpio -020,RETAIL  DSD,1385777,Nov
2024-11-11,Bravo   Francisco Diaz,Invoice,008-04165,Liquids:AS White Vinegar,4/1 Gl.,2.0,10.0,20.0,3508801.57999998,American Spice,Lisset Limpio -020,RETAIL  DSD,1385778,Nov
2024-11-11,El Palacio de los jugos / Lita Foods Inc.,Invoice,008-04166,Arroz a Granel:Parboiled 50 LB -Bolsa Dos Hermanos.,,11.0,27.75,305.25,3509106.82999998,Bulk Rice,Lisset Limpio -020,Cafeteria,1385779,Nov
2024-11-11,El Palacio de los jugos / Lita Foods Inc.,Invoice,008-04166,Arroz a Granel:Parboiled 50 LB -Bolsa Dos Hermanos.,,1.0,27.75,27.75,3509134.57999998,Bulk Rice,Lisset Limpio -020,Cafeteria,1385780,Nov
2024-11-11,Mei Chang,Invoice,008-04167,Arroz a Granel:Parboiled 50 LB -Bolsa Dos Hermanos.,,10.0,28.25,282.5,3509417.07999998,Bulk Rice,Lisset Limpio -020,CAFETERIA y RESTAURANTS,1385781,Nov
2024-11-11,El Gallego Supermarket,Invoice,008-04168,Dry Beans:Dry Beans - Black Beans 50,Dry Black Beans 50 lb,1.0,45.7,45.7,3509462.77999999,Dry Beans,Lisset Limpio -020,RETAIL  DSD,1385782,Nov
2024-11-11,El Gallego Supermarket,Invoice,008-04168,Arroz a Granel:Parboiled 50 LB -Bolsa Dos Hermanos.,,5.0,28.25,141.25,3509604.02999999,Bulk Rice,Lisset Limpio -020,RETAIL  DSD,1385783,Nov
2024-11-11,El Palacio de los jugos /  EMMA FOOD CORP,Invoice,008-04169,Arroz a Granel:Parboiled 50 LB -Bolsa Dos Hermanos.,,8.0,26.75,214.0,3509818.02999999,Bulk Rice,Lisset Limpio -020,Cafeteria,1385784,Nov
2024-11-11,Sedanos Supermarkets #38,Invoice,008-04170,Arroz Envasado:Largo Fino 1kg (Long grain rice) Dos Hermanos,,2.0,17.5,35.0,3509853.02999999,Branded Rice,Lisset Limpio -020,RETAIL SEDANOS,1385785,Nov
2024-11-11,Sedanos Supermarkets #38,Invoice,008-04170,Arroz Envasado:Parboiled 5KG Dos Hermanos.,6 / 11lbs,30.0,40.5,1215.0,3511068.02999999,Branded Rice,Lisset Limpio -020,RETAIL SEDANOS,1385786,Nov
2024-11-11,Sedanos Supermarkets #38,Invoice,008-04170,Arroz Envasado:Parboiled 1kg Bolsa Dos Hermanos.,.,3.0,19.9,59.7,3511127.72999999,Branded Rice,Lisset Limpio -020,RETAIL SEDANOS,1385787,Nov
2024-11-11,Sedanos Supermarkets #38,Invoice,008-04170,Arroz Envasado:Largo Fino 1kg (Long grain rice) Dos Hermanos,,1.0,17.5,17.5,3511145.22999999,Branded Rice,Lisset Limpio -020,RETAIL SEDANOS,1385788,Nov
2024-11-11,Sedanos Supermarkets #38,Invoice,008-04170,Arroz Envasado:Parboiled 5KG Dos Hermanos.,6 / 11lbs,11.0,40.5,445.5,3511590.72999999,Branded Rice,Lisset Limpio -020,RETAIL SEDANOS,1385789,Nov
2024-11-11,Sedanos Supermarkets #38,Invoice,008-04170,,Discount,,,-26.19,3511564.53999999,,Lisset Limpio -020,RETAIL SEDANOS,1385790,Nov
2024-11-11,Sedanos Supermarkets #16,Invoice,008-04171,Arroz a Granel:Parboiled 50 LB -Bolsa Dos Hermanos.,,5.0,28.25,141.25,3511705.78999999,Bulk Rice,Keila Alfaro-Visvikis,RETAIL SEDANOS,1385791,Nov
2024-11-11,Sedanos Supermarkets #16,Invoice,008-04171,,Discount,,,-2.83,3511702.95999999,,Keila Alfaro-Visvikis,RETAIL SEDANOS,1385792,Nov
2024-11-11,El Palacio de los jugos /  Nanos Latin Foods,Invoice,008-04172,Arroz a Granel:Parboiled 50 LB -Bolsa Dos Hermanos.,,10.0,26.75,267.5,3511970.45999999,Bulk Rice,Lisset Limpio -020,Cafeteria,1385793,Nov
2024-11-11,El Palacio de los jugos /  Nanos Latin Foods,Invoice,008-04172,Arroz a Granel:Largo Fino 50 LB -Bolsa Dos Hermanos.,,6.0,27.85,167.1,3512137.55999999,Bulk Rice,Lisset Limpio -020,Cafeteria,1385794,Nov
2024-11-11,El Palacio de los jugos / Lita Foods Inc.,Credit Memo,008-04208,Varios:Promotional Allowance,,-1.0,27.75,-27.75,3512109.80999999,Bulk Rice,Lisset Limpio -020,Cafeteria,1385795,Nov
2024-11-11,Sedanos Supermarkets #38,Credit Memo,008-04209,Varios:Promotional Allowance,Arroz Envasado:Largo Fino 1kg (Long grain rice) Dos Hermanos,-1.0,17.5,-17.5,3512092.30999999,Branded Rice,Lisset Limpio -020,RETAIL SEDANOS,1385796,Nov
2024-11-11,Sedanos Supermarkets #38,Credit Memo,008-04209,Varios:Promotional Allowance,Arroz Envasado:Parboiled 5KG Dos Hermanos.,-11.0,40.5,-445.5,3511646.80999999,Branded Rice,Lisset Limpio -020,RETAIL SEDANOS,1385797,Nov
2024-11-12,Albert Deli #2,Invoice,008-04173,Arroz a Granel:Largo Fino 50 LB -Bolsa Dos Hermanos.,,2.0,27.5,55.0,3511701.80999999,Bulk Rice,Keila Alfaro-Visvikis,CAFETERIA y RESTAURANTS,1385798,Nov
2024-11-12,Albert Deli #2,Invoice,008-04173,Arroz a Granel:Parboiled 50 LB -Bolsa Dos Hermanos.,,2.0,28.25,56.5,3511758.30999999,Bulk Rice,Keila Alfaro-Visvikis,CAFETERIA y RESTAURANTS,1385799,Nov
2024-11-12,Albert Deli #2,Invoice,008-04173,Dry Beans:Dry Beans - Small Red Beans 50 lbs.,Small Red Beans 50 lbs,1.0,46.85,46.85,3511805.15999999,Dry Beans,Keila Alfaro-Visvikis,CAFETERIA y RESTAURANTS,1385800,Nov
2024-11-12,ALBERT DELI CORP #1,Invoice,008-04174,Arroz a Granel:Parboiled 50 LB -Bolsa Dos Hermanos.,,4.0,28.25,113.0,3511918.15999999,Bulk Rice,Keila Alfaro-Visvikis,CAFETERIA y RESTAURANTS,1385801,Nov
2024-11-12,ALBERT DELI CORP #1,Invoice,008-04174,Arroz a Granel:Largo Fino 50 LB -Bolsa Dos Hermanos.,,4.0,27.5,110.0,3512028.15999999,Bulk Rice,Keila Alfaro-Visvikis,CAFETERIA y RESTAURANTS,1385802,Nov
2024-11-12,ALBERT DELI CORP #1,Invoice,008-04174,Dry Beans:Dry Beans - Small Red Beans 50 lbs.,Small Red Beans 50 lbs,2.0,46.85,93.7,3512121.85999999,Dry Beans,Keila Alfaro-Visvikis,CAFETERIA y RESTAURANTS,1385803,Nov
2024-11-12,Sedanos Supermarkets #24,Invoice,008-04175,Arroz a Granel:Parboiled 50 LB -Bolsa Dos Hermanos.,,6.0,28.25,169.5,3512291.35999999,Bulk Rice,Keila Alfaro-Visvikis,RETAIL SEDANOS,1385804,Nov
2024-11-12,Sedanos Supermarkets #24,Invoice,008-04175,Rice Snack:Rice Snack Ham Flavored DOS HERMANOS,,1.0,19.9,19.9,3512311.25999999,Puffed Products,Keila Alfaro-Visvikis,RETAIL SEDANOS,1385805,Nov
2024-11-12,Sedanos Supermarkets #24,Invoice,008-04175,,Discount,,,-3.79,3512307.46999999,,Keila Alfaro-Visvikis,RETAIL SEDANOS,1385806,Nov
2024-11-12,Key Food / Holywood,Invoice,008-04176,Arroz Envasado:Largo Fino 1kg (Long grain rice) Dos Hermanos,,10.0,17.5,175.0,3512482.46999999,Branded Rice,Keila Alfaro-Visvikis,RETAIL  DSD,1385807,Nov
2024-11-12,Key Food / Holywood,Invoice,008-04176,Arroz Envasado:Parboiled 5KG Dos Hermanos.,6 / 11lbs,15.0,46.5,697.5,3513179.96999999,Branded Rice,Keila Alfaro-Visvikis,RETAIL  DSD,1385808,Nov
2024-11-12,Key Food / Holywood,Invoice,008-04176,Arroz Envasado:Parboiled 5KG Dos Hermanos.,6 / 11lbs,5.0,46.5,232.5,3513412.46999999,Branded Rice,Keila Alfaro-Visvikis,RETAIL  DSD,1385809,Nov
2024-11-12,Key Food / Holywood,Invoice,008-04176,Arroz Envasado:Largo Fino 1kg (Long grain rice) Dos Hermanos,,2.0,17.5,35.0,3513447.46999999,Branded Rice,Keila Alfaro-Visvikis,RETAIL  DSD,1385810,Nov
2024-11-12,JMN Dely Corp,Invoice,008-04177,Arroz a Granel:Largo Fino 50 LB -Bolsa Dos Hermanos.,,1.0,27.85,27.85,3513475.31999999,Bulk Rice,Keila Alfaro-Visvikis,CAFETERIA y RESTAURANTS,1385811,Nov
2024-11-12,JMN Dely Corp,Invoice,008-04177,Arroz a Granel:Parboiled 50 LB -Bolsa Dos Hermanos.,,3.0,27.75,83.25,3513558.56999999,Bulk Rice,Keila Alfaro-Visvikis,CAFETERIA y RESTAURANTS,1385812,Nov
2024-11-12,Price Choice 5 YNTO Food Corp.,Invoice,008-04178,Rice Snack:Rice Snack Ham Flavored DOS HERMANOS,,1.0,19.9,19.9,3513578.46999999,Puffed Products,Keila Alfaro-Visvikis,RETAIL  DSD,1385813,Nov
2024-11-12,Price Choice 5 YNTO Food Corp.,Invoice,008-04178,Rice Snack:Rice Snack Salami Flavored DOS HERMANOS,,1.0,19.9,19.9,3513598.36999999,Puffed Products,Keila Alfaro-Visvikis,RETAIL  DSD,1385814,Nov
2024-11-12,Price Choice 5 YNTO Food Corp.,Invoice,008-04178,"Rice Snack:Rice Snack, Pizza DH",,1.0,19.9,19.9,3513618.26999999,Puffed Products,Keila Alfaro-Visvikis,RETAIL  DSD,1385815,Nov
2024-11-12,Price Choice 5 YNTO Food Corp.,Invoice,008-04178,Rice Snack:Rice Snack Ham Flavored DOS HERMANOS,,1.0,19.9,19.9,3513638.16999999,Puffed Products,Keila Alfaro-Visvikis,RETAIL  DSD,1385816,Nov
2024-11-12,Key Food / Holywood,Credit Memo,008-04210,Varios:Promotional Allowance,Arroz Envasado:Parboiled 5KG Dos Hermanos.,-5.0,46.5,-232.5,3513405.66999999,Branded Rice,Keila Alfaro-Visvikis,RETAIL  DSD,1385817,Nov
2024-11-12,Key Food / Holywood,Credit Memo,008-04210,Varios:Promotional Allowance,Arroz Envasado:Parboiled 5KG Dos Hermanos.,-2.0,17.5,-35.0,3513370.66999999,Branded Rice,Keila Alfaro-Visvikis,RETAIL  DSD,1385818,Nov
2024-11-12,Sedanos Supermarkets #43,Credit Memo,008-04211,Varios:Producto vencido/deteriorado (no impacta en inventario),Invoice # 008-02085 SALDO VIEJO,-1.0,24.4,-24.4,3513346.26999999,,Keila Alfaro-Visvikis,RETAIL SEDANOS,1385819,Nov
2024-11-12,Price Choice 5 YNTO Food Corp.,Credit Memo,008-04213,Varios:Promotional Allowance,Rice Snack:Rice Snack Ham Flavored DOS HERMANOS,-1.0,19.9,-19.9,3513326.36999999,Puffed Products,Keila Alfaro-Visvikis,RETAIL  DSD,1385820,Nov
2024-11-13,Bravo Oakridge,Invoice,008-04179,Arroz Envasado:Parboiled 5KG Dos Hermanos.,6 / 11lbs,25.0,46.5,1162.5,3514488.86999999,Branded Rice,# Orlando 0024,RETAIL  DSD,1385821,Nov
2024-11-13,Bravo Oakridge,Invoice,008-04179,Arroz a Granel:Parboiled 50 LB -Bolsa Dos Hermanos.,,10.0,27.75,277.5,3514766.36999999,Bulk Rice,# Orlando 0024,RETAIL  DSD,1385822,Nov
2024-11-13,Bravo Oakridge,Invoice,008-04179,Arroz Envasado:Parboiled 1kg Bolsa Dos Hermanos.,.,1.0,19.9,19.9,3514786.26999999,Branded Rice,# Orlando 0024,RETAIL  DSD,1385823,Nov
2024-11-13,Bravo Oakridge,Invoice,008-04179,Arroz Envasado:Largo Fino 1kg (Long grain rice) Dos Hermanos,,1.0,18.0,18.0,3514804.26999999,Branded Rice,# Orlando 0024,RETAIL  DSD,1385824,Nov
2024-11-13,Bravo Oakridge,Invoice,008-04179,Varios:Promotional Allowance,DH Parboiled 6 / 11lbs,25.0,-6.84,-171.0,3514633.26999999,Branded Rice,# Orlando 0024,RETAIL  DSD,1385825,Nov
2024-11-13,Bravo Oakridge,Invoice,008-04179,,Discount,,,-0.9,3514632.36999999,,# Orlando 0024,RETAIL  DSD,1385826,Nov
2024-11-13,Bravo Hiawassee,Invoice,008-04180,Arroz a Granel:Parboiled 50 LB -Bolsa Dos Hermanos.,,10.0,27.75,277.5,3514909.86999999,Bulk Rice,# Orlando 0024,RETAIL  DSD,1385827,Nov
2024-11-13,Bravo Hiawassee,Invoice,008-04180,Arroz Envasado:Parboiled 5KG Dos Hermanos.,6 / 11lbs,25.0,46.5,1162.5,3516072.36999999,Branded Rice,# Orlando 0024,RETAIL  DSD,1385828,Nov
2024-11-13,Bravo Hiawassee,Invoice,008-04180,Arroz Envasado:Largo Fino 1kg (Long grain rice) Dos Hermanos,,1.0,18.0,18.0,3516090.36999999,Branded Rice,# Orlando 0024,RETAIL  DSD,1385829,Nov
2024-11-13,Bravo Hiawassee,Invoice,008-04180,Arroz Envasado:Parboiled 1kg Bolsa Dos Hermanos.,.,1.0,19.9,19.9,3516110.26999999,Branded Rice,# Orlando 0024,RETAIL  DSD,1385830,Nov
2024-11-13,Bravo Hiawassee,Invoice,008-04180,Varios:Promotional Allowance,DH Parboiled 6 / 11lbs,25.0,-6.84,-171.0,3515939.26999999,,# Orlando 0024,RETAIL  DSD,1385831,Nov
2024-11-13,"El Toro Loco Meat Distribution, LLC",Invoice,008-04181,Arroz a Granel:Largo Fino 50 LB -Bolsa Dos Hermanos.,,55.0,27.85,1531.75,3517471.01999999,Bulk Rice,Lisset Limpio -020,CAFETERIA y RESTAURANTS,1385832,Nov
2024-11-13,Sedanos Supermarkets #16,Invoice,008-04182,Arroz a Granel:Parboiled 50 LB -Bolsa Dos Hermanos.,,4.0,28.25,113.0,3517584.01999999,Bulk Rice,Keila Alfaro-Visvikis,RETAIL SEDANOS,1385833,Nov
2024-11-13,Sedanos Supermarkets #16,Invoice,008-04182,,Discount,,,-2.26,3517581.75999999,,Keila Alfaro-Visvikis,RETAIL SEDANOS,1385834,Nov
2024-11-13,Sedanos Supermarkets  #11,Invoice,008-04183,Arroz Envasado:Largo Fino 1kg (Long grain rice) Dos Hermanos,,0.0,,0.0,3517581.75999999,Branded Rice,Keila Alfaro-Visvikis,RETAIL SEDANOS,1385835,Nov
2024-11-13,Sedanos Supermarkets  #11,Invoice,008-04183,Arroz Envasado:Parboiled 1kg Bolsa Dos Hermanos.,.,0.0,,0.0,3517581.75999999,Branded Rice,Keila Alfaro-Visvikis,RETAIL SEDANOS,1385836,Nov
2024-11-13,Sedanos Supermarkets  #11,Invoice,008-04183,Rice Snack:Rice Snack Ham Flavored DOS HERMANOS,,0.0,,0.0,3517581.75999999,Puffed Products,Keila Alfaro-Visvikis,RETAIL SEDANOS,1385837,Nov
2024-11-13,Sedanos Supermarkets  #11,Invoice,008-04183,Rice Snack:Rice Snack Salami Flavored DOS HERMANOS,,0.0,,0.0,3517581.75999999,Puffed Products,Keila Alfaro-Visvikis,RETAIL SEDANOS,1385838,Nov
2024-11-13,Sedanos Supermarkets  #11,Invoice,008-04183,"Rice Snack:Rice Snack, Pizza DH",,0.0,,0.0,3517581.75999999,Puffed Products,Keila Alfaro-Visvikis,RETAIL SEDANOS,1385839,Nov
2024-11-13,Sedanos Supermarkets  #11,Invoice,008-04183,Rice Snack:Rice Snack Ham Flavored DOS HERMANOS,,0.0,,0.0,3517581.75999999,Puffed Products,Keila Alfaro-Visvikis,RETAIL SEDANOS,1385840,Nov
2024-11-13,Sedanos Supermarkets  #11,Invoice,008-04183,Rice Snack:Rice Snack Salami Flavored DOS HERMANOS,,0.0,,0.0,3517581.75999999,Puffed Products,Keila Alfaro-Visvikis,RETAIL SEDANOS,1385841,Nov
2024-11-13,Sedanos Supermarkets  #11,Invoice,008-04183,Varios:Exhibidor de pie Good Rice PVC,i18,0.0,,0.0,3517581.75999999,,Keila Alfaro-Visvikis,RETAIL SEDANOS,1385842,Nov
2024-11-13,Sedanos Supermarkets #23,Invoice,008-04184,Rice Snack:Rice Snack Ham Flavored DOS HERMANOS,,3.0,19.9,59.7,3517641.45999999,Puffed Products,Lisset Limpio -020,RETAIL SEDANOS,1385843,Nov
2024-11-13,Sedanos Supermarkets #23,Invoice,008-04184,,Discount,,,-1.19,3517640.26999999,,Lisset Limpio -020,RETAIL SEDANOS,1385844,Nov
2024-11-13,Sedanos Supermarkets #26,Invoice,008-04185,Arroz a Granel:Parboiled 50 LB -Bolsa Dos Hermanos.,,3.0,28.25,84.75,3517725.01999999,Bulk Rice,Keila Alfaro-Visvikis,RETAIL SEDANOS,1385845,Nov
2024-11-13,Sedanos Supermarkets #26,Invoice,008-04185,Arroz Envasado:Parboiled 5KG Dos Hermanos.,6 / 11lbs,2.0,40.5,81.0,3517806.01999999,Branded Rice,Keila Alfaro-Visvikis,RETAIL SEDANOS,1385846,Nov
2024-11-13,Sedanos Supermarkets #26,Invoice,008-04185,,Discount,,,-3.32,3517802.69999999,,Keila Alfaro-Visvikis,RETAIL SEDANOS,1385847,Nov
2024-11-13,Sedanos Supermarkets #28,Invoice,008-04186,Arroz Envasado:Parboiled 5KG Dos Hermanos.,6 / 11lbs,30.0,40.5,1215.0,3519017.69999999,Branded Rice,Keila Alfaro-Visvikis,RETAIL SEDANOS,1385848,Nov
2024-11-13,Sedanos Supermarkets #28,Invoice,008-04186,Rice Snack:Rice Snack Ham Flavored DOS HERMANOS,,1.0,19.9,19.9,3519037.59999999,Puffed Products,Keila Alfaro-Visvikis,RETAIL SEDANOS,1385849,Nov
2024-11-13,Sedanos Supermarkets #28,Invoice,008-04186,Rice Snack:Rice Snack Salami Flavored DOS HERMANOS,,1.0,19.9,19.9,3519057.49999999,Puffed Products,Keila Alfaro-Visvikis,RETAIL SEDANOS,1385850,Nov
2024-11-13,Sedanos Supermarkets #28,Invoice,008-04186,"Rice Snack:Rice Snack, Pizza DH",,1.0,19.9,19.9,3519077.39999999,Puffed Products,Keila Alfaro-Visvikis,RETAIL SEDANOS,1385851,Nov
2024-11-13,Sedanos Supermarkets #28,Invoice,008-04186,Rice Snack:Rice Snack Ham Flavored DOS HERMANOS,,1.0,19.9,19.9,3519097.29999999,Puffed Products,Keila Alfaro-Visvikis,RETAIL SEDANOS,1385852,Nov
2024-11-13,Sedanos Supermarkets #28,Invoice,008-04186,Arroz Envasado:Parboiled 5KG Dos Hermanos.,6 / 11lbs,11.0,40.5,445.5,3519542.79999999,Branded Rice,Keila Alfaro-Visvikis,RETAIL SEDANOS,1385853,Nov
2024-11-13,Sedanos Supermarkets #28,Invoice,008-04186,,Discount,,,-24.98,3519517.81999999,,Keila Alfaro-Visvikis,RETAIL SEDANOS,1385854,Nov
2024-11-13,Sedanos Supermarkets #33,Invoice,008-04187,Arroz a Granel:Parboiled 50 LB -Bolsa Dos Hermanos.,,4.0,28.25,113.0,3519630.81999999,Bulk Rice,Keila Alfaro-Visvikis,RETAIL SEDANOS,1385855,Nov
2024-11-13,Sedanos Supermarkets #33,Invoice,008-04187,Varios:Exhibidor de pie Good Rice PVC,i18,1.0,0.0,0.0,3519630.81999999,,Keila Alfaro-Visvikis,RETAIL SEDANOS,1385856,Nov
2024-11-13,Sedanos Supermarkets #33,Invoice,008-04187,,Discount,,,-2.26,3519628.55999999,,Keila Alfaro-Visvikis,RETAIL SEDANOS,1385857,Nov
2024-11-13,Sedanos Supermarkets #36,Invoice,008-04188,Arroz Envasado:Largo Fino 1kg (Long grain rice) Dos Hermanos,,1.0,17.5,17.5,3519646.05999999,Branded Rice,Keila Alfaro-Visvikis,RETAIL SEDANOS,1385858,Nov
2024-11-13,Sedanos Supermarkets #36,Invoice,008-04188,Arroz Envasado:Parboiled 1kg Bolsa Dos Hermanos.,.,1.0,19.9,19.9,3519665.95999999,Branded Rice,Keila Alfaro-Visvikis,RETAIL SEDANOS,1385859,Nov
2024-11-13,Sedanos Supermarkets #36,Invoice,008-04188,,Discount,,,-0.75,3519665.20999999,,Keila Alfaro-Visvikis,RETAIL SEDANOS,1385860,Nov
2024-11-13,JMN Dely Corp,Invoice,008-04189,Dry Beans:Dry Beans - Black Beans 50,Dry Black Beans 50 lb,1.0,45.7,45.7,3519710.90999999,Dry Beans,Keila Alfaro-Visvikis,CAFETERIA y RESTAURANTS,1385861,Nov
2024-11-13,Los Mejores Tamales de Miami,Invoice,008-04190,Arroz a Granel:Parboiled 50 LB -Bolsa Dos Hermanos.,,5.0,28.25,141.25,3519852.15999999,Bulk Rice,Lisset Limpio -020,CAFETERIA y RESTAURANTS,1385862,Nov
2024-11-13,Sedanos Supermarkets #28,Credit Memo,008-04191,Varios:Producto vencido/deteriorado (no impacta en inventario),"Snacks 
11 jamón 
6 salame",-17.0,1.49,-25.33,3519826.82999999,Puffed Products,Keila Alfaro-Visvikis,RETAIL SEDANOS,1385863,Nov
2024-11-13,Sedanos Supermarkets  #11,Credit Memo,008-04214,Varios:Promotional Allowance,snack + exhibidor,-2.0,19.9,-39.8,3519787.02999999,Puffed Products,Keila Alfaro-Visvikis,RETAIL SEDANOS,1385864,Nov
2024-11-13,Sedanos Supermarkets  #11,Credit Memo,008-04214,Varios:Promotional Allowance,,-1.0,1.0,-1.0,3519786.02999999,,Keila Alfaro-Visvikis,RETAIL SEDANOS,1385865,Nov
2024-11-13,Sedanos Supermarkets #28,Credit Memo,008-04215,Varios:Promotional Allowance,5k,-11.0,40.5,-445.5,3519340.52999999,Branded Rice,Keila Alfaro-Visvikis,RETAIL SEDANOS,1385866,Nov
2024-11-13,Sedanos Supermarkets #28,Credit Memo,008-04215,Varios:Promotional Allowance,Rice Snack:Rice Snack Ham Flavored DOS HERMANOS,-1.0,19.9,-19.9,3519320.62999999,Puffed Products,Keila Alfaro-Visvikis,RETAIL SEDANOS,1385867,Nov
2024-11-14,Sedanos Supermarkets  #4,Credit Memo,008-04212,Varios:Producto vencido/deteriorado (no impacta en inventario),SALDOS VIEJOS SEDANOS 4,-1.0,326.48,-326.48,3518994.14999999,,Lisset Limpio -020,RETAIL SEDANOS,1385868,Nov
2024-11-14,ALS Foods,Invoice,008-04216,Liquids:AS Cooking Wine,4/1 Gl.,1.0,17.5,17.5,3519011.64999999,American Spice,Lisset Limpio -020,CAFETERIA y RESTAURANTS,1385869,Nov
2024-11-14,ALS Foods,Invoice,008-04216,Arroz a Granel:Parboiled 50 LB -Bolsa Dos Hermanos.,,11.0,27.75,305.25,3519316.89999999,Bulk Rice,Lisset Limpio -020,CAFETERIA y RESTAURANTS,1385870,Nov
2024-11-14,ALS Foods,Invoice,008-04216,Arroz a Granel:Parboiled 50 LB -Bolsa Dos Hermanos.,,1.0,27.75,27.75,3519344.64999999,Bulk Rice,Lisset Limpio -020,CAFETERIA y RESTAURANTS,1385871,Nov
2024-11-14,El Palacio de los jugos / Lita Foods Inc.,Invoice,008-04217,Dry Beans:Dry Beans - Black Beans 50,Dry Black Beans 50 lb,1.0,45.7,45.7,3519390.34999999,Dry Beans,Lisset Limpio -020,Cafeteria,1385872,Nov
2024-11-14,El Palacio de los jugos / Lita Foods Inc.,Invoice,008-04217,Arroz a Granel:Parboiled 50 LB -Bolsa Dos Hermanos.,,11.0,27.75,305.25,3519695.59999999,Bulk Rice,Lisset Limpio -020,Cafeteria,1385873,Nov
2024-11-14,El Palacio de los jugos / Lita Foods Inc.,Invoice,008-04217,Arroz a Granel:Parboiled 50 LB -Bolsa Dos Hermanos.,,1.0,27.75,27.75,3519723.34999999,Bulk Rice,Lisset Limpio -020,Cafeteria,1385874,Nov
2024-11-14,El Palacio de los jugos / Delicias Criollas (DIAGO FOOD_MILLER),Invoice,008-04218,Dry Beans:Dry Beans - Black Beans 50,Dry Black Beans 50 lb,1.0,45.7,45.7,3519769.04999999,Dry Beans,Lisset Limpio -020,Cafeteria,1385875,Nov
2024-11-14,El Palacio de los jugos / Delicias Criollas (DIAGO FOOD_MILLER),Invoice,008-04218,Arroz a Granel:Parboiled 50 LB -Bolsa Dos Hermanos.,,22.0,27.75,610.5,3520379.54999999,Bulk Rice,Lisset Limpio -020,Cafeteria,1385876,Nov
2024-11-14,El Palacio de los jugos / Delicias Criollas (DIAGO FOOD_MILLER),Invoice,008-04218,Arroz a Granel:Parboiled 50 LB -Bolsa Dos Hermanos.,,2.0,27.75,55.5,3520435.04999999,Bulk Rice,Lisset Limpio -020,Cafeteria,1385877,Nov
2024-11-14,El Palacio de los jugos /  Mires Restaurants,Invoice,008-04219,Liquids:AS Marinating Sauce (Mojo),,1.0,18.5,18.5,3520453.54999999,American Spice,Lisset Limpio -020,Cafeteria,1385878,Nov
2024-11-14,El Palacio de los jugos /  Mires Restaurants,Invoice,008-04219,Arroz a Granel:Parboiled 50 LB -Bolsa Dos Hermanos.,,11.0,27.75,305.25,3520758.79999999,Bulk Rice,Lisset Limpio -020,Cafeteria,1385879,Nov
2024-11-14,El Palacio de los jugos /  Mires Restaurants,Invoice,008-04219,Arroz a Granel:Parboiled 50 LB -Bolsa Dos Hermanos.,,1.0,27.75,27.75,3520786.54999999,Bulk Rice,Lisset Limpio -020,Cafeteria,1385880,Nov
2024-11-14,El Palacio de los jugos /  EMMA FOOD CORP,Invoice,008-04220,Arroz a Granel:Parboiled 50 LB -Bolsa Dos Hermanos.,,8.0,26.75,214.0,3521000.54999999,Bulk Rice,Lisset Limpio -020,Cafeteria,1385881,Nov
2024-11-14,El Palacio de Los Jugos / Casa mía Food Restaurant inc,Invoice,008-04221,Dry Beans:Dry Beans - Black Beans 50,Dry Black Beans 50 lb,1.0,45.7,45.7,3521046.24999999,Dry Beans,Lisset Limpio -020,Cafeteria,1385882,Nov
2024-11-14,El Palacio de Los Jugos / Casa mía Food Restaurant inc,Invoice,008-04221,Arroz a Granel:Parboiled 50 LB -Bolsa Dos Hermanos.,,11.0,27.75,305.25,3521351.49999999,Bulk Rice,Lisset Limpio -020,Cafeteria,1385883,Nov
2024-11-14,El Palacio de Los Jugos / Casa mía Food Restaurant inc,Invoice,008-04221,Arroz a Granel:Parboiled 50 LB -Bolsa Dos Hermanos.,,1.0,27.75,27.75,3521379.24999999,Bulk Rice,Lisset Limpio -020,Cafeteria,1385884,Nov
2024-11-14,El Palacio de los jugos /  Nanos Latin Foods,Invoice,008-04222,Arroz a Granel:Largo Fino 50 LB -Bolsa Dos Hermanos.,,10.0,26.75,267.5,3521646.74999999,Bulk Rice,Lisset Limpio -020,Cafeteria,1385885,Nov
2024-11-14,Los Caringas Latin America  Foods,Invoice,008-04223,Arroz a Granel:Largo Fino 50 LB -Bolsa Dos Hermanos.,,3.0,27.85,83.55,3521730.29999999,Bulk Rice,Lisset Limpio -020,CAFETERIA y RESTAURANTS,1385886,Nov
2024-11-14,Los Caringas Latin America  Foods,Invoice,008-04223,Arroz a Granel:Parboiled 50 LB -Bolsa Dos Hermanos.,,3.0,28.25,84.75,3521815.04999999,Bulk Rice,Lisset Limpio -020,CAFETERIA y RESTAURANTS,1385887,Nov
2024-11-14,Sedanos Supermarkets #32,Invoice,008-04224,Rice Snack:Rice Snack Ham Flavored DOS HERMANOS,,2.0,19.9,39.8,3521854.84999999,Puffed Products,Lisset Limpio -020,RETAIL SEDANOS,1385888,Nov
2024-11-14,Sedanos Supermarkets #32,Invoice,008-04224,,Discount,,,-0.8,3521854.04999999,,Lisset Limpio -020,RETAIL SEDANOS,1385889,Nov
2024-11-14,Sabor Tropical Supermarket #2,Invoice,008-04225,Arroz Envasado:Largo Fino 1kg (Long grain rice) Dos Hermanos,,1.0,17.5,17.5,3521871.54999999,Branded Rice,Keila Alfaro-Visvikis,RETAIL  DSD,1385890,Nov
2024-11-14,Sabor Tropical Supermarket #2,Invoice,008-04225,Arroz Envasado:Parboiled 1kg Bolsa Dos Hermanos.,.,1.0,19.9,19.9,3521891.44999999,Branded Rice,Keila Alfaro-Visvikis,RETAIL  DSD,1385891,Nov
2024-11-14,Sabor Tropical Supermarket #2,Invoice,008-04225,Arroz Envasado:Largo Fino 1kg (Long grain rice) Dos Hermanos,,1.0,17.5,17.5,3521908.94999999,Branded Rice,Keila Alfaro-Visvikis,RETAIL  DSD,1385892,Nov
2024-11-14,Sabor Tropical Supermarket #2,Invoice,008-04225,Arroz Envasado:Parboiled 1kg Bolsa Dos Hermanos.,.,1.0,19.0,19.0,3521927.94999999,Branded Rice,Keila Alfaro-Visvikis,RETAIL  DSD,1385893,Nov
2024-11-14,Sedanos Supermarkets #31,Invoice,008-04226,Arroz a Granel:Parboiled 50 LB -Bolsa Dos Hermanos.,,4.0,28.25,113.0,3522040.94999999,Bulk Rice,Lisset Limpio -020,RETAIL SEDANOS,1385894,Nov
2024-11-14,Sedanos Supermarkets #31,Invoice,008-04226,,Discount,,,-2.26,3522038.68999999,,Lisset Limpio -020,RETAIL SEDANOS,1385895,Nov
2024-11-14,ALS Foods,Credit Memo,008-04311,Varios:Promotional Allowance,parbo,-1.0,27.75,-27.75,3522010.93999999,Bulk Rice,Lisset Limpio -020,CAFETERIA y RESTAURANTS,1385896,Nov
2024-11-15,Sabor Tropical Supermarket #7,Invoice,008-04227,Rice Snack:Rice Snack Ham Flavored DOS HERMANOS,,1.0,19.9,19.9,3522030.83999999,Puffed Products,Keila Alfaro-Visvikis,RETAIL  DSD,1385897,Nov
2024-11-15,Sabor Tropical Supermarket #7,Invoice,008-04227,Rice Snack:Rice Snack Salami Flavored DOS HERMANOS,,1.0,19.9,19.9,3522050.73999999,Puffed Products,Keila Alfaro-Visvikis,RETAIL  DSD,1385898,Nov
2024-11-15,Sabor Tropical Supermarket #7,Invoice,008-04227,"Rice Snack:Rice Snack, Pizza DH",,1.0,19.9,19.9,3522070.63999999,Puffed Products,Keila Alfaro-Visvikis,RETAIL  DSD,1385899,Nov
2024-11-15,Sabor Tropical Supermarket #7,Invoice,008-04227,Rice Snack:Rice Snack Ham Flavored DOS HERMANOS,,1.0,19.9,19.9,3522090.53999999,Puffed Products,Keila Alfaro-Visvikis,RETAIL  DSD,1385900,Nov
2024-11-15,Ideal Food Basket Davie Cafeteria,Invoice,008-04228,Arroz a Granel:Largo Fino 50 LB -Bolsa Dos Hermanos.,,12.0,27.85,334.2,3522424.73999999,Bulk Rice,Keila Alfaro-Visvikis,CAFETERIA y RESTAURANTS,1385901,Nov
2024-11-15,Aries Supermarket & Cafeteria,Invoice,008-04229,Arroz a Granel:Parboiled 50 LB -Bolsa Dos Hermanos.,,10.0,28.25,282.5,3522707.23999999,Bulk Rice,Keila Alfaro-Visvikis,CAFETERIA y RESTAURANTS,1385902,Nov
2024-11-15,ALS Foods,Invoice,008-04230,Arroz a Granel:Largo Fino 50 LB -Bolsa Dos Hermanos.,,10.0,27.85,278.5,3522985.73999999,Bulk Rice,Lisset Limpio -020,CAFETERIA y RESTAURANTS,1385903,Nov
2024-11-15,El Palacio de los jugos / Lita Foods Inc.,Credit Memo,008-04312,Varios:Promotional Allowance,parbo 50lb,-1.0,27.75,-27.75,3522957.98999999,Bulk Rice,Lisset Limpio -020,Cafeteria,1385904,Nov
2024-11-15,El Palacio de los jugos / Delicias Criollas (DIAGO FOOD_MILLER),Credit Memo,008-04313,Varios:Promotional Allowance,parbo 5lb,-2.0,27.75,-55.5,3522902.48999999,Bulk Rice,Lisset Limpio -020,Cafeteria,1385905,Nov
2024-11-15,El Palacio de los jugos /  Mires Restaurants,Credit Memo,008-04314,Varios:Promotional Allowance,50lb parbo,-1.0,27.75,-27.75,3522874.73999999,Bulk Rice,Lisset Limpio -020,Cafeteria,1385906,Nov
2024-11-15,El Palacio de Los Jugos / Casa mía Food Restaurant inc,Credit Memo,008-04315,Varios:Promotional Allowance,parbo50lb,-1.0,27.75,-27.75,3522846.98999999,Bulk Rice,Lisset Limpio -020,Cafeteria,1385907,Nov
2024-11-15,Sabor Tropical Supermarket #2,Credit Memo,008-04316,Varios:Promotional Allowance,Arroz Envasado:Largo Fino 1kg (Long grain rice) Dos Hermanos,-1.0,17.5,-17.5,3522829.48999999,Branded Rice,Keila Alfaro-Visvikis,RETAIL  DSD,1385908,Nov
2024-11-15,Sabor Tropical Supermarket #2,Credit Memo,008-04316,Varios:Promotional Allowance,Arroz Envasado:Parboiled 1kg Bolsa Dos Hermanos.,-1.0,19.0,-19.0,3522810.48999999,Branded Rice,Keila Alfaro-Visvikis,RETAIL  DSD,1385909,Nov
2024-11-15,Sabor Tropical Supermarket #7,Credit Memo,008-04317,Varios:Promotional Allowance,Rice Snack:Rice Snack Ham Flavored DOS HERMANOS,-1.0,19.9,-19.9,3522790.58999999,Puffed Products,Keila Alfaro-Visvikis,RETAIL  DSD,1385910,Nov
2024-11-18,El Palacio de los jugos /  Nanos Latin Foods,Invoice,008-04231,Arroz a Granel:Parboiled 50 LB -Bolsa Dos Hermanos.,,10.0,26.75,267.5,3523058.08999999,Bulk Rice,Lisset Limpio -020,Cafeteria,1385911,Nov
2024-11-18,El Palacio de los jugos / Lita Foods Inc.,Invoice,008-04232,Arroz a Granel:Parboiled 50 LB -Bolsa Dos Hermanos.,,11.0,27.75,305.25,3523363.33999999,Bulk Rice,Lisset Limpio -020,Cafeteria,1385912,Nov
2024-11-18,El Palacio de los jugos / Lita Foods Inc.,Invoice,008-04232,Dry Beans:Dry Beans - Black Beans 50,Dry Black Beans 50 lb,1.0,45.7,45.7,3523409.03999999,Dry Beans,Lisset Limpio -020,Cafeteria,1385913,Nov
2024-11-18,El Palacio de los jugos / Lita Foods Inc.,Invoice,008-04232,Arroz a Granel:Parboiled 50 LB -Bolsa Dos Hermanos.,,1.0,28.25,28.25,3523437.28999999,Bulk Rice,Lisset Limpio -020,Cafeteria,1385914,Nov
2024-11-18,El Palacio de los jugos / Caribe Tropical,Invoice,008-04233,Arroz a Granel:Largo Fino 50 LB -Bolsa Dos Hermanos.,,4.0,27.85,111.4,3523548.68999999,Bulk Rice,Lisset Limpio -020,Cafeteria,1385915,Nov
2024-11-18,El Palacio de los jugos / Caribe Tropical,Invoice,008-04233,Arroz a Granel:Parboiled 50 LB -Bolsa Dos Hermanos.,,10.0,26.75,267.5,3523816.18999999,Bulk Rice,Lisset Limpio -020,Cafeteria,1385916,Nov
2024-11-18,El Palacio de los jugos /  EMMA FOOD CORP,Invoice,008-04234,Arroz a Granel:Parboiled 50 LB -Bolsa Dos Hermanos.,,10.0,26.75,267.5,3524083.68999999,Bulk Rice,Lisset Limpio -020,Cafeteria,1385917,Nov
2024-11-18,El Palacio de Los Jugos / Casa mía Food Restaurant inc,Invoice,008-04235,Arroz a Granel:Parboiled 50 LB -Bolsa Dos Hermanos.,,11.0,27.75,305.25,3524388.93999999,Bulk Rice,Lisset Limpio -020,Cafeteria,1385918,Nov
2024-11-18,El Palacio de Los Jugos / Casa mía Food Restaurant inc,Invoice,008-04235,Dry Beans:Dry Beans - Black Beans 50,Dry Black Beans 50 lb,1.0,45.7,45.7,3524434.63999999,Dry Beans,Lisset Limpio -020,Cafeteria,1385919,Nov
2024-11-18,El Palacio de Los Jugos / Casa mía Food Restaurant inc,Invoice,008-04235,Arroz a Granel:Parboiled 50 LB -Bolsa Dos Hermanos.,,1.0,27.75,27.75,3524462.38999999,Bulk Rice,Lisset Limpio -020,Cafeteria,1385920,Nov
2024-11-18,Sorianos Brothers,Invoice,008-04236,Arroz a Granel:Parboiled 50 LB -Bolsa Dos Hermanos.,,55.0,26.75,1471.25,3525933.63999999,Bulk Rice,Lisset Limpio -020,CAFETERIA y RESTAURANTS,1385921,Nov
2024-11-18,Soriano Brothers,Invoice,008-04237,Arroz a Granel:Parboiled 50 LB -Bolsa Dos Hermanos.,,55.0,26.75,1471.25,3527404.88999999,Bulk Rice,Lisset Limpio -020,CAFETERIA y RESTAURANTS,1385922,Nov
2024-11-18,Rey Chavez Distributor Corp,Invoice,008-04238,Arroz a Granel:Parboiled 50 LB -Bolsa Dos Hermanos.,,110.0,28.8,3168.0,3530572.88999999,Bulk Rice,Lisset Limpio -020,WHOLESALER,1385923,Nov
2024-11-18,Bravo   Francisco Diaz,Invoice,008-04239,Liquids:AS Cooking Wine,4/1 Gl.,4.0,17.5,70.0,3530642.88999999,American Spice,Lisset Limpio -020,RETAIL  DSD,1385924,Nov
2024-11-18,Bravo   Francisco Diaz,Invoice,008-04239,Arroz a Granel:Largo Fino 50 LB -Bolsa Dos Hermanos.,,5.0,27.85,139.25,3530782.13999999,Bulk Rice,Lisset Limpio -020,RETAIL  DSD,1385925,Nov
2024-11-18,Bravo   Francisco Diaz,Invoice,008-04239,Liquids:AS Marinating Sauce (Mojo),,2.0,18.5,37.0,3530819.13999999,American Spice,Lisset Limpio -020,RETAIL  DSD,1385926,Nov
2024-11-18,Bravo   Francisco Diaz,Invoice,008-04239,Liquids:AS White Vinegar,4/1 Gl.,2.0,10.0,20.0,3530839.13999999,American Spice,Lisset Limpio -020,RETAIL  DSD,1385927,Nov
2024-11-18,Bravo   Francisco Diaz,Invoice,008-04239,Dry Beans:Dry Beans - Small Red Beans 50 lbs.,Small Red Beans 50 lbs,1.0,46.85,46.85,3530885.98999999,Dry Beans,Lisset Limpio -020,RETAIL  DSD,1385928,Nov
2024-11-18,Bravo   Francisco Diaz,Invoice,008-04239,Liquids:AS Lemon Juice 4/1 Gl,,2.0,14.95,29.9,3530915.88999999,American Spice,Lisset Limpio -020,RETAIL  DSD,1385929,Nov
2024-11-18,Sedanos Supermarkets #22,Invoice,008-04240,Rice Snack:Rice Snack Ham Flavored DOS HERMANOS,,2.0,19.9,39.8,3530955.68999999,Puffed Products,Keila Alfaro-Visvikis,RETAIL SEDANOS,1385930,Nov
2024-11-18,Sedanos Supermarkets #22,Invoice,008-04240,Arroz Envasado:Parboiled 1kg Bolsa Dos Hermanos.,.,1.0,19.9,19.9,3530975.58999999,Branded Rice,Keila Alfaro-Visvikis,RETAIL SEDANOS,1385931,Nov
2024-11-18,Sedanos Supermarkets #22,Invoice,008-04240,Arroz Envasado:Largo Fino 1kg (Long grain rice) Dos Hermanos,,1.0,17.5,17.5,3530993.08999999,Branded Rice,Keila Alfaro-Visvikis,RETAIL SEDANOS,1385932,Nov
2024-11-18,Sedanos Supermarkets #22,Invoice,008-04240,,Discount,,,-1.54,3530991.54999999,,Keila Alfaro-Visvikis,RETAIL SEDANOS,1385933,Nov
2024-11-18,Sedanos Supermarkets #31,Invoice,008-04241,Arroz Envasado:Parboiled 5KG Dos Hermanos.,6 / 11lbs,30.0,40.5,1215.0,3532206.54999999,Branded Rice,Lisset Limpio -020,RETAIL SEDANOS,1385934,Nov
2024-11-18,Sedanos Supermarkets #31,Invoice,008-04241,Rice Snack:Rice Snack Ham Flavored DOS HERMANOS,,1.0,19.9,19.9,3532226.44999999,Puffed Products,Lisset Limpio -020,RETAIL SEDANOS,1385935,Nov
2024-11-18,Sedanos Supermarkets #31,Invoice,008-04241,Rice Snack:Rice Snack Salami Flavored DOS HERMANOS,,1.0,19.9,19.9,3532246.34999999,Puffed Products,Lisset Limpio -020,RETAIL SEDANOS,1385936,Nov
2024-11-18,Sedanos Supermarkets #31,Invoice,008-04241,"Rice Snack:Rice Snack, Pizza DH",,1.0,19.9,19.9,3532266.24999999,Puffed Products,Lisset Limpio -020,RETAIL SEDANOS,1385937,Nov
2024-11-18,Sedanos Supermarkets #31,Invoice,008-04241,Arroz Envasado:Parboiled 1kg Bolsa Dos Hermanos.,.,1.0,19.9,19.9,3532286.14999999,Branded Rice,Lisset Limpio -020,RETAIL SEDANOS,1385938,Nov
2024-11-18,Sedanos Supermarkets #31,Invoice,008-04241,Arroz Envasado:Largo Fino 1kg (Long grain rice) Dos Hermanos,,1.0,17.5,17.5,3532303.64999999,Branded Rice,Lisset Limpio -020,RETAIL SEDANOS,1385939,Nov
2024-11-18,Sedanos Supermarkets #31,Invoice,008-04241,Arroz Envasado:Parboiled 5KG Dos Hermanos.,6 / 11lbs,11.0,40.5,445.5,3532749.14999999,Branded Rice,Lisset Limpio -020,RETAIL SEDANOS,1385940,Nov
2024-11-18,Sedanos Supermarkets #31,Invoice,008-04241,Varios:Exhibidor de pie Good Rice PVC,i18,1.0,0.01,0.01,3532749.15999999,,Lisset Limpio -020,RETAIL SEDANOS,1385941,Nov
2024-11-18,Sedanos Supermarkets #31,Invoice,008-04241,Rice Snack:Rice Snack Ham Flavored DOS HERMANOS,,1.0,19.9,19.9,3532769.05999999,Puffed Products,Lisset Limpio -020,RETAIL SEDANOS,1385942,Nov
2024-11-18,Sedanos Supermarkets #31,Invoice,008-04241,,Discount,,,-26.24,3532742.81999999,,Lisset Limpio -020,RETAIL SEDANOS,1385943,Nov
2024-11-18,"Soriano Brothers Diaz Food Service,Inc",Invoice,008-04242,Dry Beans:Dry Beans - Black Beans 50,Dry Black Beans 50 lb,7.0,45.7,319.9,3533062.71999999,Dry Beans,Lisset Limpio -020,CAFETERIA y RESTAURANTS,1385944,Nov
2024-11-18,"Soriano Brothers Diaz Food Service,Inc",Invoice,008-04242,Dry Beans:Dry Beans - Small Red Beans 50 lbs.,Small Red Beans 50 lbs,4.0,46.85,187.4,3533250.11999999,Dry Beans,Lisset Limpio -020,CAFETERIA y RESTAURANTS,1385945,Nov
2024-11-18,"Soriano Brothers Diaz Food Service,Inc",Invoice,008-04242,Arroz a Granel:Parboiled 50 LB -Bolsa Dos Hermanos.,,44.0,27.75,1221.0,3534471.11999999,Bulk Rice,Lisset Limpio -020,CAFETERIA y RESTAURANTS,1385946,Nov
2024-11-18,"Soriano Brothers Diaz Food Service,Inc",Invoice,008-04242,Arroz a Granel:Parboiled 50 LB -Bolsa Dos Hermanos.,,4.0,27.75,111.0,3534582.11999999,Bulk Rice,Lisset Limpio -020,CAFETERIA y RESTAURANTS,1385947,Nov
2024-11-18,Sedanos Supermarkets #31,Invoice,008-04243,Arroz a Granel:Parboiled 50 LB -Bolsa Dos Hermanos.,,5.0,28.25,141.25,3534723.36999999,Bulk Rice,Lisset Limpio -020,RETAIL SEDANOS,1385948,Nov
2024-11-18,Sedanos Supermarkets #31,Invoice,008-04243,,Discount,,,-2.83,3534720.53999999,,Lisset Limpio -020,RETAIL SEDANOS,1385949,Nov
2024-11-18,Price Choice Food Market # 2,Invoice,008-04244,Arroz Envasado:Parboiled 5KG Dos Hermanos.,6 / 11lbs,15.0,46.5,697.5,3535418.03999999,Branded Rice,Keila Alfaro-Visvikis,RETAIL  DSD,1385950,Nov
2024-11-18,Price Choice Food Market # 2,Invoice,008-04244,Arroz Envasado:Parboiled 5KG Dos Hermanos.,6 / 11lbs,6.0,46.5,279.0,3535697.03999999,Branded Rice,Keila Alfaro-Visvikis,RETAIL  DSD,1385951,Nov
2024-11-18,JMN Dely Corp,Invoice,008-04245,Dry Beans:Dry Beans - Black Beans 50,Dry Black Beans 50 lb,2.0,45.7,91.4,3535788.43999999,Dry Beans,Keila Alfaro-Visvikis,CAFETERIA y RESTAURANTS,1385952,Nov
2024-11-18,JMN Dely Corp,Invoice,008-04245,Arroz a Granel:Parboiled 50 LB -Bolsa Dos Hermanos.,,2.0,28.25,56.5,3535844.93999999,Bulk Rice,Keila Alfaro-Visvikis,CAFETERIA y RESTAURANTS,1385953,Nov
2024-11-18,JMN Dely Corp,Invoice,008-04245,Arroz a Granel:Largo Fino 50 LB -Bolsa Dos Hermanos.,,1.0,27.85,27.85,3535872.78999999,Bulk Rice,Keila Alfaro-Visvikis,CAFETERIA y RESTAURANTS,1385954,Nov
2024-11-18,JMN Dely Corp,Invoice,008-04245,,Discount,,,-0.7,3535872.08999999,,Keila Alfaro-Visvikis,CAFETERIA y RESTAURANTS,1385955,Nov
2024-11-18,El Palacio de Los Jugos / Casa mía Food Restaurant inc,Credit Memo,008-04318,Varios:Promotional Allowance,,-1.0,27.75,-27.75,3535844.33999999,Bulk Rice,Lisset Limpio -020,Cafeteria,1385956,Nov
2024-11-18,Sedanos Supermarkets #31,Credit Memo,008-04319,Varios:Promotional Allowance,Arroz Envasado:Parboiled 5KG Dos Hermanos.,-11.0,40.5,-445.5,3535398.83999999,Branded Rice,Lisset Limpio -020,RETAIL SEDANOS,1385957,Nov
2024-11-18,Sedanos Supermarkets #31,Credit Memo,008-04319,Varios:Promotional Allowance,exhib,-1.0,0.01,-0.01,3535398.82999999,,Lisset Limpio -020,RETAIL SEDANOS,1385958,Nov
2024-11-18,Sedanos Supermarkets #31,Credit Memo,008-04319,Varios:Promotional Allowance,Rice Snack:Rice Snack Ham Flavored DOS HERMANOS,-1.0,19.9,-19.9,3535378.92999999,Puffed Products,Lisset Limpio -020,RETAIL SEDANOS,1385959,Nov
2024-11-18,"Soriano Brothers Diaz Food Service,Inc",Credit Memo,008-04320,Varios:Promotional Allowance,parbo 50lb,-4.0,27.75,-111.0,3535267.92999999,Bulk Rice,Lisset Limpio -020,CAFETERIA y RESTAURANTS,1385960,Nov
2024-11-18,Price Choice Food Market # 2,Credit Memo,008-04321,Varios:Promotional Allowance,5kg,-6.0,46.5,-279.0,3534988.92999999,Branded Rice,Keila Alfaro-Visvikis,RETAIL  DSD,1385961,Nov
2024-11-20,Sedanos Supermarkets #42,Credit Memo,008-04246,Dry Beans:Dry Beans - Black Beans 50,Dry Black Beans 50 lb,-1.0,45.7,-45.7,3534943.22999999,Dry Beans,Lisset Limpio -020,RETAIL SEDANOS,1385962,Nov
2024-11-20,ALBERT DELI CORP #1,Invoice,008-04247,Arroz a Granel:Largo Fino 50 LB -Bolsa Dos Hermanos.,,4.0,27.85,111.4,3535054.62999999,Bulk Rice,Keila Alfaro-Visvikis,CAFETERIA y RESTAURANTS,1385963,Nov
2024-11-20,ALBERT DELI CORP #1,Invoice,008-04247,Arroz a Granel:Parboiled 50 LB -Bolsa Dos Hermanos.,,3.0,28.25,84.75,3535139.37999999,Bulk Rice,Keila Alfaro-Visvikis,CAFETERIA y RESTAURANTS,1385964,Nov
2024-11-20,Sedanos Supermarkets #43,Invoice,008-04248,Arroz a Granel:Parboiled 50 LB -Bolsa Dos Hermanos.,,8.0,28.25,226.0,3535365.37999999,Bulk Rice,Keila Alfaro-Visvikis,RETAIL SEDANOS,1385965,Nov
2024-11-20,Sedanos Supermarkets #43,Invoice,008-04248,,Discount,,,-4.52,3535360.85999999,,Keila Alfaro-Visvikis,RETAIL SEDANOS,1385966,Nov
2024-11-20,Sedanos Supermarkets #42,Invoice,008-04249,Arroz a Granel:Parboiled 50 LB -Bolsa Dos Hermanos.,,5.0,28.25,141.25,3535502.10999999,Bulk Rice,Lisset Limpio -020,RETAIL SEDANOS,1385967,Nov
2024-11-20,Sedanos Supermarkets #42,Invoice,008-04249,,Discount,,,-2.83,3535499.27999999,,Lisset Limpio -020,RETAIL SEDANOS,1385968,Nov
2024-11-20,Sedanos Supermarkets #26,Invoice,008-04250,Arroz a Granel:Parboiled 50 LB -Bolsa Dos Hermanos.,,3.0,28.25,84.75,3535584.02999999,Bulk Rice,Keila Alfaro-Visvikis,RETAIL SEDANOS,1385969,Nov
2024-11-20,Sedanos Supermarkets #26,Invoice,008-04250,,Discount,,,-1.7,3535582.32999998,,Keila Alfaro-Visvikis,RETAIL SEDANOS,1385970,Nov
2024-11-20,Sedanos Supermarkets #16,Invoice,008-04251,Arroz a Granel:Parboiled 50 LB -Bolsa Dos Hermanos.,,4.0,28.25,113.0,3535695.32999998,Bulk Rice,Keila Alfaro-Visvikis,RETAIL SEDANOS,1385971,Nov
2024-11-20,Sedanos Supermarkets #16,Invoice,008-04251,,Discount,,,-2.26,3535693.06999999,,Keila Alfaro-Visvikis,RETAIL SEDANOS,1385972,Nov
2024-11-20,Sedanos Supermarkets #27,Invoice,008-04252,Arroz a Granel:Parboiled 50 LB -Bolsa Dos Hermanos.,,0.0,,0.0,3535693.06999999,Bulk Rice,Keila Alfaro-Visvikis,RETAIL SEDANOS,1385973,Nov
2024-11-20,Sedanos Supermarkets #33,Invoice,008-04253,Arroz a Granel:Parboiled 50 LB -Bolsa Dos Hermanos.,,4.0,28.25,113.0,3535806.06999999,Bulk Rice,Keila Alfaro-Visvikis,RETAIL SEDANOS,1385974,Nov
2024-11-20,Sedanos Supermarkets #33,Invoice,008-04253,,Discount,,,-2.26,3535803.80999999,,Keila Alfaro-Visvikis,RETAIL SEDANOS,1385975,Nov
2024-11-20,Sedanos Supermarkets  #4,Invoice,008-04254,Arroz Envasado:Largo Fino 1kg (Long grain rice) Dos Hermanos,,1.0,17.5,17.5,3535821.30999999,Branded Rice,Lisset Limpio -020,RETAIL SEDANOS,1385976,Nov
2024-11-20,Sedanos Supermarkets  #4,Invoice,008-04254,Arroz Envasado:Parboiled 1kg Bolsa Dos Hermanos.,.,1.0,19.9,19.9,3535841.20999999,Branded Rice,Lisset Limpio -020,RETAIL SEDANOS,1385977,Nov
2024-11-20,Sedanos Supermarkets  #4,Invoice,008-04254,,Discount,,,-0.75,3535840.45999999,,Lisset Limpio -020,RETAIL SEDANOS,1385978,Nov
2024-11-20,Sedanos Supermarkets #5,Credit Memo,008-04255,Varios:Producto vencido/deteriorado (no impacta en inventario),7 unidades pizza,-7.0,1.49,-10.43,3535830.02999999,Puffed Products,Lisset Limpio -020,RETAIL SEDANOS,1385979,Nov
2024-11-20,Sedanos Supermarkets #24,Invoice,008-04256,Arroz a Granel:Parboiled 50 LB -Bolsa Dos Hermanos.,,10.0,28.25,282.5,3536112.52999999,Bulk Rice,Keila Alfaro-Visvikis,RETAIL SEDANOS,1385980,Nov
2024-11-20,Sedanos Supermarkets #24,Invoice,008-04256,,Discount,,,-5.65,3536106.87999999,,Keila Alfaro-Visvikis,RETAIL SEDANOS,1385981,Nov
2024-11-20,Aries Supermarket & Cafeteria,Invoice,008-04257,Arroz a Granel:Parboiled 50 LB -Bolsa Dos Hermanos.,,10.0,28.25,282.5,3536389.37999999,Bulk Rice,Keila Alfaro-Visvikis,CAFETERIA y RESTAURANTS,1385982,Nov
2024-11-20,Aries Supermarket & Cafeteria,Invoice,008-04257,Dry Beans:Dry Beans - Black Beans 50,Dry Black Beans 50 lb,10.0,41.75,417.5,3536806.87999999,Dry Beans,Keila Alfaro-Visvikis,CAFETERIA y RESTAURANTS,1385983,Nov
2024-11-21,Pacifico Chinese Restaurant,Invoice,008-04258,Arroz a Granel:Parboiled 50 LB -Bolsa Dos Hermanos.,,10.0,28.25,282.5,3537089.37999999,Bulk Rice,Lisset Limpio -020,CAFETERIA y RESTAURANTS,1385984,Nov
2024-11-21,El Palacio de los jugos /  EMMA FOOD CORP,Invoice,008-04259,Arroz a Granel:Parboiled 50 LB -Bolsa Dos Hermanos.,,10.0,26.75,267.5,3537356.87999999,Bulk Rice,Lisset Limpio -020,Cafeteria,1385985,Nov
2024-11-21,Be Your Will LLC,Invoice,008-04260,Liquids:AS Cooking Wine,4/1 Gl.,2.0,17.5,35.0,3537391.87999999,American Spice,Lisset Limpio -020,CAFETERIA y RESTAURANTS,1385986,Nov
2024-11-21,Be Your Will LLC,Invoice,008-04260,Arroz a Granel:Largo Fino 50 LB -Bolsa Dos Hermanos.,,8.0,27.85,222.8,3537614.67999998,Bulk Rice,Lisset Limpio -020,CAFETERIA y RESTAURANTS,1385987,Nov
2024-11-21,Be Your Will LLC,Invoice,008-04260,Arroz a Granel:Parboiled 50 LB -Bolsa Dos Hermanos.,,11.0,27.75,305.25,3537919.92999998,Bulk Rice,Lisset Limpio -020,CAFETERIA y RESTAURANTS,1385988,Nov
2024-11-21,Be Your Will LLC,Invoice,008-04260,Arroz a Granel:Parboiled 50 LB -Bolsa Dos Hermanos.,,1.0,28.25,28.25,3537948.17999998,Bulk Rice,Lisset Limpio -020,CAFETERIA y RESTAURANTS,1385989,Nov
2024-11-21,El Palacio de Los Jugos / Casa mía Food Restaurant inc,Invoice,008-04261,Arroz a Granel:Parboiled 50 LB -Bolsa Dos Hermanos.,,11.0,27.75,305.25,3538253.42999998,Bulk Rice,Lisset Limpio -020,Cafeteria,1385990,Nov
2024-11-21,El Palacio de Los Jugos / Casa mía Food Restaurant inc,Invoice,008-04261,Dry Beans:Dry Beans - Black Beans 50,Dry Black Beans 50 lb,1.0,45.7,45.7,3538299.12999999,Dry Beans,Lisset Limpio -020,Cafeteria,1385991,Nov
2024-11-21,El Palacio de Los Jugos / Casa mía Food Restaurant inc,Invoice,008-04261,Arroz a Granel:Parboiled 50 LB -Bolsa Dos Hermanos.,,1.0,27.75,27.75,3538326.87999999,Bulk Rice,Lisset Limpio -020,Cafeteria,1385992,Nov
2024-11-21,Price Choice Food Market # 6,Invoice,008-04262,Arroz a Granel:Parboiled 50 LB -Bolsa Dos Hermanos.,,30.0,28.25,847.5,3539174.37999999,Bulk Rice,Lisset Limpio -020,RETAIL  DSD,1385993,Nov
2024-11-21,Sedanos Supermarkets #5,Invoice,008-04263,Arroz Envasado:Largo Fino 1kg (Long grain rice) Dos Hermanos,,1.0,17.5,17.5,3539191.87999999,Branded Rice,Lisset Limpio -020,RETAIL SEDANOS,1385994,Nov
2024-11-21,Sedanos Supermarkets #5,Invoice,008-04263,Arroz Envasado:Parboiled 1kg Bolsa Dos Hermanos.,.,1.0,19.9,19.9,3539211.77999999,Branded Rice,Lisset Limpio -020,RETAIL SEDANOS,1385995,Nov
2024-11-21,Sedanos Supermarkets #5,Invoice,008-04263,Rice Snack:Rice Snack Ham Flavored DOS HERMANOS,,2.0,19.9,39.8,3539251.57999998,Puffed Products,Lisset Limpio -020,RETAIL SEDANOS,1385996,Nov
2024-11-21,Sedanos Supermarkets #5,Invoice,008-04263,Rice Snack:Rice Snack Salami Flavored DOS HERMANOS,,1.0,19.9,19.9,3539271.47999998,Puffed Products,Lisset Limpio -020,RETAIL SEDANOS,1385997,Nov
2024-11-21,Sedanos Supermarkets #5,Invoice,008-04263,Rice Snack:Rice Snack Ham Flavored DOS HERMANOS,,1.0,19.9,19.9,3539291.37999998,Puffed Products,Lisset Limpio -020,RETAIL SEDANOS,1385998,Nov
2024-11-21,Sedanos Supermarkets #5,Invoice,008-04263,,Discount,,,-7.39,3539283.98999998,,Lisset Limpio -020,RETAIL SEDANOS,1385999,Nov
2024-11-21,Sedanos Supermarkets #18,Invoice,008-04264,Arroz a Granel:Parboiled 50 LB -Bolsa Dos Hermanos.,,15.0,28.25,423.75,3539707.73999998,Bulk Rice,Lisset Limpio -020,RETAIL SEDANOS,1386000,Nov
2024-11-21,Sedanos Supermarkets #18,Invoice,008-04264,,Discount,,,-8.48,3539699.25999998,,Lisset Limpio -020,RETAIL SEDANOS,1386001,Nov
2024-11-21,El Palacio de los jugos / Lita Foods Inc.,Invoice,008-04265,Dry Beans:Dry Beans - Black Beans 50,Dry Black Beans 50 lb,1.0,45.7,45.7,3539744.95999998,Dry Beans,Lisset Limpio -020,Cafeteria,1386002,Nov
2024-11-21,El Palacio de los jugos / Lita Foods Inc.,Invoice,008-04265,Arroz a Granel:Parboiled 50 LB -Bolsa Dos Hermanos.,,11.0,27.75,305.25,3540050.20999998,Bulk Rice,Lisset Limpio -020,Cafeteria,1386003,Nov
2024-11-21,El Palacio de los jugos / Lita Foods Inc.,Invoice,008-04265,Arroz a Granel:Parboiled 50 LB -Bolsa Dos Hermanos.,,1.0,27.75,27.75,3540077.95999998,Bulk Rice,Lisset Limpio -020,Cafeteria,1386004,Nov
2024-11-21,El Palacio de los jugos / Caribe Tropical,Invoice,008-04266,Arroz a Granel:Largo Fino 50 LB -Bolsa Dos Hermanos.,,5.0,27.85,139.25,3540217.20999998,Bulk Rice,Lisset Limpio -020,Cafeteria,1386005,Nov
2024-11-21,El Palacio de los jugos / Caribe Tropical,Invoice,008-04266,Arroz a Granel:Parboiled 50 LB -Bolsa Dos Hermanos.,,15.0,26.75,401.25,3540618.45999998,Bulk Rice,Lisset Limpio -020,Cafeteria,1386006,Nov
2024-11-21,Soriano Brothers PB,Invoice,008-04267,Arroz a Granel:Parboiled 50 LB -Bolsa Dos Hermanos.,,50.0,27.75,1387.5,3542005.95999998,Bulk Rice,Lisset Limpio -020,CAFETERIA y RESTAURANTS,1386007,Nov
2024-11-21,Soriano Brothers PB,Invoice,008-04267,Arroz a Granel:Parboiled 50 LB -Bolsa Dos Hermanos.,,5.0,27.75,138.75,3542144.70999998,Bulk Rice,Lisset Limpio -020,CAFETERIA y RESTAURANTS,1386008,Nov
2024-11-21,Soriano Brothers PB,Invoice,008-04267,Spices:AS Sazon (for all),1 / 30 lb (box or pail),5.0,59.0,295.0,3542439.70999998,American Spice,Lisset Limpio -020,CAFETERIA y RESTAURANTS,1386009,Nov
2024-11-21,El Gallego Supermarket,Invoice,008-04268,Dry Beans:Dry Beans - Black Beans 50,Dry Black Beans 50 lb,2.0,45.7,91.4,3542531.10999998,Dry Beans,Lisset Limpio -020,RETAIL  DSD,1386010,Nov
2024-11-21,El Gallego Supermarket,Invoice,008-04268,Arroz a Granel:Parboiled 50 LB -Bolsa Dos Hermanos.,,7.0,28.25,197.75,3542728.85999998,Bulk Rice,Lisset Limpio -020,RETAIL  DSD,1386011,Nov
2024-11-21,El Palacio de los jugos /  Nanos Latin Foods,Invoice,008-04269,Arroz a Granel:Largo Fino 50 LB -Bolsa Dos Hermanos.,,10.0,27.85,278.5,3543007.35999998,Bulk Rice,Lisset Limpio -020,Cafeteria,1386012,Nov
2024-11-21,El Palacio de los jugos /  Nanos Latin Foods,Invoice,008-04269,Arroz a Granel:Parboiled 50 LB -Bolsa Dos Hermanos.,,10.0,26.75,267.5,3543274.85999998,Bulk Rice,Lisset Limpio -020,Cafeteria,1386013,Nov
2024-11-21,El Palacio de Los Jugos / Casa mía Food Restaurant inc,Credit Memo,008-04322,Varios:Promotional Allowance,parbo 50,-1.0,27.75,-27.75,3543247.10999998,Bulk Rice,Lisset Limpio -020,Cafeteria,1386014,Nov
2024-11-21,Sedanos Supermarkets #5,Credit Memo,008-04323,Varios:Promotional Allowance,Rice Snack:Rice Snack Ham Flavored DOS HERMANOS,-1.0,19.9,-19.9,3543227.20999998,Puffed Products,Lisset Limpio -020,RETAIL SEDANOS,1386015,Nov
2024-11-21,El Palacio de los jugos / Lita Foods Inc.,Credit Memo,008-04324,Varios:Promotional Allowance,Arroz a Granel:Parboiled 50 LB -Bolsa Dos Hermanos.,-1.0,27.75,-27.75,3543199.45999998,Bulk Rice,Lisset Limpio -020,Cafeteria,1386016,Nov
2024-11-21,Soriano Brothers PB,Credit Memo,008-04325,Varios:Promotional Allowance,Soriano Brothers PB,-5.0,27.75,-138.75,3543060.70999998,Bulk Rice,Lisset Limpio -020,CAFETERIA y RESTAURANTS,1386017,Nov
2024-11-22,Sedanos Supermarkets #36,Credit Memo,008-04270,Varios:Producto vencido/deteriorado (no impacta en inventario),FUERA DE FECHA CREDITO-,-1.0,11.94,-11.94,3543048.76999998,Puffed Products,Keila Alfaro-Visvikis,RETAIL SEDANOS,1386018,Nov
2024-11-22,Sedanos Supermarkets #36,Credit Memo,008-04270,,Discount,,,0.24,3543049.00999999,,Keila Alfaro-Visvikis,RETAIL SEDANOS,1386019,Nov
2024-11-25,Hings Chinese,Invoice,008-04271,Arroz a Granel:Parboiled 50 LB -Bolsa Dos Hermanos.,,5.0,28.25,141.25,3543190.25999999,Bulk Rice,Lisset Limpio -020,CAFETERIA y RESTAURANTS,1386020,Nov
2024-11-25,Fritanga Momotombo,Invoice,008-04272,Arroz a Granel:Largo Fino 50 LB -Bolsa Dos Hermanos.,,6.0,27.85,167.1,3543357.35999999,Bulk Rice,Lisset Limpio -020,CAFETERIA y RESTAURANTS,1386021,Nov
2024-11-25,El Palacio de los jugos / Delicias Criollas (DIAGO FOOD_MILLER),Invoice,008-04273,Liquids:AS Marinating Sauce (Mojo),,1.0,19.5,19.5,3543376.85999999,American Spice,Lisset Limpio -020,Cafeteria,1386022,Nov
2024-11-25,El Palacio de los jugos / Delicias Criollas (DIAGO FOOD_MILLER),Invoice,008-04273,Arroz a Granel:Parboiled 50 LB -Bolsa Dos Hermanos.,,22.0,27.75,610.5,3543987.35999999,Bulk Rice,Lisset Limpio -020,Cafeteria,1386023,Nov
2024-11-25,El Palacio de los jugos / Delicias Criollas (DIAGO FOOD_MILLER),Invoice,008-04273,Arroz a Granel:Parboiled 50 LB -Bolsa Dos Hermanos.,,2.0,27.75,55.5,3544042.85999999,Bulk Rice,Lisset Limpio -020,Cafeteria,1386024,Nov
2024-11-25,El Palacio de los jugos /  Mires Restaurants,Invoice,008-04274,Arroz a Granel:Parboiled 50 LB -Bolsa Dos Hermanos.,,11.0,27.75,305.25,3544348.10999999,Bulk Rice,Lisset Limpio -020,Cafeteria,1386025,Nov
2024-11-25,El Palacio de los jugos /  Mires Restaurants,Invoice,008-04274,Liquids:AS Marinating Sauce (Mojo),,1.0,18.5,18.5,3544366.60999999,American Spice,Lisset Limpio -020,Cafeteria,1386026,Nov
2024-11-25,El Palacio de los jugos /  Mires Restaurants,Invoice,008-04274,Arroz a Granel:Parboiled 50 LB -Bolsa Dos Hermanos.,,1.0,27.75,27.75,3544394.35999999,Bulk Rice,Lisset Limpio -020,Cafeteria,1386027,Nov
2024-11-25,El Palacio de los jugos / Caribe Tropical,Invoice,008-04275,Arroz a Granel:Largo Fino 50 LB -Bolsa Dos Hermanos.,,6.0,27.85,167.1,3544561.45999999,Bulk Rice,Lisset Limpio -020,Cafeteria,1386028,Nov
2024-11-25,El Palacio de los jugos / Caribe Tropical,Invoice,008-04275,Arroz a Granel:Parboiled 50 LB -Bolsa Dos Hermanos.,,10.0,26.75,267.5,3544828.95999999,Bulk Rice,Lisset Limpio -020,Cafeteria,1386029,Nov
2024-11-25,El Palacio de los jugos /  Nanos Latin Foods,Invoice,008-04276,Arroz a Granel:Parboiled 50 LB -Bolsa Dos Hermanos.,,10.0,26.75,267.5,3545096.45999999,Bulk Rice,Lisset Limpio -020,Cafeteria,1386030,Nov
2024-11-25,El Palacio de los jugos /  Nanos Latin Foods,Invoice,008-04276,Arroz a Granel:Largo Fino 50 LB -Bolsa Dos Hermanos.,,7.0,27.85,194.95,3545291.40999999,Bulk Rice,Lisset Limpio -020,Cafeteria,1386031,Nov
2024-11-25,Bravo   Francisco Diaz,Invoice,008-04277,Arroz a Granel:Largo Fino 50 LB -Bolsa Dos Hermanos.,,7.0,27.85,194.95,3545486.35999999,Bulk Rice,Lisset Limpio -020,RETAIL  DSD,1386032,Nov
2024-11-25,Bravo   Francisco Diaz,Invoice,008-04277,Liquids:AS Cooking Wine,4/1 Gl.,4.0,17.5,70.0,3545556.35999999,American Spice,Lisset Limpio -020,RETAIL  DSD,1386033,Nov
2024-11-25,Bravo   Francisco Diaz,Invoice,008-04277,Liquids:AS White Vinegar,4/1 Gl.,2.0,10.0,20.0,3545576.35999999,American Spice,Lisset Limpio -020,RETAIL  DSD,1386034,Nov
2024-11-25,Bravo   Francisco Diaz,Invoice,008-04277,Liquids:AS Marinating Sauce (Mojo),,2.0,18.5,37.0,3545613.35999999,American Spice,Lisset Limpio -020,RETAIL  DSD,1386035,Nov
2024-11-25,El Palacio de Los Jugos / Casa mía Food Restaurant inc,Invoice,008-04278,Dry Beans:Dry Beans - Black Beans 50,Dry Black Beans 50 lb,1.0,45.7,45.7,3545659.05999999,Dry Beans,Lisset Limpio -020,Cafeteria,1386036,Nov
2024-11-25,El Palacio de Los Jugos / Casa mía Food Restaurant inc,Invoice,008-04278,Arroz a Granel:Parboiled 50 LB -Bolsa Dos Hermanos.,,11.0,27.75,305.25,3545964.30999999,Bulk Rice,Lisset Limpio -020,Cafeteria,1386037,Nov
2024-11-25,El Palacio de Los Jugos / Casa mía Food Restaurant inc,Invoice,008-04278,Arroz a Granel:Parboiled 50 LB -Bolsa Dos Hermanos.,,1.0,27.75,27.75,3545992.05999999,Bulk Rice,Lisset Limpio -020,Cafeteria,1386038,Nov
2024-11-25,Mei Chang,Invoice,008-04279,Arroz a Granel:Parboiled 50 LB -Bolsa Dos Hermanos.,,10.0,28.25,282.5,3546274.55999999,Bulk Rice,Lisset Limpio -020,CAFETERIA y RESTAURANTS,1386039,Nov
2024-11-25,Thrifty Specialty Produce & Meats,Invoice,008-04280,Arroz a Granel:Parboiled 50 LB -Bolsa Dos Hermanos.,,10.0,30.0,300.0,3546574.55999999,Bulk Rice,# Orlando 0024,RETAIL  DSD,1386040,Nov
2024-11-25,Bravo Supermarkets Palm Bay,Invoice,008-04281,Arroz a Granel:Parboiled 50 LB -Bolsa Dos Hermanos.,,10.0,30.0,300.0,3546874.55999999,Bulk Rice,# Orlando 0024,RETAIL  DSD,1386041,Nov
2024-11-25,ALS Foods,Invoice,008-04282,Arroz a Granel:Largo Fino 50 LB -Bolsa Dos Hermanos.,,8.0,27.85,222.8,3547097.35999999,Bulk Rice,Lisset Limpio -020,CAFETERIA y RESTAURANTS,1386042,Nov
2024-11-25,ALS Foods,Invoice,008-04282,Arroz a Granel:Parboiled 50 LB -Bolsa Dos Hermanos.,,22.0,27.75,610.5,3547707.85999999,Bulk Rice,Lisset Limpio -020,CAFETERIA y RESTAURANTS,1386043,Nov
2024-11-25,ALS Foods,Invoice,008-04282,Arroz a Granel:Parboiled 50 LB -Bolsa Dos Hermanos.,,2.0,27.75,55.5,3547763.35999999,Bulk Rice,Lisset Limpio -020,CAFETERIA y RESTAURANTS,1386044,Nov
2024-11-25,El Palacio de los jugos / Lita Foods Inc.,Invoice,008-04283,Dry Beans:Dry Beans - Black Beans 50,Dry Black Beans 50 lb,1.0,45.7,45.7,3547809.05999999,Dry Beans,Lisset Limpio -020,Cafeteria,1386045,Nov
2024-11-25,El Palacio de los jugos / Lita Foods Inc.,Invoice,008-04283,Arroz a Granel:Parboiled 50 LB -Bolsa Dos Hermanos.,,11.0,27.75,305.25,3548114.30999999,Bulk Rice,Lisset Limpio -020,Cafeteria,1386046,Nov
2024-11-25,El Palacio de los jugos / Lita Foods Inc.,Invoice,008-04283,Arroz a Granel:Parboiled 50 LB -Bolsa Dos Hermanos.,,1.0,27.75,27.75,3548142.05999999,Bulk Rice,Lisset Limpio -020,Cafeteria,1386047,Nov
2024-11-25,Sedanos Supermarkets  #11,Invoice,008-04284,Arroz Envasado:Largo Fino 1kg (Long grain rice) Dos Hermanos,,2.0,17.5,35.0,3548177.05999999,Branded Rice,Keila Alfaro-Visvikis,RETAIL SEDANOS,1386048,Nov
2024-11-25,Sedanos Supermarkets  #11,Invoice,008-04284,Arroz Envasado:Parboiled 1kg Bolsa Dos Hermanos.,.,3.0,19.9,59.7,3548236.75999999,Branded Rice,Keila Alfaro-Visvikis,RETAIL SEDANOS,1386049,Nov
2024-11-25,Sedanos Supermarkets  #11,Invoice,008-04284,Rice Snack:Rice Snack Ham Flavored DOS HERMANOS,,2.0,19.9,39.8,3548276.55999999,Puffed Products,Keila Alfaro-Visvikis,RETAIL SEDANOS,1386050,Nov
2024-11-25,Sedanos Supermarkets  #11,Invoice,008-04284,Rice Snack:Rice Snack Salami Flavored DOS HERMANOS,,2.0,19.9,39.8,3548316.35999999,Puffed Products,Keila Alfaro-Visvikis,RETAIL SEDANOS,1386051,Nov
2024-11-25,Sedanos Supermarkets  #11,Invoice,008-04284,"Rice Snack:Rice Snack, Pizza DH",,2.0,19.9,39.8,3548356.15999999,Puffed Products,Keila Alfaro-Visvikis,RETAIL SEDANOS,1386052,Nov
2024-11-25,Sedanos Supermarkets  #11,Invoice,008-04284,Rice Snack:Rice Snack Ham Flavored DOS HERMANOS,,1.0,19.9,19.9,3548376.05999999,Puffed Products,Keila Alfaro-Visvikis,RETAIL SEDANOS,1386053,Nov
2024-11-25,Sedanos Supermarkets  #11,Invoice,008-04284,Rice Snack:Rice Snack Salami Flavored DOS HERMANOS,,1.0,19.9,19.9,3548395.95999999,Puffed Products,Keila Alfaro-Visvikis,RETAIL SEDANOS,1386054,Nov
2024-11-25,Sedanos Supermarkets  #11,Invoice,008-04284,Arroz Envasado:Largo Fino 1kg (Long grain rice) Dos Hermanos,,1.0,17.5,17.5,3548413.45999999,Branded Rice,Keila Alfaro-Visvikis,RETAIL SEDANOS,1386055,Nov
2024-11-25,Sedanos Supermarkets  #11,Invoice,008-04284,,Discount,,,-3.47,3548409.98999999,,Keila Alfaro-Visvikis,RETAIL SEDANOS,1386056,Nov
2024-11-25,JMN Dely Corp,Invoice,008-04285,Arroz a Granel:Largo Fino 50 LB -Bolsa Dos Hermanos.,,2.0,27.85,55.7,3548465.68999999,Bulk Rice,Keila Alfaro-Visvikis,CAFETERIA y RESTAURANTS,1386057,Nov
2024-11-25,JMN Dely Corp,Invoice,008-04285,Dry Beans:Dry Beans - Black Beans 50,Dry Black Beans 50 lb,1.0,45.7,45.7,3548511.38999999,Dry Beans,Keila Alfaro-Visvikis,CAFETERIA y RESTAURANTS,1386058,Nov
2024-11-25,JMN Dely Corp,Invoice,008-04285,Arroz a Granel:Parboiled 50 LB -Bolsa Dos Hermanos.,,2.0,28.25,56.5,3548567.88999999,Bulk Rice,Keila Alfaro-Visvikis,CAFETERIA y RESTAURANTS,1386059,Nov
2024-11-25,Sedanos Supermarkets #43,Invoice,008-04286,Arroz Envasado:Largo Fino 1kg (Long grain rice) Dos Hermanos,,2.0,17.5,35.0,3548602.88999999,Branded Rice,Keila Alfaro-Visvikis,RETAIL SEDANOS,1386060,Nov
2024-11-25,Sedanos Supermarkets #43,Invoice,008-04286,Arroz Envasado:Parboiled 1kg Bolsa Dos Hermanos.,.,3.0,19.9,59.7,3548662.58999999,Branded Rice,Keila Alfaro-Visvikis,RETAIL SEDANOS,1386061,Nov
2024-11-25,Sedanos Supermarkets #43,Invoice,008-04286,Rice Snack:Rice Snack Ham Flavored DOS HERMANOS,,2.0,19.9,39.8,3548702.38999999,Puffed Products,Keila Alfaro-Visvikis,RETAIL SEDANOS,1386062,Nov
2024-11-25,Sedanos Supermarkets #43,Invoice,008-04286,Rice Snack:Rice Snack Salami Flavored DOS HERMANOS,,2.0,19.9,39.8,3548742.18999999,Puffed Products,Keila Alfaro-Visvikis,RETAIL SEDANOS,1386063,Nov
2024-11-25,Sedanos Supermarkets #43,Invoice,008-04286,"Rice Snack:Rice Snack, Pizza DH",,2.0,19.9,39.8,3548781.98999999,Puffed Products,Keila Alfaro-Visvikis,RETAIL SEDANOS,1386064,Nov
2024-11-25,Sedanos Supermarkets #43,Invoice,008-04286,Arroz Envasado:Largo Fino 1kg (Long grain rice) Dos Hermanos,,1.0,17.5,17.5,3548799.48999999,Branded Rice,Keila Alfaro-Visvikis,RETAIL SEDANOS,1386065,Nov
2024-11-25,Sedanos Supermarkets #43,Invoice,008-04286,Rice Snack:Rice Snack Ham Flavored DOS HERMANOS,,1.0,19.9,19.9,3548819.38999998,Puffed Products,Keila Alfaro-Visvikis,RETAIL SEDANOS,1386066,Nov
2024-11-25,Sedanos Supermarkets #43,Invoice,008-04286,Rice Snack:Rice Snack Salami Flavored DOS HERMANOS,,1.0,19.9,19.9,3548839.28999998,Puffed Products,Keila Alfaro-Visvikis,RETAIL SEDANOS,1386067,Nov
2024-11-25,Sedanos Supermarkets #43,Invoice,008-04286,Varios:Exhibidor de pie Good Rice PVC,i18,1.0,0.01,0.01,3548839.29999998,,Keila Alfaro-Visvikis,RETAIL SEDANOS,1386068,Nov
2024-11-25,Sedanos Supermarkets #43,Invoice,008-04286,,Discount,,,-4.28,3548835.01999998,,Keila Alfaro-Visvikis,RETAIL SEDANOS,1386069,Nov
2024-11-25,Sedanos Supermarkets #22,Invoice,008-04287,Arroz a Granel:Parboiled 50 LB -Bolsa Dos Hermanos.,,5.0,28.25,141.25,3548976.26999998,Bulk Rice,Keila Alfaro-Visvikis,RETAIL SEDANOS,1386070,Nov
2024-11-25,Sedanos Supermarkets #22,Invoice,008-04287,Spices:AS Chicken Base,1 / 30 lb. (box or pail),1.0,39.0,39.0,3549015.26999998,American Spice,Keila Alfaro-Visvikis,RETAIL SEDANOS,1386071,Nov
2024-11-25,Sedanos Supermarkets #22,Invoice,008-04287,,Discount,,,-3.61,3549011.65999998,,Keila Alfaro-Visvikis,RETAIL SEDANOS,1386072,Nov
2024-11-25,Sedanos Supermarkets #24,Invoice,008-04288,Arroz a Granel:Parboiled 50 LB -Bolsa Dos Hermanos.,,5.0,28.25,141.25,3549152.90999998,Bulk Rice,Keila Alfaro-Visvikis,RETAIL SEDANOS,1386073,Nov
2024-11-25,Sedanos Supermarkets #24,Invoice,008-04288,,Discount,,,-2.83,3549150.07999998,,Keila Alfaro-Visvikis,RETAIL SEDANOS,1386074,Nov
2024-11-25,Sedanos Supermarkets #34,Invoice,008-04289,Arroz a Granel:Parboiled 50 LB -Bolsa Dos Hermanos.,,16.0,28.25,452.0,3549602.07999998,Bulk Rice,Keila Alfaro-Visvikis,RETAIL SEDANOS,1386075,Nov
2024-11-25,Sedanos Supermarkets #34,Invoice,008-04289,,Discount,,,-9.04,3549593.03999998,,Keila Alfaro-Visvikis,RETAIL SEDANOS,1386076,Nov
2024-11-25,Sedanos Supermarkets #27,Invoice,008-04290,Arroz Envasado:Largo Fino 1kg (Long grain rice) Dos Hermanos,,2.0,17.5,35.0,3549628.03999998,Branded Rice,Keila Alfaro-Visvikis,RETAIL SEDANOS,1386077,Nov
2024-11-25,Sedanos Supermarkets #27,Invoice,008-04290,Arroz Envasado:Parboiled 1kg Bolsa Dos Hermanos.,.,3.0,19.9,59.7,3549687.73999999,Branded Rice,Keila Alfaro-Visvikis,RETAIL SEDANOS,1386078,Nov
2024-11-25,Sedanos Supermarkets #27,Invoice,008-04290,Rice Snack:Rice Snack Ham Flavored DOS HERMANOS,,2.0,19.9,39.8,3549727.53999998,Puffed Products,Keila Alfaro-Visvikis,RETAIL SEDANOS,1386079,Nov
2024-11-25,Sedanos Supermarkets #27,Invoice,008-04290,Rice Snack:Rice Snack Salami Flavored DOS HERMANOS,,2.0,19.9,39.8,3549767.33999998,Puffed Products,Keila Alfaro-Visvikis,RETAIL SEDANOS,1386080,Nov
2024-11-25,Sedanos Supermarkets #27,Invoice,008-04290,"Rice Snack:Rice Snack, Pizza DH",,2.0,19.9,39.8,3549807.13999998,Puffed Products,Keila Alfaro-Visvikis,RETAIL SEDANOS,1386081,Nov
2024-11-25,Sedanos Supermarkets #27,Invoice,008-04290,Arroz Envasado:Largo Fino 1kg (Long grain rice) Dos Hermanos,,1.0,17.5,17.5,3549824.63999998,Branded Rice,Keila Alfaro-Visvikis,RETAIL SEDANOS,1386082,Nov
2024-11-25,Sedanos Supermarkets #27,Invoice,008-04290,Rice Snack:Rice Snack Ham Flavored DOS HERMANOS,,1.0,19.9,19.9,3549844.53999998,Puffed Products,Keila Alfaro-Visvikis,RETAIL SEDANOS,1386083,Nov
2024-11-25,Sedanos Supermarkets #27,Invoice,008-04290,Rice Snack:Rice Snack Salami Flavored DOS HERMANOS,,1.0,19.9,19.9,3549864.43999998,Puffed Products,Keila Alfaro-Visvikis,RETAIL SEDANOS,1386084,Nov
2024-11-25,Sedanos Supermarkets #27,Invoice,008-04290,Varios:Exhibidor de pie Good Rice PVC,i18,1.0,0.1,0.1,3549864.53999998,,Keila Alfaro-Visvikis,RETAIL SEDANOS,1386085,Nov
2024-11-25,Sedanos Supermarkets #27,Invoice,008-04290,,Discount,,,-4.28,3549860.25999998,,Keila Alfaro-Visvikis,RETAIL SEDANOS,1386086,Nov
2024-11-25,Sedanos Supermarkets #27,Invoice,008-04291,Arroz a Granel:Parboiled 50 LB -Bolsa Dos Hermanos.,,10.0,28.25,282.5,3550142.75999998,Bulk Rice,Keila Alfaro-Visvikis,RETAIL SEDANOS,1386087,Nov
2024-11-25,Sedanos Supermarkets #27,Invoice,008-04291,,Discount,,,-5.65,3550137.10999998,,Keila Alfaro-Visvikis,RETAIL SEDANOS,1386088,Nov
2024-11-25,Price Choice 5 YNTO Food Corp.,Invoice,008-04292,Arroz Envasado:Largo Fino 1kg (Long grain rice) Dos Hermanos,,0.0,,0.0,3550137.10999998,Branded Rice,Keila Alfaro-Visvikis,RETAIL  DSD,1386089,Nov
2024-11-25,Price Choice 5 YNTO Food Corp.,Invoice,008-04292,Arroz Envasado:Parboiled 1kg Bolsa Dos Hermanos.,.,0.0,,0.0,3550137.10999998,Branded Rice,Keila Alfaro-Visvikis,RETAIL  DSD,1386090,Nov
2024-11-25,Price Choice 5 YNTO Food Corp.,Invoice,008-04292,Arroz Envasado:Largo Fino 1kg (Long grain rice) Dos Hermanos,,0.0,0.0,0.0,3550137.10999998,Branded Rice,Keila Alfaro-Visvikis,RETAIL  DSD,1386091,Nov
2024-11-25,Price Choice Food Market # 7,Invoice,008-04293,Arroz Envasado:Largo Fino 1kg (Long grain rice) Dos Hermanos,,3.0,17.5,52.5,3550189.60999998,Branded Rice,Keila Alfaro-Visvikis,RETAIL  DSD,1386092,Nov
2024-11-25,Price Choice Food Market # 7,Invoice,008-04293,Arroz Envasado:Parboiled 1kg Bolsa Dos Hermanos.,.,2.0,19.9,39.8,3550229.40999998,Branded Rice,Keila Alfaro-Visvikis,RETAIL  DSD,1386093,Nov
2024-11-25,Price Choice Food Market # 7,Invoice,008-04293,Arroz Envasado:Parboiled 5KG Dos Hermanos.,6 / 11lbs,10.0,46.5,465.0,3550694.40999998,Branded Rice,Keila Alfaro-Visvikis,RETAIL  DSD,1386094,Nov
2024-11-25,Price Choice Food Market # 7,Invoice,008-04293,Arroz Envasado:Parboiled 5KG Dos Hermanos.,6 / 11lbs,5.0,46.5,232.5,3550926.90999998,Branded Rice,Keila Alfaro-Visvikis,RETAIL  DSD,1386095,Nov
2024-11-25,Price Choice Food Market # 7,Invoice,008-04293,Arroz Envasado:Largo Fino 1kg (Long grain rice) Dos Hermanos,,1.0,17.5,17.5,3550944.40999998,Branded Rice,Keila Alfaro-Visvikis,RETAIL  DSD,1386096,Nov
2024-11-25,Mama ‘s Kitchen F.D.CORP,Invoice,008-04294,Arroz a Granel:Parboiled 50 LB -Bolsa Dos Hermanos.,,2.0,28.25,56.5,3551000.90999998,Bulk Rice,Keila Alfaro-Visvikis,CAFETERIA y RESTAURANTS,1386097,Nov
2024-11-25,Mama ‘s Kitchen F.D.CORP,Invoice,008-04294,Spices:AS Chicken Base,1 / 30 lb. (box or pail),1.0,39.0,39.0,3551039.90999998,American Spice,Keila Alfaro-Visvikis,CAFETERIA y RESTAURANTS,1386098,Nov
2024-11-25,ALS Foods,Credit Memo,008-04326,Varios:Promotional Allowance,,-2.0,27.75,-55.5,3550984.40999998,Bulk Rice,Lisset Limpio -020,CAFETERIA y RESTAURANTS,1386099,Nov
2024-11-25,Sedanos Supermarkets #27,Credit Memo,008-04327,Varios:Promotional Allowance,Arroz Envasado:Largo Fino 1kg (Long grain rice) Dos Hermanos,-1.0,17.5,-17.5,3550966.90999998,Branded Rice,Keila Alfaro-Visvikis,RETAIL SEDANOS,1386100,Nov
2024-11-25,Sedanos Supermarkets #27,Credit Memo,008-04327,Varios:Promotional Allowance,Rice Snack:Rice Snack Ham Flavored DOS HERMANOS,-1.0,19.9,-19.9,3550947.00999998,Puffed Products,Keila Alfaro-Visvikis,RETAIL SEDANOS,1386101,Nov
2024-11-25,Sedanos Supermarkets #27,Credit Memo,008-04327,Varios:Promotional Allowance,Rice Snack:Rice Snack Salami Flavored DOS HERMANOS,-1.0,19.9,-19.9,3550927.10999998,Puffed Products,Keila Alfaro-Visvikis,RETAIL SEDANOS,1386102,Nov
2024-11-25,Sedanos Supermarkets #27,Credit Memo,008-04327,Varios:Promotional Allowance,exhibidor,-1.0,0.01,-0.01,3550927.09999998,,Keila Alfaro-Visvikis,RETAIL SEDANOS,1386103,Nov
2024-11-25,El Palacio de los jugos / Lita Foods Inc.,Credit Memo,008-04328,Varios:Promotional Allowance,,-1.0,27.75,-27.75,3550899.34999998,Bulk Rice,Lisset Limpio -020,Cafeteria,1386104,Nov
2024-11-25,Sedanos Supermarkets  #11,Credit Memo,008-04329,Varios:Promotional Allowance,Rice Snack:Rice Snack Ham Flavored DOS HERMANOS,-1.0,19.9,-19.9,3550879.44999998,Puffed Products,Keila Alfaro-Visvikis,RETAIL SEDANOS,1386105,Nov
2024-11-25,Sedanos Supermarkets  #11,Credit Memo,008-04329,Varios:Promotional Allowance,Rice Snack:Rice Snack Salami Flavored DOS HERMANOS,-1.0,19.9,-19.9,3550859.54999999,Puffed Products,Keila Alfaro-Visvikis,RETAIL SEDANOS,1386106,Nov
2024-11-25,Sedanos Supermarkets  #11,Credit Memo,008-04329,Varios:Promotional Allowance,Arroz Envasado:Largo Fino 1kg (Long grain rice) Dos Hermanos,-1.0,17.5,-17.5,3550842.04999999,Branded Rice,Keila Alfaro-Visvikis,RETAIL SEDANOS,1386107,Nov
2024-11-25,El Palacio de los jugos / Delicias Criollas (DIAGO FOOD_MILLER),Credit Memo,008-04330,Varios:Promotional Allowance,,-2.0,27.75,-55.5,3550786.54999999,Bulk Rice,Lisset Limpio -020,Cafeteria,1386108,Nov
2024-11-25,Sedanos Supermarkets #43,Credit Memo,008-04331,Varios:Promotional Allowance,Arroz Envasado:Largo Fino 1kg (Long grain rice) Dos Hermanos,-1.0,17.5,-17.5,3550769.04999999,Branded Rice,Keila Alfaro-Visvikis,RETAIL SEDANOS,1386109,Nov
2024-11-25,Sedanos Supermarkets #43,Credit Memo,008-04331,Varios:Promotional Allowance,ham y salami,-2.0,19.9,-39.8,3550729.24999999,Puffed Products,Keila Alfaro-Visvikis,RETAIL SEDANOS,1386110,Nov
2024-11-25,Sedanos Supermarkets #43,Credit Memo,008-04331,Varios:Promotional Allowance,exhibidor,-1.0,0.01,-0.01,3550729.23999999,,Keila Alfaro-Visvikis,RETAIL SEDANOS,1386111,Nov
2024-11-25,El Palacio de los jugos /  Mires Restaurants,Credit Memo,008-04332,Varios:Promotional Allowance,,-1.0,27.75,-27.75,3550701.48999999,Bulk Rice,Lisset Limpio -020,Cafeteria,1386112,Nov
2024-11-25,El Palacio de Los Jugos / Casa mía Food Restaurant inc,Credit Memo,008-04333,Varios:Promotional Allowance,,-1.0,27.75,-27.75,3550673.73999999,Bulk Rice,Lisset Limpio -020,Cafeteria,1386113,Nov
2024-11-25,Price Choice Food Market # 7,Credit Memo,008-04334,Varios:Promotional Allowance,Arroz Envasado:Parboiled 5KG Dos Hermanos.,-5.0,46.5,-232.5,3550441.23999999,Branded Rice,Keila Alfaro-Visvikis,RETAIL  DSD,1386114,Nov
2024-11-25,Price Choice Food Market # 7,Credit Memo,008-04334,Varios:Promotional Allowance,Arroz Envasado:Largo Fino 1kg (Long grain rice) Dos Hermanos,-1.0,17.5,-17.5,3550423.73999999,Branded Rice,Keila Alfaro-Visvikis,RETAIL  DSD,1386115,Nov
2024-11-26,Sedanos Supermarkets #41,Invoice,008-04295,Arroz Envasado:Parboiled 5KG Dos Hermanos.,6 / 11lbs,20.0,40.5,810.0,3551233.73999999,Branded Rice,Armando Carpio - 017,RETAIL SEDANOS,1386116,Nov
2024-11-26,Sedanos Supermarkets #41,Invoice,008-04295,Arroz Envasado:Parboiled 5KG Dos Hermanos.,6 / 11lbs,20.0,40.5,810.0,3552043.73999999,Branded Rice,Armando Carpio - 017,RETAIL SEDANOS,1386117,Nov
2024-11-26,Sedanos Supermarkets #41,Invoice,008-04295,,Discount,,,-16.2,3552027.53999999,,Armando Carpio - 017,RETAIL SEDANOS,1386118,Nov
2024-11-26,Sedanos Supermarkets #40,Invoice,008-04296,Arroz Envasado:Parboiled 5KG Dos Hermanos.,6 / 11lbs,10.0,40.5,405.0,3552432.53999999,Branded Rice,Armando Carpio - 017,RETAIL SEDANOS,1386119,Nov
2024-11-26,Sedanos Supermarkets #40,Invoice,008-04296,Arroz Envasado:Parboiled 5KG Dos Hermanos.,6 / 11lbs,10.0,40.5,405.0,3552837.53999999,Branded Rice,Armando Carpio - 017,RETAIL SEDANOS,1386120,Nov
2024-11-26,Sedanos Supermarkets #40,Invoice,008-04296,,Discount,,,-8.1,3552829.43999999,,Armando Carpio - 017,RETAIL SEDANOS,1386121,Nov
2024-11-26,Panda Depot,Invoice,008-04297,Arroz a Granel:Largo Fino 50 LB -Bolsa Dos Hermanos.,,110.0,24.5,2695.0,3555524.43999999,Bulk Rice,Lisset Limpio -020,WHOLESALER,1386122,Nov
2024-11-26,Panda Depot,Invoice,008-04297,Arroz a Granel:Parboiled 50 LB -Bolsa Dos Hermanos.,,275.0,25.0,6875.0,3562399.43999999,Bulk Rice,Lisset Limpio -020,WHOLESALER,1386123,Nov
2024-11-26,El Palacio de los jugos / Lita Foods Inc.,Invoice,008-04298,Arroz a Granel:Parboiled 50 LB -Bolsa Dos Hermanos.,,11.0,27.75,305.25,3562704.68999999,Bulk Rice,Lisset Limpio -020,Cafeteria,1386124,Nov
2024-11-26,El Palacio de los jugos / Lita Foods Inc.,Invoice,008-04298,Dry Beans:Dry Beans - Black Beans 50,Dry Black Beans 50 lb,1.0,45.7,45.7,3562750.38999999,Dry Beans,Lisset Limpio -020,Cafeteria,1386125,Nov
2024-11-26,El Palacio de los jugos / Lita Foods Inc.,Invoice,008-04298,Arroz a Granel:Parboiled 50 LB -Bolsa Dos Hermanos.,,1.0,27.75,27.75,3562778.13999999,Bulk Rice,Lisset Limpio -020,Cafeteria,1386126,Nov
2024-11-26,El Palacio de Los Jugos / Casa mía Food Restaurant inc,Invoice,008-04299,Arroz a Granel:Parboiled 50 LB -Bolsa Dos Hermanos.,,11.0,27.75,305.25,3563083.38999999,Bulk Rice,Lisset Limpio -020,Cafeteria,1386127,Nov
2024-11-26,El Palacio de Los Jugos / Casa mía Food Restaurant inc,Invoice,008-04299,Dry Beans:Dry Beans - Black Beans 50,Dry Black Beans 50 lb,1.0,45.7,45.7,3563129.08999999,Dry Beans,Lisset Limpio -020,Cafeteria,1386128,Nov
2024-11-26,El Palacio de Los Jugos / Casa mía Food Restaurant inc,Invoice,008-04299,Arroz a Granel:Parboiled 50 LB -Bolsa Dos Hermanos.,,1.0,27.75,27.75,3563156.83999999,Bulk Rice,Lisset Limpio -020,Cafeteria,1386129,Nov
2024-11-26,Sedanos Supermarkets #26,Invoice,008-04300,Arroz a Granel:Parboiled 50 LB -Bolsa Dos Hermanos.,,3.0,28.25,84.75,3563241.58999999,Bulk Rice,Keila Alfaro-Visvikis,RETAIL SEDANOS,1386130,Nov
2024-11-26,Sedanos Supermarkets #26,Invoice,008-04300,,Discount,,,-1.7,3563239.88999999,,Keila Alfaro-Visvikis,RETAIL SEDANOS,1386131,Nov
2024-11-26,Los Caringas Latin America  Foods,Invoice,008-04301,Arroz a Granel:Largo Fino 50 LB -Bolsa Dos Hermanos.,,3.0,27.85,83.55,3563323.43999999,Bulk Rice,Lisset Limpio -020,CAFETERIA y RESTAURANTS,1386132,Nov
2024-11-26,Los Caringas Latin America  Foods,Invoice,008-04301,Arroz a Granel:Parboiled 50 LB -Bolsa Dos Hermanos.,,3.0,28.25,84.75,3563408.18999999,Bulk Rice,Lisset Limpio -020,CAFETERIA y RESTAURANTS,1386133,Nov
2024-11-26,El Palacio de los jugos / Caribe Tropical,Invoice,008-04302,Arroz a Granel:Largo Fino 50 LB -Bolsa Dos Hermanos.,,5.0,27.85,139.25,3563547.43999999,Bulk Rice,Lisset Limpio -020,Cafeteria,1386134,Nov
2024-11-26,El Palacio de los jugos / Caribe Tropical,Invoice,008-04302,Arroz a Granel:Parboiled 50 LB -Bolsa Dos Hermanos.,,20.0,26.75,535.0,3564082.43999999,Bulk Rice,Lisset Limpio -020,Cafeteria,1386135,Nov
2024-11-26,Los Mejores Tamales de Miami,Invoice,008-04303,Arroz a Granel:Parboiled 50 LB -Bolsa Dos Hermanos.,,7.0,28.25,197.75,3564280.18999999,Bulk Rice,Lisset Limpio -020,CAFETERIA y RESTAURANTS,1386136,Nov
2024-11-26,El Palacio de los jugos /  Nanos Latin Foods,Invoice,008-04304,Arroz a Granel:Largo Fino 50 LB -Bolsa Dos Hermanos.,,10.0,27.85,278.5,3564558.68999999,Bulk Rice,Lisset Limpio -020,Cafeteria,1386137,Nov
2024-11-26,El Palacio de los jugos /  Nanos Latin Foods,Invoice,008-04304,Arroz a Granel:Parboiled 50 LB -Bolsa Dos Hermanos.,,15.0,26.75,401.25,3564959.93999999,Bulk Rice,Lisset Limpio -020,Cafeteria,1386138,Nov
2024-11-26,Rey Chavez Distributor #2,Invoice,008-04305,Arroz a Granel:Parboiled 50 LB -Bolsa Dos Hermanos.,,20.0,28.8,576.0,3565535.93999999,Bulk Rice,Lisset Limpio -020,WHOLESALER,1386139,Nov
2024-11-26,El Palacio de los jugos /  EMMA FOOD CORP,Invoice,008-04306,Arroz a Granel:Largo Fino 50 LB -Bolsa Dos Hermanos.,,8.0,27.85,222.8,3565758.73999999,Bulk Rice,Lisset Limpio -020,Cafeteria,1386140,Nov
2024-11-26,El Palacio de los jugos /  EMMA FOOD CORP,Invoice,008-04306,Arroz a Granel:Parboiled 50 LB -Bolsa Dos Hermanos.,,15.0,26.75,401.25,3566159.98999999,Bulk Rice,Lisset Limpio -020,Cafeteria,1386141,Nov
2024-11-26,Sabor Tropical #1 - Supermarket,Invoice,008-04307,Arroz Envasado:Largo Fino 1kg (Long grain rice) Dos Hermanos,,2.0,17.5,35.0,3566194.98999999,Branded Rice,Keila Alfaro-Visvikis,RETAIL  DSD,1386142,Nov
2024-11-26,Sabor Tropical #1 - Supermarket,Invoice,008-04307,Arroz Envasado:Parboiled 1kg Bolsa Dos Hermanos.,.,3.0,19.9,59.7,3566254.68999999,Branded Rice,Keila Alfaro-Visvikis,RETAIL  DSD,1386143,Nov
2024-11-26,Sabor Tropical #1 - Supermarket,Invoice,008-04307,Arroz Envasado:Largo Fino 1kg (Long grain rice) Dos Hermanos,,1.0,17.5,17.5,3566272.18999999,Branded Rice,Keila Alfaro-Visvikis,RETAIL  DSD,1386144,Nov
2024-11-26,Sabor Tropical #1 - Cafeteria,Invoice,008-04308,Arroz a Granel:Parboiled 50 LB -Bolsa Dos Hermanos.,,10.0,27.75,277.5,3566549.68999999,Bulk Rice,Keila Alfaro-Visvikis,CAFETERIA y RESTAURANTS,1386145,Nov
2024-11-26,Ideal Food Basket Davie Cafeteria,Invoice,008-04309,Arroz a Granel:Largo Fino 50 LB -Bolsa Dos Hermanos.,,15.0,27.85,417.75,3566967.43999999,Bulk Rice,Keila Alfaro-Visvikis,CAFETERIA y RESTAURANTS,1386146,Nov
2024-11-26,Sedanos Supermarkets #41,Credit Memo,008-04335,Varios:Promotional Allowance,5kg,-20.0,40.5,-810.0,3566157.43999999,Branded Rice,Armando Carpio - 017,RETAIL SEDANOS,1386147,Nov
2024-11-26,El Palacio de los jugos / Lita Foods Inc.,Credit Memo,008-04336,Varios:Promotional Allowance,,-1.0,27.75,-27.75,3566129.68999999,Bulk Rice,Lisset Limpio -020,Cafeteria,1386148,Nov
2024-11-26,El Palacio de Los Jugos / Casa mía Food Restaurant inc,Credit Memo,008-04337,Varios:Promotional Allowance,,-1.0,27.75,-27.75,3566101.93999999,Bulk Rice,Lisset Limpio -020,Cafeteria,1386149,Nov
2024-11-26,Sedanos Supermarkets #40,Credit Memo,008-04338,Varios:Promotional Allowance,,-10.0,40.5,-405.0,3565696.93999999,Branded Rice,Armando Carpio - 017,RETAIL SEDANOS,1386150,Nov
2024-11-26,Sabor Tropical #1 - Supermarket,Credit Memo,008-04339,Varios:Promotional Allowance,,-1.0,17.5,-17.5,3565679.43999999,Branded Rice,Keila Alfaro-Visvikis,RETAIL  DSD,1386151,Nov
2024-11-29,"American Spice Trading Co, Inc.",Invoice,008-04310,Arroz a Granel (MWH):Arroz Parboil Bolsa 50LB Dos hermanos (MWH),,1100.0,27.5,30250.0,3595929.43999999,Bulk Rice,Armando Carpio - 017,WHOLESALER MANUFACTURY,1386152,Nov
2024-12-02,El Palacio de los jugos /  Nanos Latin Foods,Invoice,008-04340,Arroz a Granel:Parboiled 50 LB -Bolsa Dos Hermanos.,,12.0,26.75,321.0,3596250.43999999,Bulk Rice,Lisset Limpio -020,Cafeteria,1386153,Dec
2024-12-02,El Palacio de los jugos /  EMMA FOOD CORP,Invoice,008-04341,Arroz a Granel:Parboiled 50 LB -Bolsa Dos Hermanos.,,11.0,26.75,294.25,3596544.68999999,Bulk Rice,Lisset Limpio -020,Cafeteria,1386154,Dec
2024-12-02,Aries Supermarket & Cafeteria,Invoice,008-04342,Arroz a Granel:Parboiled 50 LB -Bolsa Dos Hermanos.,,10.0,28.25,282.5,3596827.18999999,Bulk Rice,Keila Alfaro-Visvikis,CAFETERIA y RESTAURANTS,1386155,Dec
2024-12-02,Sedanos Supermarkets  #11,Invoice,008-04343,Arroz Envasado:Parboiled 5KG Dos Hermanos.,6 / 11lbs,20.0,40.5,810.0,3597637.18999999,Branded Rice,Keila Alfaro-Visvikis,RETAIL SEDANOS,1386156,Dec
2024-12-02,Sedanos Supermarkets  #11,Invoice,008-04343,Arroz Envasado:Parboiled 5KG Dos Hermanos.,6 / 11lbs,20.0,40.5,810.0,3598447.18999999,Branded Rice,Keila Alfaro-Visvikis,RETAIL SEDANOS,1386157,Dec
2024-12-02,Sedanos Supermarkets  #11,Invoice,008-04343,,Discount,,,-16.2,3598430.98999999,,Keila Alfaro-Visvikis,RETAIL SEDANOS,1386158,Dec
2024-12-02,Sedanos Supermarkets #22,Invoice,008-04344,Arroz Envasado:Parboiled 5KG Dos Hermanos.,6 / 11lbs,15.0,40.5,607.5,3599038.48999999,Branded Rice,Keila Alfaro-Visvikis,RETAIL SEDANOS,1386159,Dec
2024-12-02,Sedanos Supermarkets #22,Invoice,008-04344,Arroz Envasado:Parboiled 5KG Dos Hermanos.,6 / 11lbs,15.0,40.5,607.5,3599645.98999999,Branded Rice,Keila Alfaro-Visvikis,RETAIL SEDANOS,1386160,Dec
2024-12-02,Sedanos Supermarkets #22,Invoice,008-04344,,Discount,,,-12.15,3599633.83999999,,Keila Alfaro-Visvikis,RETAIL SEDANOS,1386161,Dec
2024-12-02,Sedanos Supermarkets #9,Invoice,008-04345,Arroz Envasado:Parboiled 5KG Dos Hermanos.,6 / 11lbs,20.0,40.5,810.0,3600443.83999999,Branded Rice,Keila Alfaro-Visvikis,RETAIL SEDANOS,1386162,Dec
2024-12-02,Sedanos Supermarkets #9,Invoice,008-04345,Arroz Envasado:Parboiled 5KG Dos Hermanos.,6 / 11lbs,20.0,40.5,810.0,3601253.83999999,Branded Rice,Keila Alfaro-Visvikis,RETAIL SEDANOS,1386163,Dec
2024-12-02,Sedanos Supermarkets #9,Invoice,008-04345,,Discount,,,-16.2,3601237.63999998,,Keila Alfaro-Visvikis,RETAIL SEDANOS,1386164,Dec
2024-12-02,Sedanos Supermarkets  #11,Credit Memo,008-04406,Varios:Promotional Allowance,5kg,-20.0,40.5,-810.0,3600427.63999998,Branded Rice,Keila Alfaro-Visvikis,RETAIL SEDANOS,1386165,Dec
2024-12-02,Sedanos Supermarkets #22,Credit Memo,008-04407,Varios:Promotional Allowance,6x5kg,-15.0,40.5,-607.5,3599820.13999998,Branded Rice,Keila Alfaro-Visvikis,RETAIL SEDANOS,1386166,Dec
2024-12-02,Sedanos Supermarkets #9,Credit Memo,008-04408,Varios:Promotional Allowance,,-20.0,40.5,-810.0,3599010.13999998,Branded Rice,Keila Alfaro-Visvikis,RETAIL SEDANOS,1386167,Dec
2024-12-03,Be Your Will LLC,Invoice,008-04346,Liquids:AS Cooking Wine,4/1 Gl.,2.0,17.5,35.0,3599045.13999998,American Spice,Lisset Limpio -020,CAFETERIA y RESTAURANTS,1386168,Dec
2024-12-03,Be Your Will LLC,Invoice,008-04346,Arroz a Granel:Largo Fino 50 LB -Bolsa Dos Hermanos.,,10.0,27.85,278.5,3599323.63999998,Bulk Rice,Lisset Limpio -020,CAFETERIA y RESTAURANTS,1386169,Dec
2024-12-03,Be Your Will LLC,Invoice,008-04346,Arroz a Granel:Parboiled 50 LB -Bolsa Dos Hermanos.,,11.0,27.75,305.25,3599628.88999998,Bulk Rice,Lisset Limpio -020,CAFETERIA y RESTAURANTS,1386170,Dec
2024-12-03,Be Your Will LLC,Invoice,008-04346,Arroz a Granel:Parboiled 50 LB -Bolsa Dos Hermanos.,,1.0,27.75,27.75,3599656.63999998,Bulk Rice,Lisset Limpio -020,CAFETERIA y RESTAURANTS,1386171,Dec
2024-12-03,Sedanos Supermarkets #29,Invoice,008-04347,Arroz Envasado:Parboiled 5KG Dos Hermanos.,6 / 11lbs,15.0,40.5,607.5,3600264.13999998,Branded Rice,Keila Alfaro-Visvikis,RETAIL SEDANOS,1386172,Dec
2024-12-03,Sedanos Supermarkets #29,Invoice,008-04347,Arroz Envasado:Parboiled 5KG Dos Hermanos.,6 / 11lbs,15.0,40.5,607.5,3600871.63999998,Branded Rice,Keila Alfaro-Visvikis,RETAIL SEDANOS,1386173,Dec
2024-12-03,Sedanos Supermarkets #29,Invoice,008-04347,Arroz Envasado:Largo Fino 1kg (Long grain rice) Dos Hermanos,,1.0,17.5,17.5,3600889.13999998,Branded Rice,Keila Alfaro-Visvikis,RETAIL SEDANOS,1386174,Dec
2024-12-03,Sedanos Supermarkets #29,Invoice,008-04347,Arroz Envasado:Parboiled 1kg Bolsa Dos Hermanos.,.,1.0,19.9,19.9,3600909.03999998,Branded Rice,Keila Alfaro-Visvikis,RETAIL SEDANOS,1386175,Dec
2024-12-03,Sedanos Supermarkets #29,Invoice,008-04347,,Discount,,,-12.9,3600896.13999998,,Keila Alfaro-Visvikis,RETAIL SEDANOS,1386176,Dec
2024-12-03,El Palacio de los jugos / Delicias Criollas (DIAGO FOOD_MILLER),Invoice,008-04348,Dry Beans:Dry Beans - Black Beans 50,Dry Black Beans 50 lb,1.0,45.7,45.7,3600941.83999999,Dry Beans,Lisset Limpio -020,Cafeteria,1386177,Dec
2024-12-03,El Palacio de los jugos / Delicias Criollas (DIAGO FOOD_MILLER),Invoice,008-04348,Arroz a Granel:Parboiled 50 LB -Bolsa Dos Hermanos.,,11.0,27.75,305.25,3601247.08999999,Bulk Rice,Lisset Limpio -020,Cafeteria,1386178,Dec
2024-12-03,El Palacio de los jugos / Delicias Criollas (DIAGO FOOD_MILLER),Invoice,008-04348,Arroz a Granel:Parboiled 50 LB -Bolsa Dos Hermanos.,,1.0,27.75,27.75,3601274.83999999,Bulk Rice,Lisset Limpio -020,Cafeteria,1386179,Dec
2024-12-03,Sedanos Supermarkets #33,Invoice,008-04349,Arroz Envasado:Parboiled 5KG Dos Hermanos.,6 / 11lbs,10.0,40.5,405.0,3601679.83999999,Branded Rice,Keila Alfaro-Visvikis,RETAIL SEDANOS,1386180,Dec
2024-12-03,Sedanos Supermarkets #33,Invoice,008-04349,Arroz Envasado:Parboiled 5KG Dos Hermanos.,6 / 11lbs,10.0,40.5,405.0,3602084.83999999,Branded Rice,Keila Alfaro-Visvikis,RETAIL SEDANOS,1386181,Dec
2024-12-03,Sedanos Supermarkets #33,Invoice,008-04349,,Discount,,,-8.1,3602076.73999999,,Keila Alfaro-Visvikis,RETAIL SEDANOS,1386182,Dec
2024-12-03,Sedanos Supermarkets #17,Invoice,008-04350,Arroz Envasado:Parboiled 5KG Dos Hermanos.,6 / 11lbs,15.0,40.5,607.5,3602684.23999999,Branded Rice,Keila Alfaro-Visvikis,RETAIL SEDANOS,1386183,Dec
2024-12-03,Sedanos Supermarkets #17,Invoice,008-04350,Arroz Envasado:Parboiled 5KG Dos Hermanos.,6 / 11lbs,15.0,40.5,607.5,3603291.73999999,Branded Rice,Keila Alfaro-Visvikis,RETAIL SEDANOS,1386184,Dec
2024-12-03,Sedanos Supermarkets #17,Invoice,008-04350,,Discount,,,-12.15,3603279.58999999,,Keila Alfaro-Visvikis,RETAIL SEDANOS,1386185,Dec
2024-12-03,Sedanos Supermarkets #5,Invoice,008-04351,Arroz Envasado:Parboiled 5KG Dos Hermanos.,6 / 11lbs,20.0,40.5,810.0,3604089.58999999,Branded Rice,Lisset Limpio -020,RETAIL SEDANOS,1386186,Dec
2024-12-03,Sedanos Supermarkets #5,Invoice,008-04351,Arroz Envasado:Parboiled 5KG Dos Hermanos.,6 / 11lbs,20.0,40.5,810.0,3604899.58999999,Branded Rice,Lisset Limpio -020,RETAIL SEDANOS,1386187,Dec
2024-12-03,Sedanos Supermarkets #5,Invoice,008-04351,,Discount,,,-16.2,3604883.38999998,,Lisset Limpio -020,RETAIL SEDANOS,1386188,Dec
2024-12-03,Sedanos Supermarkets #18,Invoice,008-04352,Arroz Envasado:Parboiled 5KG Dos Hermanos.,6 / 11lbs,20.0,40.5,810.0,3605693.38999998,Branded Rice,Keila Alfaro-Visvikis,RETAIL SEDANOS,1386189,Dec
2024-12-03,Sedanos Supermarkets #18,Invoice,008-04352,Arroz Envasado:Parboiled 5KG Dos Hermanos.,6 / 11lbs,20.0,40.5,810.0,3606503.38999998,Branded Rice,Keila Alfaro-Visvikis,RETAIL SEDANOS,1386190,Dec
2024-12-03,Sedanos Supermarkets #18,Invoice,008-04352,,Discount,,,-16.2,3606487.18999998,,Keila Alfaro-Visvikis,RETAIL SEDANOS,1386191,Dec
2024-12-03,La Ranchera Meat Market #3,Invoice,008-04353,Arroz a Granel:Largo Fino 50 LB -Bolsa Dos Hermanos.,,20.0,27.85,557.0,3607044.18999998,Bulk Rice,Keila Alfaro-Visvikis,CAFETERIA y RESTAURANTS,1386192,Dec
2024-12-03,Be Your Will LLC,Credit Memo,008-04409,Varios:Promotional Allowance,parbo 50lb,-1.0,27.75,-27.75,3607016.43999998,Bulk Rice,Lisset Limpio -020,CAFETERIA y RESTAURANTS,1386193,Dec
2024-12-03,Sedanos Supermarkets #29,Credit Memo,008-04410,Varios:Promotional Allowance,,-15.0,40.5,-607.5,3606408.93999998,Branded Rice,Keila Alfaro-Visvikis,RETAIL SEDANOS,1386194,Dec
2024-12-03,El Palacio de los jugos / Delicias Criollas (DIAGO FOOD_MILLER),Credit Memo,008-04411,Varios:Promotional Allowance,,-1.0,27.75,-27.75,3606381.18999998,,Lisset Limpio -020,Cafeteria,1386195,Dec
2024-12-03,Sedanos Supermarkets #33,Credit Memo,008-04412,Varios:Promotional Allowance,,-10.0,40.5,-405.0,3605976.18999998,Branded Rice,Keila Alfaro-Visvikis,RETAIL SEDANOS,1386196,Dec
2024-12-03,Sedanos Supermarkets #17,Credit Memo,008-04413,Varios:Promotional Allowance,,-15.0,40.5,-607.5,3605368.68999998,Branded Rice,Keila Alfaro-Visvikis,RETAIL SEDANOS,1386197,Dec
2024-12-03,Sedanos Supermarkets #5,Credit Memo,008-04414,Varios:Promotional Allowance,,-20.0,40.5,-810.0,3604558.68999998,Branded Rice,Keila Alfaro-Visvikis,RETAIL SEDANOS,1386198,Dec
2024-12-03,Sedanos Supermarkets #18,Credit Memo,008-04415,Varios:Promotional Allowance,,-20.0,40.5,-810.0,3603748.68999998,Branded Rice,Keila Alfaro-Visvikis,RETAIL SEDANOS,1386199,Dec
2024-12-04,Vitos Meat and Provisions,Invoice,008-04354,Arroz a Granel:Parboiled 50 LB -Bolsa Dos Hermanos.,,30.0,27.75,832.5,3604581.18999998,Bulk Rice,Keila Alfaro-Visvikis,WHOLESALER,1386200,Dec
2024-12-04,ALBERT DELI CORP #1,Invoice,008-04355,Arroz a Granel:Largo Fino 50 LB -Bolsa Dos Hermanos.,,6.0,27.85,167.1,3604748.28999998,Bulk Rice,Keila Alfaro-Visvikis,CAFETERIA y RESTAURANTS,1386201,Dec
2024-12-04,ALBERT DELI CORP #1,Invoice,008-04355,Arroz a Granel:Parboiled 50 LB -Bolsa Dos Hermanos.,,6.0,28.25,169.5,3604917.78999998,Bulk Rice,Keila Alfaro-Visvikis,CAFETERIA y RESTAURANTS,1386202,Dec
2024-12-04,Sedanos Supermarkets #33,Invoice,008-04356,Arroz a Granel:Parboiled 50 LB -Bolsa Dos Hermanos.,,6.0,28.25,169.5,3605087.28999998,Bulk Rice,Keila Alfaro-Visvikis,RETAIL SEDANOS,1386203,Dec
2024-12-04,Sedanos Supermarkets #33,Invoice,008-04356,,Discount,,,-3.39,3605083.89999998,,Keila Alfaro-Visvikis,RETAIL SEDANOS,1386204,Dec
2024-12-04,Key Foods  / Ivan,Invoice,008-04357,Arroz Envasado:Parboiled 5KG Dos Hermanos.,6 / 11lbs,30.0,46.5,1395.0,3606478.89999998,Branded Rice,Keila Alfaro-Visvikis,RETAIL  DSD,1386205,Dec
2024-12-04,Key Foods  / Ivan,Invoice,008-04357,Arroz Envasado:Parboiled 5KG Dos Hermanos.,6 / 11lbs,11.0,46.5,511.5,3606990.39999998,Branded Rice,Keila Alfaro-Visvikis,RETAIL  DSD,1386206,Dec
2024-12-04,Sedanos Supermarkets  #4,Invoice,008-04358,Arroz Envasado:Parboiled 5KG Dos Hermanos.,6 / 11lbs,10.0,40.5,405.0,3607395.39999998,Branded Rice,Keila Alfaro-Visvikis,RETAIL SEDANOS,1386207,Dec
2024-12-04,Sedanos Supermarkets  #4,Invoice,008-04358,Arroz Envasado:Parboiled 5KG Dos Hermanos.,6 / 11lbs,10.0,40.5,405.0,3607800.39999998,Branded Rice,Keila Alfaro-Visvikis,RETAIL SEDANOS,1386208,Dec
2024-12-04,Sedanos Supermarkets  #4,Invoice,008-04358,,Discount,,,-8.1,3607792.29999998,,Keila Alfaro-Visvikis,RETAIL SEDANOS,1386209,Dec
2024-12-04,Sedanos Supermarkets #7,Invoice,008-04359,Arroz Envasado:Parboiled 5KG Dos Hermanos.,6 / 11lbs,15.0,40.5,607.5,3608399.79999998,Branded Rice,Keila Alfaro-Visvikis,RETAIL SEDANOS,1386210,Dec
2024-12-04,Sedanos Supermarkets #7,Invoice,008-04359,Arroz Envasado:Parboiled 5KG Dos Hermanos.,6 / 11lbs,15.0,40.5,607.5,3609007.29999998,Branded Rice,Keila Alfaro-Visvikis,RETAIL SEDANOS,1386211,Dec
2024-12-04,Sedanos Supermarkets #7,Invoice,008-04359,,Discount,,,-12.15,3608995.14999998,,Keila Alfaro-Visvikis,RETAIL SEDANOS,1386212,Dec
2024-12-04,Sedanos Supermarkets #42,Invoice,008-04360,Arroz Envasado:Parboiled 5KG Dos Hermanos.,6 / 11lbs,15.0,40.5,607.5,3609602.64999998,Branded Rice,Keila Alfaro-Visvikis,RETAIL SEDANOS,1386213,Dec
2024-12-04,Sedanos Supermarkets #42,Invoice,008-04360,Arroz Envasado:Parboiled 5KG Dos Hermanos.,6 / 11lbs,15.0,40.5,607.5,3610210.14999998,Branded Rice,Keila Alfaro-Visvikis,RETAIL SEDANOS,1386214,Dec
2024-12-04,Sedanos Supermarkets #42,Invoice,008-04360,,Discount,,,-12.15,3610197.99999998,,Keila Alfaro-Visvikis,RETAIL SEDANOS,1386215,Dec
2024-12-04,Sedanos Supermarkets #23,Invoice,008-04361,Arroz Envasado:Parboiled 5KG Dos Hermanos.,6 / 11lbs,15.0,40.5,607.5,3610805.49999998,Branded Rice,Keila Alfaro-Visvikis,RETAIL SEDANOS,1386216,Dec
2024-12-04,Sedanos Supermarkets #23,Invoice,008-04361,Arroz Envasado:Parboiled 5KG Dos Hermanos.,6 / 11lbs,15.0,40.5,607.5,3611412.99999998,Branded Rice,Keila Alfaro-Visvikis,RETAIL SEDANOS,1386217,Dec
2024-12-04,Sedanos Supermarkets #23,Invoice,008-04361,,Discount,,,-12.15,3611400.84999998,,Keila Alfaro-Visvikis,RETAIL SEDANOS,1386218,Dec
2024-12-04,Sedanos Supermarkets #14,Invoice,008-04362,Arroz Envasado:Parboiled 5KG Dos Hermanos.,6 / 11lbs,15.0,40.5,607.5,3612008.34999998,Branded Rice,Keila Alfaro-Visvikis,RETAIL SEDANOS,1386219,Dec
2024-12-04,Sedanos Supermarkets #14,Invoice,008-04362,Arroz Envasado:Parboiled 5KG Dos Hermanos.,6 / 11lbs,15.0,40.5,607.5,3612615.84999998,Branded Rice,Keila Alfaro-Visvikis,RETAIL SEDANOS,1386220,Dec
2024-12-04,Sedanos Supermarkets #14,Invoice,008-04362,,Discount,,,-12.15,3612603.69999998,,Keila Alfaro-Visvikis,RETAIL SEDANOS,1386221,Dec
2024-12-04,Los Mejores Tamales de Miami,Invoice,008-04363,Arroz a Granel:Parboiled 50 LB -Bolsa Dos Hermanos.,,4.0,28.25,113.0,3612716.69999998,Bulk Rice,Lisset Limpio -020,CAFETERIA y RESTAURANTS,1386222,Dec
2024-12-04,Sedanos Supermarkets #36,Invoice,008-04364,Arroz Envasado:Parboiled 5KG Dos Hermanos.,6 / 11lbs,15.0,40.5,607.5,3613324.19999998,Branded Rice,Keila Alfaro-Visvikis,RETAIL SEDANOS,1386223,Dec
2024-12-04,Sedanos Supermarkets #36,Invoice,008-04364,Arroz Envasado:Parboiled 5KG Dos Hermanos.,6 / 11lbs,15.0,40.5,607.5,3613931.69999998,Branded Rice,Keila Alfaro-Visvikis,RETAIL SEDANOS,1386224,Dec
2024-12-04,Sedanos Supermarkets #36,Invoice,008-04364,,Discount,,,-12.15,3613919.54999999,,Keila Alfaro-Visvikis,RETAIL SEDANOS,1386225,Dec
2024-12-04,Sedanos Supermarkets #24,Invoice,008-04365,Arroz a Granel:Parboiled 50 LB -Bolsa Dos Hermanos.,,10.0,28.25,282.5,3614202.04999999,Bulk Rice,Keila Alfaro-Visvikis,RETAIL SEDANOS,1386226,Dec
2024-12-04,Sedanos Supermarkets #24,Invoice,008-04365,,Discount,,,-5.65,3614196.39999999,,Keila Alfaro-Visvikis,RETAIL SEDANOS,1386227,Dec
2024-12-04,Sedanos Supermarkets  #4,Credit Memo,008-04417,Varios:Promotional Allowance,,-10.0,40.5,-405.0,3613791.39999999,Branded Rice,Keila Alfaro-Visvikis,RETAIL SEDANOS,1386228,Dec
2024-12-04,Sedanos Supermarkets #7,Credit Memo,008-04418,Varios:Promotional Allowance,,-15.0,40.5,-607.5,3613183.89999999,Branded Rice,Keila Alfaro-Visvikis,RETAIL SEDANOS,1386229,Dec
2024-12-04,Sedanos Supermarkets #42,Credit Memo,008-04419,Varios:Promotional Allowance,,-15.0,40.5,-607.5,3612576.39999999,Branded Rice,Keila Alfaro-Visvikis,RETAIL SEDANOS,1386230,Dec
2024-12-04,Sedanos Supermarkets #23,Credit Memo,008-04420,Varios:Promotional Allowance,,-15.0,40.5,-607.5,3611968.89999999,Branded Rice,Keila Alfaro-Visvikis,RETAIL SEDANOS,1386231,Dec
2024-12-04,Sedanos Supermarkets #14,Credit Memo,008-04421,Varios:Promotional Allowance,,-15.0,40.5,-607.5,3611361.39999999,Branded Rice,Keila Alfaro-Visvikis,RETAIL SEDANOS,1386232,Dec
2024-12-04,Sedanos Supermarkets #36,Credit Memo,008-04422,Varios:Promotional Allowance,,-15.0,40.5,-607.5,3610753.89999999,Branded Rice,Keila Alfaro-Visvikis,RETAIL SEDANOS,1386233,Dec
2024-12-04,Sedanos Supermarkets #43,Credit Memo,008-04423,Varios:Promotional Allowance,,0.0,,0.0,3610753.89999999,Branded Rice,Keila Alfaro-Visvikis,RETAIL SEDANOS,1386234,Dec
2024-12-05,Sedanos Supermarkets #43,Invoice,008-04366,Arroz a Granel:Parboiled 50 LB -Bolsa Dos Hermanos.,,5.0,28.25,141.25,3610895.14999999,Bulk Rice,Keila Alfaro-Visvikis,RETAIL SEDANOS,1386235,Dec
2024-12-05,Sedanos Supermarkets #43,Invoice,008-04366,,Discount,,,-2.83,3610892.31999999,,Keila Alfaro-Visvikis,RETAIL SEDANOS,1386236,Dec
2024-12-05,Sedanos Supermarkets #43,Invoice,008-04367,Arroz Envasado:Parboiled 5KG Dos Hermanos.,6 / 11lbs,0.0,,0.0,3610892.31999999,Branded Rice,Keila Alfaro-Visvikis,RETAIL SEDANOS,1386237,Dec
2024-12-05,Sedanos Supermarkets #43,Invoice,008-04367,Arroz Envasado:Parboiled 5KG Dos Hermanos.,6 / 11lbs,0.0,,0.0,3610892.31999999,Branded Rice,Keila Alfaro-Visvikis,RETAIL SEDANOS,1386238,Dec
2024-12-05,El Palacio de los jugos /  Nanos Latin Foods,Invoice,008-04368,Arroz a Granel:Parboiled 50 LB -Bolsa Dos Hermanos.,,10.0,26.75,267.5,3611159.81999999,Bulk Rice,Lisset Limpio -020,Cafeteria,1386239,Dec
2024-12-05,El Palacio de los jugos / Caribe Tropical,Invoice,008-04369,Arroz a Granel:Largo Fino 50 LB -Bolsa Dos Hermanos.,,6.0,27.85,167.1,3611326.91999999,Bulk Rice,Lisset Limpio -020,Cafeteria,1386240,Dec
2024-12-05,El Palacio de los jugos / Caribe Tropical,Invoice,008-04369,Arroz a Granel:Parboiled 50 LB -Bolsa Dos Hermanos.,,8.0,26.75,214.0,3611540.91999999,Bulk Rice,Lisset Limpio -020,Cafeteria,1386241,Dec
2024-12-05,El Palacio de los jugos /  EMMA FOOD CORP,Invoice,008-04370,Arroz a Granel:Parboiled 50 LB -Bolsa Dos Hermanos.,,6.0,26.75,160.5,3611701.41999999,Bulk Rice,Lisset Limpio -020,Cafeteria,1386242,Dec
2024-12-05,El Palacio de los jugos / Lita Foods Inc.,Invoice,008-04371,Dry Beans:Dry Beans - Black Beans 50,Dry Black Beans 50 lb,1.0,45.7,45.7,3611747.11999999,Dry Beans,Lisset Limpio -020,Cafeteria,1386243,Dec
2024-12-05,El Palacio de los jugos / Lita Foods Inc.,Invoice,008-04371,Arroz a Granel:Parboiled 50 LB -Bolsa Dos Hermanos.,,11.0,27.75,305.25,3612052.36999999,Bulk Rice,Lisset Limpio -020,Cafeteria,1386244,Dec
2024-12-05,El Palacio de los jugos / Lita Foods Inc.,Invoice,008-04371,Arroz a Granel:Parboiled 50 LB -Bolsa Dos Hermanos.,,1.0,27.75,27.75,3612080.11999999,Bulk Rice,Lisset Limpio -020,Cafeteria,1386245,Dec
2024-12-05,Chavez Distributors Inc.,Invoice,008-04372,Arroz a Granel:Parboiled 50 LB -Bolsa Dos Hermanos.,,55.0,27.75,1526.25,3613606.36999999,Bulk Rice,Keila Alfaro-Visvikis,WHOLESALER,1386246,Dec
2024-12-05,Ideal Food Basket Davie Grocery,Invoice,008-04373,Arroz Envasado:Largo Fino 1kg (Long grain rice) Dos Hermanos,,5.0,17.5,87.5,3613693.86999999,Branded Rice,Keila Alfaro-Visvikis,RETAIL  DSD,1386247,Dec
2024-12-05,Ideal Food Basket Davie Grocery,Invoice,008-04373,Arroz Envasado:Largo Fino 1kg (Long grain rice) Dos Hermanos,,1.0,17.5,17.5,3613711.36999999,Branded Rice,Keila Alfaro-Visvikis,RETAIL  DSD,1386248,Dec
2024-12-05,Ideal Food Basket Davie Cafeteria,Invoice,008-04374,Arroz a Granel:Largo Fino 50 LB -Bolsa Dos Hermanos.,,8.0,27.85,222.8,3613934.16999999,Bulk Rice,Keila Alfaro-Visvikis,CAFETERIA y RESTAURANTS,1386249,Dec
2024-12-05,Sedanos Supermarkets #26,Invoice,008-04375,Arroz a Granel:Parboiled 50 LB -Bolsa Dos Hermanos.,,3.0,28.25,84.75,3614018.91999999,Bulk Rice,Keila Alfaro-Visvikis,RETAIL SEDANOS,1386250,Dec
2024-12-05,Sedanos Supermarkets #26,Invoice,008-04375,,Discount,,,-1.7,3614017.21999998,,Keila Alfaro-Visvikis,RETAIL SEDANOS,1386251,Dec
2024-12-05,Sedanos Supermarkets #16,Invoice,008-04376,Arroz a Granel:Parboiled 50 LB -Bolsa Dos Hermanos.,,6.0,28.25,169.5,3614186.71999998,Bulk Rice,Keila Alfaro-Visvikis,RETAIL SEDANOS,1386252,Dec
2024-12-05,Sedanos Supermarkets #16,Invoice,008-04376,,Discount,,,-3.39,3614183.32999998,,Keila Alfaro-Visvikis,RETAIL SEDANOS,1386253,Dec
2024-12-05,Sedanos Supermarkets #27,Invoice,008-04377,Arroz a Granel:Parboiled 50 LB -Bolsa Dos Hermanos.,,6.0,28.25,169.5,3614352.82999998,Bulk Rice,Keila Alfaro-Visvikis,RETAIL SEDANOS,1386254,Dec
2024-12-05,Sedanos Supermarkets #27,Invoice,008-04377,,Discount,,,-3.39,3614349.43999998,,Keila Alfaro-Visvikis,RETAIL SEDANOS,1386255,Dec
2024-12-05,Sedanos Supermarkets #27,Invoice,008-04378,Arroz Envasado:Parboiled 5KG Dos Hermanos.,6 / 11lbs,10.0,40.5,405.0,3614754.43999998,Branded Rice,Keila Alfaro-Visvikis,RETAIL SEDANOS,1386256,Dec
2024-12-05,Sedanos Supermarkets #27,Invoice,008-04378,Arroz Envasado:Parboiled 5KG Dos Hermanos.,6 / 11lbs,10.0,40.5,405.0,3615159.43999998,Branded Rice,Keila Alfaro-Visvikis,RETAIL SEDANOS,1386257,Dec
2024-12-05,Sedanos Supermarkets #27,Invoice,008-04378,,Discount,,,-8.1,3615151.33999998,,Keila Alfaro-Visvikis,RETAIL SEDANOS,1386258,Dec
2024-12-05,Sedanos Supermarkets #26,Invoice,008-04379,Arroz Envasado:Parboiled 5KG Dos Hermanos.,6 / 11lbs,5.0,40.5,202.5,3615353.83999998,Branded Rice,Keila Alfaro-Visvikis,RETAIL SEDANOS,1386259,Dec
2024-12-05,Sedanos Supermarkets #26,Invoice,008-04379,Arroz Envasado:Parboiled 5KG Dos Hermanos.,6 / 11lbs,5.0,40.5,202.5,3615556.33999998,Branded Rice,Keila Alfaro-Visvikis,RETAIL SEDANOS,1386260,Dec
2024-12-05,Sedanos Supermarkets #26,Invoice,008-04379,,Discount,,,-4.05,3615552.28999998,,Keila Alfaro-Visvikis,RETAIL SEDANOS,1386261,Dec
2024-12-05,Sedanos Supermarkets #24,Invoice,008-04380,Arroz Envasado:Parboiled 5KG Dos Hermanos.,6 / 11lbs,10.0,40.5,405.0,3615957.28999998,Branded Rice,Keila Alfaro-Visvikis,RETAIL SEDANOS,1386262,Dec
2024-12-05,Sedanos Supermarkets #24,Invoice,008-04380,Arroz Envasado:Parboiled 5KG Dos Hermanos.,6 / 11lbs,10.0,40.5,405.0,3616362.28999998,Branded Rice,Keila Alfaro-Visvikis,RETAIL SEDANOS,1386263,Dec
2024-12-05,Sedanos Supermarkets #24,Invoice,008-04380,,Discount,,,-8.1,3616354.18999998,,Keila Alfaro-Visvikis,RETAIL SEDANOS,1386264,Dec
2024-12-05,Key Foods  / Ivan,Credit Memo,008-04416,Varios:Promotional Allowance,,-11.0,46.5,-511.5,3615842.68999998,Branded Rice,Keila Alfaro-Visvikis,RETAIL  DSD,1386265,Dec
2024-12-05,Sedanos Supermarkets #27,Credit Memo,008-04424,Varios:Promotional Allowance,,-10.0,40.5,-405.0,3615437.68999998,Branded Rice,Keila Alfaro-Visvikis,RETAIL SEDANOS,1386266,Dec
2024-12-05,El Palacio de los jugos / Lita Foods Inc.,Credit Memo,008-04425,Varios:Promotional Allowance,,-1.0,27.75,-27.75,3615409.93999998,Bulk Rice,Lisset Limpio -020,Cafeteria,1386267,Dec
2024-12-05,Sedanos Supermarkets #26,Credit Memo,008-04426,Varios:Promotional Allowance,,-5.0,40.5,-202.5,3615207.43999998,Branded Rice,Keila Alfaro-Visvikis,RETAIL SEDANOS,1386268,Dec
2024-12-05,Ideal Food Basket Davie Grocery,Credit Memo,008-04427,Varios:Promotional Allowance,,-1.0,17.5,-17.5,3615189.93999998,Branded Rice,Keila Alfaro-Visvikis,RETAIL  DSD,1386269,Dec
2024-12-05,Sedanos Supermarkets #24,Credit Memo,008-04428,Varios:Promotional Allowance,,-10.0,40.5,-405.0,3614784.93999998,Branded Rice,Keila Alfaro-Visvikis,RETAIL SEDANOS,1386270,Dec
2024-12-05,El Palacio de Los Jugos / Casa mía Food Restaurant inc,Credit Memo,008-04429,Varios:Promotional Allowance,,-1.0,27.75,-27.75,3614757.18999998,Bulk Rice,Lisset Limpio -020,Cafeteria,1386271,Dec
2024-12-05,Lissete Limpio,Credit Memo,008-04430,Varios:Promotional Allowance,,-1.0,17.0,-17.0,3614740.18999998,Branded Rice,Lisset Limpio -020,OTHER,1386272,Dec
2024-12-05,Lissete Limpio,Credit Memo,008-04430,Varios:Promotional Allowance,,-1.0,19.9,-19.9,3614720.28999998,Branded Rice,Lisset Limpio -020,OTHER,1386273,Dec
2024-12-06,El Palacio de Los Jugos / Casa mía Food Restaurant inc,Invoice,008-04381,Dry Beans:Dry Beans - Black Beans 50,Dry Black Beans 50 lb,1.0,45.7,45.7,3614765.98999999,Dry Beans,Lisset Limpio -020,Cafeteria,1386274,Dec
2024-12-06,El Palacio de Los Jugos / Casa mía Food Restaurant inc,Invoice,008-04381,Arroz a Granel:Parboiled 50 LB -Bolsa Dos Hermanos.,,11.0,27.75,305.25,3615071.23999999,Bulk Rice,Lisset Limpio -020,Cafeteria,1386275,Dec
2024-12-06,El Palacio de Los Jugos / Casa mía Food Restaurant inc,Invoice,008-04381,Arroz a Granel:Parboiled 50 LB -Bolsa Dos Hermanos.,,1.0,27.75,27.75,3615098.98999999,Bulk Rice,Lisset Limpio -020,Cafeteria,1386276,Dec
2024-12-06,El Gallego Supermarket,Invoice,008-04382,Dry Beans:Dry Beans - Black Beans 50,Dry Black Beans 50 lb,2.0,45.7,91.4,3615190.38999998,Dry Beans,Lisset Limpio -020,RETAIL  DSD,1386277,Dec
2024-12-06,El Gallego Supermarket,Invoice,008-04382,Arroz a Granel:Parboiled 50 LB -Bolsa Dos Hermanos.,,5.0,28.25,141.25,3615331.63999998,Bulk Rice,Lisset Limpio -020,RETAIL  DSD,1386278,Dec
2024-12-06,Bravo   Francisco Diaz,Invoice,008-04383,Arroz a Granel:Largo Fino 50 LB -Bolsa Dos Hermanos.,,5.0,27.85,139.25,3615470.88999998,Bulk Rice,Lisset Limpio -020,RETAIL  DSD,1386279,Dec
2024-12-06,Lissete Limpio,Invoice,008-04384,Arroz Envasado:Largo Fino 1kg (Long grain rice) Dos Hermanos,,1.0,17.0,17.0,3615487.88999998,Branded Rice,Lisset Limpio -020,OTHER,1386280,Dec
2024-12-06,Lissete Limpio,Invoice,008-04384,Arroz Envasado:Parboiled 1kg Bolsa Dos Hermanos.,.,1.0,19.9,19.9,3615507.78999998,Branded Rice,Lisset Limpio -020,OTHER,1386281,Dec
2024-12-08,El Palacio de los jugos /  Nanos Latin Foods,Invoice,008-04385,Arroz a Granel:Parboiled 50 LB -Bolsa Dos Hermanos.,,8.0,26.75,214.0,3615721.78999998,Bulk Rice,Lisset Limpio -020,Cafeteria,1386282,Dec
2024-12-08,Fritanga Momotombo,Invoice,008-04386,Arroz a Granel:Largo Fino 50 LB -Bolsa Dos Hermanos.,,7.0,27.85,194.95,3615916.73999999,Bulk Rice,Lisset Limpio -020,CAFETERIA y RESTAURANTS,1386283,Dec
2024-12-08,Sorianos Brothers,Invoice,008-04387,Arroz a Granel:Parboiled 50 LB -Bolsa Dos Hermanos.,,25.0,26.75,668.75,3616585.48999999,Bulk Rice,Lisset Limpio -020,CAFETERIA y RESTAURANTS,1386284,Dec
2024-12-08,El Palacio de los jugos /  EMMA FOOD CORP,Invoice,008-04388,Arroz a Granel:Parboiled 50 LB -Bolsa Dos Hermanos.,,8.0,26.75,214.0,3616799.48999999,Bulk Rice,Lisset Limpio -020,Cafeteria,1386285,Dec
2024-12-08,Soriano Brothers,Invoice,008-04389,Arroz a Granel:Parboiled 50 LB -Bolsa Dos Hermanos.,,55.0,26.75,1471.25,3618270.73999999,Bulk Rice,Lisset Limpio -020,CAFETERIA y RESTAURANTS,1386286,Dec
2024-12-08,Aries Supermarket & Cafeteria,Invoice,008-04390,Spices:AS Whole Bay Leaves,4/12 OZ,1.0,30.0,30.0,3618300.73999999,American Spice,Keila Alfaro-Visvikis,CAFETERIA y RESTAURANTS,1386287,Dec
2024-12-08,Aries Supermarket & Cafeteria,Invoice,008-04390,Arroz a Granel:Parboiled 50 LB -Bolsa Dos Hermanos.,,10.0,28.25,282.5,3618583.23999999,Bulk Rice,Keila Alfaro-Visvikis,CAFETERIA y RESTAURANTS,1386288,Dec
2024-12-09,Sedanos Supermarkets #28,Invoice,008-04392,Arroz Envasado:Parboiled 5KG Dos Hermanos.,6 / 11lbs,5.0,40.5,202.5,3618785.73999999,Branded Rice,Keila Alfaro-Visvikis,RETAIL SEDANOS,1386289,Dec
2024-12-09,Sedanos Supermarkets #28,Invoice,008-04392,Arroz Envasado:Parboiled 5KG Dos Hermanos.,6 / 11lbs,5.0,40.5,202.5,3618988.23999999,Branded Rice,Keila Alfaro-Visvikis,RETAIL SEDANOS,1386290,Dec
2024-12-09,Sedanos Supermarkets #28,Invoice,008-04392,,Discount,,,-4.05,3618984.18999999,,Keila Alfaro-Visvikis,RETAIL SEDANOS,1386291,Dec
2024-12-09,Sedanos Supermarkets #16,Invoice,008-04393,Arroz Envasado:Parboiled 5KG Dos Hermanos.,6 / 11lbs,15.0,40.5,607.5,3619591.68999999,Branded Rice,Keila Alfaro-Visvikis,RETAIL SEDANOS,1386292,Dec
2024-12-09,Sedanos Supermarkets #16,Invoice,008-04393,Arroz Envasado:Parboiled 5KG Dos Hermanos.,6 / 11lbs,15.0,40.5,607.5,3620199.18999999,Branded Rice,Keila Alfaro-Visvikis,RETAIL SEDANOS,1386293,Dec
2024-12-09,Sedanos Supermarkets #16,Invoice,008-04393,,Discount,,,-12.15,3620187.03999999,,Keila Alfaro-Visvikis,RETAIL SEDANOS,1386294,Dec
2024-12-09,Sedanos Supermarkets #10,Invoice,008-04394,Arroz Envasado:Parboiled 5KG Dos Hermanos.,6 / 11lbs,3.0,40.5,121.5,3620308.53999999,Branded Rice,Keila Alfaro-Visvikis,RETAIL SEDANOS,1386295,Dec
2024-12-09,Sedanos Supermarkets #10,Invoice,008-04394,Arroz Envasado:Parboiled 5KG Dos Hermanos.,6 / 11lbs,3.0,40.5,121.5,3620430.03999999,Branded Rice,Keila Alfaro-Visvikis,RETAIL SEDANOS,1386296,Dec
2024-12-09,Sedanos Supermarkets #10,Invoice,008-04394,,Discount,,,-2.43,3620427.60999999,,Keila Alfaro-Visvikis,RETAIL SEDANOS,1386297,Dec
2024-12-09,Sedanos Supermarkets #8,Invoice,008-04395,Arroz Envasado:Parboiled 5KG Dos Hermanos.,6 / 11lbs,10.0,40.5,405.0,3620832.60999999,Branded Rice,Keila Alfaro-Visvikis,RETAIL SEDANOS,1386298,Dec
2024-12-09,Sedanos Supermarkets #8,Invoice,008-04395,Arroz Envasado:Parboiled 5KG Dos Hermanos.,6 / 11lbs,10.0,40.5,405.0,3621237.60999999,Branded Rice,Keila Alfaro-Visvikis,RETAIL SEDANOS,1386299,Dec
2024-12-09,Sedanos Supermarkets #8,Invoice,008-04395,,Discount,,,-8.1,3621229.50999999,,Keila Alfaro-Visvikis,RETAIL SEDANOS,1386300,Dec
2024-12-09,El Palacio de los jugos / Lita Foods Inc.,Invoice,008-04396,Dry Beans:Dry Beans - Black Beans 50,Dry Black Beans 50 lb,1.0,45.7,45.7,3621275.20999999,Dry Beans,Lisset Limpio -020,Cafeteria,1386301,Dec
2024-12-09,El Palacio de los jugos / Lita Foods Inc.,Invoice,008-04396,Arroz a Granel:Parboiled 50 LB -Bolsa Dos Hermanos.,,11.0,27.75,305.25,3621580.45999999,Bulk Rice,Lisset Limpio -020,Cafeteria,1386302,Dec
2024-12-09,El Palacio de los jugos / Lita Foods Inc.,Invoice,008-04396,Arroz a Granel:Parboiled 50 LB -Bolsa Dos Hermanos.,,1.0,27.75,27.75,3621608.20999999,Bulk Rice,Lisset Limpio -020,Cafeteria,1386303,Dec
2024-12-09,Panda Depot,Invoice,008-04397,Arroz a Granel (MWH):Arroz Parboil Bolsa 50LB Dos hermanos (MWH),,165.0,25.0,4125.0,3625733.20999999,Bulk Rice,Lisset Limpio -020,WHOLESALER,1386304,Dec
2024-12-09,El Palacio de los jugos / Delicias Criollas (DIAGO FOOD_MILLER),Invoice,008-04398,Arroz a Granel:Parboiled 50 LB -Bolsa Dos Hermanos.,,11.0,27.75,305.25,3626038.45999999,Bulk Rice,Lisset Limpio -020,Cafeteria,1386305,Dec
2024-12-09,El Palacio de los jugos / Delicias Criollas (DIAGO FOOD_MILLER),Invoice,008-04398,Dry Beans:Dry Beans - Black Beans 50,Dry Black Beans 50 lb,1.0,45.7,45.7,3626084.15999999,Dry Beans,Lisset Limpio -020,Cafeteria,1386306,Dec
2024-12-09,El Palacio de los jugos / Delicias Criollas (DIAGO FOOD_MILLER),Invoice,008-04398,Arroz a Granel:Parboiled 50 LB -Bolsa Dos Hermanos.,,1.0,27.75,27.75,3626111.90999999,Bulk Rice,Lisset Limpio -020,Cafeteria,1386307,Dec
2024-12-09,Pacifico Chinese Restaurant,Invoice,008-04399,Arroz a Granel:Parboiled 50 LB -Bolsa Dos Hermanos.,,10.0,28.25,282.5,3626394.40999999,Bulk Rice,Lisset Limpio -020,CAFETERIA y RESTAURANTS,1386308,Dec
2024-12-09,Sedanos Supermarkets #32,Invoice,008-04400,Arroz Envasado:Largo Fino 1kg (Long grain rice) Dos Hermanos,,2.0,17.5,35.0,3626429.40999999,Branded Rice,Keila Alfaro-Visvikis,RETAIL SEDANOS,1386309,Dec
2024-12-09,Sedanos Supermarkets #32,Invoice,008-04400,Arroz Envasado:Parboiled 1kg Bolsa Dos Hermanos.,.,3.0,19.9,59.7,3626489.10999999,Branded Rice,Keila Alfaro-Visvikis,RETAIL SEDANOS,1386310,Dec
2024-12-09,Sedanos Supermarkets #32,Invoice,008-04400,Rice Snack:Rice Snack Ham Flavored DOS HERMANOS,,1.0,19.9,19.9,3626509.00999999,Puffed Products,Keila Alfaro-Visvikis,RETAIL SEDANOS,1386311,Dec
2024-12-09,Sedanos Supermarkets #32,Invoice,008-04400,Arroz Envasado:Parboiled 5KG Dos Hermanos.,6 / 11lbs,6.0,40.5,243.0,3626752.00999999,Branded Rice,Keila Alfaro-Visvikis,RETAIL SEDANOS,1386312,Dec
2024-12-09,Sedanos Supermarkets #32,Invoice,008-04400,Arroz Envasado:Largo Fino 1kg (Long grain rice) Dos Hermanos,,1.0,17.5,17.5,3626769.50999999,Branded Rice,Keila Alfaro-Visvikis,RETAIL SEDANOS,1386313,Dec
2024-12-09,Sedanos Supermarkets #32,Invoice,008-04400,Arroz Envasado:Parboiled 5KG Dos Hermanos.,6 / 11lbs,6.0,40.5,243.0,3627012.50999999,Branded Rice,Keila Alfaro-Visvikis,RETAIL SEDANOS,1386314,Dec
2024-12-09,Sedanos Supermarkets #32,Invoice,008-04400,,Discount,,,-7.15,3627005.35999999,,Keila Alfaro-Visvikis,RETAIL SEDANOS,1386315,Dec
2024-12-09,Sedanos Supermarkets #38,Invoice,008-04401,Arroz Envasado:Largo Fino 1kg (Long grain rice) Dos Hermanos,,1.0,17.5,17.5,3627022.85999999,Branded Rice,Keila Alfaro-Visvikis,RETAIL SEDANOS,1386316,Dec
2024-12-09,Sedanos Supermarkets #38,Invoice,008-04401,Arroz Envasado:Parboiled 5KG Dos Hermanos.,6 / 11lbs,20.0,40.5,810.0,3627832.85999999,Branded Rice,Keila Alfaro-Visvikis,RETAIL SEDANOS,1386317,Dec
2024-12-09,Sedanos Supermarkets #38,Invoice,008-04401,Arroz Envasado:Parboiled 5KG Dos Hermanos.,6 / 11lbs,20.0,40.5,810.0,3628642.85999999,Branded Rice,Keila Alfaro-Visvikis,RETAIL SEDANOS,1386318,Dec
2024-12-09,Sedanos Supermarkets #38,Invoice,008-04401,,Discount,,,-16.2,3628626.65999999,,Keila Alfaro-Visvikis,RETAIL SEDANOS,1386319,Dec
2024-12-09,Sedanos Supermarkets  #37,Invoice,008-04402,Arroz a Granel:Largo Fino 50 LB -Bolsa Dos Hermanos.,,6.0,27.85,167.1,3628793.75999999,Bulk Rice,Keila Alfaro-Visvikis,RETAIL SEDANOS,1386320,Dec
2024-12-09,Sedanos Supermarkets  #37,Invoice,008-04402,,Discount,,,-3.34,3628790.41999999,,Keila Alfaro-Visvikis,RETAIL SEDANOS,1386321,Dec
2024-12-09,Sedanos Supermarkets  #37,Invoice,008-04403,Arroz Envasado:Parboiled 5KG Dos Hermanos.,6 / 11lbs,6.0,40.5,243.0,3629033.41999999,Branded Rice,Keila Alfaro-Visvikis,RETAIL SEDANOS,1386322,Dec
2024-12-09,Sedanos Supermarkets  #37,Invoice,008-04403,Arroz Envasado:Largo Fino 1kg (Long grain rice) Dos Hermanos,,1.0,17.5,17.5,3629050.91999999,Branded Rice,Keila Alfaro-Visvikis,RETAIL SEDANOS,1386323,Dec
2024-12-09,Sedanos Supermarkets  #37,Invoice,008-04403,Arroz Envasado:Parboiled 1kg Bolsa Dos Hermanos.,.,1.0,19.9,19.9,3629070.81999999,Branded Rice,Keila Alfaro-Visvikis,RETAIL SEDANOS,1386324,Dec
2024-12-09,Sedanos Supermarkets  #37,Invoice,008-04403,Arroz Envasado:Parboiled 5KG Dos Hermanos.,6 / 11lbs,6.0,40.5,243.0,3629313.81999999,Branded Rice,Keila Alfaro-Visvikis,RETAIL SEDANOS,1386325,Dec
2024-12-09,Sedanos Supermarkets  #37,Invoice,008-04403,,Discount,,,-5.61,3629308.20999999,,Keila Alfaro-Visvikis,RETAIL SEDANOS,1386326,Dec
2024-12-09,Sedanos Supermarkets #21,Invoice,008-04404,Arroz Envasado:Largo Fino 1kg (Long grain rice) Dos Hermanos,,1.0,17.5,17.5,3629325.70999999,Branded Rice,Keila Alfaro-Visvikis,RETAIL SEDANOS,1386327,Dec
2024-12-09,Sedanos Supermarkets #21,Invoice,008-04404,Arroz Envasado:Parboiled 1kg Bolsa Dos Hermanos.,.,1.0,19.9,19.9,3629345.60999999,Branded Rice,Keila Alfaro-Visvikis,RETAIL SEDANOS,1386328,Dec
2024-12-09,Sedanos Supermarkets #21,Invoice,008-04404,Rice Snack:Rice Snack Ham Flavored DOS HERMANOS,,2.0,19.9,39.8,3629385.40999999,Puffed Products,Keila Alfaro-Visvikis,RETAIL SEDANOS,1386329,Dec
2024-12-09,Sedanos Supermarkets #21,Invoice,008-04404,Rice Snack:Rice Snack Ham Flavored DOS HERMANOS,,1.0,19.9,19.9,3629405.30999999,Puffed Products,Keila Alfaro-Visvikis,RETAIL SEDANOS,1386330,Dec
2024-12-09,Sedanos Supermarkets #21,Invoice,008-04404,Rice Snack:Rice Snack Salami Flavored DOS HERMANOS,,1.0,19.9,19.9,3629425.20999999,Puffed Products,Keila Alfaro-Visvikis,RETAIL SEDANOS,1386331,Dec
2024-12-09,Sedanos Supermarkets #21,Invoice,008-04404,Arroz Envasado:Parboiled 5KG Dos Hermanos.,6 / 11lbs,10.0,40.5,405.0,3629830.20999999,Branded Rice,Keila Alfaro-Visvikis,RETAIL SEDANOS,1386332,Dec
2024-12-09,Sedanos Supermarkets #21,Invoice,008-04404,Arroz Envasado:Parboiled 5KG Dos Hermanos.,6 / 11lbs,10.0,40.5,405.0,3630235.20999999,Branded Rice,Keila Alfaro-Visvikis,RETAIL SEDANOS,1386333,Dec
2024-12-09,Sedanos Supermarkets #21,Invoice,008-04404,,Discount,,,-10.04,3630225.16999999,,Keila Alfaro-Visvikis,RETAIL SEDANOS,1386334,Dec
2024-12-09,ALS Foods,Invoice,008-04405,Arroz a Granel:Largo Fino 50 LB -Bolsa Dos Hermanos.,,8.0,27.85,222.8,3630447.96999998,Bulk Rice,Lisset Limpio -020,CAFETERIA y RESTAURANTS,1386335,Dec
2024-12-09,ALS Foods,Invoice,008-04405,Arroz a Granel:Parboiled 50 LB -Bolsa Dos Hermanos.,,11.0,27.75,305.25,3630753.21999998,Bulk Rice,Lisset Limpio -020,CAFETERIA y RESTAURANTS,1386336,Dec
2024-12-09,ALS Foods,Invoice,008-04405,Arroz a Granel:Parboiled 50 LB -Bolsa Dos Hermanos.,,1.0,27.75,27.75,3630780.96999998,Bulk Rice,Lisset Limpio -020,CAFETERIA y RESTAURANTS,1386337,Dec
2024-12-09,ALS Foods,Invoice,008-04405,Liquids:AS Cooking Wine,4/1 Gl.,2.0,17.5,35.0,3630815.96999998,American Spice,Lisset Limpio -020,CAFETERIA y RESTAURANTS,1386338,Dec
2024-12-10,El Palacio de los jugos / Delicias Criollas (DIAGO FOOD_MILLER),Credit Memo,008-04431,Varios:Promotional Allowance,,-1.0,27.75,-27.75,3630788.21999998,Bulk Rice,Lisset Limpio -020,Cafeteria,1386339,Dec
2024-12-10,Sedanos Supermarkets #32,Credit Memo,008-04432,Varios:Promotional Allowance,,-1.0,17.5,-17.5,3630770.71999998,Branded Rice,Keila Alfaro-Visvikis,RETAIL SEDANOS,1386340,Dec
2024-12-10,Sedanos Supermarkets #32,Credit Memo,008-04432,Varios:Promotional Allowance,,-6.0,40.5,-243.0,3630527.71999998,Branded Rice,Keila Alfaro-Visvikis,RETAIL SEDANOS,1386341,Dec
2024-12-10,Sedanos Supermarkets #38,Credit Memo,008-04433,Varios:Promotional Allowance,,-20.0,40.5,-810.0,3629717.71999998,Branded Rice,Keila Alfaro-Visvikis,RETAIL SEDANOS,1386342,Dec
2024-12-10,Sedanos Supermarkets #38,Credit Memo,008-04433,Varios:Promotional Allowance,,-1.0,17.5,-17.5,3629700.21999998,Branded Rice,Keila Alfaro-Visvikis,RETAIL SEDANOS,1386343,Dec
2024-12-10,Sedanos Supermarkets #28,Credit Memo,008-04434,Varios:Promotional Allowance,,-5.0,40.5,-202.5,3629497.71999998,Branded Rice,Keila Alfaro-Visvikis,RETAIL SEDANOS,1386344,Dec
2024-12-10,Sedanos Supermarkets #16,Credit Memo,008-04435,Varios:Promotional Allowance,,-15.0,40.5,-607.5,3628890.21999998,Branded Rice,Keila Alfaro-Visvikis,RETAIL SEDANOS,1386345,Dec
2024-12-10,Sedanos Supermarkets #10,Credit Memo,008-04436,Varios:Promotional Allowance,,-3.0,40.5,-121.5,3628768.71999998,Branded Rice,Keila Alfaro-Visvikis,RETAIL SEDANOS,1386346,Dec
2024-12-10,Sedanos Supermarkets #8,Credit Memo,008-04437,Varios:Promotional Allowance,,-10.0,40.5,-405.0,3628363.71999998,Branded Rice,Keila Alfaro-Visvikis,RETAIL SEDANOS,1386347,Dec
2024-12-10,El Palacio de los jugos / Lita Foods Inc.,Credit Memo,008-04438,Varios:Promotional Allowance,,-1.0,27.75,-27.75,3628335.96999998,Bulk Rice,Lisset Limpio -020,Cafeteria,1386348,Dec
2024-12-10,Sedanos Supermarkets  #37,Credit Memo,008-04439,Varios:Promotional Allowance,,-6.0,40.5,-243.0,3628092.96999998,Branded Rice,Keila Alfaro-Visvikis,RETAIL SEDANOS,1386349,Dec
2024-12-10,Sedanos Supermarkets #21,Credit Memo,008-04440,Varios:Promotional Allowance,,-10.0,40.5,-405.0,3627687.96999998,Branded Rice,Keila Alfaro-Visvikis,RETAIL SEDANOS,1386350,Dec
2024-12-10,Sedanos Supermarkets #21,Credit Memo,008-04440,Varios:Promotional Allowance,,-1.0,19.9,-19.9,3627668.06999999,Puffed Products,Keila Alfaro-Visvikis,RETAIL SEDANOS,1386351,Dec
2024-12-10,ALS Foods,Credit Memo,008-04441,Varios:Promotional Allowance,,-1.0,27.75,-27.75,3627640.31999999,Bulk Rice,Lisset Limpio -020,CAFETERIA y RESTAURANTS,1386352,Dec
2024-12-11,JMN Dely Corp,Invoice,008-04442,Arroz a Granel:Largo Fino 50 LB -Bolsa Dos Hermanos.,,2.0,27.85,55.7,3627696.01999999,Bulk Rice,Keila Alfaro-Visvikis,CAFETERIA y RESTAURANTS,1386353,Dec
2024-12-11,JMN Dely Corp,Invoice,008-04442,Arroz a Granel:Parboiled 50 LB -Bolsa Dos Hermanos.,,3.0,28.25,84.75,3627780.76999999,Bulk Rice,Keila Alfaro-Visvikis,CAFETERIA y RESTAURANTS,1386354,Dec
2024-12-11,JMN Dely Corp,Invoice,008-04442,Dry Beans:Dry Beans - Black Beans 50,Dry Black Beans 50 lb,1.0,45.7,45.7,3627826.46999999,Dry Beans,Keila Alfaro-Visvikis,CAFETERIA y RESTAURANTS,1386355,Dec
2024-12-11,Ideal Food Basket Davie Cafeteria,Invoice,008-04443,Arroz a Granel:Largo Fino 50 LB -Bolsa Dos Hermanos.,,10.0,27.85,278.5,3628104.96999999,Bulk Rice,Keila Alfaro-Visvikis,CAFETERIA y RESTAURANTS,1386356,Dec
2024-12-11,Sedanos Supermarkets #24,Invoice,008-04444,Arroz a Granel:Parboiled 50 LB -Bolsa Dos Hermanos.,,6.0,28.25,169.5,3628274.46999999,Bulk Rice,Keila Alfaro-Visvikis,RETAIL SEDANOS,1386357,Dec
2024-12-11,Sedanos Supermarkets #24,Invoice,008-04444,,Discount,,,-3.39,3628271.07999999,,Keila Alfaro-Visvikis,RETAIL SEDANOS,1386358,Dec
2024-12-11,Sedanos Supermarkets #27,Invoice,008-04445,Arroz a Granel:Parboiled 50 LB -Bolsa Dos Hermanos.,,6.0,28.25,169.5,3628440.57999999,Bulk Rice,Keila Alfaro-Visvikis,RETAIL SEDANOS,1386359,Dec
2024-12-11,Sedanos Supermarkets #27,Invoice,008-04445,,Discount,,,-3.39,3628437.18999999,,Keila Alfaro-Visvikis,RETAIL SEDANOS,1386360,Dec
2024-12-11,Sedanos Supermarkets #34,Invoice,008-04446,Arroz Envasado:Parboiled 5KG Dos Hermanos.,6 / 11lbs,2.0,40.5,81.0,3628518.18999999,Branded Rice,Keila Alfaro-Visvikis,RETAIL SEDANOS,1386361,Dec
2024-12-11,Sedanos Supermarkets #34,Invoice,008-04446,Arroz Envasado:Parboiled 5KG Dos Hermanos.,6 / 11lbs,2.0,40.5,81.0,3628599.18999999,Branded Rice,Keila Alfaro-Visvikis,RETAIL SEDANOS,1386362,Dec
2024-12-11,Sedanos Supermarkets #34,Invoice,008-04446,,Discount,,,-1.62,3628597.56999999,,Keila Alfaro-Visvikis,RETAIL SEDANOS,1386363,Dec
2024-12-11,Los Caringas Latin America  Foods,Invoice,008-04447,Arroz a Granel:Largo Fino 50 LB -Bolsa Dos Hermanos.,,3.0,27.85,83.55,3628681.11999998,Bulk Rice,Lisset Limpio -020,CAFETERIA y RESTAURANTS,1386364,Dec
2024-12-11,Los Caringas Latin America  Foods,Invoice,008-04447,Arroz a Granel:Parboiled 50 LB -Bolsa Dos Hermanos.,,3.0,28.25,84.75,3628765.86999998,Bulk Rice,Lisset Limpio -020,CAFETERIA y RESTAURANTS,1386365,Dec
2024-12-11,Sedanos Supermarkets #26,Invoice,008-04448,Arroz a Granel:Parboiled 50 LB -Bolsa Dos Hermanos.,,3.0,28.25,84.75,3628850.61999998,Bulk Rice,Keila Alfaro-Visvikis,RETAIL SEDANOS,1386366,Dec
2024-12-11,Sedanos Supermarkets #26,Invoice,008-04448,,Discount,,,-1.7,3628848.91999998,,Keila Alfaro-Visvikis,RETAIL SEDANOS,1386367,Dec
2024-12-11,Sedanos Supermarkets #16,Invoice,008-04449,Arroz a Granel:Parboiled 50 LB -Bolsa Dos Hermanos.,,3.0,28.25,84.75,3628933.66999998,Bulk Rice,Keila Alfaro-Visvikis,RETAIL SEDANOS,1386368,Dec
2024-12-11,Sedanos Supermarkets #16,Invoice,008-04449,,Discount,,,-1.7,3628931.96999998,,Keila Alfaro-Visvikis,RETAIL SEDANOS,1386369,Dec
2024-12-11,Sedanos Supermarkets #43,Invoice,008-04450,Arroz a Granel:Parboiled 50 LB -Bolsa Dos Hermanos.,,5.0,28.25,141.25,3629073.21999998,Bulk Rice,Keila Alfaro-Visvikis,RETAIL SEDANOS,1386370,Dec
2024-12-11,Sedanos Supermarkets #43,Invoice,008-04450,,Discount,,,-2.83,3629070.38999998,,Keila Alfaro-Visvikis,RETAIL SEDANOS,1386371,Dec
2024-12-11,Sedanos Supermarkets #34,Credit Memo,008-04533,Varios:Promotional Allowance,5kg,-2.0,40.5,-81.0,3628989.38999998,Branded Rice,Keila Alfaro-Visvikis,RETAIL SEDANOS,1386372,Dec
2024-12-12,Bravo   Francisco Diaz,Invoice,008-04451,Arroz a Granel:Largo Fino 50 LB -Bolsa Dos Hermanos.,,5.0,27.85,139.25,3629128.63999998,Bulk Rice,Lisset Limpio -020,RETAIL  DSD,1386373,Dec
2024-12-12,El Palacio de los jugos /  EMMA FOOD CORP,Invoice,008-04452,Arroz a Granel:Parboiled 50 LB -Bolsa Dos Hermanos.,,8.0,26.75,214.0,3629342.63999998,Bulk Rice,Lisset Limpio -020,Cafeteria,1386374,Dec
2024-12-12,"El Toro Loco Meat Distribution, LLC",Invoice,008-04453,Arroz a Granel:Largo Fino 50 LB -Bolsa Dos Hermanos.,,55.0,27.85,1531.75,3630874.38999998,Bulk Rice,Lisset Limpio -020,CAFETERIA y RESTAURANTS,1386375,Dec
2024-12-12,El Palacio de los jugos / Lita Foods Inc.,Invoice,008-04454,Dry Beans:Dry Beans - Black Beans 50,Dry Black Beans 50 lb,1.0,45.7,45.7,3630920.08999998,Dry Beans,Lisset Limpio -020,Cafeteria,1386376,Dec
2024-12-12,El Palacio de los jugos / Lita Foods Inc.,Invoice,008-04454,Arroz a Granel:Parboiled 50 LB -Bolsa Dos Hermanos.,,11.0,27.75,305.25,3631225.33999998,Bulk Rice,Lisset Limpio -020,Cafeteria,1386377,Dec
2024-12-12,El Palacio de los jugos / Lita Foods Inc.,Invoice,008-04454,Arroz a Granel:Parboiled 50 LB -Bolsa Dos Hermanos.,,1.0,27.75,27.75,3631253.08999998,Bulk Rice,Lisset Limpio -020,Cafeteria,1386378,Dec
2024-12-12,El Palacio de los jugos /  Nanos Latin Foods,Invoice,008-04455,Arroz a Granel:Largo Fino 50 LB -Bolsa Dos Hermanos.,,10.0,27.85,278.5,3631531.58999998,Bulk Rice,Lisset Limpio -020,Cafeteria,1386379,Dec
2024-12-12,El Palacio de los jugos /  Nanos Latin Foods,Invoice,008-04455,Arroz a Granel:Parboiled 50 LB -Bolsa Dos Hermanos.,,10.0,26.75,267.5,3631799.08999998,Bulk Rice,Lisset Limpio -020,Cafeteria,1386380,Dec
2024-12-12,Hings Chinese,Invoice,008-04456,Arroz a Granel:Parboiled 50 LB -Bolsa Dos Hermanos.,,5.0,28.25,141.25,3631940.33999998,Bulk Rice,Lisset Limpio -020,CAFETERIA y RESTAURANTS,1386381,Dec
2024-12-12,El Palacio de los jugos /  Mires Restaurants,Invoice,008-04457,Liquids:AS Marinating Sauce (Mojo),,1.0,18.5,18.5,3631958.83999998,American Spice,Lisset Limpio -020,Cafeteria,1386382,Dec
2024-12-12,El Palacio de los jugos /  Mires Restaurants,Invoice,008-04457,Arroz a Granel:Parboiled 50 LB -Bolsa Dos Hermanos.,,11.0,27.75,305.25,3632264.08999998,Bulk Rice,Lisset Limpio -020,Cafeteria,1386383,Dec
2024-12-12,El Palacio de los jugos /  Mires Restaurants,Invoice,008-04457,Arroz a Granel:Parboiled 50 LB -Bolsa Dos Hermanos.,,1.0,27.75,27.75,3632291.83999998,Bulk Rice,Lisset Limpio -020,Cafeteria,1386384,Dec
2024-12-12,Be Your Will LLC,Invoice,008-04458,Liquids:AS Cooking Wine,4/1 Gl.,1.0,17.5,17.5,3632309.33999998,American Spice,Lisset Limpio -020,CAFETERIA y RESTAURANTS,1386385,Dec
2024-12-12,Be Your Will LLC,Invoice,008-04458,Arroz a Granel:Largo Fino 50 LB -Bolsa Dos Hermanos.,,6.0,27.85,167.1,3632476.43999998,Bulk Rice,Lisset Limpio -020,CAFETERIA y RESTAURANTS,1386386,Dec
2024-12-12,Be Your Will LLC,Invoice,008-04458,Arroz a Granel:Parboiled 50 LB -Bolsa Dos Hermanos.,,11.0,27.75,305.25,3632781.68999998,Bulk Rice,Lisset Limpio -020,CAFETERIA y RESTAURANTS,1386387,Dec
2024-12-12,Be Your Will LLC,Invoice,008-04458,Arroz a Granel:Parboiled 50 LB -Bolsa Dos Hermanos.,,1.0,27.75,27.75,3632809.43999998,Bulk Rice,Lisset Limpio -020,CAFETERIA y RESTAURANTS,1386388,Dec
2024-12-12,El Palacio de Los Jugos / Casa mía Food Restaurant inc,Invoice,008-04459,Arroz a Granel:Parboiled 50 LB -Bolsa Dos Hermanos.,,11.0,27.75,305.25,3633114.68999998,Bulk Rice,Lisset Limpio -020,Cafeteria,1386389,Dec
2024-12-12,El Palacio de Los Jugos / Casa mía Food Restaurant inc,Invoice,008-04459,Dry Beans:Dry Beans - Black Beans 50,Dry Black Beans 50 lb,1.0,45.7,45.7,3633160.38999998,Dry Beans,Lisset Limpio -020,Cafeteria,1386390,Dec
2024-12-12,El Palacio de Los Jugos / Casa mía Food Restaurant inc,Invoice,008-04459,Arroz a Granel:Parboiled 50 LB -Bolsa Dos Hermanos.,,1.0,27.75,27.75,3633188.13999998,Bulk Rice,Lisset Limpio -020,Cafeteria,1386391,Dec
2024-12-12,Sedanos Supermarkets #32,Invoice,008-04460,Arroz a Granel:Largo Fino 50 LB -Bolsa Dos Hermanos.,,3.0,27.85,83.55,3633271.68999998,Bulk Rice,Keila Alfaro-Visvikis,RETAIL SEDANOS,1386392,Dec
2024-12-12,Sedanos Supermarkets #32,Invoice,008-04460,,Discount,,,-1.67,3633270.01999998,,Keila Alfaro-Visvikis,RETAIL SEDANOS,1386393,Dec
2024-12-12,"Meat Club Market, LLC.",Invoice,008-04461,Arroz Envasado:Largo Fino 1kg (Long grain rice) Dos Hermanos,,2.0,17.5,35.0,3633305.01999998,Branded Rice,Lisset Limpio -020,RETAIL  DSD,1386394,Dec
2024-12-12,"Meat Club Market, LLC.",Invoice,008-04461,Arroz Envasado:Parboiled 1kg Bolsa Dos Hermanos.,.,2.0,19.9,39.8,3633344.81999998,Branded Rice,Lisset Limpio -020,RETAIL  DSD,1386395,Dec
2024-12-12,"Meat Club Market, LLC.",Invoice,008-04461,Arroz Envasado:Sushi Rice Dos Hermanos.,.,3.0,25.5,76.5,3633421.31999998,Branded Rice,Lisset Limpio -020,RETAIL  DSD,1386396,Dec
2024-12-12,"Meat Club Market, LLC.",Invoice,008-04461,Arroz Envasado:Sushi Rice Dos Hermanos 5kg.,,3.0,60.0,180.0,3633601.31999998,Branded Rice,Lisset Limpio -020,RETAIL  DSD,1386397,Dec
2024-12-12,Sedanos Supermarkets #33,Invoice,008-04462,Arroz a Granel:Parboiled 50 LB -Bolsa Dos Hermanos.,,4.0,28.25,113.0,3633714.31999998,Bulk Rice,Keila Alfaro-Visvikis,RETAIL SEDANOS,1386398,Dec
2024-12-12,Sedanos Supermarkets #33,Invoice,008-04462,,Discount,,,-2.26,3633712.05999998,,Keila Alfaro-Visvikis,RETAIL SEDANOS,1386399,Dec
2024-12-12,Sedanos Supermarkets #18,Invoice,008-04463,Arroz a Granel:Parboiled 50 LB -Bolsa Dos Hermanos.,,15.0,28.25,423.75,3634135.80999998,Bulk Rice,Keila Alfaro-Visvikis,RETAIL SEDANOS,1386400,Dec
2024-12-12,Sedanos Supermarkets #18,Invoice,008-04463,,Discount,,,-8.48,3634127.32999998,,Keila Alfaro-Visvikis,RETAIL SEDANOS,1386401,Dec
2024-12-12,Sedanos Supermarkets #18,Invoice,008-04464,Arroz Envasado:Largo Fino 1kg (Long grain rice) Dos Hermanos,,1.0,17.5,17.5,3634144.82999998,Branded Rice,Keila Alfaro-Visvikis,RETAIL SEDANOS,1386402,Dec
2024-12-12,Sedanos Supermarkets #18,Invoice,008-04464,Arroz Envasado:Parboiled 1kg Bolsa Dos Hermanos.,.,1.0,19.9,19.9,3634164.72999998,Branded Rice,Keila Alfaro-Visvikis,RETAIL SEDANOS,1386403,Dec
2024-12-12,Sedanos Supermarkets #18,Invoice,008-04464,,Discount,,,-0.75,3634163.97999998,,Keila Alfaro-Visvikis,RETAIL SEDANOS,1386404,Dec
2024-12-12,El Palacio de los jugos / Lita Foods Inc.,Credit Memo,008-04534,Varios:Promotional Allowance,,-1.0,27.75,-27.75,3634136.22999998,Bulk Rice,Lisset Limpio -020,Cafeteria,1386405,Dec
2024-12-12,El Palacio de los jugos /  Mires Restaurants,Credit Memo,008-04535,Varios:Promotional Allowance,,-1.0,27.75,-27.75,3634108.47999998,Bulk Rice,Lisset Limpio -020,Cafeteria,1386406,Dec
2024-12-12,Be Your Will LLC,Credit Memo,008-04536,Varios:Promotional Allowance,,-1.0,27.75,-27.75,3634080.72999998,Bulk Rice,Lisset Limpio -020,CAFETERIA y RESTAURANTS,1386407,Dec
2024-12-12,El Palacio de Los Jugos / Casa mía Food Restaurant inc,Credit Memo,008-04537,Varios:Promotional Allowance,,-1.0,27.75,-27.75,3634052.97999998,Bulk Rice,Lisset Limpio -020,Cafeteria,1386408,Dec
2024-12-13,Rey Chavez Distributor Corp,Invoice,008-04465,Arroz a Granel:Parboiled 50 LB -Bolsa Dos Hermanos.,,110.0,28.8,3168.0,3637220.97999998,Bulk Rice,Lisset Limpio -020,WHOLESALER,1386409,Dec
2024-12-13,Rey Chavez Distributor #2,Invoice,008-04466,Arroz a Granel:Parboiled 50 LB -Bolsa Dos Hermanos.,,20.0,28.8,576.0,3637796.97999998,Bulk Rice,Lisset Limpio -020,WHOLESALER,1386410,Dec
2024-12-13,Aries Supermarket & Cafeteria,Invoice,008-04467,Arroz a Granel:Parboiled 50 LB -Bolsa Dos Hermanos.,,10.0,28.25,282.5,3638079.47999998,Bulk Rice,Keila Alfaro-Visvikis,CAFETERIA y RESTAURANTS,1386411,Dec
2024-12-14,Sedanos Supermarkets #32,Invoice,008-04468,Arroz a Granel:Parboiled 50 LB -Bolsa Dos Hermanos.,,3.0,28.25,84.75,3638164.22999998,Bulk Rice,Keila Alfaro-Visvikis,RETAIL SEDANOS,1386412,Dec
2024-12-14,Sedanos Supermarkets #32,Invoice,008-04468,,Discount,,,-1.7,3638162.52999998,,Keila Alfaro-Visvikis,RETAIL SEDANOS,1386413,Dec
2024-12-16,El Palacio de los jugos / Lita Foods Inc.,Invoice,008-04469,Dry Beans:Dry Beans - Black Beans 50,Dry Black Beans 50 lb,1.0,45.7,45.7,3638208.22999998,Dry Beans,Lisset Limpio -020,Cafeteria,1386414,Dec
2024-12-16,El Palacio de los jugos / Lita Foods Inc.,Invoice,008-04469,Arroz a Granel:Parboiled 50 LB -Bolsa Dos Hermanos.,,11.0,27.75,305.25,3638513.47999998,Bulk Rice,Lisset Limpio -020,Cafeteria,1386415,Dec
2024-12-16,El Palacio de los jugos / Lita Foods Inc.,Invoice,008-04469,Arroz a Granel:Parboiled 50 LB -Bolsa Dos Hermanos.,,1.0,27.75,27.75,3638541.22999998,Bulk Rice,Lisset Limpio -020,Cafeteria,1386416,Dec
2024-12-16,El Palacio de los jugos /  EMMA FOOD CORP,Invoice,008-04470,Arroz a Granel:Parboiled 50 LB -Bolsa Dos Hermanos.,,8.0,26.75,214.0,3638755.22999998,Bulk Rice,Lisset Limpio -020,Cafeteria,1386417,Dec
2024-12-16,El Palacio de los jugos /  Nanos Latin Foods,Invoice,008-04471,Arroz a Granel:Parboiled 50 LB -Bolsa Dos Hermanos.,,8.0,26.75,214.0,3638969.22999998,Bulk Rice,Lisset Limpio -020,Cafeteria,1386418,Dec
2024-12-16,Sister Eva Perez,Invoice,008-04472,"Rice Snack:Rice Snack, Pizza DH",,47.0,19.9,935.3,3639904.52999998,Puffed Products,Armando Carpio - 017,,1386419,Dec
2024-12-16,JMN Dely Corp,Invoice,008-04473,Arroz a Granel:Largo Fino 50 LB -Bolsa Dos Hermanos.,,2.0,27.85,55.7,3639960.22999998,Bulk Rice,Keila Alfaro-Visvikis,CAFETERIA y RESTAURANTS,1386420,Dec
2024-12-16,JMN Dely Corp,Invoice,008-04473,Arroz a Granel:Parboiled 50 LB -Bolsa Dos Hermanos.,,3.0,27.75,83.25,3640043.47999998,Bulk Rice,Keila Alfaro-Visvikis,CAFETERIA y RESTAURANTS,1386421,Dec
2024-12-16,JMN Dely Corp,Invoice,008-04473,Dry Beans:Dry Beans - Black Beans 50,Dry Black Beans 50 lb,1.0,45.7,45.7,3640089.17999998,Dry Beans,Keila Alfaro-Visvikis,CAFETERIA y RESTAURANTS,1386422,Dec
2024-12-16,Price Choice 5 YNTO Food Corp.,Invoice,008-04474,Arroz Envasado:Largo Fino 1kg (Long grain rice) Dos Hermanos,,1.0,17.5,17.5,3640106.67999998,Branded Rice,Keila Alfaro-Visvikis,RETAIL  DSD,1386423,Dec
2024-12-16,"American Spice Trading Co, Inc.",Invoice,008-04475,Arroz a Granel (MWH):Arroz Parboil Bolsa 50LB Dos hermanos (MWH),,1100.0,27.5,30250.0,3670356.67999998,Bulk Rice,Armando Carpio - 017,WHOLESALER MANUFACTURY,1386424,Dec
2024-12-16,El Palacio de los jugos / Delicias Criollas (DIAGO FOOD_MILLER),Invoice,008-04476,Arroz a Granel:Parboiled 50 LB -Bolsa Dos Hermanos.,,11.0,27.75,305.25,3670661.92999998,Bulk Rice,Lisset Limpio -020,Cafeteria,1386425,Dec
2024-12-16,El Palacio de los jugos / Delicias Criollas (DIAGO FOOD_MILLER),Invoice,008-04476,Dry Beans:Dry Beans - Black Beans 50,Dry Black Beans 50 lb,1.0,45.7,45.7,3670707.62999999,Dry Beans,Lisset Limpio -020,Cafeteria,1386426,Dec
2024-12-16,El Palacio de los jugos / Delicias Criollas (DIAGO FOOD_MILLER),Invoice,008-04476,Arroz a Granel:Parboiled 50 LB -Bolsa Dos Hermanos.,,1.0,27.75,27.75,3670735.37999999,Bulk Rice,Lisset Limpio -020,Cafeteria,1386427,Dec
2024-12-16,Bravo   Francisco Diaz,Invoice,008-04477,Arroz a Granel:Largo Fino 50 LB -Bolsa Dos Hermanos.,,5.0,27.85,139.25,3670874.62999999,Bulk Rice,Lisset Limpio -020,RETAIL  DSD,1386428,Dec
2024-12-16,Bravo   Francisco Diaz,Invoice,008-04477,Liquids:AS Cooking Wine,4/1 Gl.,3.0,17.5,52.5,3670927.12999999,American Spice,Lisset Limpio -020,RETAIL  DSD,1386429,Dec
2024-12-16,Bravo   Francisco Diaz,Invoice,008-04477,Liquids:AS Marinating Sauce (Mojo),,3.0,18.5,55.5,3670982.62999999,American Spice,Lisset Limpio -020,RETAIL  DSD,1386430,Dec
2024-12-16,Bravo   Francisco Diaz,Invoice,008-04477,Liquids:AS White Vinegar,4/1 Gl.,3.0,10.0,30.0,3671012.62999999,American Spice,Lisset Limpio -020,RETAIL  DSD,1386431,Dec
2024-12-16,Sedanos Supermarkets  #37,Invoice,008-04478,Arroz a Granel:Largo Fino 50 LB -Bolsa Dos Hermanos.,,6.0,27.85,167.1,3671179.72999999,Bulk Rice,Keila Alfaro-Visvikis,RETAIL SEDANOS,1386432,Dec
2024-12-16,Sedanos Supermarkets  #37,Invoice,008-04478,,Discount,,,-3.34,3671176.38999999,,Keila Alfaro-Visvikis,RETAIL SEDANOS,1386433,Dec
2024-12-16,Soriano Brothers PB,Invoice,008-04479,Spices:AS Sazon (for all),1 / 30 lb (box or pail),5.0,51.0,255.0,3671431.38999999,American Spice,Lisset Limpio -020,CAFETERIA y RESTAURANTS,1386434,Dec
2024-12-16,Soriano Brothers PB,Invoice,008-04479,Arroz a Granel:Largo Fino 50 LB -Bolsa Dos Hermanos.,,10.0,27.85,278.5,3671709.88999999,Bulk Rice,Lisset Limpio -020,CAFETERIA y RESTAURANTS,1386435,Dec
2024-12-16,Soriano Brothers PB,Invoice,008-04479,Arroz a Granel:Parboiled 50 LB -Bolsa Dos Hermanos.,,22.0,27.75,610.5,3672320.38999999,Bulk Rice,Lisset Limpio -020,CAFETERIA y RESTAURANTS,1386436,Dec
2024-12-16,Soriano Brothers PB,Invoice,008-04479,Arroz a Granel:Parboiled 50 LB -Bolsa Dos Hermanos.,,2.0,27.75,55.5,3672375.88999999,Bulk Rice,Lisset Limpio -020,CAFETERIA y RESTAURANTS,1386437,Dec
2024-12-16,"Soriano Brothers Diaz Food Service,Inc",Invoice,008-04480,Dry Beans:Dry Beans - Black Beans 50,Dry Black Beans 50 lb,16.0,45.7,731.2,3673107.08999999,Dry Beans,Lisset Limpio -020,CAFETERIA y RESTAURANTS,1386438,Dec
2024-12-16,"Soriano Brothers Diaz Food Service,Inc",Invoice,008-04480,Arroz a Granel:Parboiled 50 LB -Bolsa Dos Hermanos.,,55.0,27.75,1526.25,3674633.33999999,Bulk Rice,Lisset Limpio -020,CAFETERIA y RESTAURANTS,1386439,Dec
2024-12-16,"Soriano Brothers Diaz Food Service,Inc",Invoice,008-04480,Arroz a Granel:Parboiled 50 LB -Bolsa Dos Hermanos.,,5.0,27.75,138.75,3674772.08999999,Bulk Rice,Lisset Limpio -020,CAFETERIA y RESTAURANTS,1386440,Dec
2024-12-16,Sedanos Supermarkets #31,Invoice,008-04481,Arroz a Granel:Parboiled 50 LB -Bolsa Dos Hermanos.,,4.0,28.25,113.0,3674885.08999999,Bulk Rice,Keila Alfaro-Visvikis,RETAIL SEDANOS,1386441,Dec
2024-12-16,Sedanos Supermarkets #31,Invoice,008-04481,,Discount,,,-2.26,3674882.82999999,,Keila Alfaro-Visvikis,RETAIL SEDANOS,1386442,Dec
2024-12-16,El Palacio de los jugos / Lita Foods Inc.,Credit Memo,008-04538,Varios:Promotional Allowance,,-1.0,27.75,-27.75,3674855.07999999,Bulk Rice,Lisset Limpio -020,Cafeteria,1386443,Dec
2024-12-16,Sister Eva Perez,Credit Memo,008-04539,Varios:Promotional Allowance,DONACION SNACK||,-47.0,19.9,-935.3,3673919.77999999,Puffed Products,Armando Carpio - 017,,1386444,Dec
2024-12-16,El Palacio de los jugos / Delicias Criollas (DIAGO FOOD_MILLER),Credit Memo,008-04540,Varios:Promotional Allowance,,-1.0,27.75,-27.75,3673892.02999999,Bulk Rice,Lisset Limpio -020,Cafeteria,1386445,Dec
2024-12-16,Soriano Brothers PB,Credit Memo,008-04541,Varios:Promotional Allowance,,-2.0,27.75,-55.5,3673836.52999999,Bulk Rice,Lisset Limpio -020,CAFETERIA y RESTAURANTS,1386446,Dec
2024-12-16,"Soriano Brothers Diaz Food Service,Inc",Credit Memo,008-04542,Varios:Promotional Allowance,,-5.0,27.75,-138.75,3673697.77999999,Bulk Rice,Lisset Limpio -020,CAFETERIA y RESTAURANTS,1386447,Dec
2024-12-17,Panda Depot,Invoice,008-04482,Arroz a Granel (MWH):Arroz Parboil Bolsa 50LB Dos hermanos (MWH),,275.0,25.0,6875.0,3680572.77999999,Bulk Rice,Lisset Limpio -020,WHOLESALER,1386448,Dec
2024-12-19,Sedanos Supermarkets #34,Invoice,008-04483,Arroz a Granel:Parboiled 50 LB -Bolsa Dos Hermanos.,,12.0,28.25,339.0,3680911.77999999,Bulk Rice,Keila Alfaro-Visvikis,RETAIL SEDANOS,1386449,Dec
2024-12-19,Sedanos Supermarkets #34,Invoice,008-04483,,Discount,,,-6.78,3680904.99999999,,Keila Alfaro-Visvikis,RETAIL SEDANOS,1386450,Dec
2024-12-19,Sedanos Supermarkets #33,Invoice,008-04484,Arroz a Granel:Parboiled 50 LB -Bolsa Dos Hermanos.,,4.0,28.25,113.0,3681017.99999999,Bulk Rice,Keila Alfaro-Visvikis,RETAIL SEDANOS,1386451,Dec
2024-12-19,Sedanos Supermarkets #33,Invoice,008-04484,,Discount,,,-2.26,3681015.73999999,,Keila Alfaro-Visvikis,RETAIL SEDANOS,1386452,Dec
2024-12-19,Sedanos Supermarkets #24,Invoice,008-04485,Arroz a Granel:Parboiled 50 LB -Bolsa Dos Hermanos.,,10.0,28.25,282.5,3681298.23999999,Bulk Rice,Keila Alfaro-Visvikis,RETAIL SEDANOS,1386453,Dec
2024-12-19,Sedanos Supermarkets #24,Invoice,008-04485,,Discount,,,-5.65,3681292.58999999,,Keila Alfaro-Visvikis,RETAIL SEDANOS,1386454,Dec
2024-12-19,Ideal Food Basket Davie Cafeteria,Invoice,008-04486,Arroz a Granel:Largo Fino 50 LB -Bolsa Dos Hermanos.,,7.0,27.85,194.95,3681487.53999999,Bulk Rice,Keila Alfaro-Visvikis,CAFETERIA y RESTAURANTS,1386455,Dec
2024-12-19,Sedanos Supermarkets #43,Invoice,008-04487,Arroz a Granel:Parboiled 50 LB -Bolsa Dos Hermanos.,,7.0,28.25,197.75,3681685.28999999,Bulk Rice,Keila Alfaro-Visvikis,RETAIL SEDANOS,1386456,Dec
2024-12-19,Sedanos Supermarkets #43,Invoice,008-04487,,Discount,,,-3.96,3681681.32999999,,Keila Alfaro-Visvikis,RETAIL SEDANOS,1386457,Dec
2024-12-19,El Palacio de Los Jugos / Casa mía Food Restaurant inc,Invoice,008-04488,Dry Beans:Dry Beans - Black Beans 50,Dry Black Beans 50 lb,1.0,45.7,45.7,3681727.02999999,Dry Beans,Lisset Limpio -020,Cafeteria,1386458,Dec
2024-12-19,El Palacio de Los Jugos / Casa mía Food Restaurant inc,Invoice,008-04488,Arroz a Granel:Parboiled 50 LB -Bolsa Dos Hermanos.,,11.0,27.75,305.25,3682032.27999999,Bulk Rice,Lisset Limpio -020,Cafeteria,1386459,Dec
2024-12-19,El Palacio de Los Jugos / Casa mía Food Restaurant inc,Invoice,008-04488,Arroz a Granel:Parboiled 50 LB -Bolsa Dos Hermanos.,,1.0,28.25,28.25,3682060.52999999,Bulk Rice,Lisset Limpio -020,Cafeteria,1386460,Dec
2024-12-19,Sedanos Supermarkets #22,Invoice,008-04489,Arroz a Granel:Parboiled 50 LB -Bolsa Dos Hermanos.,,5.0,28.25,141.25,3682201.77999999,Bulk Rice,Keila Alfaro-Visvikis,RETAIL SEDANOS,1386461,Dec
2024-12-19,Sedanos Supermarkets #22,Invoice,008-04489,,Discount,,,-2.83,3682198.94999999,,Keila Alfaro-Visvikis,RETAIL SEDANOS,1386462,Dec
2024-12-19,Sedanos Supermarkets #16,Invoice,008-04490,Arroz a Granel:Parboiled 50 LB -Bolsa Dos Hermanos.,,6.0,28.25,169.5,3682368.44999999,Bulk Rice,Keila Alfaro-Visvikis,RETAIL SEDANOS,1386463,Dec
2024-12-19,Sedanos Supermarkets #16,Invoice,008-04490,,Discount,,,-3.39,3682365.05999999,,Keila Alfaro-Visvikis,RETAIL SEDANOS,1386464,Dec
2024-12-19,Soriano Brothers,Invoice,008-04491,Dry Beans:Dry Beans - Black Beans 50,Dry Black Beans 50 lb,6.0,38.0,228.0,3682593.05999999,Dry Beans,Lisset Limpio -020,CAFETERIA y RESTAURANTS,1386465,Dec
2024-12-19,Soriano Brothers,Invoice,008-04491,Arroz a Granel:Parboiled 50 LB -Bolsa Dos Hermanos.,,27.0,26.75,722.25,3683315.30999999,Bulk Rice,Lisset Limpio -020,CAFETERIA y RESTAURANTS,1386466,Dec
2024-12-19,Sedanos Supermarkets #27,Invoice,008-04492,Arroz a Granel:Parboiled 50 LB -Bolsa Dos Hermanos.,,6.0,28.25,169.5,3683484.80999999,Bulk Rice,Keila Alfaro-Visvikis,RETAIL SEDANOS,1386467,Dec
2024-12-19,Sedanos Supermarkets #27,Invoice,008-04492,,Discount,,,-3.39,3683481.41999999,,Keila Alfaro-Visvikis,RETAIL SEDANOS,1386468,Dec
2024-12-19,Key Food / Holywood,Invoice,008-04493,Arroz Envasado:Largo Fino 1kg (Long grain rice) Dos Hermanos,,10.0,17.5,175.0,3683656.41999999,Branded Rice,Keila Alfaro-Visvikis,RETAIL  DSD,1386469,Dec
2024-12-19,Key Food / Holywood,Invoice,008-04493,Arroz Envasado:Largo Fino 1kg (Long grain rice) Dos Hermanos,,2.0,17.5,35.0,3683691.41999999,Branded Rice,Keila Alfaro-Visvikis,RETAIL  DSD,1386470,Dec
2024-12-19,Mango Tree Supermarket,Invoice,008-04494,Arroz Envasado:Largo Fino 1kg (Long grain rice) Dos Hermanos,,3.0,17.5,52.5,3683743.91999999,Branded Rice,Keila Alfaro-Visvikis,RETAIL  DSD,1386471,Dec
2024-12-19,Mango Tree Supermarket,Invoice,008-04494,Arroz Envasado:Parboiled 1kg Bolsa Dos Hermanos.,.,2.0,19.9,39.8,3683783.71999999,Branded Rice,Keila Alfaro-Visvikis,RETAIL  DSD,1386472,Dec
2024-12-19,Key Food Pembroke,Invoice,008-04495,Arroz Envasado:Largo Fino 1kg (Long grain rice) Dos Hermanos,,3.0,18.0,54.0,3683837.71999999,Branded Rice,Keila Alfaro-Visvikis,RETAIL  DSD,1386473,Dec
2024-12-19,Los Mejores Tamales de Miami,Invoice,008-04496,Arroz a Granel:Parboiled 50 LB -Bolsa Dos Hermanos.,,10.0,28.25,282.5,3684120.21999999,Bulk Rice,Lisset Limpio -020,CAFETERIA y RESTAURANTS,1386474,Dec
2024-12-19,El Palacio de los jugos / Leti Corp.,Credit Memo,008-04497,Varios:Producto vencido/deteriorado (no impacta en inventario),Cierre saldo,-1.0,0.1,-0.1,3684120.11999999,,Lisset Limpio -020,Cafeteria,1386475,Dec
2024-12-19,Key Foods 40 St,Invoice,008-04498,Arroz a Granel:Parboiled 50 LB -Bolsa Dos Hermanos.,,4.0,28.25,113.0,3684233.11999999,Bulk Rice,Keila Alfaro-Visvikis,RETAIL  DSD,1386476,Dec
2024-12-19,El Palacio de los jugos /  EMMA FOOD CORP,Invoice,008-04499,Arroz a Granel:Parboiled 50 LB -Bolsa Dos Hermanos.,,12.0,26.75,321.0,3684554.11999999,Bulk Rice,Lisset Limpio -020,Cafeteria,1386477,Dec
2024-12-19,El Palacio de los jugos / Lita Foods Inc.,Invoice,008-04500,Dry Beans:Dry Beans - Black Beans 50,Dry Black Beans 50 lb,1.0,45.7,45.7,3684599.81999999,Dry Beans,Lisset Limpio -020,Cafeteria,1386478,Dec
2024-12-19,El Palacio de los jugos / Lita Foods Inc.,Invoice,008-04500,Arroz a Granel:Parboiled 50 LB -Bolsa Dos Hermanos.,,55.0,27.75,1526.25,3686126.06999999,Bulk Rice,Lisset Limpio -020,Cafeteria,1386479,Dec
2024-12-19,El Palacio de los jugos / Lita Foods Inc.,Invoice,008-04500,Arroz a Granel:Parboiled 50 LB -Bolsa Dos Hermanos.,,5.0,27.75,138.75,3686264.81999999,Bulk Rice,Lisset Limpio -020,Cafeteria,1386480,Dec
2024-12-19,El Gallego Supermarket,Invoice,008-04501,Dry Beans:Dry Beans - Black Beans 50,Dry Black Beans 50 lb,4.0,45.7,182.8,3686447.61999999,Dry Beans,Lisset Limpio -020,RETAIL  DSD,1386481,Dec
2024-12-19,El Gallego Supermarket,Invoice,008-04501,Arroz a Granel:Parboiled 50 LB -Bolsa Dos Hermanos.,,10.0,28.25,282.5,3686730.11999999,Bulk Rice,Lisset Limpio -020,RETAIL  DSD,1386482,Dec
2024-12-19,Sorianos Brothers,Invoice,008-04502,Dry Beans:Dry Beans - Black Beans 50,Dry Black Beans 50 lb,6.0,38.0,228.0,3686958.11999999,Dry Beans,Lisset Limpio -020,CAFETERIA y RESTAURANTS,1386483,Dec
2024-12-19,Sorianos Brothers,Invoice,008-04502,Arroz a Granel:Parboiled 50 LB -Bolsa Dos Hermanos.,,25.0,26.75,668.75,3687626.86999999,Bulk Rice,Lisset Limpio -020,CAFETERIA y RESTAURANTS,1386484,Dec
2024-12-19,Sedanos Supermarkets #32,Invoice,008-04503,Arroz a Granel:Largo Fino 50 LB -Bolsa Dos Hermanos.,,3.0,27.85,83.55,3687710.41999999,Bulk Rice,Keila Alfaro-Visvikis,RETAIL SEDANOS,1386485,Dec
2024-12-19,Sedanos Supermarkets #32,Invoice,008-04503,Arroz a Granel:Parboiled 50 LB -Bolsa Dos Hermanos.,,2.0,28.25,56.5,3687766.91999999,Bulk Rice,Keila Alfaro-Visvikis,RETAIL SEDANOS,1386486,Dec
2024-12-19,Sedanos Supermarkets #32,Invoice,008-04503,,Discount,,,-2.8,3687764.11999999,,Keila Alfaro-Visvikis,RETAIL SEDANOS,1386487,Dec
2024-12-19,Sedanos Supermarkets #18,Invoice,008-04504,Arroz a Granel:Parboiled 50 LB -Bolsa Dos Hermanos.,,6.0,28.25,169.5,3687933.61999999,Bulk Rice,Keila Alfaro-Visvikis,RETAIL SEDANOS,1386488,Dec
2024-12-19,Sedanos Supermarkets #18,Invoice,008-04504,,Discount,,,-3.39,3687930.22999999,,Keila Alfaro-Visvikis,RETAIL SEDANOS,1386489,Dec
2024-12-19,Los Caringas Latin America  Foods,Invoice,008-04505,Arroz a Granel:Largo Fino 50 LB -Bolsa Dos Hermanos.,,3.0,27.85,83.55,3688013.77999999,Bulk Rice,Lisset Limpio -020,CAFETERIA y RESTAURANTS,1386490,Dec
2024-12-19,Los Caringas Latin America  Foods,Invoice,008-04505,Arroz a Granel:Parboiled 50 LB -Bolsa Dos Hermanos.,,3.0,28.25,84.75,3688098.52999999,Bulk Rice,Lisset Limpio -020,CAFETERIA y RESTAURANTS,1386491,Dec
2024-12-19,El Palacio de los jugos /  Nanos Latin Foods,Invoice,008-04506,Arroz a Granel:Largo Fino 50 LB -Bolsa Dos Hermanos.,,10.0,27.85,278.5,3688377.02999999,Bulk Rice,Lisset Limpio -020,Cafeteria,1386492,Dec
2024-12-19,El Palacio de los jugos /  Nanos Latin Foods,Invoice,008-04506,Arroz a Granel:Parboiled 50 LB -Bolsa Dos Hermanos.,,10.0,26.75,267.5,3688644.52999999,Bulk Rice,Lisset Limpio -020,Cafeteria,1386493,Dec
2024-12-19,Sabor Tropical #1 - Cafeteria,Invoice,008-04507,Arroz a Granel:Parboiled 50 LB -Bolsa Dos Hermanos.,,10.0,27.75,277.5,3688922.02999999,Bulk Rice,Keila Alfaro-Visvikis,CAFETERIA y RESTAURANTS,1386494,Dec
2024-12-19,El Palacio de los jugos /  Mires Restaurants,Invoice,008-04508,Arroz a Granel:Parboiled 50 LB -Bolsa Dos Hermanos.,,11.0,27.75,305.25,3689227.27999999,Bulk Rice,Lisset Limpio -020,Cafeteria,1386495,Dec
2024-12-19,El Palacio de los jugos /  Mires Restaurants,Invoice,008-04508,Liquids:AS Marinating Sauce (Mojo),,1.0,18.5,18.5,3689245.77999999,American Spice,Lisset Limpio -020,Cafeteria,1386496,Dec
2024-12-19,El Palacio de los jugos /  Mires Restaurants,Invoice,008-04508,Arroz a Granel:Parboiled 50 LB -Bolsa Dos Hermanos.,,1.0,27.75,27.75,3689273.52999999,Bulk Rice,Lisset Limpio -020,Cafeteria,1386497,Dec
2024-12-19,Soriano Brothers PB,Invoice,008-04509,Spices:AS Sazon (for all),1 / 30 lb (box or pail),2.0,51.0,102.0,3689375.52999999,American Spice,Lisset Limpio -020,CAFETERIA y RESTAURANTS,1386498,Dec
2024-12-19,Soriano Brothers PB,Invoice,008-04509,Arroz a Granel:Largo Fino 50 LB -Bolsa Dos Hermanos.,,10.0,27.85,278.5,3689654.02999999,Bulk Rice,Lisset Limpio -020,CAFETERIA y RESTAURANTS,1386499,Dec
2024-12-19,Soriano Brothers PB,Invoice,008-04509,Arroz a Granel:Parboiled 50 LB -Bolsa Dos Hermanos.,,22.0,27.75,610.5,3690264.52999999,Bulk Rice,Lisset Limpio -020,CAFETERIA y RESTAURANTS,1386500,Dec
2024-12-19,Soriano Brothers PB,Invoice,008-04509,Arroz a Granel:Parboiled 50 LB -Bolsa Dos Hermanos.,,2.0,27.75,55.5,3690320.02999999,Bulk Rice,Lisset Limpio -020,CAFETERIA y RESTAURANTS,1386501,Dec
2024-12-19,Key Food / Holywood,Credit Memo,008-04543,Varios:Promotional Allowance,,-2.0,17.5,-35.0,3690285.02999999,Branded Rice,Keila Alfaro-Visvikis,RETAIL  DSD,1386502,Dec
2024-12-19,El Palacio de los jugos /  Mires Restaurants,Credit Memo,008-04544,Varios:Promotional Allowance,,-1.0,27.75,-27.75,3690257.27999999,Bulk Rice,Lisset Limpio -020,Cafeteria,1386503,Dec
2024-12-19,Soriano Brothers PB,Credit Memo,008-04545,Varios:Promotional Allowance,,-2.0,27.75,-55.5,3690201.77999999,Bulk Rice,Lisset Limpio -020,CAFETERIA y RESTAURANTS,1386504,Dec
2024-12-19,El Palacio de los jugos / Lita Foods Inc.,Credit Memo,008-04546,Varios:Promotional Allowance,,-5.0,27.75,-138.75,3690063.02999999,Bulk Rice,Lisset Limpio -020,Cafeteria,1386505,Dec
2024-12-20,ALS Foods,Invoice,008-04510,Liquids:AS Cooking Wine,4/1 Gl.,1.0,17.5,17.5,3690080.52999999,American Spice,Lisset Limpio -020,CAFETERIA y RESTAURANTS,1386506,Dec
2024-12-20,ALS Foods,Invoice,008-04510,Arroz a Granel:Largo Fino 50 LB -Bolsa Dos Hermanos.,,5.0,27.85,139.25,3690219.77999999,Bulk Rice,Lisset Limpio -020,CAFETERIA y RESTAURANTS,1386507,Dec
2024-12-20,ALS Foods,Invoice,008-04510,Arroz a Granel:Parboiled 50 LB -Bolsa Dos Hermanos.,,11.0,27.75,305.25,3690525.02999999,Bulk Rice,Lisset Limpio -020,CAFETERIA y RESTAURANTS,1386508,Dec
2024-12-20,ALS Foods,Invoice,008-04510,Arroz a Granel:Parboiled 50 LB -Bolsa Dos Hermanos.,,1.0,27.75,27.75,3690552.77999999,Bulk Rice,Lisset Limpio -020,CAFETERIA y RESTAURANTS,1386509,Dec
2024-12-20,ALS Foods,Credit Memo,008-04547,Varios:Promotional Allowance,,-1.0,27.75,-27.75,3690525.02999999,Bulk Rice,Lisset Limpio -020,CAFETERIA y RESTAURANTS,1386510,Dec
2024-12-23,El Palacio de los jugos /  Nanos Latin Foods,Invoice,008-04511,Arroz a Granel:Largo Fino 50 LB -Bolsa Dos Hermanos.,,5.0,27.85,139.25,3690664.27999999,Bulk Rice,Lisset Limpio -020,Cafeteria,1386511,Dec
2024-12-23,El Palacio de los jugos /  Nanos Latin Foods,Invoice,008-04511,Arroz a Granel:Parboiled 50 LB -Bolsa Dos Hermanos.,,15.0,26.75,401.25,3691065.52999999,Bulk Rice,Lisset Limpio -020,Cafeteria,1386512,Dec
2024-12-23,El Palacio de los jugos /  Mires Restaurants,Invoice,008-04512,Liquids:AS Marinating Sauce (Mojo),,1.0,18.5,18.5,3691084.02999999,American Spice,Lisset Limpio -020,Cafeteria,1386513,Dec
2024-12-23,El Palacio de los jugos /  Mires Restaurants,Invoice,008-04512,Arroz a Granel:Parboiled 50 LB -Bolsa Dos Hermanos.,,11.0,27.75,305.25,3691389.27999999,Bulk Rice,Lisset Limpio -020,Cafeteria,1386514,Dec
2024-12-23,El Palacio de los jugos /  Mires Restaurants,Invoice,008-04512,Arroz a Granel:Parboiled 50 LB -Bolsa Dos Hermanos.,,1.0,27.75,27.75,3691417.02999999,Bulk Rice,Lisset Limpio -020,Cafeteria,1386515,Dec
2024-12-23,El Palacio de los jugos /  EMMA FOOD CORP,Invoice,008-04513,Arroz a Granel:Largo Fino 50 LB -Bolsa Dos Hermanos.,,15.0,27.85,417.75,3691834.77999999,Bulk Rice,Lisset Limpio -020,Cafeteria,1386516,Dec
2024-12-23,El Palacio de los jugos /  EMMA FOOD CORP,Invoice,008-04513,Arroz a Granel:Parboiled 50 LB -Bolsa Dos Hermanos.,,20.0,26.75,535.0,3692369.77999999,Bulk Rice,Lisset Limpio -020,Cafeteria,1386517,Dec
2024-12-23,Fritanga Momotombo,Invoice,008-04514,Arroz a Granel:Largo Fino 50 LB -Bolsa Dos Hermanos.,,7.0,27.85,194.95,3692564.72999999,Bulk Rice,Lisset Limpio -020,CAFETERIA y RESTAURANTS,1386518,Dec
2024-12-23,El Gallego Supermarket,Invoice,008-04515,Arroz a Granel:Parboiled 50 LB -Bolsa Dos Hermanos.,,5.0,28.25,141.25,3692705.97999999,Bulk Rice,Lisset Limpio -020,RETAIL  DSD,1386519,Dec
2024-12-23,El Gallego Supermarket,Invoice,008-04515,Dry Beans:Dry Beans - Black Beans 50,Dry Black Beans 50 lb,2.0,45.7,91.4,3692797.37999999,Dry Beans,Lisset Limpio -020,RETAIL  DSD,1386520,Dec
2024-12-23,El Palacio de Los Jugos / Casa mía Food Restaurant inc,Invoice,008-04516,Dry Beans:Dry Beans - Black Beans 50,Dry Black Beans 50 lb,2.0,45.7,91.4,3692888.77999999,Dry Beans,Lisset Limpio -020,Cafeteria,1386521,Dec
2024-12-23,El Palacio de Los Jugos / Casa mía Food Restaurant inc,Invoice,008-04516,Arroz a Granel:Parboiled 50 LB -Bolsa Dos Hermanos.,,22.0,27.75,610.5,3693499.27999999,Bulk Rice,Lisset Limpio -020,Cafeteria,1386522,Dec
2024-12-23,El Palacio de Los Jugos / Casa mía Food Restaurant inc,Invoice,008-04516,Arroz a Granel:Parboiled 50 LB -Bolsa Dos Hermanos.,,2.0,27.75,55.5,3693554.77999999,Bulk Rice,Lisset Limpio -020,Cafeteria,1386523,Dec
2024-12-23,China Tokyo,Invoice,008-04517,Arroz a Granel:Parboiled 50 LB -Bolsa Dos Hermanos.,,10.0,27.0,270.0,3693824.77999999,Bulk Rice,Lisset Limpio -020,CAFETERIA y RESTAURANTS,1386524,Dec
2024-12-23,JMN Dely Corp,Invoice,008-04518,Arroz a Granel:Largo Fino 50 LB -Bolsa Dos Hermanos.,,2.0,27.85,55.7,3693880.47999999,Bulk Rice,Keila Alfaro-Visvikis,CAFETERIA y RESTAURANTS,1386525,Dec
2024-12-23,JMN Dely Corp,Invoice,008-04518,Arroz a Granel:Parboiled 50 LB -Bolsa Dos Hermanos.,,2.0,27.75,55.5,3693935.97999999,Bulk Rice,Keila Alfaro-Visvikis,CAFETERIA y RESTAURANTS,1386526,Dec
2024-12-23,JMN Dely Corp,Invoice,008-04518,Dry Beans:Dry Beans - Black Beans 50,Dry Black Beans 50 lb,1.0,45.7,45.7,3693981.67999999,Dry Beans,Keila Alfaro-Visvikis,CAFETERIA y RESTAURANTS,1386527,Dec
2024-12-23,Aries Supermarket & Cafeteria,Invoice,008-04519,Arroz a Granel:Parboiled 50 LB -Bolsa Dos Hermanos.,,10.0,28.25,282.5,3694264.17999999,Bulk Rice,Keila Alfaro-Visvikis,CAFETERIA y RESTAURANTS,1386528,Dec
2024-12-23,Aries Supermarket & Cafeteria,Invoice,008-04519,Dry Beans:Dry Beans - Black Beans 50,Dry Black Beans 50 lb,8.0,45.7,365.6,3694629.77999999,Dry Beans,Keila Alfaro-Visvikis,CAFETERIA y RESTAURANTS,1386529,Dec
2024-12-23,Aries Supermarket & Cafeteria,Invoice,008-04519,Spices:AS Cumin Ground,4 / 4 lb,1.0,50.25,50.25,3694680.02999999,American Spice,Keila Alfaro-Visvikis,CAFETERIA y RESTAURANTS,1386530,Dec
2024-12-23,Aries Supermarket & Cafeteria,Invoice,008-04519,Spices:AS Whole Bay Leaves,4/12 OZ,1.0,25.3,25.3,3694705.32999999,American Spice,Keila Alfaro-Visvikis,CAFETERIA y RESTAURANTS,1386531,Dec
2024-12-23,Mei Chang,Invoice,008-04520,Arroz a Granel:Parboiled 50 LB -Bolsa Dos Hermanos.,,6.0,28.25,169.5,3694874.82999999,Bulk Rice,Lisset Limpio -020,CAFETERIA y RESTAURANTS,1386532,Dec
2024-12-23,Mama ‘s Kitchen F.D.CORP,Invoice,008-04521,Liquids:AS Marinating Sauce (Mojo),,2.0,18.5,37.0,3694911.82999999,American Spice,Keila Alfaro-Visvikis,CAFETERIA y RESTAURANTS,1386533,Dec
2024-12-23,Mama ‘s Kitchen F.D.CORP,Invoice,008-04521,Liquids:AS Cooking Wine,4/1 Gl.,1.0,17.5,17.5,3694929.32999999,American Spice,Keila Alfaro-Visvikis,CAFETERIA y RESTAURANTS,1386534,Dec
2024-12-23,Mama ‘s Kitchen F.D.CORP,Invoice,008-04521,Spices:AS Chicken Base,1 / 30 lb. (box or pail),1.0,39.0,39.0,3694968.32999999,American Spice,Keila Alfaro-Visvikis,CAFETERIA y RESTAURANTS,1386535,Dec
2024-12-23,Mama ‘s Kitchen F.D.CORP,Invoice,008-04521,Liquids:AS Bitter Orange,,2.0,15.9,31.8,3695000.12999999,American Spice,Keila Alfaro-Visvikis,CAFETERIA y RESTAURANTS,1386536,Dec
2024-12-23,El Palacio de los jugos / Delicias Criollas (DIAGO FOOD_MILLER),Invoice,008-04522,Arroz a Granel:Parboiled 50 LB -Bolsa Dos Hermanos.,,11.0,27.75,305.25,3695305.37999999,Bulk Rice,Lisset Limpio -020,Cafeteria,1386537,Dec
2024-12-23,El Palacio de los jugos / Delicias Criollas (DIAGO FOOD_MILLER),Invoice,008-04522,Liquids:AS Cooking Wine,4/1 Gl.,1.0,17.5,17.5,3695322.87999999,American Spice,Lisset Limpio -020,Cafeteria,1386538,Dec
2024-12-23,El Palacio de los jugos / Delicias Criollas (DIAGO FOOD_MILLER),Invoice,008-04522,Arroz a Granel:Parboiled 50 LB -Bolsa Dos Hermanos.,,1.0,27.75,27.75,3695350.62999999,Bulk Rice,Lisset Limpio -020,Cafeteria,1386539,Dec
2024-12-23,El Palacio de los jugos /  Mires Restaurants,Credit Memo,008-04548,Varios:Promotional Allowance,,-1.0,27.75,-27.75,3695322.87999999,Bulk Rice,Lisset Limpio -020,Cafeteria,1386540,Dec
2024-12-23,El Palacio de Los Jugos / Casa mía Food Restaurant inc,Credit Memo,008-04549,Varios:Promotional Allowance,,-1.0,27.75,-27.75,3695295.12999999,Bulk Rice,Lisset Limpio -020,Cafeteria,1386541,Dec
2024-12-23,El Palacio de los jugos / Delicias Criollas (DIAGO FOOD_MILLER),Credit Memo,008-04550,Varios:Promotional Allowance,,-1.0,27.75,-27.75,3695267.37999999,Bulk Rice,Lisset Limpio -020,Cafeteria,1386542,Dec
2024-12-26,Hings Chinese,Invoice,008-04523,Arroz a Granel:Parboiled 50 LB -Bolsa Dos Hermanos.,,5.0,28.25,141.25,3695408.62999999,Bulk Rice,Lisset Limpio -020,CAFETERIA y RESTAURANTS,1386543,Dec
2024-12-26,El Palacio de los jugos /  Nanos Latin Foods,Invoice,008-04524,Arroz a Granel:Parboiled 50 LB -Bolsa Dos Hermanos.,,10.0,26.75,267.5,3695676.12999999,Bulk Rice,Lisset Limpio -020,Cafeteria,1386544,Dec
2024-12-26,Be Your Will LLC,Invoice,008-04525,Liquids:AS Bitter Orange,,1.0,14.0,14.0,3695690.12999999,American Spice,Lisset Limpio -020,CAFETERIA y RESTAURANTS,1386545,Dec
2024-12-26,Be Your Will LLC,Invoice,008-04525,Arroz a Granel:Parboiled 50 LB -Bolsa Dos Hermanos.,,11.0,27.75,305.25,3695995.37999999,Bulk Rice,Lisset Limpio -020,CAFETERIA y RESTAURANTS,1386546,Dec
2024-12-26,Be Your Will LLC,Invoice,008-04525,Arroz a Granel:Largo Fino 50 LB -Bolsa Dos Hermanos.,,7.0,27.85,194.95,3696190.32999999,Bulk Rice,Lisset Limpio -020,CAFETERIA y RESTAURANTS,1386547,Dec
2024-12-26,Be Your Will LLC,Invoice,008-04525,Arroz a Granel:Parboiled 50 LB -Bolsa Dos Hermanos.,,1.0,27.75,27.75,3696218.07999999,Bulk Rice,Lisset Limpio -020,CAFETERIA y RESTAURANTS,1386548,Dec
2024-12-26,Be Your Will LLC,Invoice,008-04525,,Discount,,,-3.5,3696214.57999999,,Lisset Limpio -020,CAFETERIA y RESTAURANTS,1386549,Dec
2024-12-26,Sabor Tropical #1 - Cafeteria,Invoice,008-04526,Arroz a Granel:Largo Fino 50 LB -Bolsa Dos Hermanos.,,1.0,27.85,27.85,3696242.42999999,Bulk Rice,Keila Alfaro-Visvikis,CAFETERIA y RESTAURANTS,1386550,Dec
2024-12-26,Sedanos Supermarkets #24,Invoice,008-04527,Arroz a Granel:Parboiled 50 LB -Bolsa Dos Hermanos.,,5.0,28.25,141.25,3696383.67999999,Bulk Rice,Keila Alfaro-Visvikis,RETAIL SEDANOS,1386551,Dec
2024-12-26,Sedanos Supermarkets #24,Invoice,008-04527,Arroz a Granel:Parboiled 50 LB -Bolsa Dos Hermanos.,,5.0,28.25,141.25,3696524.92999999,Bulk Rice,Keila Alfaro-Visvikis,RETAIL SEDANOS,1386552,Dec
2024-12-26,Sedanos Supermarkets #24,Invoice,008-04527,,Discount,,,-5.65,3696519.27999999,,Keila Alfaro-Visvikis,RETAIL SEDANOS,1386553,Dec
2024-12-26,Sedanos Supermarkets #27,Invoice,008-04528,Arroz a Granel:Parboiled 50 LB -Bolsa Dos Hermanos.,,12.0,28.25,339.0,3696858.27999999,Bulk Rice,Keila Alfaro-Visvikis,RETAIL SEDANOS,1386554,Dec
2024-12-26,Sedanos Supermarkets #27,Invoice,008-04528,,Discount,,,-6.78,3696851.49999999,,Keila Alfaro-Visvikis,RETAIL SEDANOS,1386555,Dec
2024-12-26,Ideal Food Basket Davie Cafeteria,Invoice,008-04529,Arroz a Granel:Largo Fino 50 LB -Bolsa Dos Hermanos.,,7.0,27.85,194.95,3697046.44999999,Dry Beans,Keila Alfaro-Visvikis,CAFETERIA y RESTAURANTS,1386556,Dec
2024-12-26,Sedanos Supermarkets #26,Invoice,008-04530,Arroz a Granel:Parboiled 50 LB -Bolsa Dos Hermanos.,,3.0,28.25,84.75,3697131.19999999,Bulk Rice,Keila Alfaro-Visvikis,RETAIL SEDANOS,1386557,Dec
2024-12-26,Sedanos Supermarkets #26,Invoice,008-04530,,Discount,,,-1.7,3697129.49999999,,Keila Alfaro-Visvikis,RETAIL SEDANOS,1386558,Dec
2024-12-26,Sabor Tropical Supermarket #7,Invoice,008-04531,Arroz Envasado:Largo Fino 1kg (Long grain rice) Dos Hermanos,,4.0,17.5,70.0,3697199.49999999,Branded Rice,Keila Alfaro-Visvikis,RETAIL  DSD,1386559,Dec
2024-12-26,Sabor Tropical Supermarket #7,Invoice,008-04531,Arroz Envasado:Parboiled 1kg Bolsa Dos Hermanos.,.,1.0,19.9,19.9,3697219.39999999,Branded Rice,Keila Alfaro-Visvikis,RETAIL  DSD,1386560,Dec
2024-12-26,Sabor Tropical Supermarket #7,Invoice,008-04531,Rice Snack:Rice Snack Ham Flavored DOS HERMANOS,,1.0,19.9,19.9,3697239.29999999,Puffed Products,Keila Alfaro-Visvikis,RETAIL  DSD,1386561,Dec
2024-12-26,Sabor Tropical Supermarket #7,Invoice,008-04531,Arroz Envasado:Largo Fino 1kg (Long grain rice) Dos Hermanos,,1.0,17.5,17.5,3697256.79999999,Branded Rice,Keila Alfaro-Visvikis,RETAIL  DSD,1386562,Dec
2024-12-26,Sabor Tropical Supermarket #4,Invoice,008-04532,Arroz Envasado:Largo Fino 1kg (Long grain rice) Dos Hermanos,,5.0,18.0,90.0,3697346.79999999,Branded Rice,Keila Alfaro-Visvikis,RETAIL  DSD,1386563,Dec
2024-12-26,Sabor Tropical Supermarket #4,Invoice,008-04532,Arroz Envasado:Parboiled 5KG Dos Hermanos.,6 / 11lbs,5.0,46.5,232.5,3697579.29999999,Branded Rice,Keila Alfaro-Visvikis,RETAIL  DSD,1386564,Dec
2024-12-26,Sabor Tropical Supermarket #4,Invoice,008-04532,Arroz Envasado:Largo Fino 1kg (Long grain rice) Dos Hermanos,,1.0,18.0,18.0,3697597.29999999,Branded Rice,Keila Alfaro-Visvikis,RETAIL  DSD,1386565,Dec
2024-12-26,Sabor Tropical Supermarket #4,Invoice,008-04532,Arroz Envasado:Parboiled 5KG Dos Hermanos.,6 / 11lbs,1.0,46.5,46.5,3697643.79999999,Branded Rice,Keila Alfaro-Visvikis,RETAIL  DSD,1386566,Dec
2024-12-26,Bravo   Francisco Diaz,Invoice,008-04551,Liquids:AS White Vinegar,4/1 Gl.,3.0,10.0,30.0,3697673.79999999,American Spice,Lisset Limpio -020,RETAIL  DSD,1386567,Dec
2024-12-26,Bravo   Francisco Diaz,Invoice,008-04551,Liquids:AS Cooking Wine,4/1 Gl.,5.0,17.5,87.5,3697761.29999999,American Spice,Lisset Limpio -020,RETAIL  DSD,1386568,Dec
2024-12-26,Bravo   Francisco Diaz,Invoice,008-04551,Arroz a Granel:Largo Fino 50 LB -Bolsa Dos Hermanos.,,5.0,27.85,139.25,3697900.54999999,Bulk Rice,Lisset Limpio -020,RETAIL  DSD,1386569,Dec
2024-12-26,Bravo   Francisco Diaz,Invoice,008-04551,Spices:AS Sazon (for all),1 / 30 lb (box or pail),1.0,59.0,59.0,3697959.54999999,American Spice,Lisset Limpio -020,RETAIL  DSD,1386570,Dec
2024-12-26,Bravo   Francisco Diaz,Invoice,008-04551,Liquids:AS Marinating Sauce (Mojo),,3.0,18.5,55.5,3698015.04999999,American Spice,Lisset Limpio -020,RETAIL  DSD,1386571,Dec
2024-12-26,El Palacio de los jugos / Lita Foods Inc.,Invoice,008-04552,Dry Beans:Dry Beans - Black Beans 50,Dry Black Beans 50 lb,1.0,45.7,45.7,3698060.74999999,Dry Beans,Lisset Limpio -020,Cafeteria,1386572,Dec
2024-12-26,El Palacio de los jugos / Lita Foods Inc.,Invoice,008-04552,Arroz a Granel:Parboiled 50 LB -Bolsa Dos Hermanos.,,22.0,27.75,610.5,3698671.24999999,Bulk Rice,Lisset Limpio -020,Cafeteria,1386573,Dec
2024-12-26,El Palacio de los jugos / Lita Foods Inc.,Invoice,008-04552,Arroz a Granel:Parboiled 50 LB -Bolsa Dos Hermanos.,,2.0,27.75,55.5,3698726.74999999,Bulk Rice,Lisset Limpio -020,Cafeteria,1386574,Dec
2024-12-26,Sorianos Brothers,Invoice,008-04553,Arroz a Granel:Parboiled 50 LB -Bolsa Dos Hermanos.,,25.0,26.75,668.75,3699395.49999999,Bulk Rice,Lisset Limpio -020,CAFETERIA y RESTAURANTS,1386575,Dec
2024-12-26,El Palacio de los jugos /  Mires Restaurants,Invoice,008-04554,Liquids:AS Marinating Sauce (Mojo),,1.0,18.5,18.5,3699413.99999999,American Spice,Lisset Limpio -020,Cafeteria,1386576,Dec
2024-12-26,El Palacio de los jugos /  Mires Restaurants,Invoice,008-04554,Arroz a Granel:Parboiled 50 LB -Bolsa Dos Hermanos.,,11.0,27.75,305.25,3699719.24999999,Bulk Rice,Lisset Limpio -020,Cafeteria,1386577,Dec
2024-12-26,El Palacio de los jugos /  Mires Restaurants,Invoice,008-04554,Arroz a Granel:Parboiled 50 LB -Bolsa Dos Hermanos.,,1.0,27.75,27.75,3699746.99999999,Bulk Rice,Lisset Limpio -020,Cafeteria,1386578,Dec
2024-12-26,Sedanos Supermarkets #18,Invoice,008-04555,Arroz a Granel:Parboiled 50 LB -Bolsa Dos Hermanos.,,10.0,28.25,282.5,3700029.49999999,Bulk Rice,Keila Alfaro-Visvikis,RETAIL SEDANOS,1386579,Dec
2024-12-26,Sedanos Supermarkets #18,Invoice,008-04555,,Discount,,,-5.65,3700023.84999999,,Keila Alfaro-Visvikis,RETAIL SEDANOS,1386580,Dec
2024-12-26,Los Mejores Tamales de Miami,Invoice,008-04556,Arroz a Granel:Parboiled 50 LB -Bolsa Dos Hermanos.,,8.0,28.25,226.0,3700249.84999999,Bulk Rice,Lisset Limpio -020,CAFETERIA y RESTAURANTS,1386581,Dec
2024-12-26,Sedanos Supermarkets #38,Invoice,008-04557,Arroz Envasado:Parboiled 5KG Dos Hermanos.,6 / 11lbs,20.0,40.5,810.0,3701059.84999999,Branded Rice,Keila Alfaro-Visvikis,RETAIL SEDANOS,1386582,Dec
2024-12-26,Sedanos Supermarkets #38,Invoice,008-04557,Rice Snack:Rice Snack Ham Flavored DOS HERMANOS,,2.0,19.9,39.8,3701099.64999999,Puffed Products,Keila Alfaro-Visvikis,RETAIL SEDANOS,1386583,Dec
2024-12-26,Sedanos Supermarkets #38,Invoice,008-04557,Arroz Envasado:Parboiled 5KG Dos Hermanos.,6 / 11lbs,20.0,40.5,810.0,3701909.64999999,Branded Rice,Keila Alfaro-Visvikis,RETAIL SEDANOS,1386584,Dec
2024-12-26,Sedanos Supermarkets #38,Invoice,008-04557,,Discount,,,-17.0,3701892.64999999,,Keila Alfaro-Visvikis,RETAIL SEDANOS,1386585,Dec
2024-12-26,Key Foods 40 St,Invoice,008-04558,Arroz Envasado:Parboiled 5KG Dos Hermanos.,6 / 11lbs,31.0,46.5,1441.5,3703334.14999999,Branded Rice,Keila Alfaro-Visvikis,RETAIL  DSD,1386586,Dec
2024-12-26,Key Foods 40 St,Invoice,008-04558,Arroz Envasado:Parboiled 1kg Bolsa Dos Hermanos.,.,3.0,19.9,59.7,3703393.84999999,Branded Rice,Keila Alfaro-Visvikis,RETAIL  DSD,1386587,Dec
2024-12-26,Key Foods 40 St,Invoice,008-04558,Arroz Envasado:Largo Fino 1kg (Long grain rice) Dos Hermanos,,2.0,18.0,36.0,3703429.84999999,Branded Rice,Keila Alfaro-Visvikis,RETAIL  DSD,1386588,Dec
2024-12-26,Key Foods 40 St,Invoice,008-04558,Arroz Envasado:Parboiled 5KG Dos Hermanos.,6 / 11lbs,10.0,46.5,465.0,3703894.84999999,Branded Rice,Keila Alfaro-Visvikis,RETAIL  DSD,1386589,Dec
2024-12-26,Key Foods 40 St,Invoice,008-04558,Arroz Envasado:Largo Fino 1kg (Long grain rice) Dos Hermanos,,1.0,18.0,18.0,3703912.84999999,Branded Rice,Keila Alfaro-Visvikis,RETAIL  DSD,1386590,Dec
2024-12-26,Food-Star Supermarket,Invoice,008-04559,Arroz Envasado:Parboiled 5KG Dos Hermanos.,6 / 11lbs,15.0,46.5,697.5,3704610.34999999,Branded Rice,Lisset Limpio -020,RETAIL  DSD,1386591,Dec
2024-12-26,Food-Star Supermarket,Invoice,008-04559,Arroz Envasado:Parboiled 5KG Dos Hermanos.,6 / 11lbs,2.0,46.5,93.0,3704703.34999999,Branded Rice,Lisset Limpio -020,RETAIL  DSD,1386592,Dec
2024-12-26,Be Your Will LLC,Credit Memo,008-04584,Varios:Promotional Allowance,,-1.0,27.75,-27.75,3704675.59999999,Bulk Rice,Lisset Limpio -020,CAFETERIA y RESTAURANTS,1386593,Dec
2024-12-26,Sabor Tropical Supermarket #7,Credit Memo,008-04585,Varios:Promotional Allowance,,-1.0,17.5,-17.5,3704658.09999999,Branded Rice,Keila Alfaro-Visvikis,RETAIL  DSD,1386594,Dec
2024-12-26,Sabor Tropical Supermarket #4,Credit Memo,008-04586,Varios:Promotional Allowance,,-1.0,18.0,-18.0,3704640.09999999,Branded Rice,Keila Alfaro-Visvikis,RETAIL  DSD,1386595,Dec
2024-12-26,Sabor Tropical Supermarket #4,Credit Memo,008-04586,Varios:Promotional Allowance,,-1.0,46.5,-46.5,3704593.59999999,Branded Rice,Keila Alfaro-Visvikis,RETAIL  DSD,1386596,Dec
2024-12-26,El Palacio de los jugos / Lita Foods Inc.,Credit Memo,008-04587,Varios:Promotional Allowance,,-2.0,27.75,-55.5,3704538.09999999,Bulk Rice,Lisset Limpio -020,Cafeteria,1386597,Dec
2024-12-26,El Palacio de los jugos /  Mires Restaurants,Credit Memo,008-04588,Varios:Promotional Allowance,,-1.0,27.75,-27.75,3704510.34999999,Bulk Rice,Lisset Limpio -020,Cafeteria,1386598,Dec
2024-12-26,Sedanos Supermarkets #38,Credit Memo,008-04589,Varios:Promotional Allowance,,-20.0,40.5,-810.0,3703700.34999999,Branded Rice,Keila Alfaro-Visvikis,RETAIL SEDANOS,1386599,Dec
2024-12-26,Key Foods 40 St,Credit Memo,008-04590,Varios:Promotional Allowance,,-10.0,46.5,-465.0,3703235.34999999,Branded Rice,Keila Alfaro-Visvikis,RETAIL  DSD,1386600,Dec
2024-12-26,Key Foods 40 St,Credit Memo,008-04590,Varios:Promotional Allowance,,-1.0,18.0,-18.0,3703217.34999999,Branded Rice,Keila Alfaro-Visvikis,RETAIL  DSD,1386601,Dec
2024-12-26,Food-Star Supermarket,Credit Memo,008-04591,Varios:Promotional Allowance,,-2.0,46.5,-93.0,3703124.34999999,Branded Rice,Lisset Limpio -020,RETAIL  DSD,1386602,Dec
2024-12-29,ALS Foods,Invoice,008-04560,Arroz a Granel:Parboiled 50 LB -Bolsa Dos Hermanos.,,11.0,27.75,305.25,3703429.59999999,Bulk Rice,Lisset Limpio -020,CAFETERIA y RESTAURANTS,1386603,Dec
2024-12-29,ALS Foods,Invoice,008-04560,Arroz a Granel:Largo Fino 50 LB -Bolsa Dos Hermanos.,,4.0,27.85,111.4,3703540.99999999,Bulk Rice,Lisset Limpio -020,CAFETERIA y RESTAURANTS,1386604,Dec
2024-12-29,ALS Foods,Invoice,008-04560,Liquids:AS Cooking Wine,4/1 Gl.,1.0,17.5,17.5,3703558.49999999,American Spice,Lisset Limpio -020,CAFETERIA y RESTAURANTS,1386605,Dec
2024-12-29,ALS Foods,Invoice,008-04560,Arroz a Granel:Parboiled 50 LB -Bolsa Dos Hermanos.,,1.0,27.75,27.75,3703586.24999999,Bulk Rice,Lisset Limpio -020,CAFETERIA y RESTAURANTS,1386606,Dec
2024-12-29,El Palacio de los jugos /  Nanos Latin Foods,Invoice,008-04561,Arroz a Granel:Largo Fino 50 LB -Bolsa Dos Hermanos.,,6.0,27.85,167.1,3703753.34999999,Bulk Rice,Lisset Limpio -020,Cafeteria,1386607,Dec
2024-12-29,El Palacio de los jugos /  Nanos Latin Foods,Invoice,008-04561,Arroz a Granel:Parboiled 50 LB -Bolsa Dos Hermanos.,,10.0,26.75,267.5,3704020.84999999,Bulk Rice,Lisset Limpio -020,Cafeteria,1386608,Dec
2024-12-29,El Palacio de los jugos /  EMMA FOOD CORP,Invoice,008-04562,Arroz a Granel:Largo Fino 50 LB -Bolsa Dos Hermanos.,,12.0,27.85,334.2,3704355.04999999,Bulk Rice,Lisset Limpio -020,Cafeteria,1386609,Dec
2024-12-29,El Palacio de los jugos /  EMMA FOOD CORP,Invoice,008-04562,Arroz a Granel:Parboiled 50 LB -Bolsa Dos Hermanos.,,15.0,26.75,401.25,3704756.29999999,Bulk Rice,Lisset Limpio -020,Cafeteria,1386610,Dec
2024-12-29,El Palacio de Los Jugos / Casa mía Food Restaurant inc,Invoice,008-04563,Dry Beans:Dry Beans - Black Beans 50,Dry Black Beans 50 lb,1.0,45.7,45.7,3704801.99999999,Dry Beans,Lisset Limpio -020,Cafeteria,1386611,Dec
2024-12-29,El Palacio de Los Jugos / Casa mía Food Restaurant inc,Invoice,008-04563,Arroz a Granel:Parboiled 50 LB -Bolsa Dos Hermanos.,,11.0,27.75,305.25,3705107.24999999,Bulk Rice,Lisset Limpio -020,Cafeteria,1386612,Dec
2024-12-29,El Palacio de Los Jugos / Casa mía Food Restaurant inc,Invoice,008-04563,Arroz a Granel:Parboiled 50 LB -Bolsa Dos Hermanos.,,1.0,27.75,27.75,3705134.99999999,Bulk Rice,Lisset Limpio -020,Cafeteria,1386613,Dec
2024-12-29,Panda Depot,Invoice,008-04564,Arroz a Granel:Largo Fino 50 LB -Bolsa Dos Hermanos.,,110.0,24.5,2695.0,3707829.99999999,Bulk Rice,Lisset Limpio -020,WHOLESALER,1386614,Dec
2024-12-29,Aries Supermarket & Cafeteria,Invoice,008-04565,Arroz a Granel:Parboiled 50 LB -Bolsa Dos Hermanos.,,10.0,28.25,282.5,3708112.49999999,Bulk Rice,Keila Alfaro-Visvikis,CAFETERIA y RESTAURANTS,1386615,Dec
2024-12-29,Aries Supermarket & Cafeteria,Invoice,008-04565,Dry Beans:Dry Beans - Black Beans 50,Dry Black Beans 50 lb,8.0,45.7,365.6,3708478.09999999,Dry Beans,Keila Alfaro-Visvikis,CAFETERIA y RESTAURANTS,1386616,Dec
2024-12-29,Sedanos Supermarkets #16,Invoice,008-04566,Arroz a Granel:Parboiled 50 LB -Bolsa Dos Hermanos.,,8.0,28.25,226.0,3708704.09999999,Bulk Rice,Keila Alfaro-Visvikis,RETAIL SEDANOS,1386617,Dec
2024-12-29,Sedanos Supermarkets #16,Invoice,008-04566,,Discount,,,-4.52,3708699.57999999,,Keila Alfaro-Visvikis,RETAIL SEDANOS,1386618,Dec
2024-12-29,JMN Dely Corp,Invoice,008-04567,Arroz a Granel:Largo Fino 50 LB -Bolsa Dos Hermanos.,,2.0,27.85,55.7,3708755.27999999,Bulk Rice,Keila Alfaro-Visvikis,CAFETERIA y RESTAURANTS,1386619,Dec
2024-12-29,JMN Dely Corp,Invoice,008-04567,Arroz a Granel:Parboiled 50 LB -Bolsa Dos Hermanos.,,3.0,28.25,84.75,3708840.02999999,Bulk Rice,Keila Alfaro-Visvikis,CAFETERIA y RESTAURANTS,1386620,Dec
2024-12-29,JMN Dely Corp,Invoice,008-04567,Dry Beans:Dry Beans - Black Beans 50,Dry Black Beans 50 lb,1.0,45.7,45.7,3708885.72999999,Dry Beans,Keila Alfaro-Visvikis,CAFETERIA y RESTAURANTS,1386621,Dec
2024-12-29,El Palacio de los jugos / Delicias Criollas (DIAGO FOOD_MILLER),Invoice,008-04568,Arroz a Granel:Parboiled 50 LB -Bolsa Dos Hermanos.,,22.0,27.75,610.5,3709496.22999999,Bulk Rice,Lisset Limpio -020,Cafeteria,1386622,Dec
2024-12-29,El Palacio de los jugos / Delicias Criollas (DIAGO FOOD_MILLER),Invoice,008-04568,Arroz a Granel:Parboiled 50 LB -Bolsa Dos Hermanos.,,2.0,27.75,55.5,3709551.72999999,Bulk Rice,Lisset Limpio -020,Cafeteria,1386623,Dec
2024-12-29,El Palacio de los jugos / Delicias Criollas (DIAGO FOOD_MILLER),Invoice,008-04568,Liquids:AS Cooking Wine,4/1 Gl.,1.0,17.5,17.5,3709569.22999999,American Spice,Lisset Limpio -020,Cafeteria,1386624,Dec
2024-12-29,El Palacio de los jugos / Delicias Criollas (DIAGO FOOD_MILLER),Invoice,008-04568,Liquids:AS Bitter Orange,,1.0,15.9,15.9,3709585.12999999,American Spice,Lisset Limpio -020,Cafeteria,1386625,Dec
2024-12-29,El Palacio de los jugos / Lita Foods Inc.,Invoice,008-04569,Dry Beans:Dry Beans - Black Beans 50,Dry Black Beans 50 lb,0.0,,0.0,3709585.12999999,Dry Beans,Lisset Limpio -020,Cafeteria,1386626,Dec
2024-12-29,El Palacio de los jugos / Lita Foods Inc.,Invoice,008-04569,Arroz a Granel:Parboiled 50 LB -Bolsa Dos Hermanos.,,0.0,,0.0,3709585.12999999,Bulk Rice,Lisset Limpio -020,Cafeteria,1386627,Dec
2024-12-29,El Palacio de los jugos / Lita Foods Inc.,Invoice,008-04569,Arroz a Granel:Parboiled 50 LB -Bolsa Dos Hermanos.,,0.0,0.0,0.0,3709585.12999999,Bulk Rice,Lisset Limpio -020,Cafeteria,1386628,Dec
2024-12-29,Soriano Brothers PB,Invoice,008-04570,Spices:AS Sazon (for all),1 / 30 lb (box or pail),0.0,,0.0,3709585.12999999,American Spice,Lisset Limpio -020,CAFETERIA y RESTAURANTS,1386629,Dec
2024-12-29,Soriano Brothers PB,Invoice,008-04570,Arroz a Granel:Parboiled 50 LB -Bolsa Dos Hermanos.,,0.0,,0.0,3709585.12999999,Bulk Rice,Lisset Limpio -020,CAFETERIA y RESTAURANTS,1386630,Dec
2024-12-29,Soriano Brothers PB,Invoice,008-04570,Arroz a Granel:Largo Fino 50 LB -Bolsa Dos Hermanos.,,0.0,,0.0,3709585.12999999,Bulk Rice,Lisset Limpio -020,CAFETERIA y RESTAURANTS,1386631,Dec
2024-12-29,Soriano Brothers PB,Invoice,008-04570,Arroz a Granel:Parboiled 50 LB -Bolsa Dos Hermanos.,,0.0,0.0,0.0,3709585.12999999,Bulk Rice,Lisset Limpio -020,CAFETERIA y RESTAURANTS,1386632,Dec
2024-12-29,ALS Foods,Credit Memo,008-04592,Varios:Promotional Allowance,,-1.0,27.75,-27.75,3709557.37999999,Bulk Rice,Lisset Limpio -020,CAFETERIA y RESTAURANTS,1386633,Dec
2024-12-29,El Palacio de Los Jugos / Casa mía Food Restaurant inc,Credit Memo,008-04593,Varios:Promotional Allowance,,-1.0,27.75,-27.75,3709529.62999999,Bulk Rice,Lisset Limpio -020,Cafeteria,1386634,Dec
2024-12-29,El Palacio de los jugos / Delicias Criollas (DIAGO FOOD_MILLER),Credit Memo,008-04594,Varios:Promotional Allowance,,-2.0,27.75,-55.5,3709474.12999999,Bulk Rice,Lisset Limpio -020,Cafeteria,1386635,Dec
2024-12-30,Soriano Brothers PB,Invoice,008-04571,Spices:AS Sazon (for all),1 / 30 lb (box or pail),1.0,51.0,51.0,3709525.12999999,American Spice,Lisset Limpio -020,CAFETERIA y RESTAURANTS,1386636,Dec
2024-12-30,Soriano Brothers PB,Invoice,008-04571,Arroz a Granel:Parboiled 50 LB -Bolsa Dos Hermanos.,,15.0,27.75,416.25,3709941.37999999,Bulk Rice,Lisset Limpio -020,CAFETERIA y RESTAURANTS,1386637,Dec
2024-12-30,Soriano Brothers PB,Invoice,008-04571,Arroz a Granel:Largo Fino 50 LB -Bolsa Dos Hermanos.,,7.0,27.85,194.95,3710136.32999999,Bulk Rice,Lisset Limpio -020,CAFETERIA y RESTAURANTS,1386638,Dec
2024-12-30,Soriano Brothers PB,Invoice,008-04571,Arroz a Granel:Parboiled 50 LB -Bolsa Dos Hermanos.,,1.0,27.75,27.75,3710164.07999999,Bulk Rice,Lisset Limpio -020,CAFETERIA y RESTAURANTS,1386639,Dec
2024-12-30,Sedanos Supermarkets #34,Invoice,008-04572,Arroz a Granel:Parboiled 50 LB -Bolsa Dos Hermanos.,,12.0,28.25,339.0,3710503.07999999,Bulk Rice,Keila Alfaro-Visvikis,RETAIL SEDANOS,1386640,Dec
2024-12-30,Sedanos Supermarkets #34,Invoice,008-04572,,Discount,,,-6.78,3710496.29999999,,Keila Alfaro-Visvikis,RETAIL SEDANOS,1386641,Dec
2024-12-30,Sedanos Supermarkets #33,Invoice,008-04573,Arroz a Granel:Parboiled 50 LB -Bolsa Dos Hermanos.,,4.0,28.25,113.0,3710609.29999999,Bulk Rice,Keila Alfaro-Visvikis,RETAIL SEDANOS,1386642,Dec
2024-12-30,Sedanos Supermarkets #33,Invoice,008-04573,,Discount,,,-2.26,3710607.03999999,,Keila Alfaro-Visvikis,RETAIL SEDANOS,1386643,Dec
2024-12-30,Sedanos Supermarkets #31,Invoice,008-04574,Arroz a Granel:Parboiled 50 LB -Bolsa Dos Hermanos.,,3.0,28.25,84.75,3710691.78999999,Bulk Rice,Keila Alfaro-Visvikis,RETAIL SEDANOS,1386644,Dec
2024-12-30,Sedanos Supermarkets #31,Invoice,008-04574,,Discount,,,-1.7,3710690.08999999,,Keila Alfaro-Visvikis,RETAIL SEDANOS,1386645,Dec
2024-12-30,Soriano Brothers PB,Credit Memo,008-04595,Varios:Promotional Allowance,,-1.0,27.75,-27.75,3710662.33999999,Bulk Rice,Lisset Limpio -020,CAFETERIA y RESTAURANTS,1386646,Dec
2024-12-31,Ideal Food Basket Davie Cafeteria,Invoice,008-04575,Arroz a Granel:Largo Fino 50 LB -Bolsa Dos Hermanos.,,10.0,27.85,278.5,3710940.83999999,Bulk Rice,Keila Alfaro-Visvikis,CAFETERIA y RESTAURANTS,1386647,Dec
2024-12-31,Festival Supermarket Margate,Invoice,008-04576,Arroz Envasado:Parboiled 5KG Dos Hermanos.,6 / 11lbs,15.0,46.5,697.5,3711638.33999999,Branded Rice,Keila Alfaro-Visvikis,RETAIL  DSD,1386648,Dec
2024-12-31,Festival Supermarket Margate,Invoice,008-04576,Arroz Envasado:Parboiled 5KG Dos Hermanos.,6 / 11lbs,5.0,46.5,232.5,3711870.83999999,Branded Rice,Keila Alfaro-Visvikis,RETAIL  DSD,1386649,Dec
2024-12-31,Sabor Tropical #1 - Cafeteria,Invoice,008-04577,Arroz a Granel:Largo Fino 50 LB -Bolsa Dos Hermanos.,,55.0,27.5,1512.5,3713383.33999999,Bulk Rice,Keila Alfaro-Visvikis,CAFETERIA y RESTAURANTS,1386650,Dec
2024-12-31,Sedanos Supermarkets #27,Invoice,008-04578,Arroz a Granel:Parboiled 50 LB -Bolsa Dos Hermanos.,,4.0,28.25,113.0,3713496.33999999,Bulk Rice,Keila Alfaro-Visvikis,RETAIL SEDANOS,1386651,Dec
2024-12-31,Sedanos Supermarkets #27,Invoice,008-04578,,Discount,,,-2.26,3713494.07999999,,Keila Alfaro-Visvikis,RETAIL SEDANOS,1386652,Dec
2024-12-31,Los Caringas Latin America  Foods,Invoice,008-04579,Arroz a Granel:Largo Fino 50 LB -Bolsa Dos Hermanos.,,1.0,27.85,27.85,3713521.92999999,Bulk Rice,Lisset Limpio -020,CAFETERIA y RESTAURANTS,1386653,Dec
2024-12-31,Los Caringas Latin America  Foods,Invoice,008-04579,Arroz a Granel:Parboiled 50 LB -Bolsa Dos Hermanos.,,4.0,28.25,113.0,3713634.92999999,Bulk Rice,Lisset Limpio -020,CAFETERIA y RESTAURANTS,1386654,Dec
2024-12-31,Sedanos Supermarkets #24,Invoice,008-04580,Arroz a Granel:Parboiled 50 LB -Bolsa Dos Hermanos.,,10.0,28.25,282.5,3713917.42999999,Bulk Rice,Keila Alfaro-Visvikis,RETAIL SEDANOS,1386655,Dec
2024-12-31,Sedanos Supermarkets #24,Invoice,008-04580,,Discount,,,-5.65,3713911.77999999,,Keila Alfaro-Visvikis,RETAIL SEDANOS,1386656,Dec
2024-12-31,Sedanos Supermarkets #7,Invoice,008-04581,Arroz Envasado:Largo Fino 1kg (Long grain rice) Dos Hermanos,,1.0,17.5,17.5,3713929.27999999,Branded Rice,Keila Alfaro-Visvikis,RETAIL SEDANOS,1386657,Dec
2024-12-31,Sedanos Supermarkets #7,Invoice,008-04581,Arroz Envasado:Parboiled 1kg Bolsa Dos Hermanos.,.,1.0,19.9,19.9,3713949.17999999,Branded Rice,Keila Alfaro-Visvikis,RETAIL SEDANOS,1386658,Dec
2024-12-31,Sedanos Supermarkets #7,Invoice,008-04581,Rice Snack:Rice Snack Ham Flavored DOS HERMANOS,,1.0,19.9,19.9,3713969.07999999,Puffed Products,Keila Alfaro-Visvikis,RETAIL SEDANOS,1386659,Dec
2024-12-31,Sedanos Supermarkets #7,Invoice,008-04581,,Discount,,,-1.15,3713967.92999999,,Keila Alfaro-Visvikis,RETAIL SEDANOS,1386660,Dec
2024-12-31,Sedanos Supermarkets #42,Invoice,008-04582,Arroz Envasado:Largo Fino 1kg (Long grain rice) Dos Hermanos,,1.0,17.5,17.5,3713985.42999999,Branded Rice,Keila Alfaro-Visvikis,RETAIL SEDANOS,1386661,Dec
2024-12-31,Sedanos Supermarkets #42,Invoice,008-04582,Arroz Envasado:Parboiled 1kg Bolsa Dos Hermanos.,.,1.0,19.9,19.9,3714005.32999999,Branded Rice,Keila Alfaro-Visvikis,RETAIL SEDANOS,1386662,Dec
2024-12-31,Sedanos Supermarkets #42,Invoice,008-04582,Rice Snack:Rice Snack Ham Flavored DOS HERMANOS,,1.0,19.9,19.9,3714025.22999999,Puffed Products,Keila Alfaro-Visvikis,RETAIL SEDANOS,1386663,Dec
2024-12-31,Sedanos Supermarkets #42,Invoice,008-04582,Rice Snack:Rice Snack Salami Flavored DOS HERMANOS,,1.0,19.9,19.9,3714045.12999999,Puffed Products,Keila Alfaro-Visvikis,RETAIL SEDANOS,1386664,Dec
2024-12-31,Sedanos Supermarkets #42,Invoice,008-04582,,Discount,,,-1.54,3714043.58999999,,Keila Alfaro-Visvikis,RETAIL SEDANOS,1386665,Dec
2024-12-31,Sedanos Supermarkets #14,Invoice,008-04583,Arroz Envasado:Largo Fino 1kg (Long grain rice) Dos Hermanos,,1.0,17.5,17.5,3714061.08999999,Branded Rice,Keila Alfaro-Visvikis,RETAIL SEDANOS,1386666,Dec
2024-12-31,Sedanos Supermarkets #14,Invoice,008-04583,Arroz Envasado:Parboiled 1kg Bolsa Dos Hermanos.,.,1.0,19.9,19.9,3714080.98999999,Branded Rice,Keila Alfaro-Visvikis,RETAIL SEDANOS,1386667,Dec
2024-12-31,Sedanos Supermarkets #14,Invoice,008-04583,Rice Snack:Rice Snack Ham Flavored DOS HERMANOS,,1.0,19.9,19.9,3714100.88999999,Puffed Products,Keila Alfaro-Visvikis,RETAIL SEDANOS,1386668,Dec
2024-12-31,Sedanos Supermarkets #14,Invoice,008-04583,Rice Snack:Rice Snack Salami Flavored DOS HERMANOS,,1.0,19.9,19.9,3714120.78999999,Puffed Products,Keila Alfaro-Visvikis,RETAIL SEDANOS,1386669,Dec
2024-12-31,Sedanos Supermarkets #14,Invoice,008-04583,,Discount,,,-1.54,3714119.24999999,,Keila Alfaro-Visvikis,RETAIL SEDANOS,1386670,Dec
2024-12-31,Festival Supermarket Margate,Credit Memo,008-04596,Varios:Promotional Allowance,,-5.0,46.5,-232.5,3713886.74999999,Branded Rice,Keila Alfaro-Visvikis,RETAIL  DSD,1386671,Dec
2024-12-31,El Palacio de los jugos /  EMMA FOOD CORP,Invoice,008-04607,Arroz a Granel:Largo Fino 50 LB -Bolsa Dos Hermanos.,,10.0,27.75,277.5,3714164.24999999,Bulk Rice,Lisset Limpio -020,Cafeteria,1386672,Dec
2024-12-31,El Palacio de los jugos /  EMMA FOOD CORP,Invoice,008-04607,Arroz a Granel:Parboiled 50 LB -Bolsa Dos Hermanos.,,10.0,26.75,267.5,3714431.74999999,Bulk Rice,Lisset Limpio -020,Cafeteria,1386673,Dec
2025-01-02,Bravo   Francisco Diaz,Invoice,008-04597,Arroz a Granel:Largo Fino 50 LB -Bolsa Dos Hermanos.,,5.0,27.85,139.25,3714570.99999999,Bulk Rice,Lisset Limpio -020,RETAIL  DSD,1386674,Jan
2025-01-02,Bravo   Francisco Diaz,Invoice,008-04597,Liquids:AS Cooking Wine,4/1 Gl.,3.0,17.5,52.5,3714623.49999999,American Spice,Lisset Limpio -020,RETAIL  DSD,1386675,Jan
2025-01-02,Bravo   Francisco Diaz,Invoice,008-04597,Liquids:AS Lemon Juice 4/1 Gl,,1.0,14.95,14.95,3714638.44999999,American Spice,Lisset Limpio -020,RETAIL  DSD,1386676,Jan
2025-01-02,El Palacio de los jugos /  Nanos Latin Foods,Invoice,008-04598,Arroz a Granel:Largo Fino 50 LB -Bolsa Dos Hermanos.,,5.0,27.85,139.25,3714777.69999999,Bulk Rice,Lisset Limpio -020,Cafeteria,1386677,Jan
2025-01-02,El Palacio de los jugos /  Nanos Latin Foods,Invoice,008-04598,Arroz a Granel:Parboiled 50 LB -Bolsa Dos Hermanos.,,10.0,26.75,267.5,3715045.19999999,Bulk Rice,Lisset Limpio -020,Cafeteria,1386678,Jan
2025-01-02,Sedanos Supermarkets #33,Invoice,008-04599,Arroz a Granel:Parboiled 50 LB -Bolsa Dos Hermanos.,,4.0,28.25,113.0,3715158.19999999,Bulk Rice,Keila Alfaro-Visvikis,RETAIL SEDANOS,1386679,Jan
2025-01-02,Sedanos Supermarkets #33,Invoice,008-04599,,Discount,,,-2.26,3715155.93999999,,Keila Alfaro-Visvikis,RETAIL SEDANOS,1386680,Jan
2025-01-02,Rey Chavez Distributor #2,Invoice,008-04600,Arroz a Granel:Parboiled 50 LB -Bolsa Dos Hermanos.,,20.0,28.8,576.0,3715731.93999999,Bulk Rice,Lisset Limpio -020,WHOLESALER,1386681,Jan
2025-01-02,Sedanos Supermarkets #36,Invoice,008-04601,Arroz Envasado:Largo Fino 1kg (Long grain rice) Dos Hermanos,,1.0,17.5,17.5,3715749.43999999,Branded Rice,Keila Alfaro-Visvikis,RETAIL SEDANOS,1386682,Jan
2025-01-02,Sedanos Supermarkets #36,Invoice,008-04601,Arroz Envasado:Parboiled 1kg Bolsa Dos Hermanos.,.,1.0,19.9,19.9,3715769.33999999,Branded Rice,Keila Alfaro-Visvikis,RETAIL SEDANOS,1386683,Jan
2025-01-02,Sedanos Supermarkets #36,Invoice,008-04601,,Discount,,,-0.75,3715768.58999999,,Keila Alfaro-Visvikis,RETAIL SEDANOS,1386684,Jan
2025-01-02,Hings Chinese,Invoice,008-04602,Arroz a Granel:Parboiled 50 LB -Bolsa Dos Hermanos.,,5.0,28.25,141.25,3715909.83999999,Bulk Rice,Lisset Limpio -020,CAFETERIA y RESTAURANTS,1386685,Jan
2025-01-02,Sedanos Supermarkets #22,Invoice,008-04603,Arroz a Granel:Parboiled 50 LB -Bolsa Dos Hermanos.,,4.0,28.25,113.0,3716022.83999999,Bulk Rice,Keila Alfaro-Visvikis,RETAIL SEDANOS,1386686,Jan
2025-01-02,Sedanos Supermarkets #22,Invoice,008-04603,,Discount,,,-2.26,3716020.57999999,,Keila Alfaro-Visvikis,RETAIL SEDANOS,1386687,Jan
2025-01-02,Sedanos Supermarkets #43,Invoice,008-04604,Arroz a Granel:Parboiled 50 LB -Bolsa Dos Hermanos.,,5.0,28.25,141.25,3716161.82999999,Bulk Rice,Keila Alfaro-Visvikis,RETAIL SEDANOS,1386688,Jan
2025-01-02,Sedanos Supermarkets #43,Invoice,008-04604,,Discount,,,-2.83,3716158.99999999,,Keila Alfaro-Visvikis,RETAIL SEDANOS,1386689,Jan
2025-01-02,El Palacio de Los Jugos / Casa mía Food Restaurant inc,Invoice,008-04605,Arroz a Granel:Parboiled 50 LB -Bolsa Dos Hermanos.,,11.0,27.75,305.25,3716464.24999999,Bulk Rice,Lisset Limpio -020,Cafeteria,1386690,Jan
2025-01-02,El Palacio de Los Jugos / Casa mía Food Restaurant inc,Invoice,008-04605,Dry Beans:Dry Beans - Black Beans 50,Dry Black Beans 50 lb,1.0,45.7,45.7,3716509.94999999,Dry Beans,Lisset Limpio -020,Cafeteria,1386691,Jan
2025-01-02,El Palacio de Los Jugos / Casa mía Food Restaurant inc,Invoice,008-04605,Arroz a Granel:Parboiled 50 LB -Bolsa Dos Hermanos.,,1.0,27.75,27.75,3716537.69999999,Bulk Rice,Lisset Limpio -020,Cafeteria,1386692,Jan
2025-01-02,Be Your Will LLC,Invoice,008-04606,Liquids:AS Cooking Wine,4 1 Gl.,1.0,17.5,17.5,3716555.19999999,American Spice,Lisset Limpio -020,CAFETERIA y RESTAURANTS,1386693,Jan
2025-01-02,Be Your Will LLC,Invoice,008-04606,Arroz a Granel:Largo Fino 50 LB -Bolsa Dos Hermanos.,,7.0,27.85,194.95,3716750.14999999,Bulk Rice,Lisset Limpio -020,CAFETERIA y RESTAURANTS,1386694,Jan
2025-01-02,Be Your Will LLC,Invoice,008-04606,Arroz a Granel:Parboiled 50 LB -Bolsa Dos Hermanos.,,11.0,27.75,305.25,3717055.39999999,Bulk Rice,Lisset Limpio -020,CAFETERIA y RESTAURANTS,1386695,Jan
2025-01-02,Be Your Will LLC,Invoice,008-04606,Arroz a Granel:Parboiled 50 LB -Bolsa Dos Hermanos.,,1.0,27.75,27.75,3717083.14999999,Bulk Rice,Lisset Limpio -020,CAFETERIA y RESTAURANTS,1386696,Jan
2025-01-02,El Palacio de Los Jugos / Casa mía Food Restaurant inc,Credit Memo,008-04650,Varios:Promotional Allowance,Arroz a Granel:Parboiled 50 LB -Bolsa Dos Hermanos.,-1.0,27.75,-27.75,3717055.39999999,Bulk Rice,Lisset Limpio -020,Cafeteria,1386697,Jan
2025-01-02,Be Your Will LLC,Credit Memo,008-04651,Varios:Promotional Allowance,Arroz a Granel:Parboiled 50 LB -Bolsa Dos Hermanos.,-1.0,27.75,-27.75,3717027.64999999,Bulk Rice,Lisset Limpio -020,CAFETERIA y RESTAURANTS,1386698,Jan
2025-01-05,El Palacio de los jugos / Lita Foods Inc.,Invoice,008-04608,Dry Beans:Dry Beans - Black Beans 50,Dry Black Beans 50 lb,1.0,45.7,45.7,3717073.34999999,Dry Beans,Lisset Limpio -020,Cafeteria,1386699,Jan
2025-01-05,El Palacio de los jugos / Lita Foods Inc.,Invoice,008-04608,Arroz a Granel:Parboiled 50 LB -Bolsa Dos Hermanos.,,11.0,27.75,305.25,3717378.59999999,Bulk Rice,Lisset Limpio -020,Cafeteria,1386700,Jan
2025-01-05,El Palacio de los jugos / Lita Foods Inc.,Invoice,008-04608,Arroz a Granel:Parboiled 50 LB -Bolsa Dos Hermanos.,,1.0,27.75,27.75,3717406.34999999,Bulk Rice,Lisset Limpio -020,Cafeteria,1386701,Jan
2025-01-05,El Palacio de los jugos /  EMMA FOOD CORP,Invoice,008-04609,Arroz a Granel:Largo Fino 50 LB -Bolsa Dos Hermanos.,,5.0,27.85,139.25,3717545.59999999,Bulk Rice,Lisset Limpio -020,Cafeteria,1386702,Jan
2025-01-05,El Palacio de los jugos /  Nanos Latin Foods,Invoice,008-04610,Arroz a Granel:Largo Fino 50 LB -Bolsa Dos Hermanos.,,5.0,27.85,139.25,3717684.84999999,Bulk Rice,Lisset Limpio -020,Cafeteria,1386703,Jan
2025-01-05,El Palacio de los jugos /  Nanos Latin Foods,Invoice,008-04610,Arroz a Granel:Parboiled 50 LB -Bolsa Dos Hermanos.,,10.0,26.75,267.5,3717952.34999999,Bulk Rice,Lisset Limpio -020,Cafeteria,1386704,Jan
2025-01-05,Fritanga Momotombo,Invoice,008-04611,Arroz a Granel:Largo Fino 50 LB -Bolsa Dos Hermanos.,,7.0,27.85,194.95,3718147.29999999,Bulk Rice,Lisset Limpio -020,CAFETERIA y RESTAURANTS,1386705,Jan
2025-01-05,Soriano Brothers,Invoice,008-04612,Arroz a Granel:Parboiled 50 LB -Bolsa Dos Hermanos.,,25.0,26.75,668.75,3718816.04999999,Bulk Rice,Lisset Limpio -020,CAFETERIA y RESTAURANTS,1386706,Jan
2025-01-05,JMN Dely Corp,Invoice,008-04613,Arroz a Granel:Largo Fino 50 LB -Bolsa Dos Hermanos.,,2.0,27.85,55.7,3718871.74999999,Bulk Rice,Keila Alfaro-Visvikis,CAFETERIA y RESTAURANTS,1386707,Jan
2025-01-05,JMN Dely Corp,Invoice,008-04613,Arroz a Granel:Parboiled 50 LB -Bolsa Dos Hermanos.,,2.0,28.25,56.5,3718928.24999999,Bulk Rice,Keila Alfaro-Visvikis,CAFETERIA y RESTAURANTS,1386708,Jan
2025-01-05,JMN Dely Corp,Invoice,008-04613,Dry Beans:Dry Beans - Black Beans 50,Dry Black Beans 50 lb,1.0,45.7,45.7,3718973.94999999,Dry Beans,Keila Alfaro-Visvikis,CAFETERIA y RESTAURANTS,1386709,Jan
2025-01-05,Aries Supermarket & Cafeteria,Invoice,008-04614,Arroz a Granel:Parboiled 50 LB -Bolsa Dos Hermanos.,,5.0,28.25,141.25,3719115.19999999,Bulk Rice,Keila Alfaro-Visvikis,CAFETERIA y RESTAURANTS,1386710,Jan
2025-01-05,Mei Chang,Invoice,008-04615,Arroz a Granel:Parboiled 50 LB -Bolsa Dos Hermanos.,,7.0,28.25,197.75,3719312.94999999,Bulk Rice,Lisset Limpio -020,CAFETERIA y RESTAURANTS,1386711,Jan
2025-01-05,El Palacio de los jugos / Lita Foods Inc.,Credit Memo,008-04652,Varios:Promotional Allowance,Arroz a Granel:Parboiled 50 LB -Bolsa Dos Hermanos.,-1.0,27.75,-27.75,3719285.19999999,Bulk Rice,Lisset Limpio -020,Cafeteria,1386712,Jan
2025-01-08,"El Toro Loco Meat Distribution, LLC",Invoice,008-04616,Arroz a Granel:Largo Fino 50 LB -Bolsa Dos Hermanos.,,55.0,27.85,1531.75,3720816.94999999,Bulk Rice,Lisset Limpio -020,CAFETERIA y RESTAURANTS,1386713,Jan
2025-01-08,Sedanos Supermarkets #33,Invoice,008-04617,Arroz a Granel:Parboiled 50 LB -Bolsa Dos Hermanos.,,3.0,28.25,84.75,3720901.69999999,Bulk Rice,Keila Alfaro-Visvikis,RETAIL SEDANOS,1386714,Jan
2025-01-08,Sedanos Supermarkets #33,Invoice,008-04617,,Discount,,,-1.7,3720899.99999999,,Keila Alfaro-Visvikis,RETAIL SEDANOS,1386715,Jan
2025-01-08,Sedanos Supermarkets #26,Invoice,008-04618,Arroz a Granel:Parboiled 50 LB -Bolsa Dos Hermanos.,,3.0,28.25,84.75,3720984.74999999,Bulk Rice,Keila Alfaro-Visvikis,RETAIL SEDANOS,1386716,Jan
2025-01-08,Sedanos Supermarkets #16,Invoice,008-04619,Arroz a Granel:Parboiled 50 LB -Bolsa Dos Hermanos.,,5.0,28.25,141.25,3721125.99999999,Bulk Rice,Keila Alfaro-Visvikis,RETAIL SEDANOS,1386717,Jan
2025-01-08,Sedanos Supermarkets #16,Invoice,008-04619,,Discount,,,-2.83,3721123.16999999,,Keila Alfaro-Visvikis,RETAIL SEDANOS,1386718,Jan
2025-01-08,Max Food Distributors,Invoice,008-04620,Arroz a Granel:Parboiled 50 LB -Bolsa Dos Hermanos.,,55.0,27.75,1526.25,3722649.41999999,Bulk Rice,Lisset Limpio -020,WHOLESALER,1386719,Jan
2025-01-08,Sedanos Supermarkets  #37,Invoice,008-04621,Arroz a Granel:Parboiled 50 LB -Bolsa Dos Hermanos.,,5.0,28.25,141.25,3722790.66999999,Bulk Rice,Keila Alfaro-Visvikis,RETAIL SEDANOS,1386720,Jan
2025-01-08,Sedanos Supermarkets  #37,Invoice,008-04621,,Discount,,,-1.84,3722788.82999999,,Keila Alfaro-Visvikis,RETAIL SEDANOS,1386721,Jan
2025-01-08,Sedanos Supermarkets #28,Invoice,008-04622,Arroz Envasado:Parboiled 5KG Dos Hermanos.,6 / 11lbs,30.0,40.5,1215.0,3724003.82999999,Branded Rice,Keila Alfaro-Visvikis,RETAIL SEDANOS,1386722,Jan
2025-01-08,Sedanos Supermarkets #28,Invoice,008-04622,Arroz Envasado:Parboiled 5KG Dos Hermanos.,6 / 11lbs,11.0,40.5,445.5,3724449.32999999,Branded Rice,Keila Alfaro-Visvikis,RETAIL SEDANOS,1386723,Jan
2025-01-08,Sedanos Supermarkets #28,Invoice,008-04622,,Discount,,,-24.3,3724425.02999999,,Keila Alfaro-Visvikis,RETAIL SEDANOS,1386724,Jan
2025-01-08,Sedanos Supermarkets #26,Invoice,008-04623,Arroz a Granel:Parboiled 50 LB -Bolsa Dos Hermanos.,,0.0,,0.0,3724425.02999999,Bulk Rice,Keila Alfaro-Visvikis,RETAIL SEDANOS,1386725,Jan
2025-01-08,Sedanos Supermarkets #22,Invoice,008-04624,Rice Snack:Rice Snack Ham Flavored DOS HERMANOS,,0.0,,0.0,3724425.02999999,Puffed Products,Keila Alfaro-Visvikis,RETAIL SEDANOS,1386726,Jan
2025-01-08,Ideal Food Basket Davie Cafeteria,Invoice,008-04625,Arroz a Granel:Largo Fino 50 LB -Bolsa Dos Hermanos.,,9.0,27.85,250.65,3724675.67999999,Bulk Rice,Keila Alfaro-Visvikis,CAFETERIA y RESTAURANTS,1386727,Jan
2025-01-08,Sedanos Supermarkets #24,Invoice,008-04626,Arroz a Granel:Parboiled 50 LB -Bolsa Dos Hermanos.,,8.0,28.25,226.0,3724901.67999999,Bulk Rice,Keila Alfaro-Visvikis,RETAIL SEDANOS,1386728,Jan
2025-01-08,Sedanos Supermarkets #24,Invoice,008-04626,,Discount,,,-4.52,3724897.15999999,,Keila Alfaro-Visvikis,RETAIL SEDANOS,1386729,Jan
2025-01-08,Sedanos Supermarkets #28,Credit Memo,008-04653,Varios:Promotional Allowance,Arroz Envasado:Parboiled 5KG Dos Hermanos.,-11.0,40.5,-445.5,3724451.65999999,Branded Rice,Keila Alfaro-Visvikis,RETAIL SEDANOS,1386730,Jan
2025-01-09,Bravo   Francisco Diaz,Invoice,008-04627,Dry Beans:Dry Beans - Small Red Beans 50 lbs.,Small Red Beans 50 lbs,1.0,42.0,42.0,3724493.65999999,Dry Beans,Lisset Limpio -020,RETAIL  DSD,1386731,Jan
2025-01-09,Bravo   Francisco Diaz,Invoice,008-04627,Arroz a Granel:Largo Fino 50 LB -Bolsa Dos Hermanos.,,5.0,27.85,139.25,3724632.90999999,Bulk Rice,Lisset Limpio -020,RETAIL  DSD,1386732,Jan
2025-01-09,Bravo   Francisco Diaz,Invoice,008-04627,Dry Beans:Dry Beans - Black Beans 50,Dry Black Beans 50 lb,1.0,45.7,45.7,3724678.60999999,Dry Beans,Lisset Limpio -020,RETAIL  DSD,1386733,Jan
2025-01-09,ALS Foods,Invoice,008-04628,Liquids:AS Cooking Wine,4/1 Gl.,1.0,17.5,17.5,3724696.10999999,American Spice,Lisset Limpio -020,CAFETERIA y RESTAURANTS,1386734,Jan
2025-01-09,ALS Foods,Invoice,008-04628,Arroz a Granel:Largo Fino 50 LB -Bolsa Dos Hermanos.,,5.0,27.85,139.25,3724835.35999999,Bulk Rice,Lisset Limpio -020,CAFETERIA y RESTAURANTS,1386735,Jan
2025-01-09,ALS Foods,Invoice,008-04628,Arroz a Granel:Parboiled 50 LB -Bolsa Dos Hermanos.,,11.0,27.75,305.25,3725140.60999999,Bulk Rice,Lisset Limpio -020,CAFETERIA y RESTAURANTS,1386736,Jan
2025-01-09,ALS Foods,Invoice,008-04628,Arroz a Granel:Parboiled 50 LB -Bolsa Dos Hermanos.,,1.0,27.75,27.75,3725168.35999999,Bulk Rice,Lisset Limpio -020,CAFETERIA y RESTAURANTS,1386737,Jan
2025-01-09,El Palacio de los jugos /  EMMA FOOD CORP,Invoice,008-04629,Arroz a Granel:Largo Fino 50 LB -Bolsa Dos Hermanos.,,5.0,27.85,139.25,3725307.60999999,Bulk Rice,Lisset Limpio -020,Cafeteria,1386738,Jan
2025-01-09,El Palacio de los jugos /  EMMA FOOD CORP,Invoice,008-04629,Arroz a Granel:Parboiled 50 LB -Bolsa Dos Hermanos.,,9.0,26.75,240.75,3725548.35999999,Bulk Rice,Lisset Limpio -020,Cafeteria,1386739,Jan
2025-01-09,El Palacio de los jugos /  Nanos Latin Foods,Invoice,008-04630,Arroz a Granel:Largo Fino 50 LB -Bolsa Dos Hermanos.,,5.0,27.85,139.25,3725687.60999999,Bulk Rice,Lisset Limpio -020,Cafeteria,1386740,Jan
2025-01-09,El Palacio de los jugos /  Nanos Latin Foods,Invoice,008-04630,Arroz a Granel:Parboiled 50 LB -Bolsa Dos Hermanos.,,5.0,26.75,133.75,3725821.35999999,Bulk Rice,Lisset Limpio -020,Cafeteria,1386741,Jan
2025-01-09,El Palacio de los jugos / Leti Corp.,Invoice,008-04631,Arroz a Granel:Largo Fino 50 LB -Bolsa Dos Hermanos.,,5.0,27.85,139.25,3725960.60999999,Bulk Rice,Lisset Limpio -020,Cafeteria,1386742,Jan
2025-01-09,El Palacio de los jugos / Leti Corp.,Invoice,008-04631,Arroz a Granel:Parboiled 50 LB -Bolsa Dos Hermanos.,,5.0,26.75,133.75,3726094.35999999,Bulk Rice,Lisset Limpio -020,Cafeteria,1386743,Jan
2025-01-09,El Palacio de los jugos / Delicias Criollas (DIAGO FOOD_MILLER),Invoice,008-04632,Arroz a Granel:Parboiled 50 LB -Bolsa Dos Hermanos.,,11.0,27.75,305.25,3726399.60999999,Bulk Rice,Lisset Limpio -020,Cafeteria,1386744,Jan
2025-01-09,El Palacio de los jugos / Delicias Criollas (DIAGO FOOD_MILLER),Invoice,008-04632,Dry Beans:Dry Beans - Black Beans 50,Dry Black Beans 50 lb,1.0,45.7,45.7,3726445.30999999,Dry Beans,Lisset Limpio -020,Cafeteria,1386745,Jan
2025-01-09,El Palacio de los jugos / Delicias Criollas (DIAGO FOOD_MILLER),Invoice,008-04632,Arroz a Granel:Parboiled 50 LB -Bolsa Dos Hermanos.,,1.0,27.75,27.75,3726473.05999999,Bulk Rice,Lisset Limpio -020,Cafeteria,1386746,Jan
2025-01-09,El Palacio de los jugos / Delicias Criollas (DIAGO FOOD_MILLER),Invoice,008-04632,,Discount,,,-0.71,3726472.34999999,,Lisset Limpio -020,Cafeteria,1386747,Jan
2025-01-09,Sedanos Supermarkets #18,Invoice,008-04633,Arroz a Granel:Parboiled 50 LB -Bolsa Dos Hermanos.,,8.0,28.25,226.0,3726698.34999999,Bulk Rice,Keila Alfaro-Visvikis,RETAIL SEDANOS,1386748,Jan
2025-01-09,Sedanos Supermarkets #18,Invoice,008-04633,,Discount,,,-4.52,3726693.82999999,,Keila Alfaro-Visvikis,RETAIL SEDANOS,1386749,Jan
2025-01-09,El Palacio de los jugos / La sabrosa salsa cubana Corp,Invoice,008-04634,Arroz a Granel:Largo Fino 50 LB -Bolsa Dos Hermanos.,,5.0,27.85,139.25,3726833.07999999,Bulk Rice,Lisset Limpio -020,Cafeteria,1386750,Jan
2025-01-09,El Gallego Supermarket,Invoice,008-04635,Arroz a Granel:Parboiled 50 LB -Bolsa Dos Hermanos.,,6.0,28.25,169.5,3727002.57999999,Bulk Rice,Lisset Limpio -020,RETAIL  DSD,1386751,Jan
2025-01-09,El Gallego Supermarket,Invoice,008-04635,Dry Beans:Dry Beans - Black Beans 50,Dry Black Beans 50 lb,3.0,45.7,137.1,3727139.67999999,Dry Beans,Lisset Limpio -020,RETAIL  DSD,1386752,Jan
2025-01-09,Sedanos Supermarkets #32,Invoice,008-04636,Arroz a Granel:Largo Fino 50 LB -Bolsa Dos Hermanos.,,5.0,27.85,139.25,3727278.92999999,Bulk Rice,Keila Alfaro-Visvikis,RETAIL SEDANOS,1386753,Jan
2025-01-09,Sedanos Supermarkets #32,Invoice,008-04636,,Discount,,,-2.79,3727276.13999999,,Keila Alfaro-Visvikis,RETAIL SEDANOS,1386754,Jan
2025-01-09,Sedanos Supermarkets #31,Invoice,008-04637,Arroz a Granel:Parboiled 50 LB -Bolsa Dos Hermanos.,,4.0,28.25,113.0,3727389.13999999,Bulk Rice,Keila Alfaro-Visvikis,RETAIL SEDANOS,1386755,Jan
2025-01-09,Sedanos Supermarkets #31,Invoice,008-04637,,Discount,,,-2.26,3727386.87999999,,Keila Alfaro-Visvikis,RETAIL SEDANOS,1386756,Jan
2025-01-09,Sedanos Supermarkets #31,Invoice,008-04638,Arroz Envasado:Largo Fino 1kg (Long grain rice) Dos Hermanos,,1.0,17.5,17.5,3727404.37999999,Branded Rice,Keila Alfaro-Visvikis,RETAIL SEDANOS,1386757,Jan
2025-01-09,Sedanos Supermarkets #31,Invoice,008-04638,Arroz Envasado:Parboiled 1kg Bolsa Dos Hermanos.,.,1.0,19.9,19.9,3727424.27999999,Branded Rice,Keila Alfaro-Visvikis,RETAIL SEDANOS,1386758,Jan
2025-01-09,Sabor Tropical Supermarket #3,Invoice,008-04639,Arroz Envasado:Largo Fino 1kg (Long grain rice) Dos Hermanos,,1.0,18.0,18.0,3727442.27999999,Branded Rice,Keila Alfaro-Visvikis,RETAIL KEY FOOD,1386759,Jan
2025-01-09,Sabor Tropical Supermarket #3,Invoice,008-04639,Arroz Envasado:Parboiled 1kg Bolsa Dos Hermanos.,.,1.0,19.9,19.9,3727462.17999999,Branded Rice,Keila Alfaro-Visvikis,RETAIL KEY FOOD,1386760,Jan
2025-01-09,Sabor Tropical Supermarket #3,Invoice,008-04639,Arroz Envasado:Parboiled 5KG Dos Hermanos.,6 / 11lbs,30.0,46.5,1395.0,3728857.17999999,Branded Rice,Keila Alfaro-Visvikis,RETAIL KEY FOOD,1386761,Jan
2025-01-09,Sabor Tropical Supermarket #3,Invoice,008-04639,Arroz Envasado:Parboiled 5KG Dos Hermanos.,6 / 11lbs,11.0,46.5,511.5,3729368.67999999,Branded Rice,Keila Alfaro-Visvikis,RETAIL KEY FOOD,1386762,Jan
2025-01-09,Sabor Tropical Supermarket #3,Invoice,008-04639,Arroz Envasado:Parboiled 1kg Bolsa Dos Hermanos.,.,1.0,19.9,19.9,3729388.57999999,Branded Rice,Keila Alfaro-Visvikis,RETAIL KEY FOOD,1386763,Jan
2025-01-09,Sabor Tropical Supermarket #3,Invoice,008-04639,Arroz a Granel:Largo Fino 50 LB -Bolsa Dos Hermanos.,,1.0,27.85,27.85,3729416.42999999,Bulk Rice,Keila Alfaro-Visvikis,RETAIL KEY FOOD,1386764,Jan
2025-01-09,"Soriano Brothers Diaz Food Service,Inc",Invoice,008-04640,Arroz a Granel:Parboiled 50 LB -Bolsa Dos Hermanos.,,44.0,27.75,1221.0,3730637.42999999,Bulk Rice,Lisset Limpio -020,CAFETERIA y RESTAURANTS,1386765,Jan
2025-01-09,"Soriano Brothers Diaz Food Service,Inc",Invoice,008-04640,Arroz a Granel:Parboiled 50 LB -Bolsa Dos Hermanos.,,4.0,27.75,111.0,3730748.42999999,Bulk Rice,Lisset Limpio -020,CAFETERIA y RESTAURANTS,1386766,Jan
2025-01-09,Sabor Tropical Supermarket #3,Credit Memo,008-04654,Varios:Promotional Allowance,Arroz Envasado:Parboiled 5KG Dos Hermanos.,-11.0,46.5,-511.5,3730236.92999999,Branded Rice,Lisset Limpio -020,RETAIL KEY FOOD,1386767,Jan
2025-01-09,Sabor Tropical Supermarket #3,Credit Memo,008-04654,Varios:Promotional Allowance,Arroz a Granel:Largo Fino 50 LB -Bolsa Dos Hermanos.,-1.0,27.85,-27.85,3730209.07999999,Bulk Rice,Lisset Limpio -020,RETAIL KEY FOOD,1386768,Jan
2025-01-09,Sabor Tropical Supermarket #3,Credit Memo,008-04654,Varios:Promotional Allowance,Arroz Envasado:Largo Fino 1kg (Long grain rice) Dos Hermanos,-1.0,18.0,-18.0,3730191.07999999,Branded Rice,Lisset Limpio -020,RETAIL KEY FOOD,1386769,Jan
2025-01-09,ALS Foods,Credit Memo,008-04655,Varios:Promotional Allowance,Arroz a Granel:Parboiled 50 LB -Bolsa Dos Hermanos.,-1.0,27.75,-27.75,3730163.32999999,Bulk Rice,Lisset Limpio -020,CAFETERIA y RESTAURANTS,1386770,Jan
2025-01-09,El Palacio de los jugos / Delicias Criollas (DIAGO FOOD_MILLER),Credit Memo,008-04656,Varios:Promotional Allowance,Arroz a Granel:Parboiled 50 LB -Bolsa Dos Hermanos.,-1.0,27.75,-27.75,3730135.57999999,Bulk Rice,Lisset Limpio -020,Cafeteria,1386771,Jan
2025-01-09,"Soriano Brothers Diaz Food Service,Inc",Credit Memo,008-04657,Varios:Promotional Allowance,Arroz a Granel:Parboiled 50 LB -Bolsa Dos Hermanos.,-4.0,27.75,-111.0,3730024.57999999,Bulk Rice,Lisset Limpio -020,CAFETERIA y RESTAURANTS,1386772,Jan
2025-01-12,Sorianos Brothers,Invoice,008-04641,Arroz a Granel:Parboiled 50 LB -Bolsa Dos Hermanos.,,25.0,26.75,668.75,3730693.32999999,Bulk Rice,Lisset Limpio -020,CAFETERIA y RESTAURANTS,1386773,Jan
2025-01-12,El Palacio de los jugos /  Nanos Latin Foods,Invoice,008-04642,Arroz a Granel:Largo Fino 50 LB -Bolsa Dos Hermanos.,,5.0,27.85,139.25,3730832.57999999,Bulk Rice,Lisset Limpio -020,Cafeteria,1386774,Jan
2025-01-12,El Palacio de los jugos /  Nanos Latin Foods,Invoice,008-04642,Arroz a Granel:Parboiled 50 LB -Bolsa Dos Hermanos.,,8.0,26.75,214.0,3731046.57999999,Bulk Rice,Lisset Limpio -020,Cafeteria,1386775,Jan
2025-01-12,El Palacio de Los Jugos / Casa mía Food Restaurant inc,Invoice,008-04643,Dry Beans:Dry Beans - Black Beans 50,Dry Black Beans 50 lb,1.0,45.7,45.7,3731092.27999999,Dry Beans,Lisset Limpio -020,Cafeteria,1386776,Jan
2025-01-12,El Palacio de Los Jugos / Casa mía Food Restaurant inc,Invoice,008-04643,Arroz a Granel:Parboiled 50 LB -Bolsa Dos Hermanos.,,11.0,27.75,305.25,3731397.52999999,Bulk Rice,Lisset Limpio -020,Cafeteria,1386777,Jan
2025-01-12,El Palacio de Los Jugos / Casa mía Food Restaurant inc,Invoice,008-04643,Arroz a Granel:Parboiled 50 LB -Bolsa Dos Hermanos.,,1.0,27.75,27.75,3731425.27999999,Bulk Rice,Lisset Limpio -020,Cafeteria,1386778,Jan
2025-01-12,El Palacio de los jugos / La sabrosa salsa cubana Corp,Invoice,008-04644,Arroz a Granel:Largo Fino 50 LB -Bolsa Dos Hermanos.,,6.0,27.85,167.1,3731592.37999999,Bulk Rice,Lisset Limpio -020,Cafeteria,1386779,Jan
2025-01-12,El Palacio de los jugos / Rodriguez Foods,Invoice,008-04645,Arroz a Granel:Largo Fino 50 LB -Bolsa Dos Hermanos.,,5.0,27.85,139.25,3731731.62999999,Bulk Rice,Lisset Limpio -020,Cafeteria,1386780,Jan
2025-01-12,El Palacio de los jugos / Rodriguez Foods,Invoice,008-04645,Arroz a Granel:Parboiled 50 LB -Bolsa Dos Hermanos.,,5.0,26.75,133.75,3731865.37999999,Bulk Rice,Lisset Limpio -020,Cafeteria,1386781,Jan
2025-01-12,JMN Dely Corp,Invoice,008-04646,Arroz a Granel:Largo Fino 50 LB -Bolsa Dos Hermanos.,,2.0,27.85,55.7,3731921.07999999,Bulk Rice,Keila Alfaro-Visvikis,CAFETERIA y RESTAURANTS,1386782,Jan
2025-01-12,JMN Dely Corp,Invoice,008-04646,Arroz a Granel:Parboiled 50 LB -Bolsa Dos Hermanos.,,2.0,27.75,55.5,3731976.57999999,Bulk Rice,Keila Alfaro-Visvikis,CAFETERIA y RESTAURANTS,1386783,Jan
2025-01-12,JMN Dely Corp,Invoice,008-04646,Dry Beans:Dry Beans - Black Beans 50,Dry Black Beans 50 lb,1.0,45.7,45.7,3732022.27999999,Dry Beans,Keila Alfaro-Visvikis,CAFETERIA y RESTAURANTS,1386784,Jan
2025-01-12,Sedanos Supermarkets #14,Invoice,008-04647,Arroz a Granel:Parboiled 50 LB -Bolsa Dos Hermanos.,,2.0,28.25,56.5,3732078.77999999,Bulk Rice,Keila Alfaro-Visvikis,RETAIL SEDANOS,1386785,Jan
2025-01-12,Sedanos Supermarkets #14,Invoice,008-04647,,Discount,,,-1.13,3732077.64999999,,Keila Alfaro-Visvikis,RETAIL SEDANOS,1386786,Jan
2025-01-12,Sedanos Supermarkets #14,Invoice,008-04648,Arroz Envasado:Largo Fino 1kg (Long grain rice) Dos Hermanos,,1.0,17.5,17.5,3732095.14999999,Branded Rice,Keila Alfaro-Visvikis,RETAIL SEDANOS,1386787,Jan
2025-01-12,Sedanos Supermarkets #14,Invoice,008-04648,Arroz Envasado:Parboiled 1kg Bolsa Dos Hermanos.,.,1.0,19.9,19.9,3732115.04999999,Branded Rice,Keila Alfaro-Visvikis,RETAIL SEDANOS,1386788,Jan
2025-01-12,Sedanos Supermarkets #14,Invoice,008-04648,,Discount,,,-0.75,3732114.29999999,,Keila Alfaro-Visvikis,RETAIL SEDANOS,1386789,Jan
2025-01-12,El Palacio de los jugos /  EMMA FOOD CORP,Invoice,008-04649,Arroz a Granel:Largo Fino 50 LB -Bolsa Dos Hermanos.,,7.0,27.85,194.95,3732309.24999999,Bulk Rice,Lisset Limpio -020,Cafeteria,1386790,Jan
2025-01-12,El Palacio de Los Jugos / Casa mía Food Restaurant inc,Credit Memo,008-04658,Varios:Promotional Allowance,Arroz a Granel:Parboiled 50 LB -Bolsa Dos Hermanos.,-1.0,27.75,-27.75,3732281.49999999,Bulk Rice,Lisset Limpio -020,Cafeteria,1386791,Jan
2025-01-15,Sedanos Supermarkets #34,Invoice,008-04659,Arroz Envasado:Largo Fino 1kg (Long grain rice) Dos Hermanos,,0.0,,0.0,3732281.49999999,Branded Rice,Keila Alfaro-Visvikis,RETAIL SEDANOS,1386792,Jan
2025-01-15,Sedanos Supermarkets #34,Invoice,008-04659,Arroz Envasado:Parboiled 1kg Bolsa Dos Hermanos.,.,0.0,,0.0,3732281.49999999,Branded Rice,Keila Alfaro-Visvikis,RETAIL SEDANOS,1386793,Jan
2025-01-15,Sedanos Supermarkets #34,Invoice,008-04660,Arroz a Granel:Parboiled 50 LB -Bolsa Dos Hermanos.,,3.0,28.25,84.75,3732366.24999999,Bulk Rice,Keila Alfaro-Visvikis,RETAIL SEDANOS,1386794,Jan
2025-01-15,Sedanos Supermarkets #34,Invoice,008-04660,,Discount,,,-1.7,3732364.54999999,,Keila Alfaro-Visvikis,RETAIL SEDANOS,1386795,Jan
2025-01-15,Sedanos Supermarkets #24,Invoice,008-04661,Arroz a Granel:Parboiled 50 LB -Bolsa Dos Hermanos.,,6.0,28.25,169.5,3732534.04999999,Bulk Rice,Keila Alfaro-Visvikis,RETAIL SEDANOS,1386796,Jan
2025-01-15,Sedanos Supermarkets #24,Invoice,008-04661,,Discount,,,-3.39,3732530.65999999,,Keila Alfaro-Visvikis,RETAIL SEDANOS,1386797,Jan
2025-01-15,Sedanos Supermarkets #27,Invoice,008-04662,Arroz a Granel:Parboiled 50 LB -Bolsa Dos Hermanos.,,6.0,28.25,169.5,3732700.15999999,Bulk Rice,Keila Alfaro-Visvikis,RETAIL SEDANOS,1386798,Jan
2025-01-15,Sedanos Supermarkets #27,Invoice,008-04662,Arroz a Granel:Parboiled 50 LB -Bolsa Dos Hermanos.,,1.0,28.25,28.25,3732728.40999999,Bulk Rice,Keila Alfaro-Visvikis,RETAIL SEDANOS,1386799,Jan
2025-01-15,Sedanos Supermarkets #27,Invoice,008-04662,,Discount,,,-3.39,3732725.01999999,,Keila Alfaro-Visvikis,RETAIL SEDANOS,1386800,Jan
2025-01-15,Ideal Food Basket Davie Cafeteria,Invoice,008-04663,Arroz a Granel:Largo Fino 50 LB -Bolsa Dos Hermanos.,,8.0,27.85,222.8,3732947.81999999,Bulk Rice,Keila Alfaro-Visvikis,CAFETERIA y RESTAURANTS,1386801,Jan
2025-01-15,Key Food Kimberly Blvd.,Invoice,008-04664,Arroz Envasado:Largo Fino 1kg (Long grain rice) Dos Hermanos,,3.0,18.0,54.0,3733001.81999999,Branded Rice,Keila Alfaro-Visvikis,RETAIL  DSD,1386802,Jan
2025-01-15,Key Food Kimberly Blvd.,Invoice,008-04664,Arroz Envasado:Parboiled 1kg Bolsa Dos Hermanos.,.,2.0,19.9,39.8,3733041.61999999,Branded Rice,Keila Alfaro-Visvikis,RETAIL  DSD,1386803,Jan
2025-01-15,Key Food Kimberly Blvd.,Invoice,008-04664,Arroz Envasado:Largo Fino 1kg (Long grain rice) Dos Hermanos,,1.0,18.0,18.0,3733059.61999999,Branded Rice,Keila Alfaro-Visvikis,RETAIL  DSD,1386804,Jan
2025-01-15,Key Food Kimberly Blvd.,Invoice,008-04664,Arroz a Granel:Parboiled 50 LB -Bolsa Dos Hermanos.,CAMBIO DE PRODUCTO,4.0,28.25,113.0,3733172.61999999,Bulk Rice,Keila Alfaro-Visvikis,RETAIL  DSD,1386805,Jan
2025-01-15,Festival Supermarket,Invoice,008-04665,Arroz Envasado:Parboiled 5KG Dos Hermanos.,6 / 11lbs,10.0,46.5,465.0,3733637.61999999,Branded Rice,Keila Alfaro-Visvikis,RETAIL  DSD,1386806,Jan
2025-01-15,Festival Supermarket,Invoice,008-04665,Arroz Envasado:Largo Fino 1kg (Long grain rice) Dos Hermanos,,1.0,18.0,18.0,3733655.61999999,Branded Rice,Keila Alfaro-Visvikis,RETAIL  DSD,1386807,Jan
2025-01-15,Festival Supermarket,Invoice,008-04665,Arroz Envasado:Parboiled 5KG Dos Hermanos.,6  11lbs,10.0,46.5,465.0,3734120.61999999,Branded Rice,Keila Alfaro-Visvikis,RETAIL  DSD,1386808,Jan
2025-01-15,Festival Supermarket,Invoice,008-04665,Arroz Envasado:Largo Fino 1kg (Long grain rice) Dos Hermanos,,1.0,18.0,18.0,3734138.61999999,Branded Rice,Keila Alfaro-Visvikis,RETAIL  DSD,1386809,Jan
2025-01-15,Be Your Will LLC,Invoice,008-04666,Liquids:AS Cooking Wine,4/1 Gl.,2.0,17.5,35.0,3734173.61999999,American Spice,Lisset Limpio -020,CAFETERIA y RESTAURANTS,1386810,Jan
2025-01-15,Be Your Will LLC,Invoice,008-04666,Arroz a Granel:Parboiled 50 LB -Bolsa Dos Hermanos.,,11.0,27.75,305.25,3734478.86999999,Bulk Rice,Lisset Limpio -020,CAFETERIA y RESTAURANTS,1386811,Jan
2025-01-15,Be Your Will LLC,Invoice,008-04666,Arroz a Granel:Largo Fino 50 LB -Bolsa Dos Hermanos.,,6.0,27.85,167.1,3734645.96999999,Bulk Rice,Lisset Limpio -020,CAFETERIA y RESTAURANTS,1386812,Jan
2025-01-15,Be Your Will LLC,Invoice,008-04666,Arroz a Granel:Parboiled 50 LB -Bolsa Dos Hermanos.,,1.0,27.85,27.85,3734673.81999999,Bulk Rice,Lisset Limpio -020,CAFETERIA y RESTAURANTS,1386813,Jan
2025-01-15,Aries Supermarket & Cafeteria,Invoice,008-04667,Arroz a Granel:Parboiled 50 LB -Bolsa Dos Hermanos.,,5.0,28.25,141.25,3734815.06999999,Bulk Rice,Keila Alfaro-Visvikis,CAFETERIA y RESTAURANTS,1386814,Jan
2025-01-15,Aries Supermarket & Cafeteria,Invoice,008-04667,Dry Beans:Dry Beans - Black Beans 50,Dry Black Beans 50 lb,3.0,45.7,137.1,3734952.16999999,Dry Beans,Keila Alfaro-Visvikis,CAFETERIA y RESTAURANTS,1386815,Jan
2025-01-15,Aries Supermarket & Cafeteria,Invoice,008-04667,Spices:AS Whole Bay Leaves,4/12 OZ,1.0,25.3,25.3,3734977.46999999,American Spice,Keila Alfaro-Visvikis,CAFETERIA y RESTAURANTS,1386816,Jan
2025-01-15,Aries Supermarket & Cafeteria,Invoice,008-04667,Spices:AS Chicken Base,1 / 30 lb. (box or pail),1.0,35.0,35.0,3735012.46999999,American Spice,Keila Alfaro-Visvikis,CAFETERIA y RESTAURANTS,1386817,Jan
2025-01-15,Neighbors Food Market / Luis Diaz,Invoice,008-04668,Arroz Envasado:Parboiled 1kg Bolsa Dos Hermanos.,.,3.0,19.9,59.7,3735072.16999999,Branded Rice,Keila Alfaro-Visvikis,RETAIL  DSD,1386818,Jan
2025-01-15,Neighbors Food Market / Luis Diaz,Invoice,008-04668,Arroz Envasado:Largo Fino 1kg (Long grain rice) Dos Hermanos,,2.0,17.5,35.0,3735107.16999999,Branded Rice,Keila Alfaro-Visvikis,RETAIL  DSD,1386819,Jan
2025-01-15,Neighbors Food Market / Luis Diaz,Invoice,008-04668,Arroz Envasado:Parboiled 5KG Dos Hermanos.,6 / 11lbs,2.0,46.5,93.0,3735200.16999999,Branded Rice,Keila Alfaro-Visvikis,RETAIL  DSD,1386820,Jan
2025-01-15,Neighbors Food Market / Luis Diaz,Invoice,008-04668,Arroz Envasado:Largo Fino 1kg (Long grain rice) Dos Hermanos,,1.0,17.5,17.5,3735217.66999999,Branded Rice,Keila Alfaro-Visvikis,RETAIL  DSD,1386821,Jan
2025-01-15,Neighbors Food Market / Luis Diaz,Invoice,008-04668,Arroz Envasado:Parboiled 5KG Dos Hermanos.,6  11lbs,1.0,46.5,46.5,3735264.16999999,Branded Rice,Keila Alfaro-Visvikis,RETAIL  DSD,1386822,Jan
2025-01-15,Festival Supermarket #35- Southgate,Invoice,008-04669,Arroz Envasado:Parboiled 5KG Dos Hermanos.,6 / 11lbs,20.0,46.5,930.0,3736194.16999999,Branded Rice,Keila Alfaro-Visvikis,RETAIL  DSD,1386823,Jan
2025-01-15,Festival Supermarket #35- Southgate,Invoice,008-04669,Arroz Envasado:Parboiled 1kg Bolsa Dos Hermanos.,.,1.0,19.9,19.9,3736214.06999999,Branded Rice,Keila Alfaro-Visvikis,RETAIL  DSD,1386824,Jan
2025-01-15,Festival Supermarket #35- Southgate,Invoice,008-04669,Arroz Envasado:Largo Fino 1kg (Long grain rice) Dos Hermanos,,1.0,18.0,18.0,3736232.06999999,Branded Rice,Keila Alfaro-Visvikis,RETAIL  DSD,1386825,Jan
2025-01-15,Festival Supermarket #35- Southgate,Invoice,008-04669,Arroz Envasado:Parboiled 5KG Dos Hermanos.,6  11lbs,20.0,46.5,930.0,3737162.06999999,Branded Rice,Keila Alfaro-Visvikis,RETAIL  DSD,1386826,Jan
2025-01-15,Festival Supermarket #35- Southgate,Invoice,008-04669,Arroz Envasado:Largo Fino 1kg (Long grain rice) Dos Hermanos,,1.0,18.0,18.0,3737180.06999999,Branded Rice,Keila Alfaro-Visvikis,RETAIL  DSD,1386827,Jan
2025-01-15,Food Fair Plantation Corp,Invoice,008-04670,Arroz a Granel:Parboiled 50 LB -Bolsa Dos Hermanos.,,55.0,28.25,1553.75,3738733.81999999,Bulk Rice,Keila Alfaro-Visvikis,RETAIL  DSD,1386828,Jan
2025-01-15,Food Fair Plantation Corp,Invoice,008-04670,Arroz Envasado:Parboiled 5KG Dos Hermanos.,6 / 11lbs,15.0,46.5,697.5,3739431.31999999,Branded Rice,Keila Alfaro-Visvikis,RETAIL  DSD,1386829,Jan
2025-01-15,Food Fair Plantation Corp,Invoice,008-04670,Arroz Envasado:Parboiled 5KG Dos Hermanos.,6 / 11lbs,5.0,46.5,232.5,3739663.81999999,Branded Rice,Keila Alfaro-Visvikis,RETAIL  DSD,1386830,Jan
2025-01-15,Chavez Distributors Inc.,Invoice,008-04671,Arroz a Granel:Parboiled 50 LB -Bolsa Dos Hermanos.,,55.0,27.75,1526.25,3741190.06999999,Bulk Rice,Keila Alfaro-Visvikis,WHOLESALER,1386831,Jan
2025-01-15,Key Food Kimberly Blvd.,Credit Memo,008-04750,Arroz a Granel:Parboiled 50 LB -Bolsa Dos Hermanos.,4 PARBOILED CAMBIO POR FECHA VIEJA- REINGRESA,-4.0,28.25,-113.0,3741077.06999999,Bulk Rice,Keila Alfaro-Visvikis,RETAIL  DSD,1386832,Jan
2025-01-15,Sedanos Supermarkets #27,Credit Memo,008-04751,Varios:Promotional Allowance,Arroz a Granel:Parboiled 50 LB -Bolsa Dos Hermanos.,-1.0,28.25,-28.25,3741048.81999999,Bulk Rice,Keila Alfaro-Visvikis,RETAIL SEDANOS,1386833,Jan
2025-01-15,Festival Supermarket,Credit Memo,008-04752,Varios:Promotional Allowance,Arroz Envasado:Largo Fino 1kg (Long grain rice) Dos Hermanos,-1.0,18.0,-18.0,3741030.81999999,Branded Rice,Keila Alfaro-Visvikis,RETAIL  DSD,1386834,Jan
2025-01-15,Festival Supermarket,Credit Memo,008-04752,Varios:Promotional Allowance,Arroz Envasado:Parboiled 5KG Dos Hermanos.,-10.0,46.5,-465.0,3740565.81999999,Branded Rice,Keila Alfaro-Visvikis,RETAIL  DSD,1386835,Jan
2025-01-15,Be Your Will LLC,Credit Memo,008-04753,Varios:Promotional Allowance,Arroz a Granel:Parboiled 50 LB -Bolsa Dos Hermanos.,-1.0,27.85,-27.85,3740537.96999999,Bulk Rice,Lisset Limpio -020,CAFETERIA y RESTAURANTS,1386836,Jan
2025-01-15,Neighbors Food Market / Luis Diaz,Credit Memo,008-04754,Varios:Promotional Allowance,Arroz Envasado:Largo Fino 1kg (Long grain rice) Dos Hermanos,-1.0,17.5,-17.5,3740520.46999999,Branded Rice,Keila Alfaro-Visvikis,RETAIL  DSD,1386837,Jan
2025-01-15,Neighbors Food Market / Luis Diaz,Credit Memo,008-04754,Varios:Promotional Allowance,Arroz Envasado:Parboiled 5KG Dos Hermanos.,-1.0,46.5,-46.5,3740473.96999999,Branded Rice,Keila Alfaro-Visvikis,RETAIL  DSD,1386838,Jan
2025-01-15,Festival Supermarket #35- Southgate,Credit Memo,008-04755,Varios:Promotional Allowance,Arroz Envasado:Parboiled 5KG Dos Hermanos.,-20.0,46.5,-930.0,3739543.96999999,Branded Rice,Keila Alfaro-Visvikis,RETAIL  DSD,1386839,Jan
2025-01-15,Festival Supermarket #35- Southgate,Credit Memo,008-04755,Varios:Promotional Allowance,Arroz Envasado:Largo Fino 1kg (Long grain rice) Dos Hermanos,-1.0,18.0,-18.0,3739525.96999999,Branded Rice,Keila Alfaro-Visvikis,RETAIL  DSD,1386840,Jan
2025-01-15,Food Fair Plantation Corp,Credit Memo,008-04756,Varios:Promotional Allowance,Arroz Envasado:Parboiled 5KG Dos Hermanos.,-5.0,46.5,-232.5,3739293.46999999,Branded Rice,Keila Alfaro-Visvikis,RETAIL  DSD,1386841,Jan
2025-01-16,Sedanos Supermarkets #27,Credit Memo,008-04672,Varios:Producto vencido/deteriorado (no impacta en inventario),4 UNIDADES VENCIDAS,-1.0,5.96,-5.96,3739287.50999999,Puffed Products,Keila Alfaro-Visvikis,RETAIL SEDANOS,1386842,Jan
2025-01-16,Sedanos Supermarkets #27,Credit Memo,008-04672,,Discount,,,0.12,3739287.62999999,,Keila Alfaro-Visvikis,RETAIL SEDANOS,1386843,Jan
2025-01-16,Sedanos Supermarkets #32,Invoice,008-04673,Arroz a Granel:Largo Fino 50 LB -Bolsa Dos Hermanos.,,4.0,27.85,111.4,3739399.02999999,Bulk Rice,Keila Alfaro-Visvikis,RETAIL SEDANOS,1386844,Jan
2025-01-16,Sedanos Supermarkets #32,Invoice,008-04673,Arroz a Granel:Parboiled 50 LB -Bolsa Dos Hermanos.,,6.0,28.25,169.5,3739568.52999999,Bulk Rice,Keila Alfaro-Visvikis,RETAIL SEDANOS,1386845,Jan
2025-01-16,Sedanos Supermarkets #32,Invoice,008-04673,,Discount,,,-5.62,3739562.90999999,,Keila Alfaro-Visvikis,RETAIL SEDANOS,1386846,Jan
2025-01-16,Bravo   Francisco Diaz,Invoice,008-04674,Liquids:AS White Vinegar,4/1 Gl.,1.0,10.0,10.0,3739572.90999999,American Spice,Lisset Limpio -020,RETAIL  DSD,1386847,Jan
2025-01-16,Bravo   Francisco Diaz,Invoice,008-04674,Dry Beans:Dry Beans - Black Beans 50,Dry Black Beans 50 lb,1.0,45.7,45.7,3739618.60999999,Dry Beans,Lisset Limpio -020,RETAIL  DSD,1386848,Jan
2025-01-16,Bravo   Francisco Diaz,Invoice,008-04674,Arroz a Granel:Largo Fino 50 LB -Bolsa Dos Hermanos.,,5.0,27.85,139.25,3739757.85999999,Bulk Rice,Lisset Limpio -020,RETAIL  DSD,1386849,Jan
2025-01-16,Bravo   Francisco Diaz,Invoice,008-04674,Liquids:AS Lemon Juice 4/1 Gl,,2.0,14.95,29.9,3739787.75999999,American Spice,Lisset Limpio -020,RETAIL  DSD,1386850,Jan
2025-01-16,El Palacio de los jugos / Rodriguez Foods,Invoice,008-04675,Arroz a Granel:Largo Fino 50 LB -Bolsa Dos Hermanos.,,3.0,27.85,83.55,3739871.30999999,Bulk Rice,Lisset Limpio -020,Cafeteria,1386851,Jan
2025-01-16,El Palacio de los jugos / Rodriguez Foods,Invoice,008-04675,Arroz a Granel:Parboiled 50 LB -Bolsa Dos Hermanos.,,8.0,26.75,214.0,3740085.30999999,Bulk Rice,Lisset Limpio -020,Cafeteria,1386852,Jan
2025-01-16,El Palacio de los jugos / Lita Foods Inc.,Invoice,008-04676,Arroz a Granel:Parboiled 50 LB -Bolsa Dos Hermanos.,,11.0,27.75,305.25,3740390.55999999,Bulk Rice,Lisset Limpio -020,Cafeteria,1386853,Jan
2025-01-16,El Palacio de los jugos / Lita Foods Inc.,Invoice,008-04676,Dry Beans:Dry Beans - Black Beans 50,Dry Black Beans 50 lb,1.0,45.7,45.7,3740436.25999999,Dry Beans,Lisset Limpio -020,Cafeteria,1386854,Jan
2025-01-16,El Palacio de los jugos / Lita Foods Inc.,Invoice,008-04676,Dry Beans:Dry Beans - Small Red Beans 50 lbs.,Small Red Beans 50 lbs,1.0,42.0,42.0,3740478.25999999,Dry Beans,Lisset Limpio -020,Cafeteria,1386855,Jan
2025-01-16,El Palacio de los jugos / Lita Foods Inc.,Invoice,008-04676,Arroz a Granel:Parboiled 50 LB -Bolsa Dos Hermanos.,,1.0,27.75,27.75,3740506.00999999,Bulk Rice,Lisset Limpio -020,Cafeteria,1386856,Jan
2025-01-16,Soriano Brothers PB,Invoice,008-04677,Spices:AS Sazon (for all),1 / 30 lb (box or pail),2.0,51.0,102.0,3740608.00999999,American Spice,Lisset Limpio -020,CAFETERIA y RESTAURANTS,1386857,Jan
2025-01-16,Soriano Brothers PB,Invoice,008-04677,Arroz a Granel:Largo Fino 50 LB -Bolsa Dos Hermanos.,,15.0,27.85,417.75,3741025.75999999,Bulk Rice,Lisset Limpio -020,CAFETERIA y RESTAURANTS,1386858,Jan
2025-01-16,Soriano Brothers PB,Invoice,008-04677,Arroz a Granel:Parboiled 50 LB -Bolsa Dos Hermanos.,,5.0,26.75,133.75,3741159.50999999,Bulk Rice,Lisset Limpio -020,CAFETERIA y RESTAURANTS,1386859,Jan
2025-01-16,Sedanos Supermarkets #18,Invoice,008-04678,Rice Snack:Rice Snack Ham Flavored DOS HERMANOS,,3.0,19.9,59.7,3741219.20999999,Puffed Products,Keila Alfaro-Visvikis,RETAIL SEDANOS,1386860,Jan
2025-01-16,Sedanos Supermarkets #18,Invoice,008-04678,Rice Snack:Rice Snack Salami Flavored DOS HERMANOS,,3.0,19.9,59.7,3741278.90999999,Puffed Products,Keila Alfaro-Visvikis,RETAIL SEDANOS,1386861,Jan
2025-01-16,Sedanos Supermarkets #18,Invoice,008-04678,Rice Snack:Rice Snack Ham Flavored DOS HERMANOS,,2.0,19.9,39.8,3741318.70999999,Puffed Products,Keila Alfaro-Visvikis,RETAIL SEDANOS,1386862,Jan
2025-01-16,Sedanos Supermarkets #18,Invoice,008-04678,Rice Snack:Rice Snack Salami Flavored DOS HERMANOS,,1.0,19.9,19.9,3741338.60999999,Puffed Products,Keila Alfaro-Visvikis,RETAIL SEDANOS,1386863,Jan
2025-01-16,Sedanos Supermarkets #18,Invoice,008-04678,Varios:Exhibidor de pie Good Rice PVC,i18,1.0,0.001,0.0,3741338.60999999,,Keila Alfaro-Visvikis,RETAIL SEDANOS,1386864,Jan
2025-01-16,Sedanos Supermarkets #18,Invoice,008-04678,,Discount,,,-2.39,3741336.21999999,,Keila Alfaro-Visvikis,RETAIL SEDANOS,1386865,Jan
2025-01-16,El Palacio de los jugos /  EMMA FOOD CORP,Invoice,008-04679,Arroz a Granel:Largo Fino 50 LB -Bolsa Dos Hermanos.,,5.0,27.85,139.25,3741475.46999999,Bulk Rice,Lisset Limpio -020,Cafeteria,1386866,Jan
2025-01-16,El Palacio de los jugos / Delicias Criollas (DIAGO FOOD_MILLER),Invoice,008-04680,Dry Beans:Dry Beans - Black Beans 50,Dry Black Beans 50 lb,1.0,45.7,45.7,3741521.16999999,Dry Beans,Lisset Limpio -020,Cafeteria,1386867,Jan
2025-01-16,El Palacio de los jugos / Delicias Criollas (DIAGO FOOD_MILLER),Invoice,008-04680,Arroz a Granel:Parboiled 50 LB -Bolsa Dos Hermanos.,,11.0,27.75,305.25,3741826.41999999,Bulk Rice,Lisset Limpio -020,Cafeteria,1386868,Jan
2025-01-16,El Palacio de los jugos / Delicias Criollas (DIAGO FOOD_MILLER),Invoice,008-04680,Arroz a Granel:Parboiled 50 LB -Bolsa Dos Hermanos.,,1.0,27.75,27.75,3741854.16999999,Bulk Rice,Lisset Limpio -020,Cafeteria,1386869,Jan
2025-01-16,Rey Chavez Distributor #2,Invoice,008-04681,Arroz a Granel:Parboiled 50 LB -Bolsa Dos Hermanos.,,25.0,28.8,720.0,3742574.16999999,Bulk Rice,Lisset Limpio -020,WHOLESALER,1386870,Jan
2025-01-16,Sedanos Supermarkets #33,Invoice,008-04682,Arroz a Granel:Parboiled 50 LB -Bolsa Dos Hermanos.,,2.0,28.25,56.5,3742630.66999999,Bulk Rice,Keila Alfaro-Visvikis,RETAIL SEDANOS,1386871,Jan
2025-01-16,Sedanos Supermarkets #33,Invoice,008-04682,,Discount,,,-1.13,3742629.53999999,,Keila Alfaro-Visvikis,RETAIL SEDANOS,1386872,Jan
2025-01-16,Hings Chinese,Invoice,008-04683,Arroz a Granel:Parboiled 50 LB -Bolsa Dos Hermanos.,,5.0,28.25,141.25,3742770.78999999,Bulk Rice,Lisset Limpio -020,CAFETERIA y RESTAURANTS,1386873,Jan
2025-01-16,Los Mejores Tamales de Miami,Invoice,008-04684,Arroz a Granel:Parboiled 50 LB -Bolsa Dos Hermanos.,,4.0,28.25,113.0,3742883.78999999,Bulk Rice,Lisset Limpio -020,CAFETERIA y RESTAURANTS,1386874,Jan
2025-01-16,Los Caringas Latin America  Foods,Invoice,008-04685,Arroz a Granel:Largo Fino 50 LB -Bolsa Dos Hermanos.,,3.0,27.85,83.55,3742967.33999999,Bulk Rice,Lisset Limpio -020,CAFETERIA y RESTAURANTS,1386875,Jan
2025-01-16,Los Caringas Latin America  Foods,Invoice,008-04685,Arroz a Granel:Parboiled 50 LB -Bolsa Dos Hermanos.,,3.0,28.25,84.75,3743052.08999999,Bulk Rice,Lisset Limpio -020,CAFETERIA y RESTAURANTS,1386876,Jan
2025-01-16,El Palacio de los jugos / Lita Foods Inc.,Credit Memo,008-04791,Varios:Promotional Allowance,Arroz a Granel:Parboiled 50 LB -Bolsa Dos Hermanos.,-1.0,27.75,-27.75,3743024.33999999,Bulk Rice,Lisset Limpio -020,Cafeteria,1386877,Jan
2025-01-16,Sedanos Supermarkets #18,Credit Memo,008-04792,Varios:Promotional Allowance,Rice Snack:Rice Snack Salami Flavored DOS HERMANOS,-1.0,19.9,-19.9,3743004.43999999,Puffed Products,Keila Alfaro-Visvikis,RETAIL SEDANOS,1386878,Jan
2025-01-16,Sedanos Supermarkets #18,Credit Memo,008-04792,Varios:Promotional Allowance,Rice Snack:Rice Snack Ham Flavored DOS HERMANOS,-2.0,19.9,-39.8,3742964.63999999,Puffed Products,Keila Alfaro-Visvikis,RETAIL SEDANOS,1386879,Jan
2025-01-16,El Palacio de los jugos / Delicias Criollas (DIAGO FOOD_MILLER),Credit Memo,008-04793,Varios:Promotional Allowance,Arroz a Granel:Parboiled 50 LB -Bolsa Dos Hermanos.,-1.0,27.75,-27.75,3742936.88999999,Bulk Rice,Lisset Limpio -020,Cafeteria,1386880,Jan
2025-01-17,El Palacio de los jugos /  Nanos Latin Foods,Invoice,008-04686,Arroz a Granel:Largo Fino 50 LB -Bolsa Dos Hermanos.,,8.0,27.85,222.8,3743159.68999999,Bulk Rice,Lisset Limpio -020,Cafeteria,1386881,Jan
2025-01-17,El Palacio de los jugos /  Nanos Latin Foods,Invoice,008-04686,Arroz a Granel:Parboiled 50 LB -Bolsa Dos Hermanos.,,10.0,26.75,267.5,3743427.18999999,Bulk Rice,Lisset Limpio -020,Cafeteria,1386882,Jan
2025-01-17,El Palacio de los jugos / Leti Corp.,Invoice,008-04687,Arroz a Granel:Largo Fino 50 LB -Bolsa Dos Hermanos.,,5.0,27.85,139.25,3743566.43999999,Bulk Rice,Lisset Limpio -020,Cafeteria,1386883,Jan
2025-01-17,El Palacio de los jugos / Leti Corp.,Invoice,008-04687,Arroz a Granel:Parboiled 50 LB -Bolsa Dos Hermanos.,,5.0,26.75,133.75,3743700.18999999,Bulk Rice,Lisset Limpio -020,Cafeteria,1386884,Jan
2025-01-17,ALS Foods,Invoice,008-04688,Liquids:AS Cooking Wine,4/1 Gl.,0.0,,0.0,3743700.18999999,American Spice,Lisset Limpio -020,CAFETERIA y RESTAURANTS,1386885,Jan
2025-01-17,ALS Foods,Invoice,008-04688,Arroz a Granel:Largo Fino 50 LB -Bolsa Dos Hermanos.,,0.0,,0.0,3743700.18999999,Bulk Rice,Lisset Limpio -020,CAFETERIA y RESTAURANTS,1386886,Jan
2025-01-17,ALS Foods,Invoice,008-04688,Arroz a Granel:Parboiled 50 LB -Bolsa Dos Hermanos.,,0.0,,0.0,3743700.18999999,Bulk Rice,Lisset Limpio -020,CAFETERIA y RESTAURANTS,1386887,Jan
2025-01-17,ALS Foods,Invoice,008-04688,Arroz a Granel:Parboiled 50 LB -Bolsa Dos Hermanos.,,0.0,,0.0,3743700.18999999,Bulk Rice,Lisset Limpio -020,CAFETERIA y RESTAURANTS,1386888,Jan
2025-01-17,ALS Foods,Credit Memo,008-04794,Varios:Promotional Allowance,Arroz a Granel:Parboiled 50 LB -Bolsa Dos Hermanos.,0.0,,0.0,3743700.18999999,Bulk Rice,Lisset Limpio -020,CAFETERIA y RESTAURANTS,1386889,Jan
2025-01-19,Soriano Brothers,Invoice,008-04689,Arroz a Granel:Parboiled 50 LB -Bolsa Dos Hermanos.,,25.0,26.75,668.75,3744368.93999999,Bulk Rice,Lisset Limpio -020,CAFETERIA y RESTAURANTS,1386890,Jan
2025-01-19,Fritanga Momotombo,Invoice,008-04690,Dry Beans:Dry Beans - Small Red Beans 50 lbs.,Small Red Beans 50 lbs,1.0,42.0,42.0,3744410.93999999,Dry Beans,Lisset Limpio -020,CAFETERIA y RESTAURANTS,1386891,Jan
2025-01-19,Fritanga Momotombo,Invoice,008-04690,Arroz a Granel:Largo Fino 50 LB -Bolsa Dos Hermanos.,,6.0,27.85,167.1,3744578.03999999,Bulk Rice,Lisset Limpio -020,CAFETERIA y RESTAURANTS,1386892,Jan
2025-01-19,El Palacio de los jugos / Rodriguez Foods,Invoice,008-04691,Arroz a Granel:Parboiled 50 LB -Bolsa Dos Hermanos.,,6.0,26.75,160.5,3744738.53999999,Bulk Rice,Lisset Limpio -020,Cafeteria,1386893,Jan
2025-01-19,El Palacio de los jugos /  Mires Restaurants,Invoice,008-04692,Liquids:AS Marinating Sauce (Mojo),,1.0,18.5,18.5,3744757.03999999,American Spice,Lisset Limpio -020,Cafeteria,1386894,Jan
2025-01-19,El Palacio de los jugos /  Mires Restaurants,Invoice,008-04692,Arroz a Granel:Parboiled 50 LB -Bolsa Dos Hermanos.,,11.0,27.75,305.25,3745062.28999999,Bulk Rice,Lisset Limpio -020,Cafeteria,1386895,Jan
2025-01-19,El Palacio de los jugos /  Mires Restaurants,Invoice,008-04692,Arroz a Granel:Parboiled 50 LB -Bolsa Dos Hermanos.,,1.0,27.75,27.75,3745090.03999999,Bulk Rice,Lisset Limpio -020,Cafeteria,1386896,Jan
2025-01-19,El Palacio de Los Jugos / Casa mía Food Restaurant inc,Invoice,008-04693,Dry Beans:Dry Beans - Black Beans 50,Dry Black Beans 50 lb,1.0,45.7,45.7,3745135.73999999,Dry Beans,Lisset Limpio -020,Cafeteria,1386897,Jan
2025-01-19,El Palacio de Los Jugos / Casa mía Food Restaurant inc,Invoice,008-04693,Arroz a Granel:Parboiled 50 LB -Bolsa Dos Hermanos.,,11.0,27.75,305.25,3745440.98999999,Bulk Rice,Lisset Limpio -020,Cafeteria,1386898,Jan
2025-01-19,El Palacio de Los Jugos / Casa mía Food Restaurant inc,Invoice,008-04693,Arroz a Granel:Parboiled 50 LB -Bolsa Dos Hermanos.,,1.0,27.75,27.75,3745468.73999999,Bulk Rice,Lisset Limpio -020,Cafeteria,1386899,Jan
2025-01-19,ALS Foods,Invoice,008-04694,Arroz a Granel:Largo Fino 50 LB -Bolsa Dos Hermanos.,,6.0,27.85,167.1,3745635.83999999,Bulk Rice,Lisset Limpio -020,CAFETERIA y RESTAURANTS,1386900,Jan
2025-01-19,ALS Foods,Invoice,008-04694,Arroz a Granel:Parboiled 50 LB -Bolsa Dos Hermanos.,,11.0,27.75,305.25,3745941.08999999,Bulk Rice,Lisset Limpio -020,CAFETERIA y RESTAURANTS,1386901,Jan
2025-01-19,ALS Foods,Invoice,008-04694,Arroz a Granel:Parboiled 50 LB -Bolsa Dos Hermanos.,,1.0,27.75,27.75,3745968.83999999,Bulk Rice,Lisset Limpio -020,CAFETERIA y RESTAURANTS,1386902,Jan
2025-01-19,El Palacio de los jugos / Lita Foods Inc.,Invoice,008-04695,Dry Beans:Dry Beans - Black Beans 50,Dry Black Beans 50 lb,1.0,45.7,45.7,3746014.53999999,Dry Beans,Lisset Limpio -020,Cafeteria,1386903,Jan
2025-01-19,El Palacio de los jugos / Lita Foods Inc.,Invoice,008-04695,Arroz a Granel:Parboiled 50 LB -Bolsa Dos Hermanos.,,11.0,27.75,305.25,3746319.78999999,Bulk Rice,Lisset Limpio -020,Cafeteria,1386904,Jan
2025-01-19,El Palacio de los jugos / Lita Foods Inc.,Invoice,008-04695,Arroz a Granel:Parboiled 50 LB -Bolsa Dos Hermanos.,,1.0,27.75,27.75,3746347.53999999,Bulk Rice,Lisset Limpio -020,Cafeteria,1386905,Jan
2025-01-19,JMN Dely Corp,Invoice,008-04696,Arroz a Granel:Largo Fino 50 LB -Bolsa Dos Hermanos.,,2.0,27.85,55.7,3746403.23999999,Bulk Rice,Keila Alfaro-Visvikis,CAFETERIA y RESTAURANTS,1386906,Jan
2025-01-19,JMN Dely Corp,Invoice,008-04696,Arroz a Granel:Parboiled 50 LB -Bolsa Dos Hermanos.,,2.0,28.25,56.5,3746459.73999999,Bulk Rice,Keila Alfaro-Visvikis,CAFETERIA y RESTAURANTS,1386907,Jan
2025-01-19,JMN Dely Corp,Invoice,008-04696,Dry Beans:Dry Beans - Black Beans 50,Dry Black Beans 50 lb,1.0,45.7,45.7,3746505.43999999,Dry Beans,Keila Alfaro-Visvikis,CAFETERIA y RESTAURANTS,1386908,Jan
2025-01-19,El Palacio de los jugos /  Mires Restaurants,Credit Memo,008-04795,Varios:Promotional Allowance,Arroz a Granel:Parboiled 50 LB -Bolsa Dos Hermanos.,-1.0,27.75,-27.75,3746477.68999999,Bulk Rice,Lisset Limpio -020,Cafeteria,1386909,Jan
2025-01-19,El Palacio de Los Jugos / Casa mía Food Restaurant inc,Credit Memo,008-04796,Varios:Promotional Allowance,Arroz a Granel:Parboiled 50 LB -Bolsa Dos Hermanos.,-1.0,27.75,-27.75,3746449.93999999,Bulk Rice,Lisset Limpio -020,Cafeteria,1386910,Jan
2025-01-19,ALS Foods,Credit Memo,008-04797,Varios:Promotional Allowance,Arroz a Granel:Parboiled 50 LB -Bolsa Dos Hermanos.,-1.0,27.75,-27.75,3746422.18999999,Bulk Rice,Lisset Limpio -020,CAFETERIA y RESTAURANTS,1386911,Jan
2025-01-19,El Palacio de los jugos / Lita Foods Inc.,Credit Memo,008-04798,Varios:Promotional Allowance,Arroz a Granel:Parboiled 50 LB -Bolsa Dos Hermanos.,-1.0,27.75,-27.75,3746394.43999999,Bulk Rice,Lisset Limpio -020,Cafeteria,1386912,Jan
2025-01-20,Sedanos Supermarkets #31,Invoice,008-04697,Arroz a Granel:Parboiled 50 LB -Bolsa Dos Hermanos.,,4.0,28.25,113.0,3746507.43999999,Bulk Rice,Keila Alfaro-Visvikis,RETAIL SEDANOS,1386913,Jan
2025-01-20,Sedanos Supermarkets #31,Invoice,008-04697,Spices:AS Chicken Base,1 / 30 lb. (box or pail),1.0,40.5,40.5,3746547.93999999,American Spice,Keila Alfaro-Visvikis,RETAIL SEDANOS,1386914,Jan
2025-01-20,Sedanos Supermarkets #31,Invoice,008-04697,,Discount,,,-3.07,3746544.86999999,,Keila Alfaro-Visvikis,RETAIL SEDANOS,1386915,Jan
2025-01-20,Bake Mark USA LLC,Invoice,008-04698,Arroz a Granel:Parboiled 50 LB -Bolsa Dos Hermanos.,,1100.0,24.45,26895.0,3773439.86999999,Bulk Rice,Armando Carpio - 017,WHOLESALER MANUFACTURY,1386916,Jan
2025-01-20,Bake Mark USA LLC,Invoice,008-04699,Arroz a Granel:Parboiled 50 LB -Bolsa Dos Hermanos.,,1100.0,24.45,26895.0,3800334.86999999,Bulk Rice,Armando Carpio - 017,WHOLESALER MANUFACTURY,1386917,Jan
2025-01-22,Ideal Food Basket Davie Cafeteria,Invoice,008-04700,Arroz a Granel:Largo Fino 50 LB -Bolsa Dos Hermanos.,,8.0,27.85,222.8,3800557.66999999,Bulk Rice,Keila Alfaro-Visvikis,CAFETERIA y RESTAURANTS,1386918,Jan
2025-01-22,Sedanos Supermarkets #24,Invoice,008-04701,Arroz a Granel:Parboiled 50 LB -Bolsa Dos Hermanos.,,10.0,28.25,282.5,3800840.16999999,Bulk Rice,Keila Alfaro-Visvikis,RETAIL SEDANOS,1386919,Jan
2025-01-22,Sedanos Supermarkets #24,Invoice,008-04701,,Discount,,,-5.65,3800834.51999999,,Keila Alfaro-Visvikis,RETAIL SEDANOS,1386920,Jan
2025-01-22,Sedanos Supermarkets #26,Invoice,008-04702,Arroz a Granel:Parboiled 50 LB -Bolsa Dos Hermanos.,,5.0,28.25,141.25,3800975.76999999,Bulk Rice,Keila Alfaro-Visvikis,RETAIL SEDANOS,1386921,Jan
2025-01-22,Sedanos Supermarkets #26,Invoice,008-04702,,Discount,,,-2.83,3800972.93999999,,Keila Alfaro-Visvikis,RETAIL SEDANOS,1386922,Jan
2025-01-22,Sedanos Supermarkets #22,Invoice,008-04703,Arroz a Granel:Parboiled 50 LB -Bolsa Dos Hermanos.,,4.0,28.25,113.0,3801085.93999999,Bulk Rice,Keila Alfaro-Visvikis,RETAIL SEDANOS,1386923,Jan
2025-01-22,Sedanos Supermarkets #22,Invoice,008-04703,,Discount,,,-2.26,3801083.67999999,,Keila Alfaro-Visvikis,RETAIL SEDANOS,1386924,Jan
2025-01-22,Sedanos Supermarkets #43,Invoice,008-04704,Arroz a Granel:Parboiled 50 LB -Bolsa Dos Hermanos.,,4.0,28.25,113.0,3801196.67999999,Bulk Rice,Keila Alfaro-Visvikis,RETAIL SEDANOS,1386925,Jan
2025-01-22,Sedanos Supermarkets #43,Invoice,008-04704,,Discount,,,-2.26,3801194.41999999,,Keila Alfaro-Visvikis,RETAIL SEDANOS,1386926,Jan
2025-01-22,Sedanos Supermarkets #16,Invoice,008-04705,Arroz a Granel:Parboiled 50 LB -Bolsa Dos Hermanos.,,5.0,28.25,141.25,3801335.66999999,Bulk Rice,Keila Alfaro-Visvikis,RETAIL SEDANOS,1386927,Jan
2025-01-22,Sedanos Supermarkets #16,Invoice,008-04705,,Discount,,,-2.83,3801332.83999999,,Keila Alfaro-Visvikis,RETAIL SEDANOS,1386928,Jan
2025-01-22,Aries Supermarket & Cafeteria,Invoice,008-04706,Arroz a Granel:Parboiled 50 LB -Bolsa Dos Hermanos.,,6.0,28.25,169.5,3801502.33999999,Bulk Rice,Keila Alfaro-Visvikis,CAFETERIA y RESTAURANTS,1386929,Jan
2025-01-22,Sabor Tropical #1 - Supermarket,Invoice,008-04707,Arroz Envasado:Parboiled 5KG Dos Hermanos.,6 / 11lbs,2.0,46.5,93.0,3801595.33999999,Branded Rice,Keila Alfaro-Visvikis,RETAIL  DSD,1386930,Jan
2025-01-22,Sabor Tropical #1 - Supermarket,Invoice,008-04707,Arroz Envasado:Parboiled 5KG Dos Hermanos.,6  11lbs,1.0,46.5,46.5,3801641.83999999,Branded Rice,Keila Alfaro-Visvikis,RETAIL  DSD,1386931,Jan
2025-01-22,Sabor Tropical #1 - Cafeteria,Invoice,008-04708,Arroz a Granel:Parboiled 50 LB -Bolsa Dos Hermanos.,,10.0,28.25,282.5,3801924.33999999,Bulk Rice,Keila Alfaro-Visvikis,CAFETERIA y RESTAURANTS,1386932,Jan
2025-01-22,Sedanos Supermarkets #26,Invoice,008-04709,Arroz Envasado:Parboiled 5KG Dos Hermanos.,6  11lbs,5.0,40.5,202.5,3802126.83999999,Branded Rice,Keila Alfaro-Visvikis,RETAIL SEDANOS,1386933,Jan
2025-01-22,Sabor Tropical #1 - Supermarket,Credit Memo,008-04799,Varios:Promotional Allowance,Arroz Envasado:Parboiled 5KG Dos Hermanos.,-1.0,46.5,-46.5,3802080.33999999,Branded Rice,Keila Alfaro-Visvikis,RETAIL  DSD,1386934,Jan
2025-01-23,Sedanos Supermarkets  #4,Invoice,008-04710,Rice Snack:Rice Snack Ham Flavored DOS HERMANOS,,2.0,19.9,39.8,3802120.13999999,Puffed Products,Keila Alfaro-Visvikis,RETAIL SEDANOS,1386935,Jan
2025-01-23,Sedanos Supermarkets  #4,Invoice,008-04710,Rice Snack:Rice Snack Salami Flavored DOS HERMANOS,,1.0,19.9,19.9,3802140.03999999,Puffed Products,Keila Alfaro-Visvikis,RETAIL SEDANOS,1386936,Jan
2025-01-23,Sedanos Supermarkets  #4,Invoice,008-04710,Rice Snack:Rice Snack Salami Flavored DOS HERMANOS,,1.0,19.9,19.9,3802159.93999999,Puffed Products,Keila Alfaro-Visvikis,RETAIL SEDANOS,1386937,Jan
2025-01-23,Sedanos Supermarkets  #4,Invoice,008-04710,,Discount,,,-1.19,3802158.74999999,,Keila Alfaro-Visvikis,RETAIL SEDANOS,1386938,Jan
2025-01-23,Sedanos Supermarkets #42,Invoice,008-04711,Rice Snack:Rice Snack Ham Flavored DOS HERMANOS,,2.0,19.9,39.8,3802198.54999999,Puffed Products,Keila Alfaro-Visvikis,RETAIL SEDANOS,1386939,Jan
2025-01-23,Sedanos Supermarkets #42,Invoice,008-04711,Rice Snack:Rice Snack Salami Flavored DOS HERMANOS,,1.0,19.9,19.9,3802218.44999999,Puffed Products,Keila Alfaro-Visvikis,RETAIL SEDANOS,1386940,Jan
2025-01-23,Sedanos Supermarkets #42,Invoice,008-04711,Rice Snack:Rice Snack Salami Flavored DOS HERMANOS,,1.0,19.9,19.9,3802238.34999999,Puffed Products,Keila Alfaro-Visvikis,RETAIL SEDANOS,1386941,Jan
2025-01-23,Sedanos Supermarkets #42,Invoice,008-04711,,Discount,,,-1.19,3802237.15999999,,Keila Alfaro-Visvikis,RETAIL SEDANOS,1386942,Jan
2025-01-23,El Palacio de los jugos / Leti Corp.,Invoice,008-04712,Arroz a Granel:Largo Fino 50 LB -Bolsa Dos Hermanos.,,5.0,27.85,139.25,3802376.40999999,Bulk Rice,Lisset Limpio -020,Cafeteria,1386943,Jan
2025-01-23,El Palacio de los jugos / Leti Corp.,Invoice,008-04712,Arroz a Granel:Parboiled 50 LB -Bolsa Dos Hermanos.,,6.0,26.75,160.5,3802536.90999999,Bulk Rice,Lisset Limpio -020,Cafeteria,1386944,Jan
2025-01-23,Sedanos Supermarkets #17,Invoice,008-04713,Arroz Envasado:Largo Fino 1kg (Long grain rice) Dos Hermanos,,1.0,18.0,18.0,3802554.90999999,Branded Rice,Keila Alfaro-Visvikis,RETAIL SEDANOS,1386945,Jan
2025-01-23,Sedanos Supermarkets #17,Invoice,008-04713,Arroz Envasado:Parboiled 1kg Bolsa Dos Hermanos.,.,1.0,19.9,19.9,3802574.80999999,Branded Rice,Keila Alfaro-Visvikis,RETAIL SEDANOS,1386946,Jan
2025-01-23,Sedanos Supermarkets #17,Invoice,008-04713,Rice Snack:Rice Snack Ham Flavored DOS HERMANOS,,2.0,19.9,39.8,3802614.60999999,Puffed Products,Keila Alfaro-Visvikis,RETAIL SEDANOS,1386947,Jan
2025-01-23,Sedanos Supermarkets #17,Invoice,008-04713,Rice Snack:Rice Snack Salami Flavored DOS HERMANOS,,1.0,19.9,19.9,3802634.50999999,Puffed Products,Keila Alfaro-Visvikis,RETAIL SEDANOS,1386948,Jan
2025-01-23,Sedanos Supermarkets #17,Invoice,008-04713,Rice Snack:Rice Snack Ham Flavored DOS HERMANOS,,1.0,19.9,19.9,3802654.40999999,Puffed Products,Keila Alfaro-Visvikis,RETAIL SEDANOS,1386949,Jan
2025-01-23,Sedanos Supermarkets #17,Invoice,008-04713,,Discount,,,-1.95,3802652.45999999,,Keila Alfaro-Visvikis,RETAIL SEDANOS,1386950,Jan
2025-01-23,El Palacio de los jugos /  Nanos Latin Foods,Invoice,008-04714,Arroz a Granel:Largo Fino 50 LB -Bolsa Dos Hermanos.,,10.0,27.85,278.5,3802930.95999999,Bulk Rice,Lisset Limpio -020,Cafeteria,1386951,Jan
2025-01-23,El Palacio de los jugos /  Nanos Latin Foods,Invoice,008-04714,Arroz a Granel:Parboiled 50 LB -Bolsa Dos Hermanos.,,10.0,26.75,267.5,3803198.45999999,Bulk Rice,Lisset Limpio -020,Cafeteria,1386952,Jan
2025-01-23,El Palacio de Los Jugos / Casa mía Food Restaurant inc,Invoice,008-04715,Arroz a Granel:Parboiled 50 LB -Bolsa Dos Hermanos.,,11.0,27.75,305.25,3803503.70999999,Bulk Rice,Lisset Limpio -020,Cafeteria,1386953,Jan
2025-01-23,El Palacio de Los Jugos / Casa mía Food Restaurant inc,Invoice,008-04715,Dry Beans:Dry Beans - Black Beans 50,Dry Black Beans 50 lb,1.0,45.7,45.7,3803549.40999999,Dry Beans,Lisset Limpio -020,Cafeteria,1386954,Jan
2025-01-23,El Palacio de Los Jugos / Casa mía Food Restaurant inc,Invoice,008-04715,Arroz a Granel:Parboiled 50 LB -Bolsa Dos Hermanos.,,1.0,27.75,27.75,3803577.15999999,Bulk Rice,Lisset Limpio -020,Cafeteria,1386955,Jan
2025-01-23,Sedanos Supermarkets #5,Invoice,008-04716,Rice Snack:Rice Snack Ham Flavored DOS HERMANOS,,1.0,19.9,19.9,3803597.05999999,Puffed Products,Keila Alfaro-Visvikis,RETAIL SEDANOS,1386956,Jan
2025-01-23,Sedanos Supermarkets #5,Invoice,008-04716,Rice Snack:Rice Snack Salami Flavored DOS HERMANOS,,2.0,19.9,39.8,3803636.85999999,Puffed Products,Keila Alfaro-Visvikis,RETAIL SEDANOS,1386957,Jan
2025-01-23,Sedanos Supermarkets #5,Invoice,008-04716,Rice Snack:Rice Snack Salami Flavored DOS HERMANOS,,1.0,19.9,19.9,3803656.75999999,Puffed Products,Keila Alfaro-Visvikis,RETAIL SEDANOS,1386958,Jan
2025-01-23,Mei Chang,Invoice,008-04717,Arroz a Granel:Parboiled 50 LB -Bolsa Dos Hermanos.,,5.0,28.25,141.25,3803798.00999999,Bulk Rice,Lisset Limpio -020,CAFETERIA y RESTAURANTS,1386959,Jan
2025-01-23,Pacifico Chinese Restaurant,Invoice,008-04718,Arroz a Granel:Parboiled 50 LB -Bolsa Dos Hermanos.,,10.0,28.25,282.5,3804080.50999999,Bulk Rice,Lisset Limpio -020,CAFETERIA y RESTAURANTS,1386960,Jan
2025-01-23,Sedanos Supermarkets #38,Invoice,008-04719,Rice Snack:Rice Snack Ham Flavored DOS HERMANOS,,1.0,19.9,19.9,3804100.40999999,Puffed Products,Keila Alfaro-Visvikis,RETAIL SEDANOS,1386961,Jan
2025-01-23,Sedanos Supermarkets #38,Invoice,008-04719,Rice Snack:Rice Snack Salami Flavored DOS HERMANOS,,2.0,19.9,39.8,3804140.20999999,Puffed Products,Keila Alfaro-Visvikis,RETAIL SEDANOS,1386962,Jan
2025-01-23,Sedanos Supermarkets #38,Invoice,008-04719,Rice Snack:Rice Snack Ham Flavored DOS HERMANOS,,1.0,19.9,19.9,3804160.10999999,Puffed Products,Keila Alfaro-Visvikis,RETAIL SEDANOS,1386963,Jan
2025-01-23,Sedanos Supermarkets #38,Invoice,008-04719,,Discount,,,-1.19,3804158.91999999,,Keila Alfaro-Visvikis,RETAIL SEDANOS,1386964,Jan
2025-01-23,El Palacio de los jugos / Rodriguez Foods,Invoice,008-04720,Arroz a Granel:Parboiled 50 LB -Bolsa Dos Hermanos.,,6.0,26.75,160.5,3804319.41999999,Bulk Rice,Lisset Limpio -020,Cafeteria,1386965,Jan
2025-01-23,Bravo   Francisco Diaz,Invoice,008-04721,Arroz a Granel:Largo Fino 50 LB -Bolsa Dos Hermanos.,,5.0,27.85,139.25,3804458.66999999,Bulk Rice,Lisset Limpio -020,RETAIL  DSD,1386966,Jan
2025-01-23,Bravo   Francisco Diaz,Invoice,008-04721,Spices:AS Chicken Base,1 / 30 lb. (box or pail),1.0,39.0,39.0,3804497.66999999,American Spice,Lisset Limpio -020,RETAIL  DSD,1386967,Jan
2025-01-23,Bravo   Francisco Diaz,Invoice,008-04721,Liquids:AS Cooking Wine,4 1 Gl.,2.0,17.5,35.0,3804532.66999999,American Spice,Lisset Limpio -020,RETAIL  DSD,1386968,Jan
2025-01-23,Bravo   Francisco Diaz,Invoice,008-04721,Liquids:AS White Vinegar,4/1 Gl.,1.0,10.0,10.0,3804542.66999999,American Spice,Lisset Limpio -020,RETAIL  DSD,1386969,Jan
2025-01-23,Bravo   Francisco Diaz,Invoice,008-04721,Spices:AS Sazon (for all),1 / 30 lb (box or pail),1.0,59.0,59.0,3804601.66999999,American Spice,Lisset Limpio -020,RETAIL  DSD,1386970,Jan
2025-01-23,Sedanos Supermarkets #33,Invoice,008-04722,Arroz a Granel:Parboiled 50 LB -Bolsa Dos Hermanos.,,3.0,28.25,84.75,3804686.41999999,Bulk Rice,Keila Alfaro-Visvikis,RETAIL SEDANOS,1386971,Jan
2025-01-23,Sedanos Supermarkets #33,Invoice,008-04722,,Discount,,,-1.7,3804684.71999999,,Keila Alfaro-Visvikis,RETAIL SEDANOS,1386972,Jan
2025-01-23,Sedanos Supermarkets #18,Invoice,008-04723,Arroz a Granel:Parboiled 50 LB -Bolsa Dos Hermanos.,,10.0,28.25,282.5,3804967.21999999,Bulk Rice,Keila Alfaro-Visvikis,RETAIL SEDANOS,1386973,Jan
2025-01-23,Sedanos Supermarkets #18,Invoice,008-04723,,Discount,,,-5.65,3804961.56999999,,Keila Alfaro-Visvikis,RETAIL SEDANOS,1386974,Jan
2025-01-23,Sedanos Supermarkets  #37,Invoice,008-04724,Arroz a Granel:Largo Fino 50 LB -Bolsa Dos Hermanos.,,5.0,27.85,139.25,3805100.81999999,Bulk Rice,Keila Alfaro-Visvikis,RETAIL SEDANOS,1386975,Jan
2025-01-23,Sedanos Supermarkets  #37,Invoice,008-04724,Arroz a Granel:Parboiled 50 LB -Bolsa Dos Hermanos.,,5.0,28.25,141.25,3805242.06999999,Bulk Rice,Keila Alfaro-Visvikis,RETAIL SEDANOS,1386976,Jan
2025-01-23,Sedanos Supermarkets  #37,Invoice,008-04724,,Discount,,,-5.61,3805236.45999999,,Keila Alfaro-Visvikis,RETAIL SEDANOS,1386977,Jan
2025-01-23,Sedanos Supermarkets  #4,Credit Memo,008-04800,Varios:Promotional Allowance,Rice Snack:Rice Snack Salami Flavored DOS HERMANOS,-1.0,19.9,-19.9,3805216.55999999,Puffed Products,Keila Alfaro-Visvikis,RETAIL SEDANOS,1386978,Jan
2025-01-23,Sedanos Supermarkets #42,Credit Memo,008-04801,Varios:Promotional Allowance,Rice Snack:Rice Snack Salami Flavored DOS HERMANOS,-1.0,19.9,-19.9,3805196.65999999,Puffed Products,Keila Alfaro-Visvikis,RETAIL SEDANOS,1386979,Jan
2025-01-23,Sedanos Supermarkets #17,Credit Memo,008-04802,Varios:Promotional Allowance,Rice Snack:Rice Snack Ham Flavored DOS HERMANOS,-1.0,19.9,-19.9,3805176.75999999,Puffed Products,Keila Alfaro-Visvikis,RETAIL SEDANOS,1386980,Jan
2025-01-23,El Palacio de Los Jugos / Casa mía Food Restaurant inc,Credit Memo,008-04803,Varios:Promotional Allowance,Arroz a Granel:Parboiled 50 LB -Bolsa Dos Hermanos.,-1.0,27.75,-27.75,3805149.00999999,Puffed Products,Lisset Limpio -020,Cafeteria,1386981,Jan
2025-01-23,Sedanos Supermarkets #5,Credit Memo,008-04804,Varios:Promotional Allowance,Rice Snack:Rice Snack Salami Flavored DOS HERMANOS,-1.0,19.9,-19.9,3805129.10999999,Puffed Products,Keila Alfaro-Visvikis,RETAIL SEDANOS,1386982,Jan
2025-01-23,Sedanos Supermarkets #38,Credit Memo,008-04805,Varios:Promotional Allowance,Rice Snack:Rice Snack Ham Flavored DOS HERMANOS,-1.0,19.9,-19.9,3805109.20999999,Puffed Products,Keila Alfaro-Visvikis,RETAIL SEDANOS,1386983,Jan
2025-01-24,Sedanos Supermarkets #17,Credit Memo,008-04725,Varios:Producto vencido/deteriorado (no impacta en inventario),snack salami,-12.0,1.49,-17.88,3805091.32999999,Puffed Products,Keila Alfaro-Visvikis,RETAIL SEDANOS,1386984,Jan
2025-01-24,Sedanos Supermarkets #5,Credit Memo,008-04726,Varios:Producto vencido/deteriorado (no impacta en inventario),10 units salame,-10.0,1.49,-14.9,3805076.42999999,Puffed Products,Keila Alfaro-Visvikis,RETAIL SEDANOS,1386985,Jan
2025-01-24,Sedanos Supermarkets #5,Credit Memo,008-04726,,Discount,,,0.3,3805076.72999999,,Keila Alfaro-Visvikis,RETAIL SEDANOS,1386986,Jan
2025-01-24,Sedanos Supermarkets #38,Credit Memo,008-04727,Varios:Producto vencido/deteriorado (no impacta en inventario),8 salami 5 jamon,-13.0,1.49,-19.37,3805057.35999999,Puffed Products,Keila Alfaro-Visvikis,RETAIL SEDANOS,1386987,Jan
2025-01-24,Sedanos Supermarkets #33,Credit Memo,008-04728,Varios:Producto vencido/deteriorado (no impacta en inventario),"11 Salamie
   1 ham",-12.0,1.49,-17.88,3805039.47999999,Puffed Products,Keila Alfaro-Visvikis,RETAIL SEDANOS,1386988,Jan
2025-01-24,Sedanos Supermarkets #33,Credit Memo,008-04728,,Discount,,,0.36,3805039.83999999,,Keila Alfaro-Visvikis,RETAIL SEDANOS,1386989,Jan
2025-01-26,El Palacio de los jugos /  Nanos Latin Foods,Invoice,008-04729,Arroz a Granel:Parboiled 50 LB -Bolsa Dos Hermanos.,,10.0,26.75,267.5,3805307.33999999,Bulk Rice,Lisset Limpio -020,Cafeteria,1386990,Jan
2025-01-26,El Palacio de los jugos /  EMMA FOOD CORP,Invoice,008-04730,Arroz a Granel:Largo Fino 50 LB -Bolsa Dos Hermanos.,,10.0,27.85,278.5,3805585.83999999,Bulk Rice,Lisset Limpio -020,Cafeteria,1386991,Jan
2025-01-26,Be Your Will LLC,Invoice,008-04731,Liquids:AS Cooking Wine,4 1 Gl.,2.0,17.5,35.0,3805620.83999999,American Spice,Lisset Limpio -020,CAFETERIA y RESTAURANTS,1386992,Jan
2025-01-26,Be Your Will LLC,Invoice,008-04731,Arroz a Granel:Largo Fino 50 LB -Bolsa Dos Hermanos.,,7.0,27.85,194.95,3805815.78999999,Bulk Rice,Lisset Limpio -020,CAFETERIA y RESTAURANTS,1386993,Jan
2025-01-26,Be Your Will LLC,Invoice,008-04731,Arroz a Granel:Parboiled 50 LB -Bolsa Dos Hermanos.,,11.0,27.75,305.25,3806121.03999999,Bulk Rice,Lisset Limpio -020,CAFETERIA y RESTAURANTS,1386994,Jan
2025-01-26,Be Your Will LLC,Invoice,008-04731,Arroz a Granel:Parboiled 50 LB -Bolsa Dos Hermanos.,,1.0,27.75,27.75,3806148.78999999,Bulk Rice,Lisset Limpio -020,CAFETERIA y RESTAURANTS,1386995,Jan
2025-01-26,El Palacio de los jugos / Lita Foods Inc.,Invoice,008-04732,Dry Beans:Dry Beans - Black Beans 50,Dry Black Beans 50 lb,1.0,45.7,45.7,3806194.48999999,Dry Beans,Lisset Limpio -020,Cafeteria,1386996,Jan
2025-01-26,El Palacio de los jugos / Lita Foods Inc.,Invoice,008-04732,Arroz a Granel:Parboiled 50 LB -Bolsa Dos Hermanos.,,11.0,27.75,305.25,3806499.73999999,Bulk Rice,Lisset Limpio -020,Cafeteria,1386997,Jan
2025-01-26,El Palacio de los jugos / Lita Foods Inc.,Invoice,008-04732,Arroz a Granel:Parboiled 50 LB -Bolsa Dos Hermanos.,,1.0,27.75,27.75,3806527.48999999,Bulk Rice,Lisset Limpio -020,Cafeteria,1386998,Jan
2025-01-26,El Palacio de los jugos / Delicias Criollas (DIAGO FOOD_MILLER),Invoice,008-04733,Dry Beans:Dry Beans - Black Beans 50,Dry Black Beans 50 lb,2.0,45.7,91.4,3806618.88999999,Dry Beans,Lisset Limpio -020,Cafeteria,1386999,Jan
2025-01-26,El Palacio de los jugos / Delicias Criollas (DIAGO FOOD_MILLER),Invoice,008-04733,Arroz a Granel:Parboiled 50 LB -Bolsa Dos Hermanos.,,22.0,27.75,610.5,3807229.38999999,Bulk Rice,Lisset Limpio -020,Cafeteria,1387000,Jan
2025-01-26,El Palacio de los jugos / Delicias Criollas (DIAGO FOOD_MILLER),Invoice,008-04733,Arroz a Granel:Parboiled 50 LB -Bolsa Dos Hermanos.,,1.0,27.75,27.75,3807257.13999999,Bulk Rice,Lisset Limpio -020,Cafeteria,1387001,Jan
2025-01-26,JMN Dely Corp,Invoice,008-04734,Arroz a Granel:Parboiled 50 LB -Bolsa Dos Hermanos.,,2.0,27.75,55.5,3807312.63999999,Bulk Rice,Keila Alfaro-Visvikis,CAFETERIA y RESTAURANTS,1387002,Jan
2025-01-26,JMN Dely Corp,Invoice,008-04734,Arroz a Granel:Largo Fino 50 LB -Bolsa Dos Hermanos.,,2.0,27.85,55.7,3807368.33999999,Bulk Rice,Keila Alfaro-Visvikis,CAFETERIA y RESTAURANTS,1387003,Jan
2025-01-26,JMN Dely Corp,Invoice,008-04734,Dry Beans:Dry Beans - Black Beans 50,Dry Black Beans 50 lb,1.0,45.7,45.7,3807414.03999999,Dry Beans,Keila Alfaro-Visvikis,CAFETERIA y RESTAURANTS,1387004,Jan
2025-01-26,"Virtue Distributor, Inc",Invoice,008-04735,Arroz a Granel:Largo Fino 50 LB -Bolsa Dos Hermanos.,,55.0,27.85,1531.75,3808945.78999999,Bulk Rice,Armando Carpio - 017,Distributor,1387005,Jan
2025-01-26,Sorianos Brothers,Invoice,008-04736,Arroz a Granel:Parboiled 50 LB -Bolsa Dos Hermanos.,,25.0,26.75,668.75,3809614.53999999,Bulk Rice,Lisset Limpio -020,CAFETERIA y RESTAURANTS,1387006,Jan
2025-01-26,El Gallego Supermarket,Invoice,008-04737,Arroz Envasado:Largo Fino 1kg (Long grain rice) Dos Hermanos,,1.0,18.0,18.0,3809632.53999999,Branded Rice,Lisset Limpio -020,RETAIL  DSD,1387007,Jan
2025-01-26,El Gallego Supermarket,Invoice,008-04737,Arroz Envasado:Parboiled 1kg Bolsa Dos Hermanos.,.,1.0,19.9,19.9,3809652.43999999,Branded Rice,Lisset Limpio -020,RETAIL  DSD,1387008,Jan
2025-01-26,"Criollos Food USA, LLC",Invoice,008-04738,Arroz a Granel:Parboiled 50 LB -Bolsa Dos Hermanos.,,110.0,28.25,3107.5,3812759.93999999,Bulk Rice,Armando Carpio - 017,WHOLESALER,1387009,Jan
2025-01-26,Be Your Will LLC,Credit Memo,008-04806,Varios:Promotional Allowance,Arroz a Granel:Parboiled 50 LB -Bolsa Dos Hermanos.,-1.0,27.75,-27.75,3812732.18999999,Bulk Rice,Lisset Limpio -020,CAFETERIA y RESTAURANTS,1387010,Jan
2025-01-26,El Palacio de los jugos / Lita Foods Inc.,Credit Memo,008-04807,Varios:Promotional Allowance,Arroz a Granel:Parboiled 50 LB -Bolsa Dos Hermanos.,-1.0,27.75,-27.75,3812704.43999999,Bulk Rice,Lisset Limpio -020,Cafeteria,1387011,Jan
2025-01-26,El Palacio de los jugos / Delicias Criollas (DIAGO FOOD_MILLER),Credit Memo,008-04808,Varios:Promotional Allowance,Arroz a Granel:Parboiled 50 LB -Bolsa Dos Hermanos.,-1.0,27.75,-27.75,3812676.68999999,Bulk Rice,Lisset Limpio -020,Cafeteria,1387012,Jan
2025-01-27,El Palacio de los jugos / Rodriguez Foods,Invoice,008-04739,Dry Beans:Dry Beans - Black Beans 50,Dry Black Beans 50 lb,1.0,38.0,38.0,3812714.68999999,Dry Beans,Lisset Limpio -020,Cafeteria,1387013,Jan
2025-01-27,El Palacio de los jugos / Rodriguez Foods,Invoice,008-04739,Arroz a Granel:Largo Fino 50 LB -Bolsa Dos Hermanos.,,3.0,27.85,83.55,3812798.23999999,Bulk Rice,Lisset Limpio -020,Cafeteria,1387014,Jan
2025-01-27,El Palacio de los jugos / Rodriguez Foods,Invoice,008-04739,Arroz a Granel:Parboiled 50 LB -Bolsa Dos Hermanos.,,10.0,26.75,267.5,3813065.73999999,Bulk Rice,Lisset Limpio -020,Cafeteria,1387015,Jan
2025-01-27,El Palacio de los jugos / Rodriguez Foods,Invoice,008-04739,,Discount,,,-0.05,3813065.68999999,,Lisset Limpio -020,Cafeteria,1387016,Jan
2025-01-27,Soriano Brothers PB,Invoice,008-04740,Spices:AS Sazon (for all),1 / 30 lb (box or pail),2.0,51.0,102.0,3813167.68999999,American Spice,Lisset Limpio -020,CAFETERIA y RESTAURANTS,1387017,Jan
2025-01-27,Soriano Brothers PB,Invoice,008-04740,Arroz a Granel:Largo Fino 50 LB -Bolsa Dos Hermanos.,,10.0,27.85,278.5,3813446.18999999,Bulk Rice,Lisset Limpio -020,CAFETERIA y RESTAURANTS,1387018,Jan
2025-01-27,Soriano Brothers PB,Invoice,008-04740,Arroz a Granel:Parboiled 50 LB -Bolsa Dos Hermanos.,,11.0,27.75,305.25,3813751.43999999,Bulk Rice,Lisset Limpio -020,CAFETERIA y RESTAURANTS,1387019,Jan
2025-01-27,Soriano Brothers PB,Invoice,008-04740,Arroz a Granel:Parboiled 50 LB -Bolsa Dos Hermanos.,,1.0,27.75,27.75,3813779.18999999,Bulk Rice,Lisset Limpio -020,CAFETERIA y RESTAURANTS,1387020,Jan
2025-01-27,Sedanos Supermarkets #31,Invoice,008-04741,Arroz a Granel:Parboiled 50 LB -Bolsa Dos Hermanos.,,4.0,28.25,113.0,3813892.18999999,Bulk Rice,Keila Alfaro-Visvikis,RETAIL SEDANOS,1387021,Jan
2025-01-27,Sedanos Supermarkets #31,Invoice,008-04741,,Discount,,,-2.26,3813889.92999999,,Keila Alfaro-Visvikis,RETAIL SEDANOS,1387022,Jan
2025-01-27,Sedanos Supermarkets #31,Invoice,008-04742,Arroz Envasado:Parboiled 5KG Dos Hermanos.,6 / 11lbs,20.0,40.5,810.0,3814699.92999999,Branded Rice,Keila Alfaro-Visvikis,RETAIL SEDANOS,1387023,Jan
2025-01-27,Sedanos Supermarkets #31,Invoice,008-04742,Arroz Envasado:Parboiled 5KG Dos Hermanos.,6  11lbs,20.0,40.5,810.0,3815509.92999999,Branded Rice,Keila Alfaro-Visvikis,RETAIL SEDANOS,1387024,Jan
2025-01-27,Sedanos Supermarkets #31,Invoice,008-04742,,Discount,,,-16.2,3815493.72999999,,Keila Alfaro-Visvikis,RETAIL SEDANOS,1387025,Jan
2025-01-27,Panda Depot,Invoice,008-04743,Arroz a Granel:Parboiled 50 LB -Bolsa Dos Hermanos.,,330.0,25.0,8250.0,3823743.72999999,Bulk Rice,Lisset Limpio -020,WHOLESALER,1387026,Jan
2025-01-27,Sedanos Supermarkets #21,Invoice,008-04744,Arroz Envasado:Largo Fino 1kg (Long grain rice) Dos Hermanos,,3.0,18.0,54.0,3823797.72999999,Branded Rice,Keila Alfaro-Visvikis,RETAIL SEDANOS,1387027,Jan
2025-01-27,Sedanos Supermarkets #21,Invoice,008-04744,Arroz Envasado:Parboiled 1kg Bolsa Dos Hermanos.,.,2.0,19.9,39.8,3823837.52999999,Branded Rice,Keila Alfaro-Visvikis,RETAIL SEDANOS,1387028,Jan
2025-01-27,Sedanos Supermarkets #21,Invoice,008-04744,Rice Snack:Rice Snack Ham Flavored DOS HERMANOS,,1.0,19.9,19.9,3823857.42999999,Puffed Products,Keila Alfaro-Visvikis,RETAIL SEDANOS,1387029,Jan
2025-01-27,Sedanos Supermarkets #21,Invoice,008-04744,Rice Snack:Rice Snack Salami Flavored DOS HERMANOS,,1.0,19.9,19.9,3823877.32999999,Puffed Products,Keila Alfaro-Visvikis,RETAIL SEDANOS,1387030,Jan
2025-01-27,Sedanos Supermarkets #21,Invoice,008-04744,Arroz Envasado:Largo Fino 1kg (Long grain rice) Dos Hermanos,,1.0,18.0,18.0,3823895.32999999,Branded Rice,Keila Alfaro-Visvikis,RETAIL SEDANOS,1387031,Jan
2025-01-27,Sedanos Supermarkets #21,Invoice,008-04744,,Discount,,,-2.67,3823892.65999999,,Keila Alfaro-Visvikis,RETAIL SEDANOS,1387032,Jan
2025-01-27,Soriano Brothers PB,Credit Memo,008-04809,Varios:Promotional Allowance,Arroz a Granel:Parboiled 50 LB -Bolsa Dos Hermanos.,-1.0,27.75,-27.75,3823864.90999999,Bulk Rice,Lisset Limpio -020,CAFETERIA y RESTAURANTS,1387033,Jan
2025-01-27,Sedanos Supermarkets #31,Credit Memo,008-04810,Varios:Promotional Allowance,Arroz Envasado:Parboiled 5KG Dos Hermanos.,-20.0,40.5,-810.0,3823054.90999999,Branded Rice,Keila Alfaro-Visvikis,RETAIL SEDANOS,1387034,Jan
2025-01-28,Sedanos Supermarkets #31,Credit Memo,008-04745,Varios:Producto vencido/deteriorado (no impacta en inventario),"9 pizza, 4 salame y 1 jamon",-14.0,1.45,-20.3,3823034.60999999,Puffed Products,Keila Alfaro-Visvikis,RETAIL SEDANOS,1387035,Jan
2025-01-28,Sedanos Supermarkets #31,Credit Memo,008-04745,,Discount,,,0.41,3823035.01999999,,Keila Alfaro-Visvikis,RETAIL SEDANOS,1387036,Jan
2025-01-28,Sedanos Supermarkets #21,Credit Memo,008-04746,Varios:Producto vencido/deteriorado (no impacta en inventario),7 salame y 2 jamon,-9.0,1.45,-13.05,3823021.96999999,Puffed Products,Keila Alfaro-Visvikis,RETAIL SEDANOS,1387037,Jan
2025-01-28,Los Mejores Tamales de Miami,Invoice,008-04747,Arroz a Granel:Largo Fino 50 LB -Bolsa Dos Hermanos.,,5.0,27.85,139.25,3823161.21999999,Bulk Rice,Lisset Limpio -020,CAFETERIA y RESTAURANTS,1387038,Jan
2025-01-28,Los Mejores Tamales de Miami,Invoice,008-04747,Arroz a Granel:Parboiled 50 LB -Bolsa Dos Hermanos.,,5.0,28.25,141.25,3823302.46999999,Bulk Rice,Lisset Limpio -020,CAFETERIA y RESTAURANTS,1387039,Jan
2025-01-28,Los Mejores Tamales de Miami,Invoice,008-04747,Arroz a Granel:Parboiled 50 LB -Bolsa Dos Hermanos.,,1.0,27.85,27.85,3823330.31999999,Bulk Rice,Lisset Limpio -020,CAFETERIA y RESTAURANTS,1387040,Jan
2025-01-28,"American Spice Trading Co, Inc.",Invoice,008-04748,Arroz a Granel:Parboiled 50 LB -Bolsa Dos Hermanos.,,1100.0,27.5,30250.0,3853580.31999999,Bulk Rice,Armando Carpio - 017,WHOLESALER MANUFACTURY,1387041,Jan
2025-01-28,Los Mejores Tamales de Miami,Credit Memo,008-04811,Varios:Promotional Allowance,Arroz a Granel:Parboiled 50 LB -Bolsa Dos Hermanos.,-1.0,27.85,-27.85,3853552.46999999,Bulk Rice,Lisset Limpio -020,CAFETERIA y RESTAURANTS,1387042,Jan
2025-01-28,Sedanos Supermarkets #21,Credit Memo,008-04812,Varios:Promotional Allowance,Arroz Envasado:Largo Fino 1kg (Long grain rice) Dos Hermanos,-1.0,18.0,-18.0,3853534.46999999,Branded Rice,Keila Alfaro-Visvikis,RETAIL SEDANOS,1387043,Jan
2025-01-29,Sorianos Brothers,Credit Memo,008-04749,Varios:Producto vencido/deteriorado (no impacta en inventario),3 parboil 50 L Lote 211771 february 23 2024,-4.0,26.75,-107.0,3853427.46999999,Bulk Rice,Lisset Limpio -020,CAFETERIA y RESTAURANTS,1387044,Jan
2025-01-29,Sedanos Supermarkets #33,Invoice,008-04757,Arroz a Granel:Parboiled 50 LB -Bolsa Dos Hermanos.,,4.0,28.25,113.0,3853540.46999999,Bulk Rice,Keila Alfaro-Visvikis,RETAIL SEDANOS,1387045,Jan
2025-01-29,Sedanos Supermarkets #33,Invoice,008-04757,,Discount,,,-2.26,3853538.20999999,,Keila Alfaro-Visvikis,RETAIL SEDANOS,1387046,Jan
2025-01-29,Los Caringas Latin America  Foods,Invoice,008-04758,Arroz a Granel:Largo Fino 50 LB -Bolsa Dos Hermanos.,,3.0,27.85,83.55,3853621.75999999,Bulk Rice,Lisset Limpio -020,CAFETERIA y RESTAURANTS,1387047,Jan
2025-01-29,Los Caringas Latin America  Foods,Invoice,008-04758,Arroz a Granel:Parboiled 50 LB -Bolsa Dos Hermanos.,,3.0,28.25,84.75,3853706.50999999,Bulk Rice,Lisset Limpio -020,CAFETERIA y RESTAURANTS,1387048,Jan
2025-01-29,Aries Supermarket & Cafeteria,Invoice,008-04759,Arroz a Granel:Parboiled 50 LB -Bolsa Dos Hermanos.,,10.0,28.25,282.5,3853989.00999999,Bulk Rice,Keila Alfaro-Visvikis,CAFETERIA y RESTAURANTS,1387049,Jan
2025-01-29,Aries Supermarket & Cafeteria,Invoice,008-04759,Dry Beans:Dry Beans - Black Beans 50,Dry Black Beans 50 lb,5.0,36.0,180.0,3854169.00999999,Dry Beans,Keila Alfaro-Visvikis,CAFETERIA y RESTAURANTS,1387050,Jan
2025-01-29,China Tokyo,Invoice,008-04760,Arroz a Granel:Parboiled 50 LB -Bolsa Dos Hermanos.,,10.0,28.25,282.5,3854451.50999999,Bulk Rice,Lisset Limpio -020,CAFETERIA y RESTAURANTS,1387051,Jan
2025-01-29,Sabor Tropical Supermarket #4,Invoice,008-04761,Arroz Envasado:Parboiled 5KG Dos Hermanos.,6 / 11lbs,20.0,46.5,930.0,3855381.50999999,Branded Rice,Keila Alfaro-Visvikis,RETAIL  DSD,1387052,Jan
2025-01-29,Sabor Tropical Supermarket #4,Invoice,008-04761,Arroz Envasado:Parboiled 5KG Dos Hermanos.,6  11lbs,20.0,46.5,930.0,3856311.50999999,Branded Rice,Keila Alfaro-Visvikis,RETAIL  DSD,1387053,Jan
2025-01-29,Sabor Tropical Supermarket #4,Invoice,008-04762,Arroz Envasado:Parboiled 1kg Bolsa Dos Hermanos.,.,5.0,19.9,99.5,3856411.00999999,Branded Rice,Keila Alfaro-Visvikis,RETAIL  DSD,1387054,Jan
2025-01-29,Sabor Tropical Supermarket #4,Invoice,008-04762,Arroz Envasado:Parboiled 1kg Bolsa Dos Hermanos.,.,1.0,19.9,19.9,3856430.90999999,Branded Rice,Keila Alfaro-Visvikis,RETAIL  DSD,1387055,Jan
2025-01-29,Sedanos Supermarkets #43,Invoice,008-04763,Arroz a Granel:Parboiled 50 LB -Bolsa Dos Hermanos.,,5.0,28.25,141.25,3856572.15999999,Bulk Rice,Keila Alfaro-Visvikis,RETAIL SEDANOS,1387056,Jan
2025-01-29,Sedanos Supermarkets #43,Invoice,008-04763,,Discount,,,-2.83,3856569.32999999,,Keila Alfaro-Visvikis,RETAIL SEDANOS,1387057,Jan
2025-01-29,Sedanos Supermarkets #16,Invoice,008-04764,Arroz a Granel:Parboiled 50 LB -Bolsa Dos Hermanos.,,6.0,28.25,169.5,3856738.82999999,Bulk Rice,Keila Alfaro-Visvikis,RETAIL SEDANOS,1387058,Jan
2025-01-29,Sedanos Supermarkets #16,Invoice,008-04764,,Discount,,,-3.39,3856735.43999999,,Keila Alfaro-Visvikis,RETAIL SEDANOS,1387059,Jan
2025-01-29,Sabor Tropical Supermarket #4,Credit Memo,008-04813,Varios:Promotional Allowance,Arroz Envasado:Parboiled 5KG Dos Hermanos.,-20.0,46.5,-930.0,3855805.43999999,Branded Rice,Keila Alfaro-Visvikis,RETAIL  DSD,1387060,Jan
2025-01-29,Sabor Tropical Supermarket #4,Credit Memo,008-04814,Varios:Promotional Allowance,Arroz Envasado:Parboiled 1kg Bolsa Dos Hermanos.,-1.0,19.9,-19.9,3855785.53999999,Branded Rice,Keila Alfaro-Visvikis,RETAIL  DSD,1387061,Jan
2025-01-29,Sorianos Brothers,Invoice,008-05030,Arroz a Granel:Parboiled 50 LB -Bolsa Dos Hermanos.,,4.0,26.75,107.0,3855892.53999999,Bulk Rice,Lisset Limpio -020,CAFETERIA y RESTAURANTS,1387062,Jan
2025-01-30,Sedanos Supermarkets #20,Invoice,008-04765,Arroz Envasado:Parboiled 5KG Dos Hermanos.,6 / 11lbs,5.0,40.5,202.5,3856095.03999999,Branded Rice,Keila Alfaro-Visvikis,RETAIL SEDANOS,1387063,Jan
2025-01-30,Sedanos Supermarkets #20,Invoice,008-04765,Rice Snack:Rice Snack Ham Flavored DOS HERMANOS,,1.0,19.9,19.9,3856114.93999999,Puffed Products,Keila Alfaro-Visvikis,RETAIL SEDANOS,1387064,Jan
2025-01-30,Sedanos Supermarkets #20,Invoice,008-04765,Arroz Envasado:Parboiled 5KG Dos Hermanos.,6  11lbs,5.0,40.5,202.5,3856317.43999999,Branded Rice,Keila Alfaro-Visvikis,RETAIL SEDANOS,1387065,Jan
2025-01-30,Sedanos Supermarkets #20,Invoice,008-04765,,Discount,,,-3.87,3856313.56999999,,Keila Alfaro-Visvikis,RETAIL SEDANOS,1387066,Jan
2025-01-30,Sedanos Supermarkets #20,Credit Memo,008-04766,Varios:Producto vencido/deteriorado (no impacta en inventario),"4 Salame, 3 jamon 1 pizza",-8.0,1.49,-11.92,3856301.64999999,Puffed Products,Keila Alfaro-Visvikis,RETAIL SEDANOS,1387067,Jan
2025-01-30,Sedanos Supermarkets #20,Credit Memo,008-04766,Varios:Producto vencido/deteriorado (no impacta en inventario),7 long grain 1 parboil rice,-7.0,1.46,-10.22,3856291.42999999,Branded Rice,Keila Alfaro-Visvikis,RETAIL SEDANOS,1387068,Jan
2025-01-30,Sedanos Supermarkets #20,Credit Memo,008-04766,Varios:Producto vencido/deteriorado (no impacta en inventario),2 5kg parbo,-2.0,3.37,-6.74,3856284.68999999,Branded Rice,Keila Alfaro-Visvikis,RETAIL SEDANOS,1387069,Jan
2025-01-30,Sorianos Brothers,Credit Memo,008-04767,Varios:Producto vencido/deteriorado (no impacta en inventario),CAMBIO 20 BOLSAS 50LB,-20.0,26.75,-535.0,3855749.68999999,Bulk Rice,Lisset Limpio -020,CAFETERIA y RESTAURANTS,1387070,Jan
2025-01-30,Sorianos Brothers,Invoice,008-04768,Arroz a Granel:Parboiled 50 LB -Bolsa Dos Hermanos.,CAMBIO 20 BOLSAS 50LB,20.0,26.75,535.0,3856284.68999999,Bulk Rice,Lisset Limpio -020,CAFETERIA y RESTAURANTS,1387071,Jan
2025-01-30,"American Spice Trading Co, Inc.",Invoice,008-04769,Arroz a Granel:Parboiled 50 LB -Bolsa Dos Hermanos.,,1100.0,27.5,30250.0,3886534.68999999,Bulk Rice,Armando Carpio - 017,WHOLESALER MANUFACTURY,1387072,Jan
2025-01-30,Mama ‘s Kitchen F.D.CORP,Invoice,008-04770,Arroz a Granel:Parboiled 50 LB -Bolsa Dos Hermanos.,,1.0,28.25,28.25,3886562.93999999,Bulk Rice,Keila Alfaro-Visvikis,CAFETERIA y RESTAURANTS,1387073,Jan
2025-01-30,Mama ‘s Kitchen F.D.CORP,Invoice,008-04770,Liquids:AS Cooking Wine,4 1 Gl.,2.0,17.5,35.0,3886597.93999999,American Spice,Keila Alfaro-Visvikis,CAFETERIA y RESTAURANTS,1387074,Jan
2025-01-30,Mama ‘s Kitchen F.D.CORP,Invoice,008-04770,Liquids:AS Marinating Sauce (Mojo),,1.0,18.5,18.5,3886616.43999999,American Spice,Keila Alfaro-Visvikis,CAFETERIA y RESTAURANTS,1387075,Jan
2025-01-30,Mama ‘s Kitchen F.D.CORP,Invoice,008-04770,Spices:AS Chicken Base,1 / 30 lb. (box or pail),1.0,39.0,39.0,3886655.43999999,American Spice,Keila Alfaro-Visvikis,CAFETERIA y RESTAURANTS,1387076,Jan
2025-01-30,El Palacio de los jugos /  Nanos Latin Foods,Invoice,008-04771,Arroz a Granel:Largo Fino 50 LB -Bolsa Dos Hermanos.,,5.0,27.85,139.25,3886794.68999999,Bulk Rice,Lisset Limpio -020,Cafeteria,1387077,Jan
2025-01-30,El Palacio de los jugos /  Nanos Latin Foods,Invoice,008-04771,Arroz a Granel:Parboiled 50 LB -Bolsa Dos Hermanos.,,5.0,26.75,133.75,3886928.43999999,Bulk Rice,Lisset Limpio -020,Cafeteria,1387078,Jan
2025-01-30,El Palacio de Los Jugos / Casa mía Food Restaurant inc,Invoice,008-04772,Arroz a Granel:Parboiled 50 LB -Bolsa Dos Hermanos.,,11.0,27.75,305.25,3887233.68999999,Bulk Rice,Lisset Limpio -020,Cafeteria,1387079,Jan
2025-01-30,El Palacio de Los Jugos / Casa mía Food Restaurant inc,Invoice,008-04772,Dry Beans:Dry Beans - Black Beans 50,Dry Black Beans 50 lb,1.0,45.7,45.7,3887279.38999999,Dry Beans,Lisset Limpio -020,Cafeteria,1387080,Jan
2025-01-30,El Palacio de Los Jugos / Casa mía Food Restaurant inc,Invoice,008-04772,Arroz a Granel:Parboiled 50 LB -Bolsa Dos Hermanos.,,1.0,27.75,27.75,3887307.13999999,Bulk Rice,Lisset Limpio -020,Cafeteria,1387081,Jan
2025-01-30,Fritanga Momotombo,Invoice,008-04773,Dry Beans:Dry Beans - Small Red Beans 50 lbs.,Small Red Beans 50 lbs,2.0,42.0,84.0,3887391.13999999,Dry Beans,Lisset Limpio -020,CAFETERIA y RESTAURANTS,1387082,Jan
2025-01-30,Fritanga Momotombo,Invoice,008-04773,Arroz a Granel:Largo Fino 50 LB -Bolsa Dos Hermanos.,,5.0,27.85,139.25,3887530.38999999,Bulk Rice,Lisset Limpio -020,CAFETERIA y RESTAURANTS,1387083,Jan
2025-01-30,Sedanos Supermarkets #32,Invoice,008-04774,Arroz a Granel:Largo Fino 50 LB -Bolsa Dos Hermanos.,,6.0,27.85,167.1,3887697.48999999,Bulk Rice,Keila Alfaro-Visvikis,RETAIL SEDANOS,1387084,Jan
2025-01-30,Sedanos Supermarkets #32,Invoice,008-04774,Arroz a Granel:Parboiled 50 LB -Bolsa Dos Hermanos.,,6.0,28.25,169.5,3887866.98999999,Bulk Rice,Keila Alfaro-Visvikis,RETAIL SEDANOS,1387085,Jan
2025-01-30,Sedanos Supermarkets #32,Invoice,008-04774,,Discount,,,-6.73,3887860.25999999,,Keila Alfaro-Visvikis,RETAIL SEDANOS,1387086,Jan
2025-01-30,Sedanos Supermarkets #20,Credit Memo,008-04815,Varios:Promotional Allowance,Arroz Envasado:Parboiled 5KG Dos Hermanos.,-5.0,40.5,-202.5,3887657.75999999,Branded Rice,Keila Alfaro-Visvikis,RETAIL SEDANOS,1387087,Jan
2025-01-30,El Palacio de Los Jugos / Casa mía Food Restaurant inc,Credit Memo,008-04816,Varios:Promotional Allowance,Arroz a Granel:Parboiled 50 LB -Bolsa Dos Hermanos.,-1.0,27.75,-27.75,3887630.00999999,Bulk Rice,Lisset Limpio -020,Cafeteria,1387088,Jan
2025-01-31,El Palacio de los jugos / Leti Corp.,Invoice,008-04775,Arroz a Granel:Parboiled 50 LB -Bolsa Dos Hermanos.,,10.0,26.75,267.5,3887897.50999999,Bulk Rice,Lisset Limpio -020,Cafeteria,1387089,Jan
2025-01-31,Bravo   Francisco Diaz,Invoice,008-04776,Liquids:AS Cooking Wine,4 1 Gl.,2.0,17.5,35.0,3887932.50999999,American Spice,Lisset Limpio -020,RETAIL  DSD,1387090,Jan
2025-01-31,Bravo   Francisco Diaz,Invoice,008-04776,Liquids:AS White Vinegar,4/1 Gl.,1.0,10.0,10.0,3887942.50999999,American Spice,Lisset Limpio -020,RETAIL  DSD,1387091,Jan
2025-01-31,Bravo   Francisco Diaz,Invoice,008-04776,Dry Beans:Dry Beans - Black Beans 50,Dry Black Beans 50 lb,1.0,45.7,45.7,3887988.20999999,Dry Beans,Lisset Limpio -020,RETAIL  DSD,1387092,Jan
2025-01-31,Bravo   Francisco Diaz,Invoice,008-04776,Dry Beans:Dry Beans - Small Red Beans 50 lbs.,Small Red Beans 50 lbs,1.0,46.85,46.85,3888035.05999999,Dry Beans,Lisset Limpio -020,RETAIL  DSD,1387093,Jan
2025-01-31,Bravo   Francisco Diaz,Invoice,008-04776,Arroz a Granel:Largo Fino 50 LB -Bolsa Dos Hermanos.,,5.0,27.85,139.25,3888174.30999999,Bulk Rice,Lisset Limpio -020,RETAIL  DSD,1387094,Jan
2025-01-31,El Gallego Supermarket,Invoice,008-04777,Arroz a Granel:Parboiled 50 LB -Bolsa Dos Hermanos.,,5.0,28.25,141.25,3888315.55999999,Bulk Rice,Lisset Limpio -020,RETAIL  DSD,1387095,Jan
2025-01-31,El Gallego Supermarket,Invoice,008-04777,Dry Beans:Dry Beans - Black Beans 50,Dry Black Beans 50 lb,2.0,45.7,91.4,3888406.95999999,Dry Beans,Lisset Limpio -020,RETAIL  DSD,1387096,Jan
2025-01-31,El Palacio de los jugos /  EMMA FOOD CORP,Invoice,008-04778,Arroz a Granel:Largo Fino 50 LB -Bolsa Dos Hermanos.,,8.0,27.85,222.8,3888629.75999999,Bulk Rice,Lisset Limpio -020,Cafeteria,1387097,Jan
2025-01-31,El Palacio de los jugos /  EMMA FOOD CORP,Invoice,008-04778,Arroz a Granel:Parboiled 50 LB -Bolsa Dos Hermanos.,,1.0,26.75,26.75,3888656.50999999,Bulk Rice,Lisset Limpio -020,Cafeteria,1387098,Jan
2025-01-31,"Diaz Grocers, Inc",Invoice,008-04779,Arroz a Granel:Parboiled 50 LB -Bolsa Dos Hermanos.,,25.0,26.75,668.75,3889325.25999999,Bulk Rice,Lisset Limpio -020,RETAIL  DSD,1387099,Jan
2025-01-31,"Diaz Grocers, Inc",Invoice,008-04779,Dry Beans:Dry Beans - Black Beans 50,Dry Black Beans 50 lb,55.0,36.5,2007.5,3891332.75999999,Dry Beans,Lisset Limpio -020,RETAIL  DSD,1387100,Jan
2025-01-31,"Diaz Grocers, Inc",Invoice,008-04779,Dry Beans:Dry Beans - Small Red Beans 50 lbs.,Small Red Beans 50 lbs,16.0,40.5,648.0,3891980.75999999,Dry Beans,Lisset Limpio -020,RETAIL  DSD,1387101,Jan
2025-01-31,Sedanos Supermarkets #32,Invoice,008-04780,Arroz Envasado:Parboiled 5KG Dos Hermanos.,6 / 11lbs,20.0,40.5,810.0,3892790.75999999,Branded Rice,Keila Alfaro-Visvikis,RETAIL SEDANOS,1387102,Jan
2025-01-31,Sedanos Supermarkets #32,Invoice,008-04780,Rice Snack:Rice Snack Ham Flavored DOS HERMANOS,,1.0,19.9,19.9,3892810.65999999,Puffed Products,Keila Alfaro-Visvikis,RETAIL SEDANOS,1387103,Jan
2025-01-31,Sedanos Supermarkets #32,Invoice,008-04780,Arroz Envasado:Parboiled 5KG Dos Hermanos.,6  11lbs,20.0,40.5,810.0,3893620.65999999,Branded Rice,Keila Alfaro-Visvikis,RETAIL SEDANOS,1387104,Jan
2025-01-31,Sedanos Supermarkets #32,Invoice,008-04780,,Discount,,,-16.6,3893604.05999999,,Keila Alfaro-Visvikis,RETAIL SEDANOS,1387105,Jan
2025-01-31,Ideal Food Basket Davie Cafeteria,Invoice,008-04781,Arroz a Granel:Largo Fino 50 LB -Bolsa Dos Hermanos.,,8.0,27.85,222.8,3893826.85999999,Bulk Rice,Keila Alfaro-Visvikis,CAFETERIA y RESTAURANTS,1387106,Jan
2025-01-31,BRAVO - Flamingo #3,Invoice,008-04782,Arroz Envasado:Parboiled 5KG Dos Hermanos.,6 / 11lbs,10.0,46.5,465.0,3894291.85999999,Branded Rice,Keila Alfaro-Visvikis,RETAIL  DSD,1387107,Jan
2025-01-31,BRAVO - Flamingo #3,Invoice,008-04782,Arroz Envasado:Parboiled 1kg Bolsa Dos Hermanos.,.,3.0,19.9,59.7,3894351.55999999,Branded Rice,Keila Alfaro-Visvikis,RETAIL  DSD,1387108,Jan
2025-01-31,BRAVO - Flamingo #3,Invoice,008-04782,Arroz Envasado:Largo Fino 1kg (Long grain rice) Dos Hermanos,,2.0,18.0,36.0,3894387.55999999,Branded Rice,Keila Alfaro-Visvikis,RETAIL  DSD,1387109,Jan
2025-01-31,BRAVO - Flamingo #3,Invoice,008-04782,Rice Snack:Rice Snack Ham Flavored DOS HERMANOS,,1.0,19.9,19.9,3894407.45999999,Puffed Products,Keila Alfaro-Visvikis,RETAIL  DSD,1387110,Jan
2025-01-31,BRAVO - Flamingo #3,Invoice,008-04782,Rice Snack:Rice Snack Salami Flavored DOS HERMANOS,,1.0,19.9,19.9,3894427.35999999,Puffed Products,Keila Alfaro-Visvikis,RETAIL  DSD,1387111,Jan
2025-01-31,BRAVO - Flamingo #3,Invoice,008-04782,Arroz Envasado:Parboiled 5KG Dos Hermanos.,6  11lbs,10.0,46.5,465.0,3894892.35999999,Branded Rice,Keila Alfaro-Visvikis,RETAIL  DSD,1387112,Jan
2025-01-31,BRAVO - Flamingo #3,Invoice,008-04782,Arroz Envasado:Parboiled 1kg Bolsa Dos Hermanos.,.,1.0,19.9,19.9,3894912.25999999,Branded Rice,Keila Alfaro-Visvikis,RETAIL  DSD,1387113,Jan
2025-01-31,"El Toro Loco Meat Distribution, LLC",Invoice,008-04783,Dry Beans:Dry Beans - Black Beans 50,Dry Black Beans 50 lb,25.0,38.0,950.0,3895862.25999999,Dry Beans,Lisset Limpio -020,CAFETERIA y RESTAURANTS,1387114,Jan
2025-01-31,Sedanos Supermarkets #32,Credit Memo,008-04817,Varios:Promotional Allowance,Arroz Envasado:Parboiled 5KG Dos Hermanos.,-20.0,40.5,-810.0,3895052.25999999,Branded Rice,Keila Alfaro-Visvikis,RETAIL SEDANOS,1387115,Jan
2025-01-31,BRAVO - Flamingo #3,Credit Memo,008-04818,Varios:Promotional Allowance,Arroz Envasado:Parboiled 5KG Dos Hermanos.,-10.0,46.5,-465.0,3894587.25999999,Branded Rice,Keila Alfaro-Visvikis,RETAIL  DSD,1387116,Jan
2025-01-31,BRAVO - Flamingo #3,Credit Memo,008-04818,Varios:Promotional Allowance,Arroz Envasado:Parboiled 1kg Bolsa Dos Hermanos.,-1.0,19.9,-19.9,3894567.35999999,Branded Rice,Keila Alfaro-Visvikis,RETAIL  DSD,1387117,Jan
2025-02-01,BRAVO - Flamingo #3,Credit Memo,008-04790,Varios:Producto vencido/deteriorado (no impacta en inventario),10 salame y 10 jamon,-20.0,1.49,-29.8,3894537.55999999,Puffed Products,Keila Alfaro-Visvikis,RETAIL  DSD,1387118,Feb
2025-02-02,El Palacio de los jugos /  Mires Restaurants,Invoice,008-04784,Liquids:AS Marinating Sauce (Mojo),,1.0,18.5,18.5,3894556.05999999,American Spice,Lisset Limpio -020,Cafeteria,1387119,Feb
2025-02-02,El Palacio de los jugos /  Mires Restaurants,Invoice,008-04784,Arroz a Granel:Parboiled 50 LB -Bolsa Dos Hermanos.,,11.0,27.75,305.25,3894861.30999999,Bulk Rice,Lisset Limpio -020,Cafeteria,1387120,Feb
2025-02-02,El Palacio de los jugos /  Mires Restaurants,Invoice,008-04784,Arroz a Granel:Parboiled 50 LB -Bolsa Dos Hermanos.,,1.0,27.75,27.75,3894889.05999999,Bulk Rice,Lisset Limpio -020,Cafeteria,1387121,Feb
2025-02-02,El Palacio de los jugos /  EMMA FOOD CORP,Invoice,008-04785,Arroz a Granel:Largo Fino 50 LB -Bolsa Dos Hermanos.,,7.0,27.85,194.95,3895084.00999999,Bulk Rice,Lisset Limpio -020,Cafeteria,1387122,Feb
2025-02-02,El Palacio de los jugos / Rodriguez Foods,Invoice,008-04786,Arroz a Granel:Largo Fino 50 LB -Bolsa Dos Hermanos.,,1.0,27.85,27.85,3895111.85999999,Bulk Rice,Lisset Limpio -020,Cafeteria,1387123,Feb
2025-02-02,El Palacio de los jugos / Rodriguez Foods,Invoice,008-04786,Arroz a Granel:Parboiled 50 LB -Bolsa Dos Hermanos.,,6.0,27.75,166.5,3895278.35999999,Bulk Rice,Lisset Limpio -020,Cafeteria,1387124,Feb
2025-02-02,El Palacio de los jugos / Lita Foods Inc.,Invoice,008-04787,Dry Beans:Dry Beans - Black Beans 50,Dry Black Beans 50 lb,1.0,45.7,45.7,3895324.05999999,Dry Beans,Lisset Limpio -020,Cafeteria,1387125,Feb
2025-02-02,El Palacio de los jugos / Lita Foods Inc.,Invoice,008-04787,Arroz a Granel:Parboiled 50 LB -Bolsa Dos Hermanos.,,11.0,27.75,305.25,3895629.30999999,Bulk Rice,Lisset Limpio -020,Cafeteria,1387126,Feb
2025-02-02,El Palacio de los jugos / Lita Foods Inc.,Invoice,008-04787,Arroz a Granel:Parboiled 50 LB -Bolsa Dos Hermanos.,,1.0,27.75,27.75,3895657.05999999,Bulk Rice,Lisset Limpio -020,Cafeteria,1387127,Feb
2025-02-02,JMN Dely Corp,Invoice,008-04788,Arroz a Granel:Largo Fino 50 LB -Bolsa Dos Hermanos.,,1.0,27.85,27.85,3895684.90999999,Bulk Rice,Keila Alfaro-Visvikis,CAFETERIA y RESTAURANTS,1387128,Feb
2025-02-02,JMN Dely Corp,Invoice,008-04788,Arroz a Granel:Parboiled 50 LB -Bolsa Dos Hermanos.,,2.0,27.75,55.5,3895740.40999999,Bulk Rice,Keila Alfaro-Visvikis,CAFETERIA y RESTAURANTS,1387129,Feb
2025-02-02,JMN Dely Corp,Invoice,008-04788,Dry Beans:Dry Beans - Black Beans 50,Dry Black Beans 50 lb,2.0,45.7,91.4,3895831.80999999,Dry Beans,Keila Alfaro-Visvikis,CAFETERIA y RESTAURANTS,1387130,Feb
2025-02-02,ALS Foods,Invoice,008-04789,Liquids:AS Cooking Wine,4 1 Gl.,2.0,17.5,35.0,3895866.80999999,American Spice,Lisset Limpio -020,CAFETERIA y RESTAURANTS,1387131,Feb
2025-02-02,ALS Foods,Invoice,008-04789,Arroz a Granel:Largo Fino 50 LB -Bolsa Dos Hermanos.,,7.0,27.85,194.95,3896061.75999999,Bulk Rice,Lisset Limpio -020,CAFETERIA y RESTAURANTS,1387132,Feb
2025-02-02,ALS Foods,Invoice,008-04789,Arroz a Granel:Parboiled 50 LB -Bolsa Dos Hermanos.,,11.0,27.75,305.25,3896367.00999999,Bulk Rice,Lisset Limpio -020,CAFETERIA y RESTAURANTS,1387133,Feb
2025-02-02,ALS Foods,Invoice,008-04789,Arroz a Granel:Parboiled 50 LB -Bolsa Dos Hermanos.,,1.0,27.75,27.75,3896394.75999999,Bulk Rice,Lisset Limpio -020,CAFETERIA y RESTAURANTS,1387134,Feb
2025-02-02,El Palacio de los jugos /  Mires Restaurants,Credit Memo,008-04858,Varios:Promotional Allowance,Arroz a Granel:Parboiled 50 LB -Bolsa Dos Hermanos.,-1.0,27.75,-27.75,3896367.00999999,Bulk Rice,Lisset Limpio -020,Cafeteria,1387135,Feb
2025-02-02,ALS Foods,Credit Memo,008-04859,Varios:Promotional Allowance,Arroz a Granel:Parboiled 50 LB -Bolsa Dos Hermanos.,-1.0,27.75,-27.75,3896339.25999999,Bulk Rice,Lisset Limpio -020,CAFETERIA y RESTAURANTS,1387136,Feb
2025-02-02,El Palacio de los jugos / Lita Foods Inc.,Credit Memo,008-04860,Varios:Promotional Allowance,Arroz a Granel:Parboiled 50 LB -Bolsa Dos Hermanos.,-1.0,27.75,-27.75,3896311.50999999,Bulk Rice,Lisset Limpio -020,Cafeteria,1387137,Feb
2025-02-05,Rey Chavez Distributor #2,Invoice,008-04819,Arroz a Granel:Parboiled 50 LB -Bolsa Dos Hermanos.,,20.0,28.8,576.0,3896887.50999999,Bulk Rice,Lisset Limpio -020,WHOLESALER,1387138,Feb
2025-02-05,El Palacio de los jugos /  Nanos Latin Foods,Invoice,008-04820,Arroz a Granel:Largo Fino 50 LB -Bolsa Dos Hermanos.,,8.0,27.85,222.8,3897110.30999999,Bulk Rice,Lisset Limpio -020,Cafeteria,1387139,Feb
2025-02-05,El Palacio de los jugos /  Nanos Latin Foods,Invoice,008-04820,Arroz a Granel:Parboiled 50 LB -Bolsa Dos Hermanos.,,8.0,26.75,214.0,3897324.30999999,Bulk Rice,Lisset Limpio -020,Cafeteria,1387140,Feb
2025-02-05,El Palacio de los jugos / Leti Corp.,Invoice,008-04821,Arroz a Granel:Largo Fino 50 LB -Bolsa Dos Hermanos.,,8.0,27.85,222.8,3897547.10999999,Bulk Rice,Lisset Limpio -020,Cafeteria,1387141,Feb
2025-02-05,El Palacio de los jugos / Leti Corp.,Invoice,008-04821,Arroz a Granel:Parboiled 50 LB -Bolsa Dos Hermanos.,,8.0,26.75,214.0,3897761.10999999,Bulk Rice,Lisset Limpio -020,Cafeteria,1387142,Feb
2025-02-05,Sedanos Supermarkets #43,Invoice,008-04822,Arroz a Granel:Parboiled 50 LB -Bolsa Dos Hermanos.,,4.0,28.25,113.0,3897874.10999999,Bulk Rice,Keila Alfaro-Visvikis,RETAIL SEDANOS,1387143,Feb
2025-02-05,Sedanos Supermarkets #43,Invoice,008-04822,,Discount,,,-2.26,3897871.84999999,,Keila Alfaro-Visvikis,RETAIL SEDANOS,1387144,Feb
2025-02-05,Sedanos Supermarkets #24,Invoice,008-04823,Arroz a Granel:Parboiled 50 LB -Bolsa Dos Hermanos.,,6.0,28.25,169.5,3898041.34999999,Bulk Rice,Keila Alfaro-Visvikis,RETAIL SEDANOS,1387145,Feb
2025-02-05,Sedanos Supermarkets #24,Invoice,008-04823,,Discount,,,-3.39,3898037.95999999,,Keila Alfaro-Visvikis,RETAIL SEDANOS,1387146,Feb
2025-02-05,Sedanos Supermarkets #24,Invoice,008-04824,Arroz Envasado:Parboiled 5KG Dos Hermanos.,6 / 11lbs,0.0,,0.0,3898037.95999999,Branded Rice,Keila Alfaro-Visvikis,RETAIL SEDANOS,1387147,Feb
2025-02-05,Sedanos Supermarkets #26,Invoice,008-04825,Arroz a Granel:Parboiled 50 LB -Bolsa Dos Hermanos.,,5.0,28.25,141.25,3898179.20999999,Bulk Rice,Keila Alfaro-Visvikis,RETAIL SEDANOS,1387148,Feb
2025-02-05,Sedanos Supermarkets #26,Invoice,008-04825,,Discount,,,-2.83,3898176.37999999,,Keila Alfaro-Visvikis,RETAIL SEDANOS,1387149,Feb
2025-02-05,Sedanos Supermarkets #22,Invoice,008-04826,Arroz a Granel:Parboiled 50 LB -Bolsa Dos Hermanos.,,4.0,28.25,113.0,3898289.37999999,Bulk Rice,Keila Alfaro-Visvikis,RETAIL SEDANOS,1387150,Feb
2025-02-05,Sedanos Supermarkets #22,Invoice,008-04826,,Discount,,,-2.26,3898287.11999999,,Keila Alfaro-Visvikis,RETAIL SEDANOS,1387151,Feb
2025-02-05,Hings Chinese,Invoice,008-04827,Arroz a Granel:Parboiled 50 LB -Bolsa Dos Hermanos.,,5.0,28.25,141.25,3898428.36999999,Bulk Rice,Lisset Limpio -020,CAFETERIA y RESTAURANTS,1387152,Feb
2025-02-05,Ideal Food Basket Davie Cafeteria,Invoice,008-04828,Arroz a Granel:Largo Fino 50 LB -Bolsa Dos Hermanos.,,8.0,27.85,222.8,3898651.16999999,Bulk Rice,Keila Alfaro-Visvikis,CAFETERIA y RESTAURANTS,1387153,Feb
2025-02-05,Aries Supermarket & Cafeteria,Invoice,008-04829,Spices:AS Chicken Base,1 / 30 lb. (box or pail),2.0,39.0,78.0,3898729.16999999,American Spice,Keila Alfaro-Visvikis,CAFETERIA y RESTAURANTS,1387154,Feb
2025-02-05,Aries Supermarket & Cafeteria,Invoice,008-04829,Arroz a Granel:Parboiled 50 LB -Bolsa Dos Hermanos.,,5.0,28.25,141.25,3898870.41999999,Bulk Rice,Keila Alfaro-Visvikis,CAFETERIA y RESTAURANTS,1387155,Feb
2025-02-05,Aries Supermarket & Cafeteria,Invoice,008-04829,Dry Beans:Dry Beans - Black Beans 50,Dry Black Beans 50 lb,2.0,36.0,72.0,3898942.41999999,Dry Beans,Keila Alfaro-Visvikis,CAFETERIA y RESTAURANTS,1387156,Feb
2025-02-05,Aries Supermarket & Cafeteria,Invoice,008-04830,Arroz Envasado:Parboiled 5KG Dos Hermanos.,6 / 11lbs,5.0,46.5,232.5,3899174.91999999,Branded Rice,Keila Alfaro-Visvikis,CAFETERIA y RESTAURANTS,1387157,Feb
2025-02-05,Aries Supermarket & Cafeteria,Invoice,008-04830,Arroz Envasado:Parboiled 5KG Dos Hermanos.,6  11lbs,5.0,46.5,232.5,3899407.41999999,Branded Rice,Keila Alfaro-Visvikis,CAFETERIA y RESTAURANTS,1387158,Feb
2025-02-05,Aries Supermarket & Cafeteria,Credit Memo,008-04856,Varios:Promotional Allowance,Arroz Envasado:Parboiled 5KG Dos Hermanos.,0.0,,0.0,3899407.41999999,Branded Rice,Keila Alfaro-Visvikis,CAFETERIA y RESTAURANTS,1387159,Feb
2025-02-05,Aries Supermarket & Cafeteria,Credit Memo,008-04857,Varios:Promotional Allowance,Arroz Envasado:Parboiled 5KG Dos Hermanos.,-5.0,46.5,-232.5,3899174.91999999,Branded Rice,Keila Alfaro-Visvikis,CAFETERIA y RESTAURANTS,1387160,Feb
2025-02-07,Sedanos Supermarkets  #37,Invoice,008-04831,Arroz a Granel:Largo Fino 50 LB -Bolsa Dos Hermanos.,,3.0,27.85,83.55,3899258.46999999,Bulk Rice,Keila Alfaro-Visvikis,RETAIL SEDANOS,1387161,Feb
2025-02-07,Sedanos Supermarkets  #37,Invoice,008-04831,Arroz a Granel:Parboiled 50 LB -Bolsa Dos Hermanos.,,5.0,28.25,141.25,3899399.71999999,Bulk Rice,Keila Alfaro-Visvikis,RETAIL SEDANOS,1387162,Feb
2025-02-07,Sedanos Supermarkets  #37,Invoice,008-04831,,Discount,,,-4.5,3899395.21999999,,Keila Alfaro-Visvikis,RETAIL SEDANOS,1387163,Feb
2025-02-07,Sedanos Supermarkets #18,Invoice,008-04832,Arroz a Granel:Parboiled 50 LB -Bolsa Dos Hermanos.,,10.0,28.25,282.5,3899677.71999999,Bulk Rice,Keila Alfaro-Visvikis,RETAIL SEDANOS,1387164,Feb
2025-02-07,Sedanos Supermarkets #18,Invoice,008-04832,,Discount,,,-5.65,3899672.06999999,,Keila Alfaro-Visvikis,RETAIL SEDANOS,1387165,Feb
2025-02-07,El Palacio de Los Jugos / Casa mía Food Restaurant inc,Invoice,008-04833,Arroz a Granel:Parboiled 50 LB -Bolsa Dos Hermanos.,,11.0,27.75,305.25,3899977.31999999,Bulk Rice,Lisset Limpio -020,Cafeteria,1387166,Feb
2025-02-07,El Palacio de Los Jugos / Casa mía Food Restaurant inc,Invoice,008-04833,Dry Beans:Dry Beans - Black Beans 50,Dry Black Beans 50 lb,1.0,45.7,45.7,3900023.01999999,Dry Beans,Lisset Limpio -020,Cafeteria,1387167,Feb
2025-02-07,El Palacio de Los Jugos / Casa mía Food Restaurant inc,Invoice,008-04833,Arroz a Granel:Parboiled 50 LB -Bolsa Dos Hermanos.,,1.0,27.75,27.75,3900050.76999999,Bulk Rice,Lisset Limpio -020,Cafeteria,1387168,Feb
2025-02-07,Bravo   Francisco Diaz,Invoice,008-04834,Liquids:AS Cooking Wine,4 1 Gl.,2.0,17.5,35.0,3900085.76999999,American Spice,Lisset Limpio -020,RETAIL  DSD,1387169,Feb
2025-02-07,Bravo   Francisco Diaz,Invoice,008-04834,Liquids:AS White Vinegar,4/1 Gl.,1.0,10.0,10.0,3900095.76999999,American Spice,Lisset Limpio -020,RETAIL  DSD,1387170,Feb
2025-02-07,Bravo   Francisco Diaz,Invoice,008-04834,Arroz a Granel:Largo Fino 50 LB -Bolsa Dos Hermanos.,,5.0,27.85,139.25,3900235.01999999,Bulk Rice,Lisset Limpio -020,RETAIL  DSD,1387171,Feb
2025-02-07,Soriano Brothers PB,Invoice,008-04835,Dry Beans:Dry Beans - Black Beans 50,Dry Black Beans 50 lb,3.0,38.0,114.0,3900349.01999999,Dry Beans,Lisset Limpio -020,CAFETERIA y RESTAURANTS,1387172,Feb
2025-02-07,Soriano Brothers PB,Invoice,008-04835,Arroz a Granel:Largo Fino 50 LB -Bolsa Dos Hermanos.,,10.0,27.85,278.5,3900627.51999999,Bulk Rice,Lisset Limpio -020,CAFETERIA y RESTAURANTS,1387173,Feb
2025-02-07,Soriano Brothers PB,Invoice,008-04835,Arroz a Granel:Parboiled 50 LB -Bolsa Dos Hermanos.,,15.0,26.75,401.25,3901028.76999999,Bulk Rice,Lisset Limpio -020,CAFETERIA y RESTAURANTS,1387174,Feb
2025-02-07,Soriano Brothers PB,Invoice,008-04835,Spices:AS Sazon (for all),1 / 30 lb (box or pail),2.0,51.0,102.0,3901130.76999999,American Spice,Lisset Limpio -020,CAFETERIA y RESTAURANTS,1387175,Feb
2025-02-07,El Palacio de los jugos /  EMMA FOOD CORP,Invoice,008-04836,Arroz a Granel:Largo Fino 50 LB -Bolsa Dos Hermanos.,,8.0,27.85,222.8,3901353.56999999,Bulk Rice,Lisset Limpio -020,Cafeteria,1387176,Feb
2025-02-07,Food-Star Supermarket,Invoice,008-04837,Arroz Envasado:Largo Fino 1kg (Long grain rice) Dos Hermanos,,10.0,18.0,180.0,3901533.56999999,Branded Rice,Lisset Limpio -020,RETAIL  DSD,1387177,Feb
2025-02-07,Food-Star Supermarket,Invoice,008-04837,Arroz Envasado:Largo Fino 1kg (Long grain rice) Dos Hermanos,,2.0,18.0,36.0,3901569.56999999,Branded Rice,Lisset Limpio -020,RETAIL  DSD,1387178,Feb
2025-02-07,Sedanos Supermarkets #29,Invoice,008-04838,Arroz Envasado:Parboiled 5KG Dos Hermanos.,6 / 11lbs,10.0,40.5,405.0,3901974.56999999,Branded Rice,Keila Alfaro-Visvikis,RETAIL SEDANOS,1387179,Feb
2025-02-07,Sedanos Supermarkets #29,Invoice,008-04838,Arroz Envasado:Parboiled 1kg Bolsa Dos Hermanos.,.,1.0,19.9,19.9,3901994.46999999,Branded Rice,Keila Alfaro-Visvikis,RETAIL SEDANOS,1387180,Feb
2025-02-07,Sedanos Supermarkets #29,Invoice,008-04838,Arroz Envasado:Largo Fino 1kg (Long grain rice) Dos Hermanos,,1.0,17.5,17.5,3902011.96999999,Branded Rice,Keila Alfaro-Visvikis,RETAIL SEDANOS,1387181,Feb
2025-02-07,Sedanos Supermarkets #29,Invoice,008-04838,Arroz Envasado:Parboiled 5KG Dos Hermanos.,6  11lbs,10.0,40.5,405.0,3902416.96999999,Branded Rice,Keila Alfaro-Visvikis,RETAIL SEDANOS,1387182,Feb
2025-02-07,Sedanos Supermarkets #29,Invoice,008-04838,,Discount,,,-8.85,3902408.11999999,,Keila Alfaro-Visvikis,RETAIL SEDANOS,1387183,Feb
2025-02-07,Sedanos Supermarkets  #37,Credit Memo,008-04839,Varios:Producto vencido/deteriorado (no impacta en inventario),33 unidades x 1.99,-33.0,1.49,-49.17,3902358.94999999,Puffed Products,Keila Alfaro-Visvikis,RETAIL SEDANOS,1387184,Feb
2025-02-07,Food-Star Supermarket,Credit Memo,008-04853,Varios:Promotional Allowance,Arroz Envasado:Largo Fino 1kg (Long grain rice) Dos Hermanos,-2.0,18.0,-36.0,3902322.94999999,Branded Rice,Lisset Limpio -020,RETAIL  DSD,1387185,Feb
2025-02-07,Sedanos Supermarkets #29,Credit Memo,008-04854,Varios:Promotional Allowance,Arroz Envasado:Parboiled 5KG Dos Hermanos.,-10.0,40.5,-405.0,3901917.94999999,Branded Rice,Keila Alfaro-Visvikis,RETAIL SEDANOS,1387186,Feb
2025-02-07,El Palacio de Los Jugos / Casa mía Food Restaurant inc,Credit Memo,008-04855,Varios:Promotional Allowance,Arroz a Granel:Parboiled 50 LB -Bolsa Dos Hermanos.,-1.0,27.75,-27.75,3901890.19999999,Bulk Rice,Lisset Limpio -020,Cafeteria,1387187,Feb
2025-02-07,Panda Depot,Credit Memo,008-04868,Varios:Producto vencido/deteriorado (no impacta en inventario),5,-5.0,25.0,-125.0,3901765.19999999,Bulk Rice,Lisset Limpio -020,WHOLESALER,1387188,Feb
2025-02-10,Be Your Will LLC,Invoice,008-04840,Liquids:AS Cooking Wine,4 1 Gl.,2.0,17.5,35.0,3901800.19999999,American Spice,Lisset Limpio -020,CAFETERIA y RESTAURANTS,1387189,Feb
2025-02-10,Be Your Will LLC,Invoice,008-04840,Arroz a Granel:Largo Fino 50 LB -Bolsa Dos Hermanos.,,7.0,27.85,194.95,3901995.14999999,Bulk Rice,Lisset Limpio -020,CAFETERIA y RESTAURANTS,1387190,Feb
2025-02-10,Be Your Will LLC,Invoice,008-04840,Arroz a Granel:Parboiled 50 LB -Bolsa Dos Hermanos.,,11.0,27.75,305.25,3902300.39999999,Bulk Rice,Lisset Limpio -020,CAFETERIA y RESTAURANTS,1387191,Feb
2025-02-10,Be Your Will LLC,Invoice,008-04840,Arroz a Granel:Parboiled 50 LB -Bolsa Dos Hermanos.,,1.0,27.75,27.75,3902328.14999999,Bulk Rice,Lisset Limpio -020,CAFETERIA y RESTAURANTS,1387192,Feb
2025-02-10,El Palacio de los jugos /  Nanos Latin Foods,Invoice,008-04841,Arroz a Granel:Largo Fino 50 LB -Bolsa Dos Hermanos.,,8.0,27.85,222.8,3902550.94999999,Bulk Rice,Lisset Limpio -020,Cafeteria,1387193,Feb
2025-02-10,El Palacio de los jugos /  Nanos Latin Foods,Invoice,008-04841,Arroz a Granel:Parboiled 50 LB -Bolsa Dos Hermanos.,,8.0,26.75,214.0,3902764.94999999,Bulk Rice,Lisset Limpio -020,Cafeteria,1387194,Feb
2025-02-10,El Palacio de los jugos /  Nanos Latin Foods,Invoice,008-04841,,Discount,,,-0.8,3902764.14999999,,Lisset Limpio -020,Cafeteria,1387195,Feb
2025-02-10,El Palacio de los jugos / Rodriguez Foods,Invoice,008-04842,Arroz a Granel:Parboiled 50 LB -Bolsa Dos Hermanos.,,5.0,26.75,133.75,3902897.89999999,Bulk Rice,Lisset Limpio -020,Cafeteria,1387196,Feb
2025-02-10,El Palacio de los jugos /  EMMA FOOD CORP,Invoice,008-04843,Arroz a Granel:Largo Fino 50 LB -Bolsa Dos Hermanos.,,5.0,27.85,139.25,3903037.14999999,Bulk Rice,Lisset Limpio -020,Cafeteria,1387197,Feb
2025-02-10,El Palacio de los jugos / Delicias Criollas (DIAGO FOOD_MILLER),Invoice,008-04844,Arroz a Granel:Parboiled 50 LB -Bolsa Dos Hermanos.,,11.0,27.75,305.25,3903342.39999999,Bulk Rice,Lisset Limpio -020,Cafeteria,1387198,Feb
2025-02-10,El Palacio de los jugos / Delicias Criollas (DIAGO FOOD_MILLER),Invoice,008-04844,Dry Beans:Dry Beans - Black Beans 50,Dry Black Beans 50 lb,1.0,45.7,45.7,3903388.09999999,Dry Beans,Lisset Limpio -020,Cafeteria,1387199,Feb
2025-02-10,El Palacio de los jugos / Delicias Criollas (DIAGO FOOD_MILLER),Invoice,008-04844,Arroz a Granel:Parboiled 50 LB -Bolsa Dos Hermanos.,,1.0,27.75,27.75,3903415.84999999,Bulk Rice,Lisset Limpio -020,Cafeteria,1387200,Feb
2025-02-10,El Palacio de los jugos / Lita Foods Inc.,Invoice,008-04845,Dry Beans:Dry Beans - Black Beans 50,Dry Black Beans 50 lb,1.0,45.7,45.7,3903461.54999999,Dry Beans,Lisset Limpio -020,Cafeteria,1387201,Feb
2025-02-10,El Palacio de los jugos / Lita Foods Inc.,Invoice,008-04845,Arroz a Granel:Parboiled 50 LB -Bolsa Dos Hermanos.,,11.0,27.75,305.25,3903766.79999999,Bulk Rice,Lisset Limpio -020,Cafeteria,1387202,Feb
2025-02-10,El Palacio de los jugos / Lita Foods Inc.,Invoice,008-04845,Arroz a Granel:Parboiled 50 LB -Bolsa Dos Hermanos.,,1.0,27.75,27.75,3903794.54999999,Bulk Rice,Lisset Limpio -020,Cafeteria,1387203,Feb
2025-02-10,El Palacio de los jugos / La sabrosa salsa cubana Corp,Invoice,008-04846,Arroz a Granel:Largo Fino 50 LB -Bolsa Dos Hermanos.,,6.0,27.85,167.1,3903961.64999999,Bulk Rice,Lisset Limpio -020,Cafeteria,1387204,Feb
2025-02-10,Sedanos Supermarkets #14,Invoice,008-04847,Arroz a Granel:Parboiled 50 LB -Bolsa Dos Hermanos.,,2.0,28.25,56.5,3904018.14999999,Bulk Rice,Keila Alfaro-Visvikis,RETAIL SEDANOS,1387205,Feb
2025-02-10,Sedanos Supermarkets #14,Invoice,008-04847,,Discount,,,-1.13,3904017.01999999,,Keila Alfaro-Visvikis,RETAIL SEDANOS,1387206,Feb
2025-02-10,JMN Dely Corp,Invoice,008-04848,Dry Beans:Dry Beans - Black Beans 50,Dry Black Beans 50 lb,1.0,45.7,45.7,3904062.71999999,Dry Beans,Keila Alfaro-Visvikis,CAFETERIA y RESTAURANTS,1387207,Feb
2025-02-10,JMN Dely Corp,Invoice,008-04848,Arroz a Granel:Largo Fino 50 LB -Bolsa Dos Hermanos.,,2.0,27.85,55.7,3904118.41999999,Bulk Rice,Keila Alfaro-Visvikis,CAFETERIA y RESTAURANTS,1387208,Feb
2025-02-10,JMN Dely Corp,Invoice,008-04848,Arroz a Granel:Parboiled 50 LB -Bolsa Dos Hermanos.,,2.0,28.25,56.5,3904174.91999999,Bulk Rice,Keila Alfaro-Visvikis,CAFETERIA y RESTAURANTS,1387209,Feb
2025-02-10,Sedanos Supermarkets #14,Invoice,008-04849,Arroz Envasado:Parboiled 5KG Dos Hermanos.,6  11lbs,5.0,40.5,202.5,3904377.41999999,Branded Rice,Keila Alfaro-Visvikis,RETAIL SEDANOS,1387210,Feb
2025-02-10,Sedanos Supermarkets #14,Invoice,008-04849,Arroz Envasado:Parboiled 5KG Dos Hermanos.,6  11lbs,5.0,40.5,202.5,3904579.91999999,Branded Rice,Keila Alfaro-Visvikis,RETAIL SEDANOS,1387211,Feb
2025-02-10,Sedanos Supermarkets #14,Invoice,008-04849,,Discount,,,-4.05,3904575.86999999,,Keila Alfaro-Visvikis,RETAIL SEDANOS,1387212,Feb
2025-02-10,Bay supermarket,Invoice,008-04850,Arroz Envasado:Largo Fino 1kg (Long grain rice) Dos Hermanos,,5.0,18.0,90.0,3904665.86999999,Branded Rice,Keila Alfaro-Visvikis,RETAIL  DSD,1387213,Feb
2025-02-10,Bay supermarket,Invoice,008-04850,Arroz Envasado:Parboiled 5KG Dos Hermanos.,6 / 11lbs,2.0,46.5,93.0,3904758.86999999,Branded Rice,Keila Alfaro-Visvikis,RETAIL  DSD,1387214,Feb
2025-02-10,Bay supermarket,Invoice,008-04850,Arroz Envasado:Parboiled 5KG Dos Hermanos.,6  11lbs,2.0,46.5,93.0,3904851.86999999,Branded Rice,Keila Alfaro-Visvikis,RETAIL  DSD,1387215,Feb
2025-02-10,Bay supermarket,Invoice,008-04850,Arroz Envasado:Largo Fino 1kg (Long grain rice) Dos Hermanos,,1.0,18.0,18.0,3904869.86999999,Branded Rice,Keila Alfaro-Visvikis,RETAIL  DSD,1387216,Feb
2025-02-10,Sabor Tropical Supermarket #7,Invoice,008-04851,Arroz Envasado:Parboiled 5KG Dos Hermanos.,6 / 11lbs,5.0,46.5,232.5,3905102.36999999,Branded Rice,Keila Alfaro-Visvikis,RETAIL  DSD,1387217,Feb
2025-02-10,Sabor Tropical Supermarket #7,Invoice,008-04851,Arroz Envasado:Largo Fino 1kg (Long grain rice) Dos Hermanos,,2.0,18.0,36.0,3905138.36999999,Branded Rice,Keila Alfaro-Visvikis,RETAIL  DSD,1387218,Feb
2025-02-10,Sabor Tropical Supermarket #7,Invoice,008-04851,Arroz Envasado:Parboiled 5KG Dos Hermanos.,6  11lbs,5.0,46.5,232.5,3905370.86999999,Branded Rice,Keila Alfaro-Visvikis,RETAIL  DSD,1387219,Feb
2025-02-10,Sabor Tropical Supermarket #7,Invoice,008-04851,Arroz Envasado:Largo Fino 1kg (Long grain rice) Dos Hermanos,,1.0,18.0,18.0,3905388.86999999,Branded Rice,Keila Alfaro-Visvikis,RETAIL  DSD,1387220,Feb
2025-02-10,Price Choice 5 YNTO Food Corp.,Invoice,008-04852,Arroz Envasado:Largo Fino 1kg (Long grain rice) Dos Hermanos,,1.0,18.0,18.0,3905406.86999999,Branded Rice,Keila Alfaro-Visvikis,RETAIL  DSD,1387221,Feb
2025-02-10,Price Choice 5 YNTO Food Corp.,Invoice,008-04852,Arroz Envasado:Parboiled 1kg Bolsa Dos Hermanos.,.,1.0,18.0,18.0,3905424.86999999,Branded Rice,Keila Alfaro-Visvikis,RETAIL  DSD,1387222,Feb
2025-02-10,Price Choice 5 YNTO Food Corp.,Credit Memo,008-04861,Varios:Promotional Allowance,Arroz Envasado:Parboiled 1kg Bolsa Dos Hermanos.,-1.0,18.0,-18.0,3905406.86999999,Branded Rice,Keila Alfaro-Visvikis,RETAIL  DSD,1387223,Feb
2025-02-10,El Palacio de los jugos / Delicias Criollas (DIAGO FOOD_MILLER),Credit Memo,008-04862,Varios:Promotional Allowance,Arroz a Granel:Parboiled 50 LB -Bolsa Dos Hermanos.,-1.0,27.75,-27.75,3905379.11999999,Bulk Rice,Lisset Limpio -020,Cafeteria,1387224,Feb
2025-02-10,Sabor Tropical Supermarket #7,Credit Memo,008-04863,Varios:Promotional Allowance,Arroz Envasado:Parboiled 5KG Dos Hermanos.,-5.0,46.5,-232.5,3905146.61999999,Branded Rice,Keila Alfaro-Visvikis,RETAIL  DSD,1387225,Feb
2025-02-10,Sabor Tropical Supermarket #7,Credit Memo,008-04863,Varios:Promotional Allowance,Arroz Envasado:Largo Fino 1kg (Long grain rice) Dos Hermanos,-1.0,18.0,-18.0,3905128.61999999,Branded Rice,Keila Alfaro-Visvikis,RETAIL  DSD,1387226,Feb
2025-02-10,El Palacio de los jugos / Lita Foods Inc.,Credit Memo,008-04864,Varios:Promotional Allowance,Arroz a Granel:Parboiled 50 LB -Bolsa Dos Hermanos.,-1.0,27.75,-27.75,3905100.86999999,Bulk Rice,Lisset Limpio -020,Cafeteria,1387227,Feb
2025-02-10,Bay supermarket,Credit Memo,008-04865,Varios:Promotional Allowance,Arroz Envasado:Parboiled 5KG Dos Hermanos.,-2.0,46.5,-93.0,3905007.86999999,Branded Rice,Keila Alfaro-Visvikis,RETAIL  DSD,1387228,Feb
2025-02-10,Bay supermarket,Credit Memo,008-04865,Varios:Promotional Allowance,Arroz Envasado:Largo Fino 1kg (Long grain rice) Dos Hermanos,-1.0,18.0,-18.0,3904989.86999999,Branded Rice,Keila Alfaro-Visvikis,RETAIL  DSD,1387229,Feb
2025-02-10,Sedanos Supermarkets #14,Credit Memo,008-04866,Varios:Promotional Allowance,Arroz Envasado:Parboiled 5KG Dos Hermanos.,-5.0,40.5,-202.5,3904787.36999999,Branded Rice,Keila Alfaro-Visvikis,RETAIL SEDANOS,1387230,Feb
2025-02-10,Be Your Will LLC,Credit Memo,008-04867,Varios:Promotional Allowance,Arroz a Granel:Parboiled 50 LB -Bolsa Dos Hermanos.,-1.0,27.75,-27.75,3904759.61999999,Bulk Rice,Lisset Limpio -020,CAFETERIA y RESTAURANTS,1387231,Feb
2025-02-12,Ideal Food Basket Davie Cafeteria,Invoice,008-04869,Arroz a Granel:Largo Fino 50 LB -Bolsa Dos Hermanos.,,8.0,27.85,222.8,3904982.41999999,Bulk Rice,Keila Alfaro-Visvikis,CAFETERIA y RESTAURANTS,1387232,Feb
2025-02-12,Sedanos Supermarkets #16,Invoice,008-04870,Arroz a Granel:Parboiled 50 LB -Bolsa Dos Hermanos.,,5.0,28.25,141.25,3905123.66999999,Bulk Rice,Keila Alfaro-Visvikis,RETAIL SEDANOS,1387233,Feb
2025-02-12,Sedanos Supermarkets #16,Invoice,008-04870,,Discount,,,-2.83,3905120.83999999,,Keila Alfaro-Visvikis,RETAIL SEDANOS,1387234,Feb
2025-02-12,Sedanos Supermarkets #24,Invoice,008-04871,Arroz a Granel:Parboiled 50 LB -Bolsa Dos Hermanos.,,6.0,28.25,169.5,3905290.33999999,Bulk Rice,Keila Alfaro-Visvikis,RETAIL SEDANOS,1387235,Feb
2025-02-12,Sedanos Supermarkets #24,Invoice,008-04871,,Discount,,,-3.39,3905286.94999999,,Keila Alfaro-Visvikis,RETAIL SEDANOS,1387236,Feb
2025-02-12,Seabra Foods / A&J Supermarkets,Invoice,008-04872,Arroz Envasado:Largo Fino 1kg (Long grain rice) Dos Hermanos,,2.0,18.0,36.0,3905322.94999999,Branded Rice,Keila Alfaro-Visvikis,RETAIL  DSD,1387237,Feb
2025-02-12,Seabra Foods / A&J Supermarkets,Invoice,008-04872,Arroz Envasado:Parboiled 1kg Bolsa Dos Hermanos.,.,3.0,19.9,59.7,3905382.64999999,Branded Rice,Keila Alfaro-Visvikis,RETAIL  DSD,1387238,Feb
2025-02-12,Seabra Foods / A&J Supermarkets,Invoice,008-04872,Arroz Envasado:Largo Fino 1kg (Long grain rice) Dos Hermanos,,1.0,18.0,18.0,3905400.64999999,Branded Rice,Keila Alfaro-Visvikis,RETAIL  DSD,1387239,Feb
2025-02-12,Key Foods - 10301 Royal Palm Food Corp.,Invoice,008-04873,Arroz Envasado:Largo Fino 1kg (Long grain rice) Dos Hermanos,,50.0,18.0,900.0,3906300.64999999,Branded Rice,Keila Alfaro-Visvikis,RETAIL KEY FOOD,1387240,Feb
2025-02-12,Key Foods - 10301 Royal Palm Food Corp.,Invoice,008-04873,Arroz Envasado:Parboiled 1kg Bolsa Dos Hermanos.,.,20.0,19.9,398.0,3906698.64999999,Branded Rice,Keila Alfaro-Visvikis,RETAIL KEY FOOD,1387241,Feb
2025-02-12,Key Foods - 10301 Royal Palm Food Corp.,Invoice,008-04873,Arroz Envasado:Parboiled 5KG Dos Hermanos.,6  11lbs,20.0,46.5,930.0,3907628.64999999,Branded Rice,Keila Alfaro-Visvikis,RETAIL KEY FOOD,1387242,Feb
2025-02-12,Key Foods - 10301 Royal Palm Food Corp.,Invoice,008-04873,Arroz Envasado:Parboiled 5KG Dos Hermanos.,6  11lbs,20.0,46.5,930.0,3908558.64999999,Branded Rice,Keila Alfaro-Visvikis,RETAIL KEY FOOD,1387243,Feb
2025-02-12,Key Foods - 10301 Royal Palm Food Corp.,Invoice,008-04873,Arroz Envasado:Largo Fino 1kg (Long grain rice) Dos Hermanos,,10.0,18.0,180.0,3908738.64999999,Branded Rice,Keila Alfaro-Visvikis,RETAIL KEY FOOD,1387244,Feb
2025-02-12,Key Foods - 10301 Royal Palm Food Corp.,Invoice,008-04873,Arroz Envasado:Parboiled 1kg Bolsa Dos Hermanos.,.,4.0,19.9,79.6,3908818.24999999,Branded Rice,Keila Alfaro-Visvikis,RETAIL KEY FOOD,1387245,Feb
2025-02-12,Bravo 5851 Lake Worth Road,Invoice,008-04874,Arroz Envasado:Largo Fino 1kg (Long grain rice) Dos Hermanos,,5.0,18.0,90.0,3908908.24999999,Branded Rice,Keila Alfaro-Visvikis,RETAIL  DSD,1387246,Feb
2025-02-12,Bravo 5851 Lake Worth Road,Invoice,008-04874,Arroz Envasado:Parboiled 5KG Dos Hermanos.,6 / 11lbs,20.0,46.5,930.0,3909838.24999999,Branded Rice,Keila Alfaro-Visvikis,RETAIL  DSD,1387247,Feb
2025-02-12,Bravo 5851 Lake Worth Road,Invoice,008-04874,Arroz Envasado:Largo Fino 1kg (Long grain rice) Dos Hermanos,,1.0,18.0,18.0,3909856.24999999,Branded Rice,Keila Alfaro-Visvikis,RETAIL  DSD,1387248,Feb
2025-02-12,Bravo 5851 Lake Worth Road,Invoice,008-04874,Arroz Envasado:Parboiled 5KG Dos Hermanos.,6  11lbs,20.0,46.5,930.0,3910786.24999999,Branded Rice,Keila Alfaro-Visvikis,RETAIL  DSD,1387249,Feb
2025-02-12,Los Caringas Latin America  Foods,Invoice,008-04875,Arroz a Granel:Largo Fino 50 LB -Bolsa Dos Hermanos.,,3.0,27.85,83.55,3910869.79999999,Bulk Rice,Lisset Limpio -020,CAFETERIA y RESTAURANTS,1387250,Feb
2025-02-12,Los Caringas Latin America  Foods,Invoice,008-04875,Arroz a Granel:Parboiled 50 LB -Bolsa Dos Hermanos.,,3.0,28.25,84.75,3910954.54999999,Bulk Rice,Lisset Limpio -020,CAFETERIA y RESTAURANTS,1387251,Feb
2025-02-12,Pacifico Chinese Restaurant,Invoice,008-04876,Arroz a Granel:Parboiled 50 LB -Bolsa Dos Hermanos.,,10.0,28.25,282.5,3911237.04999999,Bulk Rice,Lisset Limpio -020,CAFETERIA y RESTAURANTS,1387252,Feb
2025-02-13,Sedanos Supermarkets #31,Invoice,008-04877,Arroz a Granel:Parboiled 50 LB -Bolsa Dos Hermanos.,,4.0,28.25,113.0,3911350.04999999,Bulk Rice,Keila Alfaro-Visvikis,RETAIL SEDANOS,1387253,Feb
2025-02-13,Sedanos Supermarkets #31,Invoice,008-04877,,Discount,,,-2.26,3911347.78999999,,Keila Alfaro-Visvikis,RETAIL SEDANOS,1387254,Feb
2025-02-13,Brito Family Corp.,Invoice,008-04878,Arroz a Granel:Largo Fino 50 LB -Bolsa Dos Hermanos.,,55.0,25.0,1375.0,3912722.78999999,Bulk Rice,Lisset Limpio -020,CAFETERIA y RESTAURANTS,1387255,Feb
2025-02-13,Brito Family Corp.,Invoice,008-04878,Arroz a Granel:Parboiled 50 LB -Bolsa Dos Hermanos.,,55.0,24.5,1347.5,3914070.28999999,Bulk Rice,Lisset Limpio -020,CAFETERIA y RESTAURANTS,1387256,Feb
2025-02-13,Bravo   Francisco Diaz,Invoice,008-04879,Liquids:AS Cooking Wine,4 1 Gl.,4.0,17.5,70.0,3914140.28999999,American Spice,Lisset Limpio -020,RETAIL  DSD,1387257,Feb
2025-02-13,Bravo   Francisco Diaz,Invoice,008-04879,Arroz a Granel:Largo Fino 50 LB -Bolsa Dos Hermanos.,,5.0,27.85,139.25,3914279.53999999,Bulk Rice,Lisset Limpio -020,RETAIL  DSD,1387258,Feb
2025-02-13,Bravo   Francisco Diaz,Invoice,008-04879,Liquids:AS White Vinegar,4/1 Gl.,2.0,10.0,20.0,3914299.53999999,American Spice,Lisset Limpio -020,RETAIL  DSD,1387259,Feb
2025-02-13,Bravo   Francisco Diaz,Invoice,008-04879,Liquids:AS Marinating Sauce (Mojo),,4.0,18.5,74.0,3914373.53999999,American Spice,Lisset Limpio -020,RETAIL  DSD,1387260,Feb
2025-02-13,Bravo   Francisco Diaz,Invoice,008-04879,Spices:AS Sazon (for all),1 / 30 lb (box or pail),1.0,59.0,59.0,3914432.53999999,American Spice,Lisset Limpio -020,RETAIL  DSD,1387261,Feb
2025-02-13,"El Toro Loco Meat Distribution, LLC",Invoice,008-04880,Arroz a Granel:Largo Fino 50 LB -Bolsa Dos Hermanos.,,55.0,27.85,1531.75,3915964.28999999,Bulk Rice,Lisset Limpio -020,CAFETERIA y RESTAURANTS,1387262,Feb
2025-02-13,"El Toro Loco Meat Distribution, LLC",Invoice,008-04880,Dry Beans:Dry Beans - Black Beans 50,Dry Black Beans 50 lb,25.0,38.0,950.0,3916914.28999999,Dry Beans,Lisset Limpio -020,CAFETERIA y RESTAURANTS,1387263,Feb
2025-02-13,El Palacio de los jugos /  Nanos Latin Foods,Invoice,008-04881,Arroz a Granel:Parboiled 50 LB -Bolsa Dos Hermanos.,,8.0,28.25,226.0,3917140.28999999,Bulk Rice,Lisset Limpio -020,Cafeteria,1387264,Feb
2025-02-13,El Palacio de Los Jugos / Casa mía Food Restaurant inc,Invoice,008-04882,Arroz a Granel:Parboiled 50 LB -Bolsa Dos Hermanos.,,11.0,27.75,305.25,3917445.53999999,Bulk Rice,Lisset Limpio -020,Cafeteria,1387265,Feb
2025-02-13,El Palacio de Los Jugos / Casa mía Food Restaurant inc,Invoice,008-04882,Dry Beans:Dry Beans - Black Beans 50,Dry Black Beans 50 lb,1.0,45.7,45.7,3917491.23999999,Dry Beans,Lisset Limpio -020,Cafeteria,1387266,Feb
2025-02-13,El Palacio de Los Jugos / Casa mía Food Restaurant inc,Invoice,008-04882,Arroz a Granel:Parboiled 50 LB -Bolsa Dos Hermanos.,,1.0,27.75,27.75,3917518.98999999,Bulk Rice,Lisset Limpio -020,Cafeteria,1387267,Feb
2025-02-13,Extra Supermarket,Invoice,008-04883,Arroz Envasado:Largo Fino 1kg (Long grain rice) Dos Hermanos,,2.0,18.0,36.0,3917554.98999999,Branded Rice,Keila Alfaro-Visvikis,RETAIL  DSD,1387268,Feb
2025-02-13,Extra Supermarket,Invoice,008-04883,Arroz Envasado:Parboiled 1kg Bolsa Dos Hermanos.,.,3.0,19.9,59.7,3917614.68999999,Branded Rice,Keila Alfaro-Visvikis,RETAIL  DSD,1387269,Feb
2025-02-13,Extra Supermarket,Invoice,008-04883,Arroz Envasado:Parboiled 5KG Dos Hermanos.,6  11lbs,5.0,46.5,232.5,3917847.18999999,Branded Rice,Keila Alfaro-Visvikis,RETAIL  DSD,1387270,Feb
2025-02-13,Extra Supermarket,Invoice,008-04883,Arroz Envasado:Parboiled 5KG Dos Hermanos.,6  11lbs,5.0,46.5,232.5,3918079.68999999,Branded Rice,Keila Alfaro-Visvikis,RETAIL  DSD,1387271,Feb
2025-02-13,Extra Supermarket,Invoice,008-04883,Arroz Envasado:Largo Fino 1kg (Long grain rice) Dos Hermanos,,1.0,18.0,18.0,3918097.68999999,Branded Rice,Keila Alfaro-Visvikis,RETAIL  DSD,1387272,Feb
2025-02-13,Sedanos Supermarkets #33,Invoice,008-04884,Arroz a Granel:Parboiled 50 LB -Bolsa Dos Hermanos.,,6.0,28.25,169.5,3918267.18999999,Bulk Rice,Keila Alfaro-Visvikis,RETAIL SEDANOS,1387273,Feb
2025-02-13,Sedanos Supermarkets #33,Invoice,008-04884,,Discount,,,-3.39,3918263.79999999,,Keila Alfaro-Visvikis,RETAIL SEDANOS,1387274,Feb
2025-02-13,Sedanos Supermarkets #26,Invoice,008-04885,Arroz a Granel:Parboiled 50 LB -Bolsa Dos Hermanos.,,3.0,28.25,84.75,3918348.54999999,Bulk Rice,Keila Alfaro-Visvikis,RETAIL SEDANOS,1387275,Feb
2025-02-13,Sedanos Supermarkets #26,Invoice,008-04885,,Discount,,,-1.7,3918346.84999999,,Keila Alfaro-Visvikis,RETAIL SEDANOS,1387276,Feb
2025-02-13,Sedanos Supermarkets #22,Invoice,008-04886,Arroz a Granel:Parboiled 50 LB -Bolsa Dos Hermanos.,,2.0,28.25,56.5,3918403.34999999,Bulk Rice,Keila Alfaro-Visvikis,RETAIL SEDANOS,1387277,Feb
2025-02-13,Sedanos Supermarkets #22,Invoice,008-04886,Spices:AS Chicken Base,1 / 30 lb. (box or pail),2.0,39.0,78.0,3918481.34999999,American Spice,Keila Alfaro-Visvikis,RETAIL SEDANOS,1387278,Feb
2025-02-13,Sedanos Supermarkets #22,Invoice,008-04886,,Discount,,,-2.69,3918478.65999999,,Keila Alfaro-Visvikis,RETAIL SEDANOS,1387279,Feb
2025-02-13,Aries Supermarket & Cafeteria,Invoice,008-04887,Arroz a Granel:Parboiled 50 LB -Bolsa Dos Hermanos.,,7.0,28.25,197.75,3918676.40999999,Bulk Rice,Keila Alfaro-Visvikis,CAFETERIA y RESTAURANTS,1387280,Feb
2025-02-13,Aries Supermarket & Cafeteria,Invoice,008-04887,Dry Beans:Dry Beans - Black Beans 50,Dry Black Beans 50 lb,5.0,36.5,182.5,3918858.90999999,Dry Beans,Keila Alfaro-Visvikis,CAFETERIA y RESTAURANTS,1387281,Feb
2025-02-13,Aries Supermarket & Cafeteria,Invoice,008-04887,Spices:AS Chicken Base,1 / 30 lb. (box or pail),8.0,39.0,312.0,3919170.90999999,American Spice,Keila Alfaro-Visvikis,CAFETERIA y RESTAURANTS,1387282,Feb
2025-02-13,Fritanga Momotombo,Invoice,008-04888,Arroz a Granel:Largo Fino 50 LB -Bolsa Dos Hermanos.,,5.0,27.85,139.25,3919310.15999999,Bulk Rice,Lisset Limpio -020,CAFETERIA y RESTAURANTS,1387283,Feb
2025-02-13,Sedanos Supermarkets #32,Invoice,008-04889,Arroz a Granel:Largo Fino 50 LB -Bolsa Dos Hermanos.,,6.0,27.85,167.1,3919477.25999999,Bulk Rice,Keila Alfaro-Visvikis,RETAIL SEDANOS,1387284,Feb
2025-02-13,Sedanos Supermarkets #32,Invoice,008-04889,Arroz a Granel:Parboiled 50 LB -Bolsa Dos Hermanos.,,6.0,28.25,169.5,3919646.75999999,Bulk Rice,Keila Alfaro-Visvikis,RETAIL SEDANOS,1387285,Feb
2025-02-13,Sedanos Supermarkets #32,Invoice,008-04889,,Discount,,,-6.73,3919640.02999999,,Keila Alfaro-Visvikis,RETAIL SEDANOS,1387286,Feb
2025-02-13,"Soriano Brothers Diaz Food Service,Inc",Invoice,008-04890,Dry Beans:Dry Beans - Black Beans 50,Dry Black Beans 50 lb,5.0,38.0,190.0,3919830.02999999,Dry Beans,Lisset Limpio -020,CAFETERIA y RESTAURANTS,1387287,Feb
2025-02-13,"Soriano Brothers Diaz Food Service,Inc",Invoice,008-04890,Arroz a Granel:Parboiled 50 LB -Bolsa Dos Hermanos.,,3.0,27.75,83.25,3919913.27999999,Bulk Rice,Lisset Limpio -020,CAFETERIA y RESTAURANTS,1387288,Feb
2025-02-13,"Soriano Brothers Diaz Food Service,Inc",Invoice,008-04890,Arroz a Granel:Parboiled 50 LB -Bolsa Dos Hermanos.,,33.0,27.75,915.75,3920829.02999999,Bulk Rice,Lisset Limpio -020,CAFETERIA y RESTAURANTS,1387289,Feb
2025-02-13,El Palacio de Los Jugos / Casa mía Food Restaurant inc,Credit Memo,008-04894,Varios:Promotional Allowance,Arroz a Granel:Parboiled 50 LB -Bolsa Dos Hermanos.,-1.0,27.75,-27.75,3920801.27999999,Bulk Rice,Lisset Limpio -020,Cafeteria,1387290,Feb
2025-02-14,Bravo 5851 Lake Worth Road,Credit Memo,008-04891,Varios:Promotional Allowance,Arroz Envasado:Largo Fino 1kg (Long grain rice) Dos Hermanos,-1.0,18.0,-18.0,3920783.27999999,Branded Rice,Keila Alfaro-Visvikis,RETAIL  DSD,1387291,Feb
2025-02-14,Bravo 5851 Lake Worth Road,Credit Memo,008-04891,Varios:Promotional Allowance,Arroz Envasado:Parboiled 5KG Dos Hermanos.,-20.0,46.5,-930.0,3919853.27999999,Branded Rice,Keila Alfaro-Visvikis,RETAIL  DSD,1387292,Feb
2025-02-14,Key Foods - 10301 Royal Palm Food Corp.,Credit Memo,008-04892,Varios:Promotional Allowance,Arroz Envasado:Parboiled 5KG Dos Hermanos.,-20.0,46.5,-930.0,3918923.27999999,Branded Rice,Keila Alfaro-Visvikis,RETAIL KEY FOOD,1387293,Feb
2025-02-14,Key Foods - 10301 Royal Palm Food Corp.,Credit Memo,008-04892,Varios:Promotional Allowance,Arroz Envasado:Largo Fino 1kg (Long grain rice) Dos Hermanos,-10.0,18.0,-180.0,3918743.27999999,Branded Rice,Keila Alfaro-Visvikis,RETAIL KEY FOOD,1387294,Feb
2025-02-14,Key Foods - 10301 Royal Palm Food Corp.,Credit Memo,008-04892,Varios:Promotional Allowance,Arroz Envasado:Parboiled 1kg Bolsa Dos Hermanos.,-4.0,19.9,-79.6,3918663.67999999,Branded Rice,Keila Alfaro-Visvikis,RETAIL KEY FOOD,1387295,Feb
2025-02-14,Seabra Foods / A&J Supermarkets,Credit Memo,008-04893,Varios:Promotional Allowance,Arroz Envasado:Largo Fino 1kg (Long grain rice) Dos Hermanos,-1.0,18.0,-18.0,3918645.67999999,Branded Rice,Keila Alfaro-Visvikis,RETAIL  DSD,1387296,Feb
2025-02-16,El Palacio de Los Jugos / Casa mía Food Restaurant inc,Invoice,008-04895,Dry Beans:Dry Beans - Black Beans 50,Dry Black Beans 50 lb,1.0,45.7,45.7,3918691.37999999,Dry Beans,Lisset Limpio -020,Cafeteria,1387297,Feb
2025-02-16,El Palacio de Los Jugos / Casa mía Food Restaurant inc,Invoice,008-04895,Arroz a Granel:Parboiled 50 LB -Bolsa Dos Hermanos.,,11.0,27.75,305.25,3918996.62999999,Bulk Rice,Lisset Limpio -020,Cafeteria,1387298,Feb
2025-02-16,El Palacio de Los Jugos / Casa mía Food Restaurant inc,Invoice,008-04895,Arroz a Granel:Parboiled 50 LB -Bolsa Dos Hermanos.,,1.0,27.75,27.75,3919024.37999999,Bulk Rice,Lisset Limpio -020,Cafeteria,1387299,Feb
2025-02-16,El Palacio de los jugos /  EMMA FOOD CORP,Invoice,008-04896,Arroz a Granel:Largo Fino 50 LB -Bolsa Dos Hermanos.,,5.0,27.85,139.25,3919163.62999999,Bulk Rice,Lisset Limpio -020,Cafeteria,1387300,Feb
2025-02-16,Hings Chinese,Invoice,008-04897,Arroz a Granel:Parboiled 50 LB -Bolsa Dos Hermanos.,,5.0,28.25,141.25,3919304.87999999,Bulk Rice,Lisset Limpio -020,CAFETERIA y RESTAURANTS,1387301,Feb
2025-02-16,ALS Foods,Invoice,008-04898,Liquids:AS Cooking Wine,4 1 Gl.,2.0,17.5,35.0,3919339.87999999,American Spice,Lisset Limpio -020,CAFETERIA y RESTAURANTS,1387302,Feb
2025-02-16,ALS Foods,Invoice,008-04898,Arroz a Granel:Largo Fino 50 LB -Bolsa Dos Hermanos.,,7.0,27.85,194.95,3919534.82999999,Bulk Rice,Lisset Limpio -020,CAFETERIA y RESTAURANTS,1387303,Feb
2025-02-16,ALS Foods,Invoice,008-04898,Arroz a Granel:Parboiled 50 LB -Bolsa Dos Hermanos.,,11.0,27.75,305.25,3919840.07999999,Bulk Rice,Lisset Limpio -020,CAFETERIA y RESTAURANTS,1387304,Feb
2025-02-16,ALS Foods,Invoice,008-04898,Arroz a Granel:Parboiled 50 LB -Bolsa Dos Hermanos.,,1.0,27.75,27.75,3919867.82999999,Bulk Rice,Lisset Limpio -020,CAFETERIA y RESTAURANTS,1387305,Feb
2025-02-16,El Gallego Supermarket,Invoice,008-04899,Arroz a Granel:Parboiled 50 LB -Bolsa Dos Hermanos.,,5.0,28.25,141.25,3920009.07999999,Bulk Rice,Lisset Limpio -020,RETAIL  DSD,1387306,Feb
2025-02-16,El Gallego Supermarket,Invoice,008-04899,Dry Beans:Dry Beans - Black Beans 50,Dry Black Beans 50 lb,2.0,45.7,91.4,3920100.47999999,Dry Beans,Lisset Limpio -020,RETAIL  DSD,1387307,Feb
2025-02-16,El Palacio de los jugos / Delicias Criollas (DIAGO FOOD_MILLER),Invoice,008-04900,Liquids:AS Marinating Sauce (Mojo),,1.0,18.5,18.5,3920118.97999999,American Spice,Lisset Limpio -020,Cafeteria,1387308,Feb
2025-02-16,El Palacio de los jugos / Delicias Criollas (DIAGO FOOD_MILLER),Invoice,008-04900,Arroz a Granel:Parboiled 50 LB -Bolsa Dos Hermanos.,,11.0,27.75,305.25,3920424.22999999,Bulk Rice,Lisset Limpio -020,Cafeteria,1387309,Feb
2025-02-16,El Palacio de los jugos / Delicias Criollas (DIAGO FOOD_MILLER),Invoice,008-04900,Arroz a Granel:Parboiled 50 LB -Bolsa Dos Hermanos.,,1.0,27.75,27.75,3920451.97999999,Bulk Rice,Lisset Limpio -020,Cafeteria,1387310,Feb
2025-02-16,El Palacio de los jugos / Lita Foods Inc.,Invoice,008-04901,Dry Beans:Dry Beans - Black Beans 50,Dry Black Beans 50 lb,1.0,45.7,45.7,3920497.67999999,Dry Beans,Lisset Limpio -020,Cafeteria,1387311,Feb
2025-02-16,El Palacio de los jugos / Lita Foods Inc.,Invoice,008-04901,Arroz a Granel:Parboiled 50 LB -Bolsa Dos Hermanos.,,11.0,27.75,305.25,3920802.92999999,Bulk Rice,Lisset Limpio -020,Cafeteria,1387312,Feb
2025-02-16,El Palacio de los jugos / Lita Foods Inc.,Invoice,008-04901,Arroz a Granel:Parboiled 50 LB -Bolsa Dos Hermanos.,,1.0,27.75,27.75,3920830.67999999,Bulk Rice,Lisset Limpio -020,Cafeteria,1387313,Feb
2025-02-16,VIÑA & SONS FOOD DIST.CORP,Invoice,008-04902,Arroz Envasado:Parboiled 5KG Dos Hermanos.,6  11lbs,5.0,46.5,232.5,3921063.17999999,Branded Rice,Keila Alfaro-Visvikis,CAFETERIA y RESTAURANTS,1387314,Feb
2025-02-16,VIÑA & SONS FOOD DIST.CORP,Invoice,008-04902,Arroz a Granel:Parboiled 50 LB -Bolsa Dos Hermanos.,,5.0,27.75,138.75,3921201.92999999,Bulk Rice,Keila Alfaro-Visvikis,CAFETERIA y RESTAURANTS,1387315,Feb
2025-02-16,VIÑA & SONS FOOD DIST.CORP,Invoice,008-04902,Arroz Envasado:Parboiled 5KG Dos Hermanos.,6  11lbs,5.0,46.5,232.5,3921434.42999999,Branded Rice,Keila Alfaro-Visvikis,CAFETERIA y RESTAURANTS,1387316,Feb
2025-02-16,Festival Supermarket #1,Invoice,008-04903,Arroz Envasado:Parboiled 5KG Dos Hermanos.,6  11lbs,10.0,46.5,465.0,3921899.42999999,Branded Rice,Keila Alfaro-Visvikis,RETAIL  DSD,1387317,Feb
2025-02-16,Festival Supermarket #1,Invoice,008-04903,Arroz Envasado:Parboiled 1kg Bolsa Dos Hermanos.,.,1.0,19.9,19.9,3921919.32999999,Branded Rice,Keila Alfaro-Visvikis,RETAIL  DSD,1387318,Feb
2025-02-16,Festival Supermarket #1,Invoice,008-04903,Arroz Envasado:Largo Fino 1kg (Long grain rice) Dos Hermanos,,1.0,18.0,18.0,3921937.32999999,Branded Rice,Keila Alfaro-Visvikis,RETAIL  DSD,1387319,Feb
2025-02-16,Festival Supermarket #1,Invoice,008-04903,Arroz Envasado:Parboiled 5KG Dos Hermanos.,6  11lbs,10.0,46.5,465.0,3922402.32999999,Branded Rice,Keila Alfaro-Visvikis,RETAIL  DSD,1387320,Feb
2025-02-16,Festival Supermarket #1,Invoice,008-04903,Arroz Envasado:Largo Fino 1kg (Long grain rice) Dos Hermanos,,1.0,18.0,18.0,3922420.32999999,Branded Rice,Keila Alfaro-Visvikis,RETAIL  DSD,1387321,Feb
2025-02-16,VIÑA & SONS FOOD DIST.CORP,Credit Memo,008-04905,Varios:Promotional Allowance,Arroz Envasado:Parboiled 5KG Dos Hermanos.,-5.0,46.5,-232.5,3922187.82999999,Branded Rice,Keila Alfaro-Visvikis,CAFETERIA y RESTAURANTS,1387322,Feb
2025-02-16,El Palacio de los jugos / Lita Foods Inc.,Credit Memo,008-04906,Varios:Promotional Allowance,Arroz a Granel:Parboiled 50 LB -Bolsa Dos Hermanos.,-1.0,27.75,-27.75,3922160.07999999,Bulk Rice,Lisset Limpio -020,Cafeteria,1387323,Feb
2025-02-16,El Palacio de Los Jugos / Casa mía Food Restaurant inc,Credit Memo,008-04907,Varios:Promotional Allowance,Arroz a Granel:Parboiled 50 LB -Bolsa Dos Hermanos.,-1.0,27.75,-27.75,3922132.32999999,Bulk Rice,Lisset Limpio -020,Cafeteria,1387324,Feb
2025-02-16,Festival Supermarket #1,Credit Memo,008-04908,Varios:Promotional Allowance,Arroz Envasado:Parboiled 5KG Dos Hermanos.,-10.0,46.5,-465.0,3921667.32999999,Branded Rice,Keila Alfaro-Visvikis,RETAIL  DSD,1387325,Feb
2025-02-16,Festival Supermarket #1,Credit Memo,008-04908,Varios:Promotional Allowance,Arroz Envasado:Largo Fino 1kg (Long grain rice) Dos Hermanos,-1.0,18.0,-18.0,3921649.32999999,Branded Rice,Keila Alfaro-Visvikis,RETAIL  DSD,1387326,Feb
2025-02-16,ALS Foods,Credit Memo,008-04910,Varios:Promotional Allowance,Arroz a Granel:Parboiled 50 LB -Bolsa Dos Hermanos.,-1.0,27.75,-27.75,3921621.57999999,Bulk Rice,Lisset Limpio -020,CAFETERIA y RESTAURANTS,1387327,Feb
2025-02-16,El Palacio de los jugos / Delicias Criollas (DIAGO FOOD_MILLER),Credit Memo,008-04911,Varios:Promotional Allowance,Arroz a Granel:Parboiled 50 LB -Bolsa Dos Hermanos.,-1.0,27.75,-27.75,3921593.82999999,Bulk Rice,Lisset Limpio -020,Cafeteria,1387328,Feb
2025-02-17,Soriano Brothers PB,Invoice,008-04904,Dry Beans:Dry Beans - Black Beans 50,Dry Black Beans 50 lb,2.0,37.0,74.0,3921667.82999999,Dry Beans,Lisset Limpio -020,CAFETERIA y RESTAURANTS,1387329,Feb
2025-02-17,Soriano Brothers PB,Invoice,008-04904,Dry Beans:Dry Beans - Small Red Beans 50 lbs.,Small Red Beans 50 lbs,1.0,42.0,42.0,3921709.82999999,Dry Beans,Lisset Limpio -020,CAFETERIA y RESTAURANTS,1387330,Feb
2025-02-17,Soriano Brothers PB,Invoice,008-04904,Arroz a Granel:Largo Fino 50 LB -Bolsa Dos Hermanos.,,17.0,27.85,473.45,3922183.27999999,Bulk Rice,Lisset Limpio -020,CAFETERIA y RESTAURANTS,1387331,Feb
2025-02-17,Soriano Brothers PB,Invoice,008-04904,Arroz a Granel:Parboiled 50 LB -Bolsa Dos Hermanos.,,15.0,26.75,401.25,3922584.52999999,Bulk Rice,Lisset Limpio -020,CAFETERIA y RESTAURANTS,1387332,Feb
2025-02-19,Festival Supermarket,Invoice,008-04912,Arroz Envasado:Parboiled 5KG Dos Hermanos.,6  11lbs,15.0,46.5,697.5,3923282.02999999,Branded Rice,Keila Alfaro-Visvikis,RETAIL  DSD,1387333,Feb
2025-02-19,Festival Supermarket,Invoice,008-04912,Arroz Envasado:Parboiled 5KG Dos Hermanos.,6  11lbs,15.0,46.5,697.5,3923979.52999999,Branded Rice,Keila Alfaro-Visvikis,RETAIL  DSD,1387334,Feb
2025-02-19,El Palacio de los jugos /  Nanos Latin Foods,Invoice,008-04913,Arroz a Granel:Largo Fino 50 LB -Bolsa Dos Hermanos.,,10.0,27.85,278.5,3924258.02999999,Bulk Rice,Lisset Limpio -020,Cafeteria,1387335,Feb
2025-02-19,El Palacio de los jugos /  Nanos Latin Foods,Invoice,008-04913,Arroz a Granel:Parboiled 50 LB -Bolsa Dos Hermanos.,,10.0,26.75,267.5,3924525.52999999,Bulk Rice,Lisset Limpio -020,Cafeteria,1387336,Feb
2025-02-19,Sedanos Supermarkets #34,Invoice,008-04914,Arroz Envasado:Parboiled 5KG Dos Hermanos.,6  11lbs,10.0,40.5,405.0,3924930.52999999,Branded Rice,Keila Alfaro-Visvikis,RETAIL SEDANOS,1387337,Feb
2025-02-19,Sedanos Supermarkets #34,Invoice,008-04914,Arroz Envasado:Parboiled 5KG Dos Hermanos.,6  11lbs,10.0,40.5,405.0,3925335.52999999,Branded Rice,Keila Alfaro-Visvikis,RETAIL SEDANOS,1387338,Feb
2025-02-19,Sedanos Supermarkets #34,Invoice,008-04914,,Discount,,,-8.1,3925327.42999999,,Keila Alfaro-Visvikis,RETAIL SEDANOS,1387339,Feb
2025-02-19,Sedanos Supermarkets #24,Invoice,008-04915,Arroz a Granel:Parboiled 50 LB -Bolsa Dos Hermanos.,,6.0,28.25,169.5,3925496.92999999,Bulk Rice,Keila Alfaro-Visvikis,RETAIL SEDANOS,1387340,Feb
2025-02-19,Sedanos Supermarkets #24,Invoice,008-04915,,Discount,,,-3.39,3925493.53999999,,Keila Alfaro-Visvikis,RETAIL SEDANOS,1387341,Feb
2025-02-19,Key Food / Holywood,Invoice,008-04916,Arroz Envasado:Parboiled 1kg Bolsa Dos Hermanos.,.,15.0,19.9,298.5,3925792.03999999,Branded Rice,Keila Alfaro-Visvikis,RETAIL  DSD,1387342,Feb
2025-02-19,Key Food / Holywood,Invoice,008-04916,Arroz Envasado:Parboiled 1kg Bolsa Dos Hermanos.,.,3.0,19.9,59.7,3925851.73999999,Branded Rice,Keila Alfaro-Visvikis,RETAIL  DSD,1387343,Feb
2025-02-19,JMN Dely Corp,Invoice,008-04917,Arroz a Granel:Largo Fino 50 LB -Bolsa Dos Hermanos.,,2.0,27.85,55.7,3925907.43999999,Bulk Rice,Keila Alfaro-Visvikis,CAFETERIA y RESTAURANTS,1387344,Feb
2025-02-19,JMN Dely Corp,Invoice,008-04917,Arroz a Granel:Parboiled 50 LB -Bolsa Dos Hermanos.,,2.0,27.75,55.5,3925962.93999999,Bulk Rice,Keila Alfaro-Visvikis,CAFETERIA y RESTAURANTS,1387345,Feb
2025-02-19,JMN Dely Corp,Invoice,008-04917,Dry Beans:Dry Beans - Black Beans 50,Dry Black Beans 50 lb,1.0,45.7,45.7,3926008.63999999,Dry Beans,Keila Alfaro-Visvikis,CAFETERIA y RESTAURANTS,1387346,Feb
2025-02-19,Ideal Food Basket Davie Cafeteria,Invoice,008-04918,Arroz a Granel:Largo Fino 50 LB -Bolsa Dos Hermanos.,,10.0,27.85,278.5,3926287.13999999,Bulk Rice,Keila Alfaro-Visvikis,CAFETERIA y RESTAURANTS,1387347,Feb
2025-02-19,Sedanos Supermarkets #33,Invoice,008-04919,Arroz Envasado:Largo Fino 1kg (Long grain rice) Dos Hermanos,,0.0,,0.0,3926287.13999999,Branded Rice,Keila Alfaro-Visvikis,RETAIL SEDANOS,1387348,Feb
2025-02-19,El Palacio de los jugos / Leti Corp.,Invoice,008-04920,Arroz a Granel:Largo Fino 50 LB -Bolsa Dos Hermanos.,,5.0,27.85,139.25,3926426.38999999,Bulk Rice,Lisset Limpio -020,Cafeteria,1387349,Feb
2025-02-19,El Palacio de los jugos / Leti Corp.,Invoice,008-04920,Arroz a Granel:Parboiled 50 LB -Bolsa Dos Hermanos.,,8.0,26.75,214.0,3926640.38999999,Bulk Rice,Lisset Limpio -020,Cafeteria,1387350,Feb
2025-02-20,Fritanga Momotombo,Invoice,008-04921,Dry Beans:Dry Beans - Small Red Beans 50 lbs.,Small Red Beans 50 lbs,2.0,42.0,84.0,3926724.38999999,Dry Beans,Lisset Limpio -020,CAFETERIA y RESTAURANTS,1387351,Feb
2025-02-20,Fritanga Momotombo,Invoice,008-04922,Dry Beans:Dry Beans - Small Red Beans 50 lbs.,Small Red Beans 50 lbs,0.0,,0.0,3926724.38999999,Dry Beans,Lisset Limpio -020,CAFETERIA y RESTAURANTS,1387352,Feb
2025-02-20,Mei Chang,Invoice,008-04923,Arroz a Granel:Parboiled 50 LB -Bolsa Dos Hermanos.,,6.0,28.25,169.5,3926893.88999999,Bulk Rice,Lisset Limpio -020,CAFETERIA y RESTAURANTS,1387353,Feb
2025-02-20,El Palacio de los jugos / Lita Foods Inc.,Invoice,008-04924,Dry Beans:Dry Beans - Black Beans 50,Dry Black Beans 50 lb,1.0,45.7,45.7,3926939.58999999,Dry Beans,Lisset Limpio -020,Cafeteria,1387354,Feb
2025-02-20,El Palacio de los jugos / Lita Foods Inc.,Invoice,008-04924,Arroz a Granel:Parboiled 50 LB -Bolsa Dos Hermanos.,,11.0,27.75,305.25,3927244.83999999,Bulk Rice,Lisset Limpio -020,Cafeteria,1387355,Feb
2025-02-20,El Palacio de los jugos / Lita Foods Inc.,Invoice,008-04924,Arroz a Granel:Parboiled 50 LB -Bolsa Dos Hermanos.,,1.0,27.75,27.75,3927272.58999999,Bulk Rice,Lisset Limpio -020,Cafeteria,1387356,Feb
2025-02-20,Sabor Tropical #1 - Supermarket,Invoice,008-04925,Arroz Envasado:Parboiled 5KG Dos Hermanos.,6  11lbs,10.0,46.5,465.0,3927737.58999999,Branded Rice,Keila Alfaro-Visvikis,RETAIL  DSD,1387357,Feb
2025-02-20,Sabor Tropical #1 - Supermarket,Invoice,008-04925,Rice Snack:Rice Snack Ham Flavored DOS HERMANOS,,1.0,19.9,19.9,3927757.48999999,Puffed Products,Keila Alfaro-Visvikis,RETAIL  DSD,1387358,Feb
2025-02-20,Sabor Tropical #1 - Supermarket,Invoice,008-04925,Rice Snack:Rice Snack Salami Flavored DOS HERMANOS,,1.0,19.9,19.9,3927777.38999999,Puffed Products,Keila Alfaro-Visvikis,RETAIL  DSD,1387359,Feb
2025-02-20,Sabor Tropical #1 - Supermarket,Invoice,008-04925,Arroz Envasado:Parboiled 5KG Dos Hermanos.,6  11lbs,10.0,46.5,465.0,3928242.38999999,Branded Rice,Keila Alfaro-Visvikis,RETAIL  DSD,1387360,Feb
2025-02-20,Sabor Tropical #1 - Supermarket,Invoice,008-04925,Rice Snack:Rice Snack Ham Flavored DOS HERMANOS,,1.0,19.9,19.9,3928262.28999999,Puffed Products,Keila Alfaro-Visvikis,RETAIL  DSD,1387361,Feb
2025-02-20,Sedanos Supermarkets #18,Invoice,008-04926,Arroz a Granel:Parboiled 50 LB -Bolsa Dos Hermanos.,,10.0,28.25,282.5,3928544.78999999,Bulk Rice,Keila Alfaro-Visvikis,RETAIL SEDANOS,1387362,Feb
2025-02-20,Sedanos Supermarkets #18,Invoice,008-04926,Spices:AS Chicken Base,1 / 30 lb. (box or pail),1.0,39.0,39.0,3928583.78999999,American Spice,Keila Alfaro-Visvikis,RETAIL SEDANOS,1387363,Feb
2025-02-20,Sedanos Supermarkets #18,Invoice,008-04926,,Discount,,,-6.43,3928577.35999999,,Keila Alfaro-Visvikis,RETAIL SEDANOS,1387364,Feb
2025-02-20,El Palacio de los jugos /  EMMA FOOD CORP,Invoice,008-04927,Arroz a Granel:Largo Fino 50 LB -Bolsa Dos Hermanos.,,5.0,27.85,139.25,3928716.60999999,Bulk Rice,Lisset Limpio -020,Cafeteria,1387365,Feb
2025-02-20,El Palacio de los jugos / Rodriguez Foods,Invoice,008-04928,Arroz a Granel:Parboiled 50 LB -Bolsa Dos Hermanos.,,8.0,26.85,214.8,3928931.40999999,Bulk Rice,Lisset Limpio -020,Cafeteria,1387366,Feb
2025-02-20,Sedanos Supermarkets  #37,Invoice,008-04929,Rice Snack:Rice Snack Ham Flavored DOS HERMANOS,,1.0,19.9,19.9,3928951.30999999,Puffed Products,Keila Alfaro-Visvikis,RETAIL SEDANOS,1387367,Feb
2025-02-20,Sedanos Supermarkets  #37,Invoice,008-04929,Rice Snack:Rice Snack Salami Flavored DOS HERMANOS,,1.0,19.9,19.9,3928971.20999999,Puffed Products,Keila Alfaro-Visvikis,RETAIL SEDANOS,1387368,Feb
2025-02-20,Sedanos Supermarkets  #37,Invoice,008-04929,,Discount,,,-0.8,3928970.40999999,,Keila Alfaro-Visvikis,RETAIL SEDANOS,1387369,Feb
2025-02-20,Sedanos Supermarkets  #37,Invoice,008-04930,Arroz a Granel:Parboiled 50 LB -Bolsa Dos Hermanos.,,5.0,28.25,141.25,3929111.65999999,Bulk Rice,Keila Alfaro-Visvikis,RETAIL SEDANOS,1387370,Feb
2025-02-20,Sedanos Supermarkets  #37,Invoice,008-04930,Arroz a Granel:Largo Fino 50 LB -Bolsa Dos Hermanos.,,3.0,27.85,83.55,3929195.20999999,Bulk Rice,Keila Alfaro-Visvikis,RETAIL SEDANOS,1387371,Feb
2025-02-20,Sedanos Supermarkets  #37,Invoice,008-04930,,Discount,,,-4.5,3929190.70999999,,Keila Alfaro-Visvikis,RETAIL SEDANOS,1387372,Feb
2025-02-20,"Diaz Grocers, Inc",Invoice,008-04931,Arroz Envasado:Parboiled 5KG Dos Hermanos.,6  11lbs,10.0,46.5,465.0,3929655.70999999,Branded Rice,Lisset Limpio -020,RETAIL  DSD,1387373,Feb
2025-02-20,"Diaz Grocers, Inc",Invoice,008-04931,Arroz Envasado:Parboiled 5KG Dos Hermanos.,6  11lbs,10.0,46.5,465.0,3930120.70999999,Branded Rice,Lisset Limpio -020,RETAIL  DSD,1387374,Feb
2025-02-20,El Palacio de los jugos /  Mires Restaurants,Invoice,008-04932,Liquids:AS Marinating Sauce (Mojo),,1.0,18.5,18.5,3930139.20999999,American Spice,Lisset Limpio -020,Cafeteria,1387375,Feb
2025-02-20,El Palacio de los jugos /  Mires Restaurants,Invoice,008-04932,Arroz a Granel:Parboiled 50 LB -Bolsa Dos Hermanos.,,11.0,27.75,305.25,3930444.45999999,Bulk Rice,Lisset Limpio -020,Cafeteria,1387376,Feb
2025-02-20,El Palacio de los jugos /  Mires Restaurants,Invoice,008-04932,Arroz a Granel:Parboiled 50 LB -Bolsa Dos Hermanos.,,1.0,27.75,27.75,3930472.20999999,Bulk Rice,Lisset Limpio -020,Cafeteria,1387377,Feb
2025-02-20,Sedanos Supermarkets #16,Invoice,008-04933,Arroz a Granel:Parboiled 50 LB -Bolsa Dos Hermanos.,,2.0,28.25,56.5,3930528.70999999,Bulk Rice,Keila Alfaro-Visvikis,RETAIL SEDANOS,1387378,Feb
2025-02-20,Sedanos Supermarkets #16,Invoice,008-04933,Spices:AS Chicken Base,1 / 30 lb. (box or pail),1.0,39.0,39.0,3930567.70999999,American Spice,Keila Alfaro-Visvikis,RETAIL SEDANOS,1387379,Feb
2025-02-20,Sedanos Supermarkets #16,Invoice,008-04933,,Discount,,,-1.91,3930565.79999999,,Keila Alfaro-Visvikis,RETAIL SEDANOS,1387380,Feb
2025-02-20,Bravo   Francisco Diaz,Invoice,008-04934,Liquids:AS Cooking Wine,4 1 Gl.,4.0,17.5,70.0,3930635.79999999,American Spice,Lisset Limpio -020,RETAIL  DSD,1387381,Feb
2025-02-20,Bravo   Francisco Diaz,Invoice,008-04934,Arroz a Granel:Largo Fino 50 LB -Bolsa Dos Hermanos.,,5.0,27.85,139.25,3930775.04999999,Bulk Rice,Lisset Limpio -020,RETAIL  DSD,1387382,Feb
2025-02-20,Bravo   Francisco Diaz,Invoice,008-04934,Liquids:AS White Vinegar,4/1 Gl.,1.0,10.0,10.0,3930785.04999999,American Spice,Lisset Limpio -020,RETAIL  DSD,1387383,Feb
2025-02-20,Bravo   Francisco Diaz,Invoice,008-04934,Liquids:AS Marinating Sauce (Mojo),,1.0,18.5,18.5,3930803.54999999,American Spice,Lisset Limpio -020,RETAIL  DSD,1387384,Feb
2025-02-20,Fritanga Momotombo,Invoice,008-04935,Arroz a Granel:Largo Fino 50 LB -Bolsa Dos Hermanos.,,6.0,27.85,167.1,3930970.64999999,Bulk Rice,Lisset Limpio -020,CAFETERIA y RESTAURANTS,1387385,Feb
2025-02-21,Key Food / Holywood,Credit Memo,008-04936,Varios:Promotional Allowance,Arroz Envasado:Parboiled 1kg Bolsa Dos Hermanos.,-3.0,19.9,-59.7,3930910.94999999,Branded Rice,Keila Alfaro-Visvikis,RETAIL  DSD,1387386,Feb
2025-02-21,Sedanos Supermarkets #34,Credit Memo,008-04937,Varios:Promotional Allowance,Arroz Envasado:Parboiled 5KG Dos Hermanos.,-10.0,40.5,-405.0,3930505.94999999,Branded Rice,Keila Alfaro-Visvikis,RETAIL SEDANOS,1387387,Feb
2025-02-21,Festival Supermarket,Credit Memo,008-04938,Varios:Promotional Allowance,Arroz Envasado:Parboiled 5KG Dos Hermanos.,-15.0,46.5,-697.5,3929808.44999999,Branded Rice,Keila Alfaro-Visvikis,RETAIL  DSD,1387388,Feb
2025-02-23,"Diaz Grocers, Inc",Credit Memo,008-04939,Varios:Promotional Allowance,Arroz Envasado:Parboiled 5KG Dos Hermanos.,-10.0,46.5,-465.0,3929343.44999999,Branded Rice,Lisset Limpio -020,RETAIL  DSD,1387389,Feb
2025-02-23,Sabor Tropical #1 - Supermarket,Credit Memo,008-04940,Varios:Promotional Allowance,Arroz Envasado:Parboiled 5KG Dos Hermanos.,-10.0,46.5,-465.0,3928878.44999999,Branded Rice,Keila Alfaro-Visvikis,RETAIL  DSD,1387390,Feb
2025-02-23,Sabor Tropical #1 - Supermarket,Credit Memo,008-04940,Varios:Promotional Allowance,Rice Snack:Rice Snack Ham Flavored DOS HERMANOS,-1.0,19.9,-19.9,3928858.54999999,Branded Rice,Keila Alfaro-Visvikis,RETAIL  DSD,1387391,Feb
2025-02-23,El Palacio de los jugos / Lita Foods Inc.,Credit Memo,008-04941,Varios:Promotional Allowance,Arroz a Granel:Parboiled 50 LB -Bolsa Dos Hermanos.,-1.0,27.75,-27.75,3928830.79999999,Bulk Rice,Lisset Limpio -020,Cafeteria,1387392,Feb
2025-02-23,El Palacio de los jugos /  Mires Restaurants,Credit Memo,008-04942,Varios:Promotional Allowance,Arroz a Granel:Parboiled 50 LB -Bolsa Dos Hermanos.,-1.0,27.75,-27.75,3928803.04999999,Bulk Rice,Lisset Limpio -020,Cafeteria,1387393,Feb
2025-02-23,Sedanos Supermarkets #38,Invoice,008-04943,Arroz Envasado:Parboiled 5KG Dos Hermanos.,6  11lbs,20.0,40.5,810.0,3929613.04999999,Branded Rice,Keila Alfaro-Visvikis,RETAIL SEDANOS,1387394,Feb
2025-02-23,Sedanos Supermarkets #38,Invoice,008-04943,Arroz Envasado:Parboiled 5KG Dos Hermanos.,6  11lbs,20.0,40.5,810.0,3930423.04999999,Branded Rice,Keila Alfaro-Visvikis,RETAIL SEDANOS,1387395,Feb
2025-02-23,Sedanos Supermarkets #38,Invoice,008-04943,Rice Snack:Rice Snack Ham Flavored DOS HERMANOS,,1.0,19.9,19.9,3930442.94999999,Puffed Products,Keila Alfaro-Visvikis,RETAIL SEDANOS,1387396,Feb
2025-02-23,Sedanos Supermarkets #38,Invoice,008-04943,Rice Snack:Rice Snack Salami Flavored DOS HERMANOS,,1.0,19.9,19.9,3930462.84999999,Puffed Products,Keila Alfaro-Visvikis,RETAIL SEDANOS,1387397,Feb
2025-02-23,Sedanos Supermarkets #38,Invoice,008-04943,Rice Snack:Rice Snack Salami Flavored DOS HERMANOS,,1.0,19.9,19.9,3930482.74999999,Puffed Products,Keila Alfaro-Visvikis,RETAIL SEDANOS,1387398,Feb
2025-02-23,Sedanos Supermarkets #38,Invoice,008-04943,,Discount,,,-17.0,3930465.74999999,,Keila Alfaro-Visvikis,RETAIL SEDANOS,1387399,Feb
2025-02-23,JMN Dely Corp,Invoice,008-04944,Dry Beans:Dry Beans - Black Beans 50,Dry Black Beans 50 lb,1.0,45.7,45.7,3930511.44999999,Dry Beans,Keila Alfaro-Visvikis,CAFETERIA y RESTAURANTS,1387400,Feb
2025-02-23,JMN Dely Corp,Invoice,008-04944,Arroz a Granel:Largo Fino 50 LB -Bolsa Dos Hermanos.,,2.0,27.85,55.7,3930567.14999999,Bulk Rice,Keila Alfaro-Visvikis,CAFETERIA y RESTAURANTS,1387401,Feb
2025-02-23,JMN Dely Corp,Invoice,008-04944,Arroz a Granel:Parboiled 50 LB -Bolsa Dos Hermanos.,,2.0,27.75,55.5,3930622.64999999,Bulk Rice,Keila Alfaro-Visvikis,CAFETERIA y RESTAURANTS,1387402,Feb
2025-02-23,El Palacio de los jugos /  EMMA FOOD CORP,Invoice,008-04945,Arroz a Granel:Largo Fino 50 LB -Bolsa Dos Hermanos.,,7.0,27.85,194.95,3930817.59999999,Bulk Rice,Lisset Limpio -020,Cafeteria,1387403,Feb
2025-02-23,El Palacio de los jugos / Caribe Tropical,Invoice,008-04946,Arroz a Granel:Parboiled 50 LB -Bolsa Dos Hermanos.,,10.0,27.75,277.5,3931095.09999999,Bulk Rice,Lisset Limpio -020,Cafeteria,1387404,Feb
2025-02-23,Be Your Will LLC,Invoice,008-04947,Liquids:AS Cooking Wine,4 1 Gl.,1.0,17.5,17.5,3931112.59999999,American Spice,Lisset Limpio -020,CAFETERIA y RESTAURANTS,1387405,Feb
2025-02-23,Be Your Will LLC,Invoice,008-04947,Arroz a Granel:Largo Fino 50 LB -Bolsa Dos Hermanos.,,7.0,27.85,194.95,3931307.54999999,Bulk Rice,Lisset Limpio -020,CAFETERIA y RESTAURANTS,1387406,Feb
2025-02-23,Be Your Will LLC,Invoice,008-04947,Arroz a Granel:Parboiled 50 LB -Bolsa Dos Hermanos.,,11.0,27.75,305.25,3931612.79999999,Bulk Rice,Lisset Limpio -020,CAFETERIA y RESTAURANTS,1387407,Feb
2025-02-23,Be Your Will LLC,Invoice,008-04947,Arroz a Granel:Parboiled 50 LB -Bolsa Dos Hermanos.,,1.0,27.75,27.75,3931640.54999999,Bulk Rice,Lisset Limpio -020,CAFETERIA y RESTAURANTS,1387408,Feb
2025-02-23,El Palacio de los jugos / Delicias Criollas (DIAGO FOOD_MILLER),Invoice,008-04948,Arroz a Granel:Parboiled 50 LB -Bolsa Dos Hermanos.,,11.0,27.75,305.25,3931945.79999999,Bulk Rice,Lisset Limpio -020,Cafeteria,1387409,Feb
2025-02-23,El Palacio de los jugos / Delicias Criollas (DIAGO FOOD_MILLER),Invoice,008-04948,Arroz a Granel:Largo Fino 50 LB -Bolsa Dos Hermanos.,,5.0,27.85,139.25,3932085.04999999,Bulk Rice,Lisset Limpio -020,Cafeteria,1387410,Feb
2025-02-23,El Palacio de los jugos / Delicias Criollas (DIAGO FOOD_MILLER),Invoice,008-04948,Arroz a Granel:Parboiled 50 LB -Bolsa Dos Hermanos.,,1.0,27.75,27.75,3932112.79999999,Bulk Rice,Lisset Limpio -020,Cafeteria,1387411,Feb
2025-02-23,Panda Depot,Invoice,008-04949,Arroz a Granel:Parboiled 50 LB -Bolsa Dos Hermanos.,,220.0,25.0,5500.0,3937612.79999999,Bulk Rice,Lisset Limpio -020,WHOLESALER,1387412,Feb
2025-02-23,Sedanos Supermarkets #31,Invoice,008-04950,Arroz a Granel:Parboiled 50 LB -Bolsa Dos Hermanos.,,0.0,,0.0,3937612.79999999,Bulk Rice,Keila Alfaro-Visvikis,RETAIL SEDANOS,1387413,Feb
2025-02-23,Sedanos Supermarkets #5,Invoice,008-04951,Rice Snack:Rice Snack Ham Flavored DOS HERMANOS,,1.0,19.9,19.9,3937632.69999999,Puffed Products,Keila Alfaro-Visvikis,RETAIL SEDANOS,1387414,Feb
2025-02-23,Sedanos Supermarkets #5,Invoice,008-04951,Rice Snack:Rice Snack Salami Flavored DOS HERMANOS,,2.0,19.9,39.8,3937672.49999999,Puffed Products,Keila Alfaro-Visvikis,RETAIL SEDANOS,1387415,Feb
2025-02-23,Sedanos Supermarkets #5,Invoice,008-04951,Rice Snack:Rice Snack Ham Flavored DOS HERMANOS,,1.0,19.9,19.9,3937692.39999999,Puffed Products,Keila Alfaro-Visvikis,RETAIL SEDANOS,1387416,Feb
2025-02-23,Sedanos Supermarkets #5,Invoice,008-04951,,Discount,,,-1.19,3937691.20999999,,Keila Alfaro-Visvikis,RETAIL SEDANOS,1387417,Feb
2025-02-23,El Palacio de los jugos /  Nanos Latin Foods,Invoice,008-04952,Arroz a Granel:Parboiled 50 LB -Bolsa Dos Hermanos.,,12.0,26.75,321.0,3938012.20999999,Bulk Rice,Lisset Limpio -020,Cafeteria,1387418,Feb
2025-02-24,Sedanos Supermarkets #33,Credit Memo,008-04953,Varios:Producto vencido/deteriorado (no impacta en inventario),"15 unidades salame, 10 pizza 1 jamon",-26.0,1.49,-38.74,3937973.46999999,Puffed Products,Keila Alfaro-Visvikis,RETAIL SEDANOS,1387419,Feb
2025-02-24,Sedanos Supermarkets #9,Credit Memo,008-04954,Varios:Promotional Allowance,Arroz Envasado:Parboiled 5KG Dos Hermanos.,-1.0,401.37,-401.37,3937572.09999999,Branded Rice,Keila Alfaro-Visvikis,RETAIL SEDANOS,1387420,Feb
2025-02-24,Be Your Will LLC,Credit Memo,008-04966,Varios:Promotional Allowance,Arroz a Granel:Parboiled 50 LB -Bolsa Dos Hermanos.,-1.0,27.75,-27.75,3937544.34999999,Bulk Rice,Lisset Limpio -020,CAFETERIA y RESTAURANTS,1387421,Feb
2025-02-24,Sedanos Supermarkets #38,Credit Memo,008-04967,Varios:Promotional Allowance,Arroz Envasado:Parboiled 5KG Dos Hermanos.,-20.0,40.5,-810.0,3936734.34999999,Branded Rice,Keila Alfaro-Visvikis,RETAIL SEDANOS,1387422,Feb
2025-02-24,Sedanos Supermarkets #38,Credit Memo,008-04967,Varios:Promotional Allowance,,-1.0,19.9,-19.9,3936714.44999999,Puffed Products,Keila Alfaro-Visvikis,RETAIL SEDANOS,1387423,Feb
2025-02-24,Sedanos Supermarkets #5,Credit Memo,008-04968,Varios:Promotional Allowance,Rice Snack:Rice Snack Ham Flavored DOS HERMANOS,-1.0,19.9,-19.9,3936694.54999999,Puffed Products,Keila Alfaro-Visvikis,RETAIL SEDANOS,1387424,Feb
2025-02-24,El Palacio de los jugos / Delicias Criollas (DIAGO FOOD_MILLER),Credit Memo,008-04969,Varios:Promotional Allowance,Arroz a Granel:Parboiled 50 LB -Bolsa Dos Hermanos.,-1.0,27.75,-27.75,3936666.79999999,Bulk Rice,Lisset Limpio -020,Cafeteria,1387425,Feb
2025-02-24,Extra Supermarket,Credit Memo,008-04970,Varios:Promotional Allowance,Arroz Envasado:Parboiled 5KG Dos Hermanos.,-5.0,46.5,-232.5,3936434.29999999,Branded Rice,Keila Alfaro-Visvikis,RETAIL  DSD,1387426,Feb
2025-02-24,Extra Supermarket,Credit Memo,008-04970,Varios:Promotional Allowance,Arroz Envasado:Largo Fino 1kg (Long grain rice) Dos Hermanos,-1.0,18.0,-18.0,3936416.29999999,Branded Rice,Keila Alfaro-Visvikis,RETAIL  DSD,1387427,Feb
2025-02-24,"Soriano Brothers Diaz Food Service,Inc",Credit Memo,008-04971,Varios:Promotional Allowance,Arroz a Granel:Parboiled 50 LB -Bolsa Dos Hermanos.,-3.0,27.75,-83.25,3936333.04999999,Bulk Rice,Lisset Limpio -020,CAFETERIA y RESTAURANTS,1387428,Feb
2025-02-26,El Palacio de Los Jugos / Casa mía Food Restaurant inc,Invoice,008-04955,Arroz a Granel:Parboiled 50 LB -Bolsa Dos Hermanos.,,8.0,27.75,222.0,3936555.04999999,Bulk Rice,Lisset Limpio -020,Cafeteria,1387429,Feb
2025-02-26,El Palacio de Los Jugos / Casa mía Food Restaurant inc,Invoice,008-04955,Dry Beans:Dry Beans - Black Beans 50,Dry Black Beans 50 lb,1.0,45.7,45.7,3936600.74999999,Dry Beans,Lisset Limpio -020,Cafeteria,1387430,Feb
2025-02-26,El Palacio de Los Jugos / Casa mía Food Restaurant inc,Invoice,008-04955,Arroz a Granel:Parboiled 50 LB -Bolsa Dos Hermanos.,,1.0,27.75,27.75,3936628.49999999,Bulk Rice,Lisset Limpio -020,Cafeteria,1387431,Feb
2025-02-26,Sedanos Supermarkets #43,Invoice,008-04956,Arroz a Granel:Parboiled 50 LB -Bolsa Dos Hermanos.,,5.0,28.25,141.25,3936769.74999999,Bulk Rice,Keila Alfaro-Visvikis,RETAIL SEDANOS,1387432,Feb
2025-02-26,Sedanos Supermarkets #33,Invoice,008-04957,Arroz a Granel:Parboiled 50 LB -Bolsa Dos Hermanos.,,6.0,28.25,169.5,3936939.24999999,Bulk Rice,Keila Alfaro-Visvikis,RETAIL SEDANOS,1387433,Feb
2025-02-26,Sedanos Supermarkets #33,Invoice,008-04957,,Discount,,,-3.39,3936935.85999999,,Keila Alfaro-Visvikis,RETAIL SEDANOS,1387434,Feb
2025-02-26,Sedanos Supermarkets #24,Invoice,008-04958,Arroz a Granel:Parboiled 50 LB -Bolsa Dos Hermanos.,,8.0,28.25,226.0,3937161.85999999,Bulk Rice,Keila Alfaro-Visvikis,RETAIL SEDANOS,1387435,Feb
2025-02-26,Sedanos Supermarkets #24,Invoice,008-04958,,Discount,,,-4.52,3937157.33999999,,Keila Alfaro-Visvikis,RETAIL SEDANOS,1387436,Feb
2025-02-26,Los Caringas Latin America  Foods,Invoice,008-04959,Arroz a Granel:Largo Fino 50 LB -Bolsa Dos Hermanos.,,3.0,27.85,83.55,3937240.88999999,Bulk Rice,Lisset Limpio -020,CAFETERIA y RESTAURANTS,1387437,Feb
2025-02-26,Los Caringas Latin America  Foods,Invoice,008-04959,Arroz a Granel:Parboiled 50 LB -Bolsa Dos Hermanos.,,3.0,28.25,84.75,3937325.63999999,Bulk Rice,Lisset Limpio -020,CAFETERIA y RESTAURANTS,1387438,Feb
2025-02-26,Los Caringas Latin America  Foods,Invoice,008-04959,Dry Beans:Dry Beans - Black Beans 50,Dry Black Beans 50 lb,1.0,45.7,45.7,3937371.33999999,Dry Beans,Lisset Limpio -020,CAFETERIA y RESTAURANTS,1387439,Feb
2025-02-26,Ideal Food Basket Davie Cafeteria,Invoice,008-04960,Arroz a Granel:Largo Fino 50 LB -Bolsa Dos Hermanos.,,5.0,27.85,139.25,3937510.58999999,Bulk Rice,Keila Alfaro-Visvikis,CAFETERIA y RESTAURANTS,1387440,Feb
2025-02-26,Sedanos Supermarkets #28,Invoice,008-04961,Arroz Envasado:Parboiled 5KG Dos Hermanos.,6  11lbs,5.0,40.5,202.5,3937713.08999999,Branded Rice,Keila Alfaro-Visvikis,RETAIL SEDANOS,1387441,Feb
2025-02-26,Sedanos Supermarkets #28,Invoice,008-04961,Rice Snack:Rice Snack Ham Flavored DOS HERMANOS,,2.0,19.9,39.8,3937752.88999999,Puffed Products,Keila Alfaro-Visvikis,RETAIL SEDANOS,1387442,Feb
2025-02-26,Sedanos Supermarkets #28,Invoice,008-04961,Rice Snack:Rice Snack Salami Flavored DOS HERMANOS,,1.0,19.9,19.9,3937772.78999999,Puffed Products,Keila Alfaro-Visvikis,RETAIL SEDANOS,1387443,Feb
2025-02-26,Sedanos Supermarkets #28,Invoice,008-04961,Rice Snack:Rice Snack Salami Flavored DOS HERMANOS,,1.0,19.9,19.9,3937792.68999999,Puffed Products,Keila Alfaro-Visvikis,RETAIL SEDANOS,1387444,Feb
2025-02-26,Sedanos Supermarkets #28,Invoice,008-04961,Arroz Envasado:Parboiled 5KG Dos Hermanos.,6  11lbs,5.0,40.5,202.5,3937995.18999999,Branded Rice,Keila Alfaro-Visvikis,RETAIL SEDANOS,1387445,Feb
2025-02-26,Sedanos Supermarkets #28,Invoice,008-04961,,Discount,,,-5.24,3937989.94999999,,Keila Alfaro-Visvikis,RETAIL SEDANOS,1387446,Feb
2025-02-26,Total Food supermarket,Invoice,008-04962,Arroz Envasado:Parboiled 5KG Dos Hermanos.,6  11lbs,3.0,46.5,139.5,3938129.44999999,Branded Rice,Keila Alfaro-Visvikis,RETAIL  DSD,1387447,Feb
2025-02-26,Total Food supermarket,Invoice,008-04962,Arroz Envasado:Parboiled 5KG Dos Hermanos.,6  11lbs,3.0,46.5,139.5,3938268.94999999,Branded Rice,Keila Alfaro-Visvikis,RETAIL  DSD,1387448,Feb
2025-02-26,China Tokyo,Invoice,008-04963,Arroz a Granel:Parboiled 50 LB -Bolsa Dos Hermanos.,,10.0,28.25,282.5,3938551.44999999,Bulk Rice,Lisset Limpio -020,CAFETERIA y RESTAURANTS,1387449,Feb
2025-02-26,Aries Supermarket & Cafeteria,Invoice,008-04964,Arroz a Granel:Parboiled 50 LB -Bolsa Dos Hermanos.,,10.0,28.25,282.5,3938833.94999999,Bulk Rice,Keila Alfaro-Visvikis,CAFETERIA y RESTAURANTS,1387450,Feb
2025-02-26,Aries Supermarket & Cafeteria,Invoice,008-04964,Spices:AS Chicken Base,1 / 30 lb. (box or pail),3.0,39.0,117.0,3938950.94999999,American Spice,Keila Alfaro-Visvikis,CAFETERIA y RESTAURANTS,1387451,Feb
2025-02-26,La Ranchera Meat Market #3,Invoice,008-04965,Arroz a Granel:Largo Fino 50 LB -Bolsa Dos Hermanos.,,20.0,27.85,557.0,3939507.94999999,Bulk Rice,Keila Alfaro-Visvikis,CAFETERIA y RESTAURANTS,1387452,Feb
2025-02-26,Sedanos Supermarkets #28,Credit Memo,008-04985,Varios:Promotional Allowance,Rice Snack:Rice Snack Salami Flavored DOS HERMANOS,-1.0,19.9,-19.9,3939488.04999999,Puffed Products,Keila Alfaro-Visvikis,RETAIL SEDANOS,1387453,Feb
2025-02-26,Sedanos Supermarkets #28,Credit Memo,008-04985,Varios:Promotional Allowance,Arroz Envasado:Parboiled 5KG Dos Hermanos.,-5.0,40.5,-202.5,3939285.54999999,Branded Rice,Keila Alfaro-Visvikis,RETAIL SEDANOS,1387454,Feb
2025-02-26,El Palacio de Los Jugos / Casa mía Food Restaurant inc,Credit Memo,008-04986,Varios:Promotional Allowance,Arroz a Granel:Parboiled 50 LB -Bolsa Dos Hermanos.,-1.0,27.75,-27.75,3939257.79999999,Bulk Rice,Lisset Limpio -020,Cafeteria,1387455,Feb
2025-02-26,Total Food supermarket,Credit Memo,008-04987,Varios:Promotional Allowance,Arroz Envasado:Parboiled 5KG Dos Hermanos.,-3.0,46.5,-139.5,3939118.29999999,Branded Rice,Keila Alfaro-Visvikis,RETAIL  DSD,1387456,Feb
2025-02-26,El Palacio de los jugos / Lita Foods Inc.,Credit Memo,008-04988,Varios:Promotional Allowance,Arroz a Granel:Parboiled 50 LB -Bolsa Dos Hermanos.,-1.0,27.75,-27.75,3939090.54999999,Bulk Rice,Lisset Limpio -020,Cafeteria,1387457,Feb
2025-02-27,El Gallego Supermarket,Invoice,008-04972,Arroz a Granel:Parboiled 50 LB -Bolsa Dos Hermanos.,,5.0,28.25,141.25,3939231.79999999,Bulk Rice,Lisset Limpio -020,RETAIL  DSD,1387458,Feb
2025-02-27,El Gallego Supermarket,Invoice,008-04972,Dry Beans:Dry Beans - Small Red Beans 50 lbs.,Small Red Beans 50 lbs,1.0,46.85,46.85,3939278.64999999,Dry Beans,Lisset Limpio -020,RETAIL  DSD,1387459,Feb
2025-02-27,El Gallego Supermarket,Invoice,008-04972,Dry Beans:Dry Beans - Black Beans 50,Dry Black Beans 50 lb,2.0,45.7,91.4,3939370.04999999,Dry Beans,Lisset Limpio -020,RETAIL  DSD,1387460,Feb
2025-02-27,Bravo   Francisco Diaz,Invoice,008-04973,Arroz a Granel:Largo Fino 50 LB -Bolsa Dos Hermanos.,,7.0,27.85,194.95,3939564.99999999,Bulk Rice,Lisset Limpio -020,RETAIL  DSD,1387461,Feb
2025-02-27,Hings Chinese,Invoice,008-04974,Arroz a Granel:Parboiled 50 LB -Bolsa Dos Hermanos.,,5.0,28.25,141.25,3939706.24999999,Bulk Rice,Lisset Limpio -020,CAFETERIA y RESTAURANTS,1387462,Feb
2025-02-27,El Palacio de los jugos / Lita Foods Inc.,Invoice,008-04975,Dry Beans:Dry Beans - Black Beans 50,Dry Black Beans 50 lb,1.0,45.7,45.7,3939751.94999999,Dry Beans,Lisset Limpio -020,Cafeteria,1387463,Feb
2025-02-27,El Palacio de los jugos / Lita Foods Inc.,Invoice,008-04975,Arroz a Granel:Parboiled 50 LB -Bolsa Dos Hermanos.,,11.0,27.75,305.25,3940057.19999999,Bulk Rice,Lisset Limpio -020,Cafeteria,1387464,Feb
2025-02-27,El Palacio de los jugos / Lita Foods Inc.,Invoice,008-04975,Arroz a Granel:Parboiled 50 LB -Bolsa Dos Hermanos.,,1.0,27.75,27.75,3940084.94999999,Bulk Rice,Lisset Limpio -020,Cafeteria,1387465,Feb
2025-02-27,Sedanos Supermarkets #22,Invoice,008-04976,Arroz a Granel:Parboiled 50 LB -Bolsa Dos Hermanos.,,4.0,28.25,113.0,3940197.94999999,Bulk Rice,Keila Alfaro-Visvikis,RETAIL SEDANOS,1387466,Feb
2025-02-27,Sedanos Supermarkets #22,Invoice,008-04976,,Discount,,,-2.26,3940195.68999999,,Keila Alfaro-Visvikis,RETAIL SEDANOS,1387467,Feb
2025-02-27,El Palacio de los jugos /  EMMA FOOD CORP,Invoice,008-04977,Arroz a Granel:Largo Fino 50 LB -Bolsa Dos Hermanos.,,6.0,27.85,167.1,3940362.78999999,Bulk Rice,Lisset Limpio -020,Cafeteria,1387468,Feb
2025-02-27,El Palacio de los jugos /  EMMA FOOD CORP,Invoice,008-04977,Arroz a Granel:Parboiled 50 LB -Bolsa Dos Hermanos.,,4.0,26.75,107.0,3940469.78999999,Bulk Rice,Lisset Limpio -020,Cafeteria,1387469,Feb
2025-02-27,El Palacio de los jugos / Caribe Tropical,Invoice,008-04978,Arroz a Granel:Largo Fino 50 LB -Bolsa Dos Hermanos.,,4.0,27.85,111.4,3940581.18999999,Bulk Rice,Lisset Limpio -020,Cafeteria,1387470,Feb
2025-02-27,El Palacio de los jugos / Caribe Tropical,Invoice,008-04978,Arroz a Granel:Parboiled 50 LB -Bolsa Dos Hermanos.,,6.0,26.75,160.5,3940741.68999999,Bulk Rice,Lisset Limpio -020,Cafeteria,1387471,Feb
2025-02-27,Rey Chavez Distributor #2,Invoice,008-04979,Arroz a Granel:Parboiled 50 LB -Bolsa Dos Hermanos.,,15.0,28.8,432.0,3941173.68999999,Bulk Rice,Lisset Limpio -020,WHOLESALER,1387472,Feb
2025-02-27,Sedanos Supermarkets #42,Invoice,008-04980,Arroz Envasado:Parboiled 5KG Dos Hermanos.,6  11lbs,20.0,40.5,810.0,3941983.68999999,Branded Rice,Keila Alfaro-Visvikis,RETAIL SEDANOS,1387473,Feb
2025-02-27,Sedanos Supermarkets #42,Invoice,008-04980,Arroz Envasado:Parboiled 1kg Bolsa Dos Hermanos.,.,3.0,19.9,59.7,3942043.38999999,Branded Rice,Keila Alfaro-Visvikis,RETAIL SEDANOS,1387474,Feb
2025-02-27,Sedanos Supermarkets #42,Invoice,008-04980,Arroz Envasado:Largo Fino 1kg (Long grain rice) Dos Hermanos,,2.0,18.0,36.0,3942079.38999999,Branded Rice,Keila Alfaro-Visvikis,RETAIL SEDANOS,1387475,Feb
2025-02-27,Sedanos Supermarkets #42,Invoice,008-04980,Arroz Envasado:Parboiled 5KG Dos Hermanos.,6  11lbs,20.0,40.5,810.0,3942889.38999999,Branded Rice,Keila Alfaro-Visvikis,RETAIL SEDANOS,1387476,Feb
2025-02-27,Sedanos Supermarkets #42,Invoice,008-04980,Arroz Envasado:Largo Fino 1kg (Long grain rice) Dos Hermanos,,1.0,18.0,18.0,3942907.38999999,Branded Rice,Keila Alfaro-Visvikis,RETAIL SEDANOS,1387477,Feb
2025-02-27,Sedanos Supermarkets #42,Invoice,008-04980,,Discount,,,-18.11,3942889.27999999,,Keila Alfaro-Visvikis,RETAIL SEDANOS,1387478,Feb
2025-02-27,El Palacio de los jugos / Rodriguez Foods,Invoice,008-04981,Arroz a Granel:Parboiled 50 LB -Bolsa Dos Hermanos.,,12.0,26.75,321.0,3943210.27999999,Bulk Rice,Lisset Limpio -020,Cafeteria,1387479,Feb
2025-02-27,Soriano Brothers PB,Invoice,008-04982,Spices:AS Sazon (for all),1 / 30 lb (box or pail),3.0,51.0,153.0,3943363.27999999,American Spice,Lisset Limpio -020,CAFETERIA y RESTAURANTS,1387480,Feb
2025-02-27,Soriano Brothers PB,Invoice,008-04982,Arroz a Granel:Largo Fino 50 LB -Bolsa Dos Hermanos.,,10.0,27.85,278.5,3943641.77999999,Bulk Rice,Lisset Limpio -020,CAFETERIA y RESTAURANTS,1387481,Feb
2025-02-27,Soriano Brothers PB,Invoice,008-04982,Arroz a Granel:Parboiled 50 LB -Bolsa Dos Hermanos.,,7.0,26.75,187.25,3943829.02999999,Bulk Rice,Lisset Limpio -020,CAFETERIA y RESTAURANTS,1387482,Feb
2025-02-27,Soriano Brothers PB,Invoice,008-04982,Dry Beans:Dry Beans - Black Beans 50,Dry Black Beans 50 lb,3.0,36.75,110.25,3943939.27999999,Dry Beans,Lisset Limpio -020,CAFETERIA y RESTAURANTS,1387483,Feb
2025-02-27,El Palacio de los jugos /  Nanos Latin Foods,Invoice,008-04983,Arroz a Granel:Largo Fino 50 LB -Bolsa Dos Hermanos.,,5.0,27.85,139.25,3944078.52999999,Bulk Rice,Lisset Limpio -020,Cafeteria,1387484,Feb
2025-02-27,El Palacio de los jugos /  Nanos Latin Foods,Invoice,008-04983,Arroz a Granel:Parboiled 50 LB -Bolsa Dos Hermanos.,,4.0,26.75,107.0,3944185.52999999,Bulk Rice,Lisset Limpio -020,Cafeteria,1387485,Feb
2025-02-27,Sedanos Supermarkets #42,Credit Memo,008-04989,Varios:Promotional Allowance,Arroz Envasado:Parboiled 5KG Dos Hermanos.,-20.0,40.5,-810.0,3943375.52999999,Branded Rice,Keila Alfaro-Visvikis,RETAIL SEDANOS,1387486,Feb
2025-02-27,Sedanos Supermarkets #42,Credit Memo,008-04989,Varios:Promotional Allowance,Arroz Envasado:Largo Fino 1kg (Long grain rice) Dos Hermanos,-1.0,18.0,-18.0,3943357.52999999,Branded Rice,Keila Alfaro-Visvikis,RETAIL SEDANOS,1387487,Feb
2025-02-28,"American Spice Trading Co, Inc.",Invoice,008-04984,Arroz a Granel:Parboiled 50 LB -Bolsa Dos Hermanos.,,1100.0,27.5,30250.0,3973607.52999999,Bulk Rice,Armando Carpio - 017,WHOLESALER MANUFACTURY,1387488,Feb
2025-02-28,"Sun Shine Spice, Corp.",Invoice,008-04990,Arroz a Granel:Parboiled 50 LB -Bolsa Dos Hermanos.,,100.0,25.5,2550.0,3976157.52999999,Bulk Rice,Keila Alfaro-Visvikis,RETAIL  DSD,1387489,Feb
2025-03-01,BRAVO - Port St Lucie,Credit Memo,008-05055,Arroz Envasado:Parboiled 5KG Dos Hermanos.,6  11lbs,-13.0,35.077,-456.0,3975701.52999999,Branded Rice,Keila Alfaro-Visvikis,RETAIL  DSD,1387490,Mar
2025-03-02,El Palacio de los jugos /  Nanos Latin Foods,Invoice,008-04991,Arroz a Granel:Largo Fino 50 LB -Bolsa Dos Hermanos.,,4.0,27.85,111.4,3975812.92999999,Bulk Rice,Lisset Limpio -020,Cafeteria,1387491,Mar
2025-03-02,El Palacio de los jugos /  Nanos Latin Foods,Invoice,008-04991,Arroz a Granel:Parboiled 50 LB -Bolsa Dos Hermanos.,,8.0,26.75,214.0,3976026.92999999,Bulk Rice,Lisset Limpio -020,Cafeteria,1387492,Mar
2025-03-02,El Palacio de los jugos / Lita Foods Inc.,Invoice,008-04992,Dry Beans:Dry Beans - Black Beans 50,Dry Black Beans 50 lb,1.0,45.7,45.7,3976072.62999999,Dry Beans,Lisset Limpio -020,Cafeteria,1387493,Mar
2025-03-02,El Palacio de los jugos / Lita Foods Inc.,Invoice,008-04992,Arroz a Granel:Parboiled 50 LB -Bolsa Dos Hermanos.,,11.0,27.75,305.25,3976377.87999999,Bulk Rice,Lisset Limpio -020,Cafeteria,1387494,Mar
2025-03-02,El Palacio de los jugos / Lita Foods Inc.,Invoice,008-04992,Arroz a Granel:Parboiled 50 LB -Bolsa Dos Hermanos.,,1.0,27.75,27.75,3976405.62999999,Bulk Rice,Lisset Limpio -020,Cafeteria,1387495,Mar
2025-03-02,El Palacio de los jugos / Delicias Criollas (DIAGO FOOD_MILLER),Invoice,008-04993,Dry Beans:Dry Beans - Black Beans 50,Dry Black Beans 50 lb,1.0,45.7,45.7,3976451.32999999,Dry Beans,Lisset Limpio -020,Cafeteria,1387496,Mar
2025-03-02,El Palacio de los jugos / Delicias Criollas (DIAGO FOOD_MILLER),Invoice,008-04993,Arroz a Granel:Parboiled 50 LB -Bolsa Dos Hermanos.,,11.0,27.75,305.25,3976756.57999999,Bulk Rice,Lisset Limpio -020,Cafeteria,1387497,Mar
2025-03-02,El Palacio de los jugos / Delicias Criollas (DIAGO FOOD_MILLER),Invoice,008-04993,Arroz a Granel:Parboiled 50 LB -Bolsa Dos Hermanos.,,1.0,27.75,27.75,3976784.32999999,Bulk Rice,Lisset Limpio -020,Cafeteria,1387498,Mar
2025-03-02,El Palacio de Los Jugos / Casa mía Food Restaurant inc,Invoice,008-04994,Arroz a Granel:Parboiled 50 LB -Bolsa Dos Hermanos.,,11.0,27.75,305.25,3977089.57999999,Bulk Rice,Lisset Limpio -020,Cafeteria,1387499,Mar
2025-03-02,El Palacio de Los Jugos / Casa mía Food Restaurant inc,Invoice,008-04994,Dry Beans:Dry Beans - Black Beans 50,Dry Black Beans 50 lb,1.0,45.7,45.7,3977135.27999999,Dry Beans,Lisset Limpio -020,Cafeteria,1387500,Mar
2025-03-02,El Palacio de Los Jugos / Casa mía Food Restaurant inc,Invoice,008-04994,Arroz a Granel:Parboiled 50 LB -Bolsa Dos Hermanos.,,1.0,27.75,27.75,3977163.02999999,Bulk Rice,Lisset Limpio -020,Cafeteria,1387501,Mar
2025-03-02,ALS Foods,Invoice,008-04995,Liquids:AS Cooking Wine,4 1 Gl.,2.0,17.5,35.0,3977198.02999999,American Spice,Lisset Limpio -020,CAFETERIA y RESTAURANTS,1387502,Mar
2025-03-02,ALS Foods,Invoice,008-04995,Arroz a Granel:Largo Fino 50 LB -Bolsa Dos Hermanos.,,7.0,27.85,194.95,3977392.97999999,Bulk Rice,Lisset Limpio -020,CAFETERIA y RESTAURANTS,1387503,Mar
2025-03-02,ALS Foods,Invoice,008-04995,Arroz a Granel:Parboiled 50 LB -Bolsa Dos Hermanos.,,11.0,27.75,305.25,3977698.22999999,Bulk Rice,Lisset Limpio -020,CAFETERIA y RESTAURANTS,1387504,Mar
2025-03-02,ALS Foods,Invoice,008-04995,Arroz a Granel:Parboiled 50 LB -Bolsa Dos Hermanos.,,1.0,27.75,27.75,3977725.97999999,Bulk Rice,Lisset Limpio -020,CAFETERIA y RESTAURANTS,1387505,Mar
2025-03-02,JMN Dely Corp,Invoice,008-04996,Dry Beans:Dry Beans - Black Beans 50,Dry Black Beans 50 lb,1.0,45.7,45.7,3977771.67999999,Dry Beans,Keila Alfaro-Visvikis,CAFETERIA y RESTAURANTS,1387506,Mar
2025-03-02,JMN Dely Corp,Invoice,008-04996,Arroz a Granel:Largo Fino 50 LB -Bolsa Dos Hermanos.,,2.0,27.85,55.7,3977827.37999999,Bulk Rice,Keila Alfaro-Visvikis,CAFETERIA y RESTAURANTS,1387507,Mar
2025-03-02,JMN Dely Corp,Invoice,008-04996,Arroz a Granel:Parboiled 50 LB -Bolsa Dos Hermanos.,,2.0,27.75,55.5,3977882.87999999,Bulk Rice,Keila Alfaro-Visvikis,CAFETERIA y RESTAURANTS,1387508,Mar
2025-03-02,El Palacio de los jugos / La sabrosa salsa cubana Corp,Invoice,008-04997,Arroz a Granel:Largo Fino 50 LB -Bolsa Dos Hermanos.,,5.0,27.85,139.25,3978022.12999999,Bulk Rice,Lisset Limpio -020,Cafeteria,1387509,Mar
2025-03-02,El Palacio de los jugos / Caribe Tropical,Invoice,008-04998,Arroz a Granel:Largo Fino 50 LB -Bolsa Dos Hermanos.,,2.0,27.85,55.7,3978077.82999999,Bulk Rice,Lisset Limpio -020,Cafeteria,1387510,Mar
2025-03-02,El Palacio de los jugos / Caribe Tropical,Invoice,008-04998,Arroz a Granel:Parboiled 50 LB -Bolsa Dos Hermanos.,,6.0,26.75,160.5,3978238.32999999,Bulk Rice,Lisset Limpio -020,Cafeteria,1387511,Mar
2025-03-02,El Palacio de los jugos /  EMMA FOOD CORP,Invoice,008-04999,Arroz a Granel:Largo Fino 50 LB -Bolsa Dos Hermanos.,,6.0,27.85,167.1,3978405.42999999,Bulk Rice,Lisset Limpio -020,Cafeteria,1387512,Mar
2025-03-03,El Palacio de los jugos / Delicias Criollas (DIAGO FOOD_MILLER),Credit Memo,008-05001,Varios:Promotional Allowance,Arroz a Granel:Parboiled 50 LB -Bolsa Dos Hermanos.,-1.0,27.75,-27.75,3978377.67999999,Bulk Rice,Lisset Limpio -020,Cafeteria,1387513,Mar
2025-03-03,El Palacio de Los Jugos / Casa mía Food Restaurant inc,Credit Memo,008-05002,Varios:Promotional Allowance,Arroz a Granel:Parboiled 50 LB -Bolsa Dos Hermanos.,-1.0,27.75,-27.75,3978349.92999999,Bulk Rice,Lisset Limpio -020,Cafeteria,1387514,Mar
2025-03-04,Bravo   Francisco Diaz,Invoice,008-05000,Liquids:AS Cooking Wine,4 1 Gl.,2.0,17.5,35.0,3978384.92999999,American Spice,Lisset Limpio -020,RETAIL  DSD,1387515,Mar
2025-03-04,Bravo   Francisco Diaz,Invoice,008-05000,Liquids:AS White Vinegar,4/1 Gl.,2.0,9.5,19.0,3978403.92999999,American Spice,Lisset Limpio -020,RETAIL  DSD,1387516,Mar
2025-03-04,Bravo   Francisco Diaz,Invoice,008-05000,Liquids:AS Marinating Sauce (Mojo),,1.0,18.5,18.5,3978422.42999999,American Spice,Lisset Limpio -020,RETAIL  DSD,1387517,Mar
2025-03-05,Ideal Food Basket Davie Cafeteria,Invoice,008-05003,Arroz a Granel:Largo Fino 50 LB -Bolsa Dos Hermanos.,,7.0,27.85,194.95,3978617.37999999,Bulk Rice,Keila Alfaro-Visvikis,CAFETERIA y RESTAURANTS,1387518,Mar
2025-03-05,Sedanos Supermarkets #24,Invoice,008-05004,Arroz a Granel:Parboiled 50 LB -Bolsa Dos Hermanos.,,8.0,28.25,226.0,3978843.37999999,Bulk Rice,Keila Alfaro-Visvikis,RETAIL SEDANOS,1387519,Mar
2025-03-05,Sedanos Supermarkets #24,Invoice,008-05004,,Discount,,,-4.52,3978838.85999999,,Keila Alfaro-Visvikis,RETAIL SEDANOS,1387520,Mar
2025-03-05,Rey Chavez Distributor Corp,Invoice,008-05005,Arroz a Granel:Parboiled 50 LB -Bolsa Dos Hermanos.,,55.0,27.5,1512.5,3980351.35999999,Bulk Rice,Lisset Limpio -020,WHOLESALER,1387521,Mar
2025-03-05,Sedanos Supermarkets #26,Invoice,008-05006,Arroz a Granel:Parboiled 50 LB -Bolsa Dos Hermanos.,,5.0,28.25,141.25,3980492.60999999,Bulk Rice,Keila Alfaro-Visvikis,RETAIL SEDANOS,1387522,Mar
2025-03-05,Sedanos Supermarkets #26,Invoice,008-05006,,Discount,,,-2.83,3980489.77999999,,Keila Alfaro-Visvikis,RETAIL SEDANOS,1387523,Mar
2025-03-05,Aries Supermarket & Cafeteria,Invoice,008-05007,Arroz a Granel:Parboiled 50 LB -Bolsa Dos Hermanos.,,5.0,28.25,141.25,3980631.02999999,Bulk Rice,Keila Alfaro-Visvikis,CAFETERIA y RESTAURANTS,1387524,Mar
2025-03-05,Aries Supermarket & Cafeteria,Invoice,008-05007,Dry Beans:Dry Beans - Black Beans 50,Dry Black Beans 50 lb,3.0,36.0,108.0,3980739.02999999,Dry Beans,Keila Alfaro-Visvikis,CAFETERIA y RESTAURANTS,1387525,Mar
2025-03-05,Aries Supermarket & Cafeteria,Invoice,008-05007,Spices:AS Whole Bay Leaves,4/12 OZ,1.0,25.3,25.3,3980764.32999999,American Spice,Keila Alfaro-Visvikis,CAFETERIA y RESTAURANTS,1387526,Mar
2025-03-05,Aries Supermarket & Cafeteria,Invoice,008-05007,Spices:AS Cumin Ground,4 / 4 lb,1.0,50.25,50.25,3980814.57999999,American Spice,Keila Alfaro-Visvikis,CAFETERIA y RESTAURANTS,1387527,Mar
2025-03-05,Aries Supermarket & Cafeteria,Invoice,008-05007,Liquids:AS Cooking Wine,4 1 Gl.,2.0,17.5,35.0,3980849.57999999,American Spice,Keila Alfaro-Visvikis,CAFETERIA y RESTAURANTS,1387528,Mar
2025-03-05,Price Choice Food Market # 6,Invoice,008-05008,Arroz Envasado:Parboiled 5KG Dos Hermanos.,6  11lbs,5.0,46.5,232.5,3981082.07999999,Branded Rice,Lisset Limpio -020,RETAIL  DSD,1387529,Mar
2025-03-05,Price Choice Food Market # 6,Invoice,008-05008,Arroz Envasado:Parboiled 5KG Dos Hermanos.,6  11lbs,5.0,46.5,232.5,3981314.57999999,Branded Rice,Lisset Limpio -020,RETAIL  DSD,1387530,Mar
2025-03-05,Sedanos Supermarkets #33,Invoice,008-05009,Arroz a Granel:Parboiled 50 LB -Bolsa Dos Hermanos.,,4.0,28.25,113.0,3981427.57999999,Bulk Rice,Keila Alfaro-Visvikis,RETAIL SEDANOS,1387531,Mar
2025-03-05,Sedanos Supermarkets #33,Invoice,008-05009,,Discount,,,-2.26,3981425.31999999,,Keila Alfaro-Visvikis,RETAIL SEDANOS,1387532,Mar
2025-03-05,Sedanos Supermarkets #36,Credit Memo,008-05010,Varios:Producto vencido/deteriorado (no impacta en inventario),"20 pizza, 13 salami,",-33.0,1.49,-49.17,3981376.14999999,Puffed Products,Keila Alfaro-Visvikis,RETAIL SEDANOS,1387533,Mar
2025-03-05,Sedanos Supermarkets #36,Credit Memo,008-05010,,Discount,49.17,0.0098,0.48,3981376.62999999,,Keila Alfaro-Visvikis,RETAIL SEDANOS,1387534,Mar
2025-03-05,Sedanos Supermarkets #26,Invoice,008-05011,Arroz Envasado:Parboiled 5KG Dos Hermanos.,6  11lbs,5.0,40.5,202.5,3981579.12999999,Branded Rice,Keila Alfaro-Visvikis,RETAIL SEDANOS,1387535,Mar
2025-03-05,Sedanos Supermarkets #26,Invoice,008-05011,Varios:Promotional Allowance,6/11lbs.,5.0,-11.15,-55.75,3981523.37999999,Branded Rice,Keila Alfaro-Visvikis,RETAIL SEDANOS,1387536,Mar
2025-03-05,Sedanos Supermarkets #36,Invoice,008-05012,Arroz Envasado:Largo Fino 1kg (Long grain rice) Dos Hermanos,,1.0,17.5,17.5,3981540.87999999,Branded Rice,Keila Alfaro-Visvikis,RETAIL SEDANOS,1387537,Mar
2025-03-05,Sedanos Supermarkets #36,Invoice,008-05012,Arroz Envasado:Parboiled 1kg Bolsa Dos Hermanos.,.,1.0,19.9,19.9,3981560.77999999,Branded Rice,Keila Alfaro-Visvikis,RETAIL SEDANOS,1387538,Mar
2025-03-05,Sedanos Supermarkets #36,Invoice,008-05012,Arroz Envasado:Parboiled 5KG Dos Hermanos.,6  11lbs,15.0,46.5,697.5,3982258.27999999,Branded Rice,Keila Alfaro-Visvikis,RETAIL SEDANOS,1387539,Mar
2025-03-05,Sedanos Supermarkets #36,Invoice,008-05012,Rice Snack:Rice Snack Ham Flavored DOS HERMANOS,,1.0,19.9,19.9,3982278.17999999,Puffed Products,Keila Alfaro-Visvikis,RETAIL SEDANOS,1387540,Mar
2025-03-05,Sedanos Supermarkets #36,Invoice,008-05012,Rice Snack:Rice Snack Salami Flavored DOS HERMANOS,,1.0,19.9,19.9,3982298.07999999,Puffed Products,Keila Alfaro-Visvikis,RETAIL SEDANOS,1387541,Mar
2025-03-05,Sedanos Supermarkets #36,Invoice,008-05012,Varios:Promotional Allowance,6/11lbs,15.0,-11.15,-167.25,3982130.82999999,Branded Rice,Keila Alfaro-Visvikis,RETAIL SEDANOS,1387542,Mar
2025-03-05,Sedanos Supermarkets #36,Invoice,008-05012,Varios:Promotional Allowance,10/2.2lbs,1.0,-2.5,-2.5,3982128.32999999,Branded Rice,Keila Alfaro-Visvikis,RETAIL SEDANOS,1387543,Mar
2025-03-05,Sedanos Supermarkets #36,Invoice,008-05012,Rice Snack:Rice Snack Salami Flavored DOS HERMANOS,,1.0,19.9,19.9,3982148.22999999,Puffed Products,Keila Alfaro-Visvikis,RETAIL SEDANOS,1387544,Mar
2025-03-05,Sedanos Supermarkets #36,Invoice,008-05012,Rice Snack:Rice Snack Ham Flavored DOS HERMANOS,,1.0,19.9,19.9,3982168.12999999,Puffed Products,Keila Alfaro-Visvikis,RETAIL SEDANOS,1387545,Mar
2025-03-05,Sedanos Supermarkets #36,Invoice,008-05012,,Discount,,,-14.05,3982154.07999999,,Keila Alfaro-Visvikis,RETAIL SEDANOS,1387546,Mar
2025-03-05,Sedanos Supermarkets #36,Credit Memo,008-05013,Varios:Producto vencido/deteriorado (no impacta en inventario),20 unidades de pizza,-20.0,1.49,-29.8,3982124.27999999,Puffed Products,Keila Alfaro-Visvikis,RETAIL SEDANOS,1387547,Mar
2025-03-05,Sedanos Supermarkets #36,Credit Memo,008-05047,Varios:Promotional Allowance,Rice Snack:Rice Snack Salami Flavored DOS HERMANOS,-1.0,19.9,-19.9,3982104.37999999,Puffed Products,Keila Alfaro-Visvikis,RETAIL SEDANOS,1387548,Mar
2025-03-05,Sedanos Supermarkets #36,Credit Memo,008-05047,Varios:Promotional Allowance,Rice Snack:Rice Snack Ham Flavored DOS HERMANOS,-1.0,19.9,-19.9,3982084.47999999,Puffed Products,Keila Alfaro-Visvikis,RETAIL SEDANOS,1387549,Mar
2025-03-05,Price Choice Food Market # 6,Credit Memo,008-05048,Varios:Promotional Allowance,Arroz Envasado:Parboiled 5KG Dos Hermanos.,-5.0,46.5,-232.5,3981851.97999999,Branded Rice,Lisset Limpio -020,RETAIL  DSD,1387550,Mar
2025-03-06,El Palacio de los jugos / Leti Corp.,Invoice,008-05014,Arroz a Granel:Largo Fino 50 LB -Bolsa Dos Hermanos.,,5.0,27.85,139.25,3981991.22999999,Bulk Rice,Lisset Limpio -020,Cafeteria,1387551,Mar
2025-03-06,El Palacio de los jugos / Leti Corp.,Invoice,008-05014,Arroz a Granel:Parboiled 50 LB -Bolsa Dos Hermanos.,,8.0,26.75,214.0,3982205.22999999,Bulk Rice,Lisset Limpio -020,Cafeteria,1387552,Mar
2025-03-06,El Palacio de los jugos /  EMMA FOOD CORP,Invoice,008-05015,Arroz a Granel:Largo Fino 50 LB -Bolsa Dos Hermanos.,,5.0,27.85,139.25,3982344.47999999,Bulk Rice,Lisset Limpio -020,Cafeteria,1387553,Mar
2025-03-06,El Palacio de los jugos / Caribe Tropical,Invoice,008-05016,Arroz a Granel:Parboiled 50 LB -Bolsa Dos Hermanos.,,8.0,26.75,214.0,3982558.47999999,Bulk Rice,Lisset Limpio -020,Cafeteria,1387554,Mar
2025-03-06,El Palacio de los jugos /  Nanos Latin Foods,Invoice,008-05017,Arroz a Granel:Largo Fino 50 LB -Bolsa Dos Hermanos.,,8.0,27.85,222.8,3982781.27999999,Bulk Rice,Lisset Limpio -020,Cafeteria,1387555,Mar
2025-03-06,El Palacio de los jugos /  Nanos Latin Foods,Invoice,008-05017,Arroz a Granel:Parboiled 50 LB -Bolsa Dos Hermanos.,,8.0,26.75,214.0,3982995.27999999,Bulk Rice,Lisset Limpio -020,Cafeteria,1387556,Mar
2025-03-06,El Palacio de Los Jugos / Casa mía Food Restaurant inc,Invoice,008-05018,Arroz a Granel:Parboiled 50 LB -Bolsa Dos Hermanos.,,11.0,27.75,305.25,3983300.52999999,Bulk Rice,Lisset Limpio -020,Cafeteria,1387557,Mar
2025-03-06,El Palacio de Los Jugos / Casa mía Food Restaurant inc,Invoice,008-05018,Dry Beans:Dry Beans - Black Beans 50,Dry Black Beans 50 lb,1.0,45.7,45.7,3983346.22999999,Dry Beans,Lisset Limpio -020,Cafeteria,1387558,Mar
2025-03-06,El Palacio de Los Jugos / Casa mía Food Restaurant inc,Invoice,008-05018,Arroz a Granel:Parboiled 50 LB -Bolsa Dos Hermanos.,,1.0,27.75,27.75,3983373.97999999,Bulk Rice,Lisset Limpio -020,Cafeteria,1387559,Mar
2025-03-06,El Palacio de los jugos / Delicias Criollas (DIAGO FOOD_MILLER),Invoice,008-05019,Arroz a Granel:Parboiled 50 LB -Bolsa Dos Hermanos.,,11.0,27.75,305.25,3983679.22999999,Bulk Rice,Lisset Limpio -020,Cafeteria,1387560,Mar
2025-03-06,El Palacio de los jugos / Delicias Criollas (DIAGO FOOD_MILLER),Invoice,008-05019,Arroz a Granel:Largo Fino 50 LB -Bolsa Dos Hermanos.,,5.0,27.85,139.25,3983818.47999999,Bulk Rice,Lisset Limpio -020,Cafeteria,1387561,Mar
2025-03-06,El Palacio de los jugos / Delicias Criollas (DIAGO FOOD_MILLER),Invoice,008-05019,Arroz a Granel:Parboiled 50 LB -Bolsa Dos Hermanos.,,1.0,27.75,27.75,3983846.22999999,Bulk Rice,Lisset Limpio -020,Cafeteria,1387562,Mar
2025-03-06,El Palacio de los jugos / Delicias Criollas (DIAGO FOOD_MILLER),Invoice,008-05019,Liquids:AS Bitter Orange,,1.0,15.9,15.9,3983862.12999999,American Spice,Lisset Limpio -020,Cafeteria,1387563,Mar
2025-03-06,Sedanos Supermarkets  #37,Invoice,008-05020,Arroz a Granel:Largo Fino 50 LB -Bolsa Dos Hermanos.,,3.0,27.85,83.55,3983945.67999999,Bulk Rice,Keila Alfaro-Visvikis,RETAIL SEDANOS,1387564,Mar
2025-03-06,Sedanos Supermarkets  #37,Invoice,008-05020,Arroz a Granel:Parboiled 50 LB -Bolsa Dos Hermanos.,,5.0,28.25,141.25,3984086.92999999,Bulk Rice,Keila Alfaro-Visvikis,RETAIL SEDANOS,1387565,Mar
2025-03-06,Sedanos Supermarkets  #37,Invoice,008-05020,,Discount,,,-4.8,3984082.12999999,,Keila Alfaro-Visvikis,RETAIL SEDANOS,1387566,Mar
2025-03-06,Sedanos Supermarkets  #37,Invoice,008-05021,Arroz Envasado:Largo Fino 1kg (Long grain rice) Dos Hermanos,,1.0,17.5,17.5,3984099.62999999,Branded Rice,Keila Alfaro-Visvikis,RETAIL SEDANOS,1387567,Mar
2025-03-06,Sedanos Supermarkets  #37,Invoice,008-05021,Varios:Promotional Allowance,10 / 1k,1.0,-2.5,-2.5,3984097.12999999,Branded Rice,Keila Alfaro-Visvikis,RETAIL SEDANOS,1387568,Mar
2025-03-06,Sedanos Supermarkets #18,Invoice,008-05022,Arroz a Granel:Parboiled 50 LB -Bolsa Dos Hermanos.,,6.0,28.25,169.5,3984266.62999999,Bulk Rice,Keila Alfaro-Visvikis,RETAIL SEDANOS,1387569,Mar
2025-03-06,Sedanos Supermarkets #18,Invoice,008-05022,,Discount,,,-3.39,3984263.23999999,,Keila Alfaro-Visvikis,RETAIL SEDANOS,1387570,Mar
2025-03-06,Sedanos Supermarkets #18,Invoice,008-05023,Arroz Envasado:Largo Fino 1kg (Long grain rice) Dos Hermanos,,2.0,17.5,35.0,3984298.23999999,Branded Rice,Keila Alfaro-Visvikis,RETAIL SEDANOS,1387571,Mar
2025-03-06,Sedanos Supermarkets #18,Invoice,008-05023,Varios:Promotional Allowance,,2.0,-2.5,-5.0,3984293.23999999,Branded Rice,Keila Alfaro-Visvikis,RETAIL SEDANOS,1387572,Mar
2025-03-06,Sedanos Supermarkets #18,Invoice,008-05023,,Discount,,,-0.6,3984292.63999999,,Keila Alfaro-Visvikis,RETAIL SEDANOS,1387573,Mar
2025-03-06,Fritanga Momotombo,Invoice,008-05024,Arroz a Granel:Largo Fino 50 LB -Bolsa Dos Hermanos.,,6.0,27.85,167.1,3984459.73999999,Bulk Rice,Lisset Limpio -020,CAFETERIA y RESTAURANTS,1387574,Mar
2025-03-06,Fritanga Momotombo,Invoice,008-05024,Dry Beans:Dry Beans - Small Red Beans 50 lbs.,Small Red Beans 50 lbs,1.0,42.0,42.0,3984501.73999999,Dry Beans,Lisset Limpio -020,CAFETERIA y RESTAURANTS,1387575,Mar
2025-03-06,Bravo   Francisco Diaz,Invoice,008-05025,Liquids:AS Cooking Wine,4 1 Gl.,3.0,17.5,52.5,3984554.23999999,American Spice,Lisset Limpio -020,RETAIL  DSD,1387576,Mar
2025-03-06,Bravo   Francisco Diaz,Invoice,008-05025,Liquids:AS Marinating Sauce (Mojo),,2.0,18.5,37.0,3984591.23999999,American Spice,Lisset Limpio -020,RETAIL  DSD,1387577,Mar
2025-03-06,Bravo   Francisco Diaz,Invoice,008-05025,Spices:AS Chicken Base,1 / 30 lb. (box or pail),1.0,39.0,39.0,3984630.23999999,American Spice,Lisset Limpio -020,RETAIL  DSD,1387578,Mar
2025-03-06,Bravo   Francisco Diaz,Invoice,008-05025,Arroz a Granel:Largo Fino 50 LB -Bolsa Dos Hermanos.,,3.0,27.85,83.55,3984713.78999999,Bulk Rice,Lisset Limpio -020,RETAIL  DSD,1387579,Mar
2025-03-06,El Palacio de los jugos / Rodriguez Foods,Invoice,008-05026,Dry Beans:Dry Beans - Black Beans 50,Dry Black Beans 50 lb,1.0,36.75,36.75,3984750.53999999,Dry Beans,Lisset Limpio -020,Cafeteria,1387580,Mar
2025-03-06,El Palacio de los jugos / Rodriguez Foods,Invoice,008-05026,Arroz a Granel:Parboiled 50 LB -Bolsa Dos Hermanos.,,10.0,26.75,267.5,3985018.03999999,Bulk Rice,Lisset Limpio -020,Cafeteria,1387581,Mar
2025-03-06,El Palacio de los jugos / Rodriguez Foods,Invoice,008-05027,Arroz a Granel:Parboiled 50 LB -Bolsa Dos Hermanos.,,2.0,26.75,53.5,3985071.53999999,Bulk Rice,Lisset Limpio -020,Cafeteria,1387582,Mar
2025-03-06,El Palacio de Los Jugos / Casa mía Food Restaurant inc,Credit Memo,008-05049,Varios:Promotional Allowance,Arroz a Granel:Parboiled 50 LB -Bolsa Dos Hermanos.,-1.0,27.75,-27.75,3985043.78999999,Bulk Rice,Lisset Limpio -020,Cafeteria,1387583,Mar
2025-03-06,El Palacio de los jugos / Delicias Criollas (DIAGO FOOD_MILLER),Credit Memo,008-05050,Varios:Promotional Allowance,Arroz a Granel:Parboiled 50 LB -Bolsa Dos Hermanos.,-1.0,27.75,-27.75,3985016.03999999,Bulk Rice,Lisset Limpio -020,Cafeteria,1387584,Mar
2025-03-07,Sedanos Supermarkets #5,Credit Memo,008-05028,Varios:Producto vencido/deteriorado (no impacta en inventario),,-1.0,21.63,-21.63,3984994.40999999,,Keila Alfaro-Visvikis,RETAIL SEDANOS,1387585,Mar
2025-03-07,Sedanos Supermarkets #31,Credit Memo,008-05029,Varios:Producto vencido/deteriorado (no impacta en inventario),,-1.0,0.75,-0.75,3984993.65999999,,Keila Alfaro-Visvikis,RETAIL SEDANOS,1387586,Mar
2025-03-09,El Palacio de los jugos /  Nanos Latin Foods,Invoice,008-05031,Arroz a Granel:Parboiled 50 LB -Bolsa Dos Hermanos.,,10.0,26.75,267.5,3985261.15999999,Bulk Rice,Lisset Limpio -020,Cafeteria,1387587,Mar
2025-03-09,Be Your Will LLC,Invoice,008-05032,Liquids:AS Cooking Wine,4 1 Gl.,2.0,17.5,35.0,3985296.15999999,American Spice,Lisset Limpio -020,CAFETERIA y RESTAURANTS,1387588,Mar
2025-03-09,Be Your Will LLC,Invoice,008-05032,Arroz a Granel:Largo Fino 50 LB -Bolsa Dos Hermanos.,,7.0,27.85,194.95,3985491.10999999,Bulk Rice,Lisset Limpio -020,CAFETERIA y RESTAURANTS,1387589,Mar
2025-03-09,Be Your Will LLC,Invoice,008-05032,Arroz a Granel:Parboiled 50 LB -Bolsa Dos Hermanos.,,11.0,27.75,305.25,3985796.35999999,Bulk Rice,Lisset Limpio -020,CAFETERIA y RESTAURANTS,1387590,Mar
2025-03-09,Be Your Will LLC,Invoice,008-05032,Arroz a Granel:Parboiled 50 LB -Bolsa Dos Hermanos.,,1.0,27.75,27.75,3985824.10999999,Bulk Rice,Lisset Limpio -020,CAFETERIA y RESTAURANTS,1387591,Mar
2025-03-09,El Palacio de los jugos / Caribe Tropical,Invoice,008-05033,Arroz a Granel:Parboiled 50 LB -Bolsa Dos Hermanos.,,8.0,26.75,214.0,3986038.10999999,Bulk Rice,Lisset Limpio -020,Cafeteria,1387592,Mar
2025-03-09,El Palacio de los jugos / Lita Foods Inc.,Invoice,008-05034,Dry Beans:Dry Beans - Black Beans 50,Dry Black Beans 50 lb,1.0,45.7,45.7,3986083.80999999,Dry Beans,Lisset Limpio -020,Cafeteria,1387593,Mar
2025-03-09,El Palacio de los jugos / Lita Foods Inc.,Invoice,008-05034,Arroz a Granel:Parboiled 50 LB -Bolsa Dos Hermanos.,,11.0,27.75,305.25,3986389.05999999,Bulk Rice,Lisset Limpio -020,Cafeteria,1387594,Mar
2025-03-09,El Palacio de los jugos / Lita Foods Inc.,Invoice,008-05034,Arroz a Granel:Parboiled 50 LB -Bolsa Dos Hermanos.,,1.0,27.75,27.75,3986416.80999999,Bulk Rice,Lisset Limpio -020,Cafeteria,1387595,Mar
2025-03-09,Panda Depot,Invoice,008-05035,Arroz a Granel:Parboiled 50 LB -Bolsa Dos Hermanos.,,110.0,25.0,2750.0,3989166.80999999,Bulk Rice,Lisset Limpio -020,WHOLESALER,1387596,Mar
2025-03-09,Panda Depot,Invoice,008-05035,Arroz a Granel:Largo Fino 50 LB -Bolsa Dos Hermanos.,,110.0,24.5,2695.0,3991861.80999999,Bulk Rice,Lisset Limpio -020,WHOLESALER,1387597,Mar
2025-03-09,Sedanos Supermarkets  #4,Invoice,008-05036,Arroz Envasado:Largo Fino 1kg (Long grain rice) Dos Hermanos,,2.0,17.5,35.0,3991896.80999999,Branded Rice,Keila Alfaro-Visvikis,RETAIL SEDANOS,1387598,Mar
2025-03-09,Sedanos Supermarkets  #4,Invoice,008-05036,Arroz Envasado:Parboiled 1kg Bolsa Dos Hermanos.,.,3.0,19.9,59.7,3991956.50999999,Branded Rice,Keila Alfaro-Visvikis,RETAIL SEDANOS,1387599,Mar
2025-03-09,Sedanos Supermarkets  #4,Invoice,008-05036,Arroz Envasado:Parboiled 5KG Dos Hermanos.,6  11lbs,5.0,40.5,202.5,3992159.00999999,Branded Rice,Keila Alfaro-Visvikis,RETAIL SEDANOS,1387600,Mar
2025-03-09,Sedanos Supermarkets  #4,Invoice,008-05036,Varios:Promotional Allowance,,5.0,-11.15,-55.75,3992103.25999999,Branded Rice,Keila Alfaro-Visvikis,RETAIL SEDANOS,1387601,Mar
2025-03-09,Sedanos Supermarkets  #4,Invoice,008-05036,Varios:Promotional Allowance,,1.0,-2.5,-2.5,3992100.75999999,Branded Rice,Keila Alfaro-Visvikis,RETAIL SEDANOS,1387602,Mar
2025-03-09,Sedanos Supermarkets  #4,Invoice,008-05036,,Discount,,,-4.78,3992095.97999999,,Keila Alfaro-Visvikis,RETAIL SEDANOS,1387603,Mar
2025-03-09,Sedanos Supermarkets #7,Invoice,008-05037,Arroz Envasado:Largo Fino 1kg (Long grain rice) Dos Hermanos,,2.0,18.0,36.0,3992131.97999999,Branded Rice,Keila Alfaro-Visvikis,RETAIL SEDANOS,1387604,Mar
2025-03-09,Sedanos Supermarkets #7,Invoice,008-05037,Arroz Envasado:Parboiled 1kg Bolsa Dos Hermanos.,.,3.0,19.9,59.7,3992191.67999999,Branded Rice,Keila Alfaro-Visvikis,RETAIL SEDANOS,1387605,Mar
2025-03-09,Sedanos Supermarkets #7,Invoice,008-05037,Varios:Promotional Allowance,,2.0,-2.5,-5.0,3992186.67999999,Branded Rice,Keila Alfaro-Visvikis,RETAIL SEDANOS,1387606,Mar
2025-03-09,Sedanos Supermarkets #7,Invoice,008-05037,,Discount,,,-7.69,3992178.98999999,,Keila Alfaro-Visvikis,RETAIL SEDANOS,1387607,Mar
2025-03-09,Sedanos Supermarkets #23,Invoice,008-05038,Arroz Envasado:Parboiled 1kg Bolsa Dos Hermanos.,.,1.0,19.9,19.9,3992198.88999999,Branded Rice,Keila Alfaro-Visvikis,RETAIL SEDANOS,1387608,Mar
2025-03-09,Sedanos Supermarkets #23,Invoice,008-05038,Arroz Envasado:Parboiled 5KG Dos Hermanos.,6  11lbs,5.0,40.5,202.5,3992401.38999999,Branded Rice,Keila Alfaro-Visvikis,RETAIL SEDANOS,1387609,Mar
2025-03-09,Sedanos Supermarkets #23,Invoice,008-05038,Arroz Envasado:Largo Fino 1kg (Long grain rice) Dos Hermanos,,1.0,17.5,17.5,3992418.88999999,Branded Rice,Keila Alfaro-Visvikis,RETAIL SEDANOS,1387610,Mar
2025-03-09,Sedanos Supermarkets #23,Invoice,008-05038,Varios:Promotional Allowance,,1.0,-2.5,-2.5,3992416.38999999,Branded Rice,Keila Alfaro-Visvikis,RETAIL SEDANOS,1387611,Mar
2025-03-09,Sedanos Supermarkets #23,Invoice,008-05038,Varios:Promotional Allowance,,5.0,-11.15,-55.75,3992360.63999999,Branded Rice,Keila Alfaro-Visvikis,RETAIL SEDANOS,1387612,Mar
2025-03-09,Sedanos Supermarkets #23,Invoice,008-05038,,Discount,,,-5.68,3992354.95999999,,Keila Alfaro-Visvikis,RETAIL SEDANOS,1387613,Mar
2025-03-09,Sedanos Supermarkets #14,Invoice,008-05039,Arroz Envasado:Largo Fino 1kg (Long grain rice) Dos Hermanos,,2.0,17.5,35.0,3992389.95999999,Branded Rice,Keila Alfaro-Visvikis,RETAIL SEDANOS,1387614,Mar
2025-03-09,Sedanos Supermarkets #14,Invoice,008-05039,Arroz Envasado:Parboiled 1kg Bolsa Dos Hermanos.,.,3.0,19.9,59.7,3992449.65999999,Branded Rice,Keila Alfaro-Visvikis,RETAIL SEDANOS,1387615,Mar
2025-03-09,Sedanos Supermarkets #14,Invoice,008-05039,Varios:Promotional Allowance,,2.0,-2.5,-5.0,3992444.65999999,Branded Rice,Keila Alfaro-Visvikis,RETAIL SEDANOS,1387616,Mar
2025-03-09,Sedanos Supermarkets #14,Invoice,008-05039,,Discount,,,-1.79,3992442.86999999,,Keila Alfaro-Visvikis,RETAIL SEDANOS,1387617,Mar
2025-03-09,Sedanos Supermarkets #17,Invoice,008-05040,Rice Snack:Rice Snack Ham Flavored DOS HERMANOS,,1.0,19.9,19.9,3992462.76999999,Puffed Products,Keila Alfaro-Visvikis,RETAIL SEDANOS,1387618,Mar
2025-03-09,Sedanos Supermarkets #17,Invoice,008-05040,Rice Snack:Rice Snack Salami Flavored DOS HERMANOS,,1.0,19.9,19.9,3992482.66999999,Puffed Products,Keila Alfaro-Visvikis,RETAIL SEDANOS,1387619,Mar
2025-03-09,Sedanos Supermarkets #17,Invoice,008-05040,Rice Snack:Rice Snack Ham Flavored DOS HERMANOS,,1.0,19.9,19.9,3992502.56999999,Puffed Products,Keila Alfaro-Visvikis,RETAIL SEDANOS,1387620,Mar
2025-03-09,Sedanos Supermarkets #17,Invoice,008-05040,,Discount,,,-0.8,3992501.76999999,,Keila Alfaro-Visvikis,RETAIL SEDANOS,1387621,Mar
2025-03-09,JMN Dely Corp,Invoice,008-05041,Dry Beans:Dry Beans - Black Beans 50,Dry Black Beans 50 lb,1.0,45.7,45.7,3992547.46999999,Dry Beans,Keila Alfaro-Visvikis,CAFETERIA y RESTAURANTS,1387622,Mar
2025-03-09,JMN Dely Corp,Invoice,008-05041,Arroz a Granel:Largo Fino 50 LB -Bolsa Dos Hermanos.,,2.0,27.85,55.7,3992603.16999999,Bulk Rice,Keila Alfaro-Visvikis,CAFETERIA y RESTAURANTS,1387623,Mar
2025-03-09,JMN Dely Corp,Invoice,008-05041,Arroz a Granel:Parboiled 50 LB -Bolsa Dos Hermanos.,,2.0,27.75,55.5,3992658.66999999,Bulk Rice,Keila Alfaro-Visvikis,CAFETERIA y RESTAURANTS,1387624,Mar
2025-03-09,Sedanos Supermarkets #14,Invoice,008-05042,Arroz a Granel:Parboiled 50 LB -Bolsa Dos Hermanos.,,2.0,28.25,56.5,3992715.16999999,Bulk Rice,Keila Alfaro-Visvikis,RETAIL SEDANOS,1387625,Mar
2025-03-09,Sedanos Supermarkets #14,Invoice,008-05042,,Discount,,,-1.13,3992714.03999999,,Keila Alfaro-Visvikis,RETAIL SEDANOS,1387626,Mar
2025-03-09,Sedanos Supermarkets #17,Credit Memo,008-05051,Varios:Promotional Allowance,Rice Snack:Rice Snack Ham Flavored DOS HERMANOS,-1.0,19.9,-19.9,3992694.13999999,Puffed Products,Keila Alfaro-Visvikis,RETAIL SEDANOS,1387627,Mar
2025-03-09,Be Your Will LLC,Credit Memo,008-05052,Varios:Promotional Allowance,Arroz a Granel:Parboiled 50 LB -Bolsa Dos Hermanos.,-1.0,27.75,-27.75,3992666.38999999,Bulk Rice,Lisset Limpio -020,CAFETERIA y RESTAURANTS,1387628,Mar
2025-03-09,El Palacio de los jugos / Lita Foods Inc.,Credit Memo,008-05053,Varios:Promotional Allowance,Arroz a Granel:Parboiled 50 LB -Bolsa Dos Hermanos.,-1.0,27.75,-27.75,3992638.63999999,Bulk Rice,Lisset Limpio -020,Cafeteria,1387629,Mar
2025-03-10,El Palacio de los jugos / Rodriguez Foods,Invoice,008-05043,Arroz a Granel:Parboiled 50 LB -Bolsa Dos Hermanos.,,5.0,27.75,138.75,3992777.38999999,Bulk Rice,Lisset Limpio -020,Cafeteria,1387630,Mar
2025-03-10,El Palacio de los jugos /  EMMA FOOD CORP,Invoice,008-05044,Arroz a Granel:Largo Fino 50 LB -Bolsa Dos Hermanos.,,6.0,27.85,167.1,3992944.48999999,Bulk Rice,Lisset Limpio -020,Cafeteria,1387631,Mar
2025-03-10,Chavez Distributors Inc.,Invoice,008-05045,Arroz a Granel:Parboiled 50 LB -Bolsa Dos Hermanos.,,55.0,27.75,1526.25,3994470.73999999,Bulk Rice,Keila Alfaro-Visvikis,WHOLESALER,1387632,Mar
2025-03-10,Soriano Brothers PB,Invoice,008-05046,Arroz a Granel:Largo Fino 50 LB -Bolsa Dos Hermanos.,,17.0,27.85,473.45,3994944.18999999,Bulk Rice,Lisset Limpio -020,CAFETERIA y RESTAURANTS,1387633,Mar
2025-03-10,Soriano Brothers PB,Invoice,008-05046,Arroz a Granel:Parboiled 50 LB -Bolsa Dos Hermanos.,,15.0,26.75,401.25,3995345.43999999,Bulk Rice,Lisset Limpio -020,CAFETERIA y RESTAURANTS,1387634,Mar
2025-03-10,Soriano Brothers PB,Invoice,008-05046,Spices:AS Sazon (for all),1 / 30 lb (box or pail),2.0,51.0,102.0,3995447.43999999,American Spice,Lisset Limpio -020,CAFETERIA y RESTAURANTS,1387635,Mar
2025-03-10,Soriano Brothers PB,Invoice,008-05046,Spices:AS Chicken Base,1 / 30 lb. (box or pail),4.0,39.0,156.0,3995603.43999999,American Spice,Lisset Limpio -020,CAFETERIA y RESTAURANTS,1387636,Mar
2025-03-10,Soriano Brothers PB,Invoice,008-05046,Dry Beans:Dry Beans - Black Beans 50,Dry Black Beans 50 lb,2.0,36.75,73.5,3995676.93999999,Dry Beans,Lisset Limpio -020,CAFETERIA y RESTAURANTS,1387637,Mar
2025-03-11,Festival Supermarket,Credit Memo,008-05054,Varios:Producto vencido/deteriorado (no impacta en inventario),6 unidades a 3.87 5kg,-1.0,23.22,-23.22,3995653.71999999,Branded Rice,Keila Alfaro-Visvikis,RETAIL  DSD,1387638,Mar
2025-03-12,Sedanos Supermarkets #27,Credit Memo,008-05056,Varios:Producto vencido/deteriorado (no impacta en inventario),"Sedanos, 27,17 Pizza, cinco sabor jamón",-22.0,1.49,-32.78,3995620.93999999,Puffed Products,Keila Alfaro-Visvikis,RETAIL SEDANOS,1387639,Mar
2025-03-12,Sedanos Supermarkets #33,Credit Memo,008-05057,Varios:Producto vencido/deteriorado (no impacta en inventario),"15salame
10pizza
1 jamón",-26.0,1.49,-38.74,3995582.19999999,Puffed Products,Keila Alfaro-Visvikis,RETAIL SEDANOS,1387640,Mar
2025-03-12,Sedanos Supermarkets #33,Credit Memo,008-05057,,Discount,38.74,,0.77,3995582.96999999,,Keila Alfaro-Visvikis,RETAIL SEDANOS,1387641,Mar
2025-03-12,Sedanos Supermarkets #34,Credit Memo,008-05058,Varios:Producto vencido/deteriorado (no impacta en inventario),"Crédito sed 34
10 pizza
8 salame",-18.0,1.49,-26.82,3995556.14999999,Puffed Products,Keila Alfaro-Visvikis,RETAIL SEDANOS,1387642,Mar
2025-03-12,Sedanos Supermarkets #16,Credit Memo,008-05059,Varios:Producto vencido/deteriorado (no impacta en inventario),"Crédito Sed 16

2 jamón
3 salme 
1 pizza",-6.0,1.49,-8.94,3995547.20999999,Puffed Products,Keila Alfaro-Visvikis,RETAIL SEDANOS,1387643,Mar
2025-03-12,Sedanos Supermarkets #16,Credit Memo,008-05059,Varios:Producto vencido/deteriorado (no impacta en inventario),8 parbo 2lb,-8.0,1.66,-13.28,3995533.93,Branded Rice,Keila Alfaro-Visvikis,RETAIL SEDANOS,1387644,Mar
2025-03-12,Sedanos Supermarkets #16,Credit Memo,008-05059,Varios:Producto vencido/deteriorado (no impacta en inventario),1 parbo 11lb,-1.0,4.89,-4.89,3995529.04,Branded Rice,Keila Alfaro-Visvikis,RETAIL SEDANOS,1387645,Mar
2025-03-12,Sedanos Supermarkets #20,Credit Memo,008-05060,Varios:Producto vencido/deteriorado (no impacta en inventario),"Crédito Sed 20
14 salame 
4 pizza",-18.0,1.49,-26.82,3995502.22,Puffed Products,Keila Alfaro-Visvikis,RETAIL SEDANOS,1387646,Mar
2025-03-12,Sedanos Supermarkets #16,Invoice,008-05061,Arroz a Granel:Parboiled 50 LB -Bolsa Dos Hermanos.,,5.0,28.25,141.25,3995643.47,Bulk Rice,Keila Alfaro-Visvikis,RETAIL SEDANOS,1387647,Mar
2025-03-12,Sedanos Supermarkets #16,Invoice,008-05061,,Discount,,,-2.83,3995640.64,,Keila Alfaro-Visvikis,RETAIL SEDANOS,1387648,Mar
2025-03-12,Sedanos Supermarkets #16,Invoice,008-05062,Arroz Envasado:Largo Fino 1kg (Long grain rice) Dos Hermanos,,1.0,17.5,17.5,3995658.14,Branded Rice,Keila Alfaro-Visvikis,RETAIL SEDANOS,1387649,Mar
2025-03-12,Sedanos Supermarkets #16,Invoice,008-05062,Arroz Envasado:Parboiled 1kg Bolsa Dos Hermanos.,.,1.0,19.9,19.9,3995678.04,Branded Rice,Keila Alfaro-Visvikis,RETAIL SEDANOS,1387650,Mar
2025-03-12,Sedanos Supermarkets #16,Invoice,008-05062,Rice Snack:Rice Snack Ham Flavored DOS HERMANOS,,1.0,19.9,19.9,3995697.93999999,Puffed Products,Keila Alfaro-Visvikis,RETAIL SEDANOS,1387651,Mar
2025-03-12,Sedanos Supermarkets #16,Invoice,008-05062,Rice Snack:Rice Snack Salami Flavored DOS HERMANOS,,1.0,19.9,19.9,3995717.83999999,Puffed Products,Keila Alfaro-Visvikis,RETAIL SEDANOS,1387652,Mar
2025-03-12,Sedanos Supermarkets #16,Invoice,008-05062,Rice Snack:Rice Snack Ham Flavored DOS HERMANOS,,1.0,19.9,19.9,3995737.73999999,Puffed Products,Keila Alfaro-Visvikis,RETAIL SEDANOS,1387653,Mar
2025-03-12,Sedanos Supermarkets #16,Invoice,008-05062,Rice Snack:Rice Snack Salami Flavored DOS HERMANOS,,1.0,19.9,19.9,3995757.63999999,Puffed Products,Keila Alfaro-Visvikis,RETAIL SEDANOS,1387654,Mar
2025-03-12,Sedanos Supermarkets #16,Invoice,008-05062,,Discount,,,-3.45,3995754.18999999,,Keila Alfaro-Visvikis,RETAIL SEDANOS,1387655,Mar
2025-03-12,Bravo   Francisco Diaz,Invoice,008-05063,Arroz a Granel:Largo Fino 50 LB -Bolsa Dos Hermanos.,,2.0,27.85,55.7,3995809.88999999,Bulk Rice,Lisset Limpio -020,RETAIL  DSD,1387656,Mar
2025-03-12,Sedanos Supermarkets #8,Invoice,008-05064,Arroz Envasado:Parboiled 1kg Bolsa Dos Hermanos.,.,1.0,19.9,19.9,3995829.78999999,Branded Rice,Keila Alfaro-Visvikis,RETAIL SEDANOS,1387657,Mar
2025-03-12,Sedanos Supermarkets #8,Invoice,008-05064,Arroz Envasado:Largo Fino 1kg (Long grain rice) Dos Hermanos,,1.0,17.5,17.5,3995847.28999999,Branded Rice,Keila Alfaro-Visvikis,RETAIL SEDANOS,1387658,Mar
2025-03-12,Sedanos Supermarkets #8,Invoice,008-05064,Varios:Promotional Allowance,,1.0,-2.5,-2.5,3995844.78999999,Branded Rice,Keila Alfaro-Visvikis,RETAIL SEDANOS,1387659,Mar
2025-03-12,Sedanos Supermarkets #8,Invoice,008-05064,Varios:Promotional Allowance,,10.0,-11.15,-111.5,3995733.28999999,Branded Rice,Keila Alfaro-Visvikis,RETAIL SEDANOS,1387660,Mar
2025-03-12,Sedanos Supermarkets #8,Invoice,008-05064,Arroz Envasado:Parboiled 5KG Dos Hermanos.,6  11lbs,10.0,40.5,405.0,3996138.28999999,Branded Rice,Keila Alfaro-Visvikis,RETAIL SEDANOS,1387661,Mar
2025-03-12,Sedanos Supermarkets #8,Invoice,008-05064,Arroz Envasado:Parboiled 5KG Dos Hermanos.,6  11lbs,1.0,40.5,40.5,3996178.78999999,Branded Rice,Keila Alfaro-Visvikis,RETAIL SEDANOS,1387662,Mar
2025-03-12,Sedanos Supermarkets #8,Invoice,008-05064,,Discount,,,-6.57,3996172.21999999,,Keila Alfaro-Visvikis,RETAIL SEDANOS,1387663,Mar
2025-03-12,Sedanos Supermarkets #22,Invoice,008-05065,Arroz a Granel:Parboiled 50 LB -Bolsa Dos Hermanos.,,4.0,28.25,113.0,3996285.21999999,Bulk Rice,Keila Alfaro-Visvikis,RETAIL SEDANOS,1387664,Mar
2025-03-12,Sedanos Supermarkets #22,Invoice,008-05065,,Discount,,,-2.26,3996282.95999999,,Keila Alfaro-Visvikis,RETAIL SEDANOS,1387665,Mar
2025-03-12,Aries Supermarket & Cafeteria,Invoice,008-05066,Dry Beans:Dry Beans - Black Beans 50,Dry Black Beans 50 lb,3.0,36.5,109.5,3996392.45999999,Dry Beans,Keila Alfaro-Visvikis,CAFETERIA y RESTAURANTS,1387666,Mar
2025-03-12,Aries Supermarket & Cafeteria,Invoice,008-05066,Arroz a Granel:Parboiled 50 LB -Bolsa Dos Hermanos.,,8.0,28.25,226.0,3996618.45999999,Bulk Rice,Keila Alfaro-Visvikis,CAFETERIA y RESTAURANTS,1387667,Mar
2025-03-12,Aries Supermarket & Cafeteria,Invoice,008-05066,Liquids:AS Bitter Orange,,2.0,15.9,31.8,3996650.25999999,American Spice,Keila Alfaro-Visvikis,CAFETERIA y RESTAURANTS,1387668,Mar
2025-03-12,Aries Supermarket & Cafeteria,Invoice,008-05066,Liquids:AS Cooking Wine,4 1 Gl.,2.0,17.5,35.0,3996685.25999999,American Spice,Keila Alfaro-Visvikis,CAFETERIA y RESTAURANTS,1387669,Mar
2025-03-12,Aries Supermarket & Cafeteria,Invoice,008-05066,Spices:AS Oregano Ground,4 / 3.5 Lbs.,1.0,37.5,37.5,3996722.75999999,American Spice,Keila Alfaro-Visvikis,CAFETERIA y RESTAURANTS,1387670,Mar
2025-03-12,Sedanos Supermarkets #28,Invoice,008-05067,Arroz Envasado:Parboiled 5KG Dos Hermanos.,6  11lbs,10.0,40.5,405.0,3997127.75999999,Branded Rice,Keila Alfaro-Visvikis,RETAIL SEDANOS,1387671,Mar
2025-03-12,Sedanos Supermarkets #28,Invoice,008-05067,Arroz Envasado:Largo Fino 1kg (Long grain rice) Dos Hermanos,,1.0,17.5,17.5,3997145.25999999,Branded Rice,Keila Alfaro-Visvikis,RETAIL SEDANOS,1387672,Mar
2025-03-12,Sedanos Supermarkets #28,Invoice,008-05067,Arroz Envasado:Parboiled 1kg Bolsa Dos Hermanos.,.,1.0,19.9,19.9,3997165.15999999,Branded Rice,Keila Alfaro-Visvikis,RETAIL SEDANOS,1387673,Mar
2025-03-12,Sedanos Supermarkets #28,Invoice,008-05067,Varios:Promotional Allowance,,10.0,-11.15,-111.5,3997053.65999999,Branded Rice,Keila Alfaro-Visvikis,RETAIL SEDANOS,1387674,Mar
2025-03-12,Sedanos Supermarkets #28,Invoice,008-05067,Arroz Envasado:Parboiled 5KG Dos Hermanos.,6  11lbs,1.0,40.5,40.5,3997094.15999999,Branded Rice,Keila Alfaro-Visvikis,RETAIL SEDANOS,1387675,Mar
2025-03-12,Sedanos Supermarkets #28,Invoice,008-05067,Varios:Promotional Allowance,,1.0,-2.5,-2.5,3997091.65999999,Branded Rice,Keila Alfaro-Visvikis,RETAIL SEDANOS,1387676,Mar
2025-03-12,Sedanos Supermarkets #28,Invoice,008-05067,,Discount,,,-6.57,3997085.08999999,,Keila Alfaro-Visvikis,RETAIL SEDANOS,1387677,Mar
2025-03-12,Ideal Food Basket Davie Cafeteria,Invoice,008-05068,Arroz a Granel:Largo Fino 50 LB -Bolsa Dos Hermanos.,,10.0,27.85,278.5,3997363.58999999,Bulk Rice,Keila Alfaro-Visvikis,CAFETERIA y RESTAURANTS,1387678,Mar
2025-03-12,Sedanos Supermarkets #34,Invoice,008-05069,Arroz Envasado:Largo Fino 1kg (Long grain rice) Dos Hermanos,,0.0,,0.0,3997363.58999999,Branded Rice,Keila Alfaro-Visvikis,RETAIL SEDANOS,1387679,Mar
2025-03-12,Sedanos Supermarkets #34,Invoice,008-05069,Arroz Envasado:Parboiled 1kg Bolsa Dos Hermanos.,.,0.0,,0.0,3997363.58999999,Branded Rice,Keila Alfaro-Visvikis,RETAIL SEDANOS,1387680,Mar
2025-03-12,Sedanos Supermarkets #34,Invoice,008-05069,Varios:Promotional Allowance,,0.0,,0.0,3997363.58999999,Branded Rice,Keila Alfaro-Visvikis,RETAIL SEDANOS,1387681,Mar
2025-03-12,Pacifico Chinese Restaurant,Invoice,008-05070,Arroz a Granel:Parboiled 50 LB -Bolsa Dos Hermanos.,,10.0,28.25,282.5,3997646.08999999,Bulk Rice,Lisset Limpio -020,CAFETERIA y RESTAURANTS,1387682,Mar
2025-03-12,Los Caringas Latin America  Foods,Invoice,008-05071,Arroz a Granel:Largo Fino 50 LB -Bolsa Dos Hermanos.,,3.0,27.85,83.55,3997729.63999999,Bulk Rice,Lisset Limpio -020,CAFETERIA y RESTAURANTS,1387683,Mar
2025-03-12,Los Caringas Latin America  Foods,Invoice,008-05071,Arroz a Granel:Parboiled 50 LB -Bolsa Dos Hermanos.,,3.0,28.25,84.75,3997814.38999999,Bulk Rice,Lisset Limpio -020,CAFETERIA y RESTAURANTS,1387684,Mar
2025-03-12,Sedanos Supermarkets #27,Invoice,008-05072,Arroz a Granel:Parboiled 50 LB -Bolsa Dos Hermanos.,,6.0,28.25,169.5,3997983.88999999,Bulk Rice,Keila Alfaro-Visvikis,RETAIL SEDANOS,1387685,Mar
2025-03-12,Sedanos Supermarkets #27,Invoice,008-05072,,Discount,,,-2.73,3997981.15999999,,Keila Alfaro-Visvikis,RETAIL SEDANOS,1387686,Mar
2025-03-12,Sedanos Supermarkets #27,Invoice,008-05073,Arroz Envasado:Parboiled 5KG Dos Hermanos.,6  11lbs,5.0,40.5,202.5,3998183.65999999,Branded Rice,Keila Alfaro-Visvikis,RETAIL SEDANOS,1387687,Mar
2025-03-12,Sedanos Supermarkets #27,Invoice,008-05073,Varios:Promotional Allowance,,5.0,-11.15,-55.75,3998127.90999999,Branded Rice,Keila Alfaro-Visvikis,RETAIL SEDANOS,1387688,Mar
2025-03-12,Sedanos Supermarkets #27,Invoice,008-05073,,Discount,,,-2.94,3998124.96999999,,Keila Alfaro-Visvikis,RETAIL SEDANOS,1387689,Mar
2025-03-12,Sedanos Supermarkets #24,Invoice,008-05074,Arroz Envasado:Largo Fino 1kg (Long grain rice) Dos Hermanos,,0.0,,0.0,3998124.96999999,Branded Rice,Keila Alfaro-Visvikis,RETAIL SEDANOS,1387690,Mar
2025-03-12,Sedanos Supermarkets #24,Invoice,008-05074,Arroz Envasado:Parboiled 5KG Dos Hermanos.,6  11lbs,0.0,,0.0,3998124.96999999,Branded Rice,Keila Alfaro-Visvikis,RETAIL SEDANOS,1387691,Mar
2025-03-12,Sedanos Supermarkets #24,Invoice,008-05074,Varios:Promotional Allowance,,0.0,,0.0,3998124.96999999,Branded Rice,Keila Alfaro-Visvikis,RETAIL SEDANOS,1387692,Mar
2025-03-12,Sedanos Supermarkets #24,Invoice,008-05074,Varios:Promotional Allowance,,0.0,,0.0,3998124.96999999,Branded Rice,Keila Alfaro-Visvikis,RETAIL SEDANOS,1387693,Mar
2025-03-12,Sedanos Supermarkets #20,Invoice,008-05075,Arroz Envasado:Largo Fino 1kg (Long grain rice) Dos Hermanos,,2.0,18.0,36.0,3998160.96999999,Branded Rice,Keila Alfaro-Visvikis,RETAIL SEDANOS,1387694,Mar
2025-03-12,Sedanos Supermarkets #20,Invoice,008-05075,Arroz Envasado:Parboiled 1kg Bolsa Dos Hermanos.,.,3.0,19.9,59.7,3998220.66999999,Branded Rice,Keila Alfaro-Visvikis,RETAIL SEDANOS,1387695,Mar
2025-03-12,Sedanos Supermarkets #20,Invoice,008-05075,Arroz Envasado:Parboiled 5KG Dos Hermanos.,6  11lbs,5.0,40.5,202.5,3998423.16999999,Branded Rice,Keila Alfaro-Visvikis,RETAIL SEDANOS,1387696,Mar
2025-03-12,Sedanos Supermarkets #20,Invoice,008-05075,Rice Snack:Rice Snack Ham Flavored DOS HERMANOS,,1.0,19.9,19.9,3998443.06999999,Puffed Products,Keila Alfaro-Visvikis,RETAIL SEDANOS,1387697,Mar
2025-03-12,Sedanos Supermarkets #20,Invoice,008-05075,Rice Snack:Rice Snack Salami Flavored DOS HERMANOS,,1.0,19.9,19.9,3998462.96999999,Puffed Products,Keila Alfaro-Visvikis,RETAIL SEDANOS,1387698,Mar
2025-03-12,Sedanos Supermarkets #20,Invoice,008-05075,Varios:Promotional Allowance,,1.0,-2.5,-2.5,3998460.46999999,Branded Rice,Keila Alfaro-Visvikis,RETAIL SEDANOS,1387699,Mar
2025-03-12,Sedanos Supermarkets #20,Invoice,008-05075,Varios:Promotional Allowance,,5.0,-11.15,-55.75,3998404.71999999,Branded Rice,Keila Alfaro-Visvikis,RETAIL SEDANOS,1387700,Mar
2025-03-12,Sedanos Supermarkets #20,Invoice,008-05075,,Discount,,,-10.94,3998393.77999999,,Keila Alfaro-Visvikis,RETAIL SEDANOS,1387701,Mar
2025-03-12,Key Food / Holywood,Invoice,008-05076,Arroz Envasado:Largo Fino 1kg (Long grain rice) Dos Hermanos,,10.0,18.0,180.0,3998573.77999999,Branded Rice,Keila Alfaro-Visvikis,RETAIL  DSD,1387702,Mar
2025-03-12,Key Food / Holywood,Invoice,008-05076,Arroz Envasado:Sushi Rice Dos Hermanos.,.,1.0,21.0,21.0,3998594.77999999,Branded Rice,Keila Alfaro-Visvikis,RETAIL  DSD,1387703,Mar
2025-03-12,Key Food / Holywood,Invoice,008-05076,Arroz Envasado:Largo Fino 1kg (Long grain rice) Dos Hermanos,,2.0,18.0,36.0,3998630.77999999,Branded Rice,Keila Alfaro-Visvikis,RETAIL  DSD,1387704,Mar
2025-03-12,Sedanos Supermarkets #28,Credit Memo,008-05094,Varios:Promotional Allowance,Arroz Envasado:Parboiled 5KG Dos Hermanos.,-1.0,40.5,-40.5,3998590.27999999,Branded Rice,Keila Alfaro-Visvikis,RETAIL SEDANOS,1387705,Mar
2025-03-13,Bravo Oakridge,Credit Memo,008-05077,Varios:Promotional Allowance,Arroz Envasado:Parboiled 5KG Dos Hermanos.,-25.0,10.0,-250.0,3998340.27999999,Branded Rice,# Orlando 0024,RETAIL  DSD,1387706,Mar
2025-03-13,Bravo Oakridge,Credit Memo,008-05077,Varios:Promotional Allowance,Arroz a Granel:Parboiled 50 LB -Bolsa Dos Hermanos.,-10.0,2.25,-22.5,3998317.77999999,Bulk Rice,# Orlando 0024,RETAIL  DSD,1387707,Mar
2025-03-13,El Palacio de los jugos / Leti Corp.,Invoice,008-05078,Arroz a Granel:Largo Fino 50 LB -Bolsa Dos Hermanos.,,4.0,27.85,111.4,3998429.17999999,Bulk Rice,Lisset Limpio -020,Cafeteria,1387708,Mar
2025-03-13,El Palacio de los jugos / Leti Corp.,Invoice,008-05078,Arroz a Granel:Parboiled 50 LB -Bolsa Dos Hermanos.,,6.0,26.75,160.5,3998589.67999999,Bulk Rice,Lisset Limpio -020,Cafeteria,1387709,Mar
2025-03-13,El Palacio de los jugos / Delicias Criollas (DIAGO FOOD_MILLER),Invoice,008-05079,Dry Beans:Dry Beans - Black Beans 50,Dry Black Beans 50 lb,1.0,45.7,45.7,3998635.37999999,Dry Beans,Lisset Limpio -020,Cafeteria,1387710,Mar
2025-03-13,El Palacio de los jugos / Delicias Criollas (DIAGO FOOD_MILLER),Invoice,008-05079,Arroz a Granel:Largo Fino 50 LB -Bolsa Dos Hermanos.,,4.0,27.85,111.4,3998746.77999999,Bulk Rice,Lisset Limpio -020,Cafeteria,1387711,Mar
2025-03-13,El Palacio de los jugos / Delicias Criollas (DIAGO FOOD_MILLER),Invoice,008-05079,Arroz a Granel:Parboiled 50 LB -Bolsa Dos Hermanos.,,11.0,27.75,305.25,3999052.02999999,Bulk Rice,Lisset Limpio -020,Cafeteria,1387712,Mar
2025-03-13,El Palacio de los jugos / Delicias Criollas (DIAGO FOOD_MILLER),Invoice,008-05079,Arroz a Granel:Parboiled 50 LB -Bolsa Dos Hermanos.,,1.0,27.75,27.75,3999079.77999999,Bulk Rice,Lisset Limpio -020,Cafeteria,1387713,Mar
2025-03-13,El Palacio de los jugos /  Mires Restaurants,Invoice,008-05080,Liquids:AS Marinating Sauce (Mojo),,1.0,18.5,18.5,3999098.27999999,American Spice,Lisset Limpio -020,Cafeteria,1387714,Mar
2025-03-13,El Palacio de los jugos /  Mires Restaurants,Invoice,008-05080,Arroz a Granel:Parboiled 50 LB -Bolsa Dos Hermanos.,,11.0,27.75,305.25,3999403.52999999,Bulk Rice,Lisset Limpio -020,Cafeteria,1387715,Mar
2025-03-13,El Palacio de los jugos /  Mires Restaurants,Invoice,008-05080,Arroz a Granel:Parboiled 50 LB -Bolsa Dos Hermanos.,,1.0,27.75,27.75,3999431.27999999,Bulk Rice,Lisset Limpio -020,Cafeteria,1387716,Mar
2025-03-13,El Gallego Supermarket,Invoice,008-05081,Dry Beans:Dry Beans - Small Red Beans 50 lbs.,Small Red Beans 50 lbs,1.0,42.0,42.0,3999473.27999999,Dry Beans,Lisset Limpio -020,RETAIL  DSD,1387717,Mar
2025-03-13,El Gallego Supermarket,Invoice,008-05081,Arroz a Granel:Parboiled 50 LB -Bolsa Dos Hermanos.,,5.0,28.25,141.25,3999614.52999999,Bulk Rice,Lisset Limpio -020,RETAIL  DSD,1387718,Mar
2025-03-13,El Gallego Supermarket,Invoice,008-05081,Dry Beans:Dry Beans - Black Beans 50,Dry Black Beans 50 lb,2.0,45.7,91.4,3999705.92999999,Dry Beans,Lisset Limpio -020,RETAIL  DSD,1387719,Mar
2025-03-13,El Palacio de los jugos /  Nanos Latin Foods,Invoice,008-05082,Arroz a Granel:Largo Fino 50 LB -Bolsa Dos Hermanos.,,8.0,27.85,222.8,3999928.72999999,Bulk Rice,Lisset Limpio -020,Cafeteria,1387720,Mar
2025-03-13,El Palacio de los jugos /  Nanos Latin Foods,Invoice,008-05082,Arroz a Granel:Parboiled 50 LB -Bolsa Dos Hermanos.,,9.0,26.75,240.75,4000169.47999999,Bulk Rice,Lisset Limpio -020,Cafeteria,1387721,Mar
2025-03-13,El Palacio de los jugos /  EMMA FOOD CORP,Invoice,008-05083,Arroz a Granel:Largo Fino 50 LB -Bolsa Dos Hermanos.,,8.0,27.85,222.8,4000392.27999999,Bulk Rice,Lisset Limpio -020,Cafeteria,1387722,Mar
2025-03-13,Bravo   Francisco Diaz,Invoice,008-05084,Arroz a Granel:Largo Fino 50 LB -Bolsa Dos Hermanos.,,5.0,27.85,139.25,4000531.52999999,Bulk Rice,Lisset Limpio -020,RETAIL  DSD,1387723,Mar
2025-03-13,El Palacio de Los Jugos / Casa mía Food Restaurant inc,Invoice,008-05085,Dry Beans:Dry Beans - Black Beans 50,Dry Black Beans 50 lb,1.0,45.7,45.7,4000577.22999999,Dry Beans,Lisset Limpio -020,Cafeteria,1387724,Mar
2025-03-13,El Palacio de Los Jugos / Casa mía Food Restaurant inc,Invoice,008-05085,Arroz a Granel:Parboiled 50 LB -Bolsa Dos Hermanos.,,11.0,27.75,305.25,4000882.47999999,Bulk Rice,Lisset Limpio -020,Cafeteria,1387725,Mar
2025-03-13,El Palacio de Los Jugos / Casa mía Food Restaurant inc,Invoice,008-05085,Arroz a Granel:Parboiled 50 LB -Bolsa Dos Hermanos.,,1.0,27.75,27.75,4000910.22999999,Bulk Rice,Lisset Limpio -020,Cafeteria,1387726,Mar
2025-03-13,Sedanos Supermarkets #18,Invoice,008-05086,Spices:AS Chicken Base,1 / 30 lb. (box or pail),1.0,39.0,39.0,4000949.22999999,American Spice,Keila Alfaro-Visvikis,RETAIL SEDANOS,1387727,Mar
2025-03-13,Sedanos Supermarkets #18,Invoice,008-05086,Arroz a Granel:Parboiled 50 LB -Bolsa Dos Hermanos.,,8.0,28.25,226.0,4001175.22999999,Bulk Rice,Keila Alfaro-Visvikis,RETAIL SEDANOS,1387728,Mar
2025-03-13,Sedanos Supermarkets #18,Invoice,008-05086,,Discount,,,-5.3,4001169.92999999,,Keila Alfaro-Visvikis,RETAIL SEDANOS,1387729,Mar
2025-03-13,El Palacio de los jugos / Caribe Tropical,Invoice,008-05087,Arroz a Granel:Largo Fino 50 LB -Bolsa Dos Hermanos.,,2.0,27.85,55.7,4001225.62999999,Bulk Rice,Lisset Limpio -020,Cafeteria,1387730,Mar
2025-03-13,El Palacio de los jugos / Caribe Tropical,Invoice,008-05087,Arroz a Granel:Parboiled 50 LB -Bolsa Dos Hermanos.,,6.0,26.75,160.5,4001386.12999999,Bulk Rice,Lisset Limpio -020,Cafeteria,1387731,Mar
2025-03-13,Rey Chavez Distributor #2,Invoice,008-05088,Arroz a Granel:Parboiled 50 LB -Bolsa Dos Hermanos.,,20.0,27.5,550.0,4001936.12999999,Bulk Rice,Lisset Limpio -020,WHOLESALER,1387732,Mar
2025-03-13,Sedanos Supermarkets #33,Invoice,008-05089,Arroz a Granel:Parboiled 50 LB -Bolsa Dos Hermanos.,,3.0,28.25,84.75,4002020.87999999,Bulk Rice,Keila Alfaro-Visvikis,RETAIL SEDANOS,1387733,Mar
2025-03-13,Sedanos Supermarkets #33,Invoice,008-05089,,Discount,,,-1.7,4002019.17999999,,Keila Alfaro-Visvikis,RETAIL SEDANOS,1387734,Mar
2025-03-13,Mei Chang,Invoice,008-05090,Arroz a Granel:Parboiled 50 LB -Bolsa Dos Hermanos.,,6.0,28.25,169.5,4002188.67999999,Bulk Rice,Lisset Limpio -020,CAFETERIA y RESTAURANTS,1387735,Mar
2025-03-13,"Meat Club Market, LLC.",Invoice,008-05091,Arroz Envasado:Largo Fino 1kg (Long grain rice) Dos Hermanos,,1.0,18.0,18.0,4002206.67999999,Branded Rice,Lisset Limpio -020,RETAIL  DSD,1387736,Mar
2025-03-13,"Meat Club Market, LLC.",Invoice,008-05091,Arroz Envasado:Sushi Rice Dos Hermanos 5kg.,,1.0,60.0,60.0,4002266.67999999,Branded Rice,Lisset Limpio -020,RETAIL  DSD,1387737,Mar
2025-03-13,"Meat Club Market, LLC.",Invoice,008-05091,Arroz Envasado:Sushi Rice Dos Hermanos.,.,2.0,25.5,51.0,4002317.67999999,Branded Rice,Lisset Limpio -020,RETAIL  DSD,1387738,Mar
2025-03-13,Sedanos Supermarkets #29,Invoice,008-05092,Arroz Envasado:Largo Fino 1kg (Long grain rice) Dos Hermanos,,3.0,17.5,52.5,4002370.17999999,Branded Rice,Keila Alfaro-Visvikis,RETAIL SEDANOS,1387739,Mar
2025-03-13,Sedanos Supermarkets #29,Invoice,008-05092,Arroz Envasado:Parboiled 1kg Bolsa Dos Hermanos.,.,2.0,19.9,39.8,4002409.97999999,Branded Rice,Keila Alfaro-Visvikis,RETAIL SEDANOS,1387740,Mar
2025-03-13,Sedanos Supermarkets #29,Invoice,008-05092,Varios:Promotional Allowance,,1.0,-2.5,-2.5,4002407.47999999,Branded Rice,Keila Alfaro-Visvikis,RETAIL SEDANOS,1387741,Mar
2025-03-13,Sedanos Supermarkets #29,Invoice,008-05092,,Discount,,,-9.15,4002398.32999999,,Keila Alfaro-Visvikis,RETAIL SEDANOS,1387742,Mar
2025-03-13,"El Toro Loco Meat Distribution, LLC",Invoice,008-05093,Dry Beans:Dry Beans - Small Red Beans 50 lbs.,Small Red Beans 50 lbs,1.0,42.0,42.0,4002440.32999999,Dry Beans,Lisset Limpio -020,CAFETERIA y RESTAURANTS,1387743,Mar
2025-03-13,"El Toro Loco Meat Distribution, LLC",Invoice,008-05093,Arroz a Granel:Largo Fino 50 LB -Bolsa Dos Hermanos.,,40.0,27.85,1114.0,4003554.32999999,Bulk Rice,Lisset Limpio -020,CAFETERIA y RESTAURANTS,1387744,Mar
2025-03-14,Sedanos Supermarkets #16,Credit Memo,008-05095,Varios:Promotional Allowance,Rice Snack:Rice Snack Ham Flavored DOS HERMANOS,-1.0,19.9,-19.9,4003534.42999999,Puffed Products,Keila Alfaro-Visvikis,RETAIL SEDANOS,1387745,Mar
2025-03-14,Sedanos Supermarkets #16,Credit Memo,008-05095,Varios:Promotional Allowance,Rice Snack:Rice Snack Salami Flavored DOS HERMANOS,-1.0,19.9,-19.9,4003514.52999999,Puffed Products,Keila Alfaro-Visvikis,RETAIL SEDANOS,1387746,Mar
2025-03-14,Sedanos Supermarkets #8,Credit Memo,008-05096,Varios:Promotional Allowance,Arroz Envasado:Parboiled 5KG Dos Hermanos.,-1.0,40.5,-40.5,4003474.02999999,Branded Rice,Keila Alfaro-Visvikis,RETAIL SEDANOS,1387747,Mar
2025-03-14,Key Food / Holywood,Credit Memo,008-05097,Varios:Promotional Allowance,Arroz Envasado:Largo Fino 1kg (Long grain rice) Dos Hermanos,-2.0,18.0,-36.0,4003438.02999999,Branded Rice,Keila Alfaro-Visvikis,RETAIL  DSD,1387748,Mar
2025-03-16,Hings Chinese,Invoice,008-05098,Arroz a Granel:Parboiled 50 LB -Bolsa Dos Hermanos.,,5.0,28.25,141.25,4003579.27999999,Bulk Rice,Lisset Limpio -020,CAFETERIA y RESTAURANTS,1387749,Mar
2025-03-16,El Palacio de los jugos /  EMMA FOOD CORP,Invoice,008-05099,Arroz a Granel:Largo Fino 50 LB -Bolsa Dos Hermanos.,,7.0,27.85,194.95,4003774.23,Bulk Rice,Lisset Limpio -020,Cafeteria,1387750,Mar
2025-03-16,ALS Foods,Invoice,008-05100,Liquids:AS Cooking Wine,4 1 Gl.,2.0,17.5,35.0,4003809.23,American Spice,Lisset Limpio -020,CAFETERIA y RESTAURANTS,1387751,Mar
2025-03-16,ALS Foods,Invoice,008-05100,Dry Beans:Dry Beans - Black Beans 50,Dry Black Beans 50 lb,2.0,36.75,73.5,4003882.73,Dry Beans,Lisset Limpio -020,CAFETERIA y RESTAURANTS,1387752,Mar
2025-03-16,ALS Foods,Invoice,008-05100,Arroz a Granel:Largo Fino 50 LB -Bolsa Dos Hermanos.,,7.0,27.85,194.95,4004077.68,Bulk Rice,Lisset Limpio -020,CAFETERIA y RESTAURANTS,1387753,Mar
2025-03-16,ALS Foods,Invoice,008-05100,Arroz a Granel:Parboiled 50 LB -Bolsa Dos Hermanos.,,11.0,27.75,305.25,4004382.93,Bulk Rice,Lisset Limpio -020,CAFETERIA y RESTAURANTS,1387754,Mar
2025-03-16,ALS Foods,Invoice,008-05100,Arroz a Granel:Parboiled 50 LB -Bolsa Dos Hermanos.,,1.0,27.75,27.75,4004410.68,Bulk Rice,Lisset Limpio -020,CAFETERIA y RESTAURANTS,1387755,Mar
2025-03-16,El Palacio de los jugos / Lita Foods Inc.,Invoice,008-05101,Dry Beans:Dry Beans - Black Beans 50,Dry Black Beans 50 lb,1.0,45.7,45.7,4004456.38,Dry Beans,Lisset Limpio -020,Cafeteria,1387756,Mar
2025-03-16,El Palacio de los jugos / Lita Foods Inc.,Invoice,008-05101,Arroz a Granel:Parboiled 50 LB -Bolsa Dos Hermanos.,,11.0,27.75,305.25,4004761.63,Bulk Rice,Lisset Limpio -020,Cafeteria,1387757,Mar
2025-03-16,El Palacio de los jugos / Lita Foods Inc.,Invoice,008-05101,Arroz a Granel:Parboiled 50 LB -Bolsa Dos Hermanos.,,1.0,27.75,27.75,4004789.38,Bulk Rice,Lisset Limpio -020,Cafeteria,1387758,Mar
2025-03-16,El Palacio de los jugos / Caribe Tropical,Invoice,008-05102,Arroz a Granel:Largo Fino 50 LB -Bolsa Dos Hermanos.,,4.0,27.85,111.4,4004900.78,Bulk Rice,Lisset Limpio -020,Cafeteria,1387759,Mar
2025-03-16,El Palacio de los jugos / Caribe Tropical,Invoice,008-05102,Arroz a Granel:Parboiled 50 LB -Bolsa Dos Hermanos.,,8.0,26.75,214.0,4005114.78,Bulk Rice,Lisset Limpio -020,Cafeteria,1387760,Mar
2025-03-16,Sedanos Supermarkets #32,Invoice,008-05103,Arroz a Granel:Parboiled 50 LB -Bolsa Dos Hermanos.,,4.0,28.25,113.0,4005227.78,Bulk Rice,Keila Alfaro-Visvikis,RETAIL SEDANOS,1387761,Mar
2025-03-16,Sedanos Supermarkets #32,Invoice,008-05103,Arroz a Granel:Largo Fino 50 LB -Bolsa Dos Hermanos.,,3.0,27.85,83.55,4005311.33,Bulk Rice,Keila Alfaro-Visvikis,RETAIL SEDANOS,1387762,Mar
2025-03-16,Sedanos Supermarkets #32,Invoice,008-05103,,Discount,,,-3.93,4005307.39999999,,Keila Alfaro-Visvikis,RETAIL SEDANOS,1387763,Mar
2025-03-16,Price Choice 5 YNTO Food Corp.,Invoice,008-05104,Arroz Envasado:Largo Fino 1kg (Long grain rice) Dos Hermanos,,3.0,18.0,54.0,4005361.39999999,Branded Rice,Keila Alfaro-Visvikis,RETAIL  DSD,1387764,Mar
2025-03-16,Price Choice 5 YNTO Food Corp.,Invoice,008-05104,Arroz Envasado:Parboiled 1kg Bolsa Dos Hermanos.,.,2.0,19.9,39.8,4005401.19999999,Branded Rice,Keila Alfaro-Visvikis,RETAIL  DSD,1387765,Mar
2025-03-16,Price Choice 5 YNTO Food Corp.,Invoice,008-05104,Arroz Envasado:Largo Fino 1kg (Long grain rice) Dos Hermanos,,1.0,18.0,18.0,4005419.19999999,Branded Rice,Keila Alfaro-Visvikis,RETAIL  DSD,1387766,Mar
2025-03-16,JMN Dely Corp,Invoice,008-05105,Dry Beans:Dry Beans - Black Beans 50,Dry Black Beans 50 lb,1.0,45.7,45.7,4005464.89999999,Dry Beans,Keila Alfaro-Visvikis,CAFETERIA y RESTAURANTS,1387767,Mar
2025-03-16,JMN Dely Corp,Invoice,008-05105,Arroz a Granel:Largo Fino 50 LB -Bolsa Dos Hermanos.,,2.0,27.85,55.7,4005520.6,Bulk Rice,Keila Alfaro-Visvikis,CAFETERIA y RESTAURANTS,1387768,Mar
2025-03-16,JMN Dely Corp,Invoice,008-05105,Arroz a Granel:Parboiled 50 LB -Bolsa Dos Hermanos.,,2.0,27.75,55.5,4005576.1,Bulk Rice,Keila Alfaro-Visvikis,CAFETERIA y RESTAURANTS,1387769,Mar
2025-03-16,El Gallego Supermarket,Invoice,008-05106,Liquids:AS Bitter Orange,,6.0,15.9,95.4,4005671.5,American Spice,Lisset Limpio -020,RETAIL  DSD,1387770,Mar
2025-03-16,El Gallego Supermarket,Invoice,008-05106,Liquids:AS Cooking Wine,4 1 Gl.,2.0,17.5,35.0,4005706.5,American Spice,Lisset Limpio -020,RETAIL  DSD,1387771,Mar
2025-03-16,El Gallego Supermarket,Invoice,008-05106,Liquids:AS Marinating Sauce (Mojo),,2.0,18.5,37.0,4005743.5,American Spice,Lisset Limpio -020,RETAIL  DSD,1387772,Mar
2025-03-16,Bravo supermarket Coral Way 26 th,Invoice,008-05107,Arroz Envasado:Parboiled 5KG Dos Hermanos.,6  11lbs,5.0,46.5,232.5,4005976.0,Branded Rice,Lisset Limpio -020,RETAIL  DSD,1387773,Mar
2025-03-16,Bravo supermarket Coral Way 26 th,Invoice,008-05107,Arroz Envasado:Parboiled 5KG Dos Hermanos.,6  11lbs,5.0,46.5,232.5,4006208.5,Branded Rice,Lisset Limpio -020,RETAIL  DSD,1387774,Mar
2025-03-16,Bravo supermarket Coral Way 26 th,Invoice,008-05108,Arroz Envasado:Parboiled 5KG Dos Hermanos.,6  11lbs,15.0,46.5,697.5,4006906.0,Branded Rice,Lisset Limpio -020,RETAIL  DSD,1387775,Mar
2025-03-16,Bravo supermarket Coral Way 26 th,Invoice,008-05108,Arroz Envasado:Parboiled 5KG Dos Hermanos.,6  11lbs,15.0,46.5,697.5,4007603.5,Branded Rice,Lisset Limpio -020,RETAIL  DSD,1387776,Mar
2025-03-16,Sedanos Supermarkets #32,Invoice,008-05109,Arroz Envasado:Largo Fino 1kg (Long grain rice) Dos Hermanos,,1.0,17.5,17.5,4007621.0,Branded Rice,Keila Alfaro-Visvikis,RETAIL SEDANOS,1387777,Mar
2025-03-16,Sedanos Supermarkets #32,Invoice,008-05109,Varios:Promotional Allowance,,1.0,-2.5,-2.5,4007618.5,Branded Rice,Keila Alfaro-Visvikis,RETAIL SEDANOS,1387778,Mar
2025-03-16,Sedanos Supermarkets #32,Invoice,008-05109,,Discount,,,-0.3,4007618.2,,Keila Alfaro-Visvikis,RETAIL SEDANOS,1387779,Mar
2025-03-16,El Palacio de Los Jugos / Casa mía Food Restaurant inc,Credit Memo,008-05110,Varios:Promotional Allowance,Arroz a Granel:Parboiled 50 LB -Bolsa Dos Hermanos.,-1.0,27.75,-27.75,4007590.45,Bulk Rice,Lisset Limpio -020,Cafeteria,1387780,Mar
2025-03-16,El Palacio de los jugos / Delicias Criollas (DIAGO FOOD_MILLER),Credit Memo,008-05111,Varios:Promotional Allowance,Arroz a Granel:Parboiled 50 LB -Bolsa Dos Hermanos.,-1.0,27.75,-27.75,4007562.7,Bulk Rice,Lisset Limpio -020,Cafeteria,1387781,Mar
2025-03-16,El Palacio de los jugos /  Mires Restaurants,Credit Memo,008-05112,Varios:Promotional Allowance,Arroz a Granel:Parboiled 50 LB -Bolsa Dos Hermanos.,-1.0,27.75,-27.75,4007534.95,Puffed Products,Lisset Limpio -020,Cafeteria,1387782,Mar
2025-03-17,Bravo Supermarkets Palm Bay,Credit Memo,008-05113,Arroz a Granel:Parboiled 50 LB -Bolsa Dos Hermanos.,,-10.0,30.0,-300.0,4007234.95,Bulk Rice,# Orlando 0024,RETAIL  DSD,1387783,Mar
2025-03-17,Ricos Latin Cusine,Invoice,008-05114,Arroz a Granel:Parboiled 50 LB -Bolsa Dos Hermanos.,,10.0,24.5,245.0,4007479.95,Bulk Rice,# Orlando 0024,CAFETERIA y RESTAURANTS,1387784,Mar
2025-03-17,Sedanos Supermarkets #26,Credit Memo,008-05115,Varios:Producto vencido/deteriorado (no impacta en inventario),"16 salame 
8
Pizza",-24.0,1.49,-35.76,4007444.19,Puffed Products,Keila Alfaro-Visvikis,RETAIL SEDANOS,1387785,Mar
2025-03-17,Sedanos Supermarkets #26,Credit Memo,008-05115,,Discount,,,0.72,4007444.91,,Keila Alfaro-Visvikis,RETAIL SEDANOS,1387786,Mar
2025-03-17,Aries Supermarket & Cafeteria,Invoice,008-05116,Dry Beans:Dry Beans - Black Beans 50,Dry Black Beans 50 lb,6.0,36.5,219.0,4007663.91,Dry Beans,Keila Alfaro-Visvikis,CAFETERIA y RESTAURANTS,1387787,Mar
2025-03-17,Aries Supermarket & Cafeteria,Invoice,008-05116,Liquids:AS Cooking Wine,4 1 Gl.,2.0,17.5,35.0,4007698.91,American Spice,Keila Alfaro-Visvikis,CAFETERIA y RESTAURANTS,1387788,Mar
2025-03-18,ALS Foods,Credit Memo,008-05117,Varios:Promotional Allowance,Arroz a Granel:Parboiled 50 LB -Bolsa Dos Hermanos.,-1.0,27.75,-27.75,4007671.16,Bulk Rice,Lisset Limpio -020,CAFETERIA y RESTAURANTS,1387789,Mar
2025-03-18,El Palacio de los jugos / Lita Foods Inc.,Credit Memo,008-05118,Varios:Promotional Allowance,Arroz a Granel:Parboiled 50 LB -Bolsa Dos Hermanos.,-1.0,27.75,-27.75,4007643.41,Bulk Rice,Lisset Limpio -020,Cafeteria,1387790,Mar
2025-03-18,Price Choice 5 YNTO Food Corp.,Credit Memo,008-05119,Varios:Promotional Allowance,Arroz Envasado:Largo Fino 1kg (Long grain rice) Dos Hermanos,-1.0,18.0,-18.0,4007625.41,Branded Rice,Keila Alfaro-Visvikis,RETAIL  DSD,1387791,Mar
2025-03-18,Bravo supermarket Coral Way 26 th,Credit Memo,008-05120,Varios:Promotional Allowance,Arroz Envasado:Parboiled 5KG Dos Hermanos.,-5.0,46.5,-232.5,4007392.91,Branded Rice,Lisset Limpio -020,RETAIL  DSD,1387792,Mar
2025-03-18,Bravo supermarket Coral Way 26 th,Credit Memo,008-05121,Varios:Promotional Allowance,Arroz Envasado:Parboiled 5KG Dos Hermanos.,-15.0,46.5,-697.5,4006695.41,Branded Rice,Lisset Limpio -020,RETAIL  DSD,1387793,Mar
2025-03-18,Sedanos Supermarkets #40,Invoice,008-05122,Rice Snack:Rice Snack Salami Flavored DOS HERMANOS,,5.0,19.9,99.5,4006794.91,Puffed Products,# Orlando 0024,RETAIL SEDANOS,1387794,Mar
2025-03-18,Sedanos Supermarkets #40,Invoice,008-05122,Rice Snack:Rice Snack Ham Flavored DOS HERMANOS,,5.0,19.9,99.5,4006894.41,Puffed Products,# Orlando 0024,RETAIL SEDANOS,1387795,Mar
2025-03-18,Sedanos Supermarkets #40,Invoice,008-05122,Arroz Envasado:Parboiled 5KG Dos Hermanos.,6  11lbs,20.0,40.5,810.0,4007704.41,Branded Rice,# Orlando 0024,RETAIL SEDANOS,1387796,Mar
2025-03-18,Sedanos Supermarkets #40,Invoice,008-05122,Arroz Envasado:Parboiled 1kg Bolsa Dos Hermanos.,.,3.0,19.9,59.7,4007764.11,Branded Rice,# Orlando 0024,RETAIL SEDANOS,1387797,Mar
2025-03-18,Sedanos Supermarkets #40,Invoice,008-05122,Arroz Envasado:Largo Fino 1kg (Long grain rice) Dos Hermanos,,2.0,18.0,36.0,4007800.11,Branded Rice,# Orlando 0024,RETAIL SEDANOS,1387798,Mar
2025-03-18,Sedanos Supermarkets #40,Invoice,008-05122,Varios:Promotional Allowance,,1.0,-2.5,-2.5,4007797.61,Branded Rice,# Orlando 0024,RETAIL SEDANOS,1387799,Mar
2025-03-18,Sedanos Supermarkets #40,Invoice,008-05122,Varios:Promotional Allowance,,20.0,-11.15,-223.0,4007574.61,Branded Rice,# Orlando 0024,RETAIL SEDANOS,1387800,Mar
2025-03-18,Sedanos Supermarkets #40,Invoice,008-05122,Rice Snack:Rice Snack Salami Flavored DOS HERMANOS,,5.0,19.9,99.5,4007674.11,Puffed Products,# Orlando 0024,RETAIL SEDANOS,1387801,Mar
2025-03-18,Sedanos Supermarkets #40,Invoice,008-05122,Rice Snack:Rice Snack Ham Flavored DOS HERMANOS,,5.0,19.9,99.5,4007773.61,Puffed Products,# Orlando 0024,RETAIL SEDANOS,1387802,Mar
2025-03-18,Sedanos Supermarkets #40,Invoice,008-05122,,Discount,,,-17.58,4007756.03,,# Orlando 0024,RETAIL SEDANOS,1387803,Mar
2025-03-18,Sedanos Supermarkets #41,Invoice,008-05123,Rice Snack:Rice Snack Salami Flavored DOS HERMANOS,,5.0,19.9,99.5,4007855.53,Puffed Products,# Orlando 0024,RETAIL SEDANOS,1387804,Mar
2025-03-18,Sedanos Supermarkets #41,Invoice,008-05123,Rice Snack:Rice Snack Ham Flavored DOS HERMANOS,,5.0,19.9,99.5,4007955.03,Puffed Products,# Orlando 0024,RETAIL SEDANOS,1387805,Mar
2025-03-18,Sedanos Supermarkets #41,Invoice,008-05123,Arroz Envasado:Parboiled 5KG Dos Hermanos.,6  11lbs,40.0,40.5,1620.0,4009575.03,Branded Rice,# Orlando 0024,RETAIL SEDANOS,1387806,Mar
2025-03-18,Sedanos Supermarkets #41,Invoice,008-05123,Arroz Envasado:Parboiled 1kg Bolsa Dos Hermanos.,.,5.0,19.9,99.5,4009674.53,Branded Rice,# Orlando 0024,RETAIL SEDANOS,1387807,Mar
2025-03-18,Sedanos Supermarkets #41,Invoice,008-05123,Arroz Envasado:Largo Fino 1kg (Long grain rice) Dos Hermanos,,5.0,18.0,90.0,4009764.53,Branded Rice,# Orlando 0024,RETAIL SEDANOS,1387808,Mar
2025-03-18,Sedanos Supermarkets #41,Invoice,008-05123,Varios:Promotional Allowance,,5.0,-2.5,-12.5,4009752.03,Branded Rice,# Orlando 0024,RETAIL SEDANOS,1387809,Mar
2025-03-18,Sedanos Supermarkets #41,Invoice,008-05123,Arroz Envasado:Parboiled 1kg Bolsa Dos Hermanos.,.,1.0,19.9,19.9,4009771.93,Branded Rice,# Orlando 0024,RETAIL SEDANOS,1387810,Mar
2025-03-18,Sedanos Supermarkets #41,Invoice,008-05123,Varios:Promotional Allowance,,40.0,-11.15,-446.0,4009325.93,Branded Rice,# Orlando 0024,RETAIL SEDANOS,1387811,Mar
2025-03-18,Sedanos Supermarkets #41,Invoice,008-05123,Rice Snack:Rice Snack Ham Flavored DOS HERMANOS,,5.0,19.9,99.5,4009425.43,Puffed Products,# Orlando 0024,RETAIL SEDANOS,1387812,Mar
2025-03-18,Sedanos Supermarkets #41,Invoice,008-05123,Rice Snack:Rice Snack Salami Flavored DOS HERMANOS,,5.0,19.9,99.5,4009524.93,Puffed Products,# Orlando 0024,RETAIL SEDANOS,1387813,Mar
2025-03-18,Bravo Supermarkets Palm Bay,Invoice,008-05124,Arroz Envasado:Parboiled 5KG Dos Hermanos.,6  11lbs,5.0,46.5,232.5,4009757.43,Branded Rice,# Orlando 0024,RETAIL  DSD,1387814,Mar
2025-03-18,Bravo Supermarkets Palm Bay,Invoice,008-05124,Arroz Envasado:Parboiled 1kg Bolsa Dos Hermanos.,.,5.0,19.9,99.5,4009856.93,Branded Rice,# Orlando 0024,RETAIL  DSD,1387815,Mar
2025-03-18,Bravo Supermarkets Palm Bay,Invoice,008-05124,Arroz Envasado:Parboiled 1kg Bolsa Dos Hermanos.,.,1.0,19.9,19.9,4009876.83,Branded Rice,# Orlando 0024,RETAIL  DSD,1387816,Mar
2025-03-18,Bravo Supermarkets Palm Bay,Invoice,008-05124,Varios:Promotional Allowance,,5.0,-15.9,-79.5,4009797.33,Branded Rice,# Orlando 0024,RETAIL  DSD,1387817,Mar
2025-03-18,Bravo Supermarkets Palm Bay,Invoice,008-05124,Rice Snack:Rice Snack Ham Flavored DOS HERMANOS,,1.0,19.9,19.9,4009817.23,Puffed Products,# Orlando 0024,RETAIL  DSD,1387818,Mar
2025-03-18,Bravo Supermarkets Palm Bay,Invoice,008-05124,Rice Snack:Rice Snack Salami Flavored DOS HERMANOS,,1.0,19.9,19.9,4009837.13,Puffed Products,# Orlando 0024,RETAIL  DSD,1387819,Mar
2025-03-19,Lissete Limpio,Invoice,008-05125,Arroz Envasado:Largo Fino 1kg (Long grain rice) Dos Hermanos,,1.0,18.0,18.0,4009855.13,Branded Rice,Lisset Limpio -020,OTHER,1387820,Mar
2025-03-19,Lissete Limpio,Invoice,008-05125,Arroz Envasado:Parboiled 1kg Bolsa Dos Hermanos.,.,1.0,19.9,19.9,4009875.03,Branded Rice,Lisset Limpio -020,OTHER,1387821,Mar
2025-03-19,Ideal Food Basket Davie Cafeteria,Invoice,008-05126,Arroz a Granel:Largo Fino 50 LB -Bolsa Dos Hermanos.,,10.0,27.85,278.5,4010153.53,Bulk Rice,Keila Alfaro-Visvikis,CAFETERIA y RESTAURANTS,1387822,Mar
2025-03-19,El Palacio de los jugos /  Nanos Latin Foods,Invoice,008-05127,Arroz a Granel:Largo Fino 50 LB -Bolsa Dos Hermanos.,,2.0,27.85,55.7,4010209.23,Bulk Rice,Lisset Limpio -020,Cafeteria,1387823,Mar
2025-03-19,El Palacio de los jugos /  Nanos Latin Foods,Invoice,008-05127,Arroz a Granel:Parboiled 50 LB -Bolsa Dos Hermanos.,,8.0,26.75,214.0,4010423.23,Bulk Rice,Lisset Limpio -020,Cafeteria,1387824,Mar
2025-03-19,Aries Supermarket & Cafeteria,Invoice,008-05128,Arroz a Granel:Parboiled 50 LB -Bolsa Dos Hermanos.,,10.0,28.25,282.5,4010705.73,Bulk Rice,Keila Alfaro-Visvikis,CAFETERIA y RESTAURANTS,1387825,Mar
2025-03-19,Aries Supermarket & Cafeteria,Invoice,008-05128,Spices:AS Chicken Base,1 / 30 lb. (box or pail),2.0,39.0,78.0,4010783.73,American Spice,Keila Alfaro-Visvikis,CAFETERIA y RESTAURANTS,1387826,Mar
2025-03-19,Aries Supermarket & Cafeteria,Invoice,008-05128,Liquids:AS Cooking Wine,4 1 Gl.,1.0,17.5,17.5,4010801.23,American Spice,Keila Alfaro-Visvikis,CAFETERIA y RESTAURANTS,1387827,Mar
2025-03-19,Aries Supermarket & Cafeteria,Invoice,008-05128,Liquids:AS Bitter Orange,,1.0,15.9,15.9,4010817.13,American Spice,Keila Alfaro-Visvikis,CAFETERIA y RESTAURANTS,1387828,Mar
2025-03-19,Key Foods  / Ivan,Invoice,008-05129,Arroz Envasado:Largo Fino 1kg (Long grain rice) Dos Hermanos,,5.0,18.0,90.0,4010907.13,Branded Rice,Keila Alfaro-Visvikis,RETAIL  DSD,1387829,Mar
2025-03-19,Key Foods  / Ivan,Invoice,008-05129,Arroz Envasado:Largo Fino 1kg (Long grain rice) Dos Hermanos,,1.0,18.0,18.0,4010925.13,Branded Rice,Keila Alfaro-Visvikis,RETAIL  DSD,1387830,Mar
2025-03-19,Food Fair Plantation Corp,Invoice,008-05130,Arroz a Granel:Parboiled 50 LB -Bolsa Dos Hermanos.,,55.0,27.75,1526.25,4012451.38,Bulk Rice,Keila Alfaro-Visvikis,RETAIL  DSD,1387831,Mar
2025-03-19,Sedanos Supermarkets #24,Invoice,008-05131,Arroz a Granel:Parboiled 50 LB -Bolsa Dos Hermanos.,,8.0,28.25,226.0,4012677.38,Bulk Rice,Keila Alfaro-Visvikis,RETAIL SEDANOS,1387832,Mar
2025-03-19,Sedanos Supermarkets #24,Invoice,008-05131,,Discount,,,-4.52,4012672.86,,Keila Alfaro-Visvikis,RETAIL SEDANOS,1387833,Mar
2025-03-19,El Palacio de Los Jugos / Casa mía Food Restaurant inc,Invoice,008-05132,Dry Beans:Dry Beans - Black Beans 50,Dry Black Beans 50 lb,1.0,45.7,45.7,4012718.56,Dry Beans,Lisset Limpio -020,Cafeteria,1387834,Mar
2025-03-19,El Palacio de Los Jugos / Casa mía Food Restaurant inc,Invoice,008-05132,Arroz a Granel:Parboiled 50 LB -Bolsa Dos Hermanos.,,11.0,27.75,305.25,4013023.81,Bulk Rice,Lisset Limpio -020,Cafeteria,1387835,Mar
2025-03-19,El Palacio de Los Jugos / Casa mía Food Restaurant inc,Invoice,008-05132,Arroz a Granel:Parboiled 50 LB -Bolsa Dos Hermanos.,,1.0,27.75,27.75,4013051.56,Bulk Rice,Lisset Limpio -020,Cafeteria,1387836,Mar
2025-03-19,Sedanos Supermarkets #26,Invoice,008-05133,Arroz a Granel:Parboiled 50 LB -Bolsa Dos Hermanos.,,5.0,28.25,141.25,4013192.81,Bulk Rice,Keila Alfaro-Visvikis,RETAIL SEDANOS,1387837,Mar
2025-03-19,Sedanos Supermarkets #26,Invoice,008-05133,,Discount,,,-2.83,4013189.98,,Keila Alfaro-Visvikis,RETAIL SEDANOS,1387838,Mar
2025-03-19,Sedanos Supermarkets #26,Invoice,008-05134,Rice Snack:Rice Snack Ham Flavored DOS HERMANOS,,1.0,19.9,19.9,4013209.88,Puffed Products,Keila Alfaro-Visvikis,RETAIL SEDANOS,1387839,Mar
2025-03-19,Sedanos Supermarkets #26,Invoice,008-05134,Rice Snack:Rice Snack Salami Flavored DOS HERMANOS,,1.0,19.9,19.9,4013229.78,Puffed Products,Keila Alfaro-Visvikis,RETAIL SEDANOS,1387840,Mar
2025-03-19,Sedanos Supermarkets #26,Invoice,008-05134,Rice Snack:Rice Snack Ham Flavored DOS HERMANOS,,1.0,19.9,19.9,4013249.68,Puffed Products,Keila Alfaro-Visvikis,RETAIL SEDANOS,1387841,Mar
2025-03-19,Sedanos Supermarkets #26,Invoice,008-05134,Rice Snack:Rice Snack Salami Flavored DOS HERMANOS,,1.0,19.9,19.9,4013269.58,Puffed Products,Keila Alfaro-Visvikis,RETAIL SEDANOS,1387842,Mar
2025-03-19,Sedanos Supermarkets #26,Invoice,008-05134,,Discount,,,-0.8,4013268.78,,Keila Alfaro-Visvikis,RETAIL SEDANOS,1387843,Mar
2025-03-19,Sedanos Supermarkets #43,Invoice,008-05135,Arroz a Granel:Parboiled 50 LB -Bolsa Dos Hermanos.,,5.0,28.25,141.25,4013410.03,Bulk Rice,Keila Alfaro-Visvikis,RETAIL SEDANOS,1387844,Mar
2025-03-19,Sedanos Supermarkets #43,Invoice,008-05135,,Discount,,,-2.83,4013407.2,,Keila Alfaro-Visvikis,RETAIL SEDANOS,1387845,Mar
2025-03-20,Sedanos Supermarkets #16,Invoice,008-05136,Arroz a Granel:Parboiled 50 LB -Bolsa Dos Hermanos.,,4.0,28.25,113.0,4013520.2,Bulk Rice,Keila Alfaro-Visvikis,RETAIL SEDANOS,1387846,Mar
2025-03-20,Sedanos Supermarkets #16,Invoice,008-05136,,Discount,,,-2.26,4013517.94,,Keila Alfaro-Visvikis,RETAIL SEDANOS,1387847,Mar
2025-03-20,Soriano Brothers PB,Invoice,008-05137,Arroz a Granel:Largo Fino 50 LB -Bolsa Dos Hermanos.,,12.0,27.85,334.2,4013852.14,Bulk Rice,Lisset Limpio -020,CAFETERIA y RESTAURANTS,1387848,Mar
2025-03-20,Soriano Brothers PB,Invoice,008-05137,Arroz a Granel:Parboiled 50 LB -Bolsa Dos Hermanos.,,15.0,26.75,401.25,4014253.39,Bulk Rice,Lisset Limpio -020,CAFETERIA y RESTAURANTS,1387849,Mar
2025-03-20,Soriano Brothers PB,Invoice,008-05137,Spices:AS Sazon (for all),1 / 30 lb (box or pail),3.0,51.0,153.0,4014406.39,American Spice,Lisset Limpio -020,CAFETERIA y RESTAURANTS,1387850,Mar
2025-03-20,Soriano Brothers PB,Invoice,008-05137,Dry Beans:Dry Beans - Black Beans 50,Dry Black Beans 50 lb,2.0,36.75,73.5,4014479.89,Dry Beans,Lisset Limpio -020,CAFETERIA y RESTAURANTS,1387851,Mar
2025-03-20,El Palacio de los jugos / Leti Corp.,Invoice,008-05138,Arroz a Granel:Largo Fino 50 LB -Bolsa Dos Hermanos.,,3.0,27.85,83.55,4014563.44,Bulk Rice,Lisset Limpio -020,Cafeteria,1387852,Mar
2025-03-20,El Palacio de los jugos / Leti Corp.,Invoice,008-05138,Arroz a Granel:Parboiled 50 LB -Bolsa Dos Hermanos.,,6.0,26.75,160.5,4014723.94,Bulk Rice,Lisset Limpio -020,Cafeteria,1387853,Mar
2025-03-20,Sedanos Supermarkets #33,Invoice,008-05139,Arroz a Granel:Parboiled 50 LB -Bolsa Dos Hermanos.,,3.0,28.25,84.75,4014808.69,Bulk Rice,Keila Alfaro-Visvikis,RETAIL SEDANOS,1387854,Mar
2025-03-20,Sedanos Supermarkets #33,Invoice,008-05139,,Discount,,,-1.7,4014806.99,,Keila Alfaro-Visvikis,RETAIL SEDANOS,1387855,Mar
2025-03-20,El Palacio de los jugos / Delicias Criollas (DIAGO FOOD_MILLER),Invoice,008-05140,Liquids:AS Cooking Wine,4 1 Gl.,1.0,17.5,17.5,4014824.49,American Spice,Lisset Limpio -020,Cafeteria,1387856,Mar
2025-03-20,El Palacio de los jugos / Delicias Criollas (DIAGO FOOD_MILLER),Invoice,008-05140,Arroz a Granel:Parboiled 50 LB -Bolsa Dos Hermanos.,,11.0,27.75,305.25,4015129.74,Bulk Rice,Lisset Limpio -020,Cafeteria,1387857,Mar
2025-03-20,El Palacio de los jugos / Delicias Criollas (DIAGO FOOD_MILLER),Invoice,008-05140,Arroz a Granel:Parboiled 50 LB -Bolsa Dos Hermanos.,,1.0,27.75,27.75,4015157.49,Bulk Rice,Lisset Limpio -020,Cafeteria,1387858,Mar
2025-03-20,El Palacio de los jugos / Lita Foods Inc.,Invoice,008-05141,Dry Beans:Dry Beans - Black Beans 50,Dry Black Beans 50 lb,1.0,45.7,45.7,4015203.19,Dry Beans,Lisset Limpio -020,Cafeteria,1387859,Mar
2025-03-20,El Palacio de los jugos / Lita Foods Inc.,Invoice,008-05141,Arroz a Granel:Parboiled 50 LB -Bolsa Dos Hermanos.,,11.0,27.75,305.25,4015508.44,Bulk Rice,Lisset Limpio -020,Cafeteria,1387860,Mar
2025-03-20,El Palacio de los jugos / Lita Foods Inc.,Invoice,008-05141,Arroz a Granel:Parboiled 50 LB -Bolsa Dos Hermanos.,,1.0,27.75,27.75,4015536.19,Bulk Rice,Lisset Limpio -020,Cafeteria,1387861,Mar
2025-03-20,El Palacio de los jugos / Caribe Tropical,Invoice,008-05142,Arroz a Granel:Largo Fino 50 LB -Bolsa Dos Hermanos.,,4.0,27.85,111.4,4015647.59,Bulk Rice,Lisset Limpio -020,Cafeteria,1387862,Mar
2025-03-20,El Palacio de los jugos / Caribe Tropical,Invoice,008-05142,Arroz a Granel:Parboiled 50 LB -Bolsa Dos Hermanos.,,6.0,26.75,160.5,4015808.09,Bulk Rice,Lisset Limpio -020,Cafeteria,1387863,Mar
2025-03-20,Sedanos Supermarkets #18,Invoice,008-05143,Arroz Envasado:Parboiled 1kg Bolsa Dos Hermanos.,.,1.0,19.9,19.9,4015827.99,Branded Rice,Keila Alfaro-Visvikis,RETAIL SEDANOS,1387864,Mar
2025-03-20,Sedanos Supermarkets #18,Invoice,008-05143,Rice Snack:Rice Snack Ham Flavored DOS HERMANOS,,1.0,19.9,19.9,4015847.89,Puffed Products,Keila Alfaro-Visvikis,RETAIL SEDANOS,1387865,Mar
2025-03-20,Sedanos Supermarkets #18,Invoice,008-05143,Rice Snack:Rice Snack Salami Flavored DOS HERMANOS,,1.0,19.9,19.9,4015867.79,Puffed Products,Keila Alfaro-Visvikis,RETAIL SEDANOS,1387866,Mar
2025-03-20,Sedanos Supermarkets #18,Invoice,008-05143,Rice Snack:Rice Snack Ham Flavored DOS HERMANOS,,1.0,19.9,19.9,4015887.68999999,Puffed Products,Keila Alfaro-Visvikis,RETAIL SEDANOS,1387867,Mar
2025-03-20,Sedanos Supermarkets #18,Invoice,008-05143,Rice Snack:Rice Snack Salami Flavored DOS HERMANOS,,1.0,19.9,19.9,4015907.58999999,Puffed Products,Keila Alfaro-Visvikis,RETAIL SEDANOS,1387868,Mar
2025-03-20,Sedanos Supermarkets #18,Invoice,008-05143,,Discount,,,-1.19,4015906.39999999,,Keila Alfaro-Visvikis,RETAIL SEDANOS,1387869,Mar
2025-03-20,El Palacio de los jugos /  EMMA FOOD CORP,Invoice,008-05144,Arroz a Granel:Largo Fino 50 LB -Bolsa Dos Hermanos.,,7.0,27.85,194.95,4016101.35,Bulk Rice,Lisset Limpio -020,Cafeteria,1387870,Mar
2025-03-20,Sedanos Supermarkets  #37,Invoice,008-05145,Arroz a Granel:Largo Fino 50 LB -Bolsa Dos Hermanos.,,5.0,27.85,139.25,4016240.6,Bulk Rice,Keila Alfaro-Visvikis,RETAIL SEDANOS,1387871,Mar
2025-03-20,Sedanos Supermarkets  #37,Invoice,008-05145,Arroz a Granel:Parboiled 50 LB -Bolsa Dos Hermanos.,,7.0,28.25,197.75,4016438.35,Bulk Rice,Keila Alfaro-Visvikis,RETAIL SEDANOS,1387872,Mar
2025-03-20,Sedanos Supermarkets  #37,Invoice,008-05145,,Discount,,,-6.74,4016431.60999999,,Keila Alfaro-Visvikis,RETAIL SEDANOS,1387873,Mar
2025-03-20,Bravo   Francisco Diaz,Invoice,008-05146,Arroz a Granel:Largo Fino 50 LB -Bolsa Dos Hermanos.,,5.0,27.85,139.25,4016570.85999999,Bulk Rice,Lisset Limpio -020,RETAIL  DSD,1387874,Mar
2025-03-20,Bravo   Francisco Diaz,Invoice,008-05146,Liquids:AS Cooking Wine,4 1 Gl.,4.0,17.5,70.0,4016640.85999999,American Spice,Lisset Limpio -020,RETAIL  DSD,1387875,Mar
2025-03-20,Bravo   Francisco Diaz,Invoice,008-05146,Liquids:AS White Vinegar,4/1 Gl.,2.0,10.0,20.0,4016660.85999999,American Spice,Lisset Limpio -020,RETAIL  DSD,1387876,Mar
2025-03-20,Bravo   Francisco Diaz,Invoice,008-05146,Dry Beans:Dry Beans - Small Red Beans 50 lbs.,Small Red Beans 50 lbs,1.0,42.0,42.0,4016702.85999999,Dry Beans,Lisset Limpio -020,RETAIL  DSD,1387877,Mar
2025-03-20,Bravo   Francisco Diaz,Invoice,008-05146,Dry Beans:Dry Beans - Black Beans 50,Dry Black Beans 50 lb,1.0,36.76,36.76,4016739.61999999,Dry Beans,Lisset Limpio -020,RETAIL  DSD,1387878,Mar
2025-03-20,Bravo   Francisco Diaz,Invoice,008-05146,Liquids:AS Lemon Juice 4/1 Gl,,1.0,14.95,14.95,4016754.56999999,American Spice,Lisset Limpio -020,RETAIL  DSD,1387879,Mar
2025-03-20,El Palacio de los jugos / J Mena Corp.,Invoice,008-05147,Dry Beans:Dry Beans - Black Beans 50,Dry Black Beans 50 lb,2.0,36.75,73.5,4016828.06999999,Dry Beans,Lisset Limpio -020,Cafeteria,1387880,Mar
2025-03-20,El Palacio de los jugos / J Mena Corp.,Invoice,008-05147,Arroz a Granel:Parboiled 50 LB -Bolsa Dos Hermanos.,,3.0,26.75,80.25,4016908.31999999,Bulk Rice,Lisset Limpio -020,Cafeteria,1387881,Mar
2025-03-20,Fritanga Momotombo,Invoice,008-05148,Dry Beans:Dry Beans - Small Red Beans 50 lbs.,Small Red Beans 50 lbs,2.0,42.0,84.0,4016992.31999999,Dry Beans,Lisset Limpio -020,CAFETERIA y RESTAURANTS,1387882,Mar
2025-03-20,Fritanga Momotombo,Invoice,008-05148,Arroz a Granel:Largo Fino 50 LB -Bolsa Dos Hermanos.,,6.0,27.85,167.1,4017159.41999999,Bulk Rice,Lisset Limpio -020,CAFETERIA y RESTAURANTS,1387883,Mar
2025-03-20,Fritanga Momotombo,Invoice,008-05148,Spices:AS Chicken Base,1 / 30 lb. (box or pail),1.0,39.0,39.0,4017198.41999999,American Spice,Lisset Limpio -020,CAFETERIA y RESTAURANTS,1387884,Mar
2025-03-20,"Soriano Brothers Diaz Food Service,Inc",Invoice,008-05149,Arroz a Granel:Parboiled 50 LB -Bolsa Dos Hermanos.,,40.0,26.75,1070.0,4018268.41999999,Bulk Rice,Lisset Limpio -020,CAFETERIA y RESTAURANTS,1387885,Mar
2025-03-20,El Palacio de los jugos / Rodriguez Foods,Invoice,008-05150,Arroz a Granel:Parboiled 50 LB -Bolsa Dos Hermanos.,,8.0,26.75,214.0,4018482.41999999,Bulk Rice,Lisset Limpio -020,Cafeteria,1387886,Mar
2025-03-20,Sedanos Supermarkets #31,Invoice,008-05151,Arroz a Granel:Parboiled 50 LB -Bolsa Dos Hermanos.,,5.0,28.25,141.25,4018623.66999999,Bulk Rice,Keila Alfaro-Visvikis,RETAIL SEDANOS,1387887,Mar
2025-03-20,Sedanos Supermarkets #31,Invoice,008-05151,,Discount,,,-2.83,4018620.83999999,,Keila Alfaro-Visvikis,RETAIL SEDANOS,1387888,Mar
2025-03-21,Sedanos Supermarkets  #37,Invoice,008-05152,Arroz Envasado:Parboiled 1kg Bolsa Dos Hermanos.,.,1.0,19.9,19.9,4018640.73999999,Branded Rice,Keila Alfaro-Visvikis,RETAIL SEDANOS,1387889,Mar
2025-03-21,Sedanos Supermarkets  #37,Invoice,008-05152,,Discount,,,-0.4,4018640.33999999,,Keila Alfaro-Visvikis,RETAIL SEDANOS,1387890,Mar
2025-03-21,Key Foods  / Ivan,Credit Memo,008-05153,Varios:Promotional Allowance,Arroz Envasado:Largo Fino 1kg (Long grain rice) Dos Hermanos,-1.0,18.0,-18.0,4018622.33999999,Branded Rice,Keila Alfaro-Visvikis,RETAIL  DSD,1387891,Mar
2025-03-21,El Palacio de Los Jugos / Casa mía Food Restaurant inc,Credit Memo,008-05154,Varios:Promotional Allowance,Arroz a Granel:Parboiled 50 LB -Bolsa Dos Hermanos.,-1.0,27.75,-27.75,4018594.58999999,Bulk Rice,Lisset Limpio -020,Cafeteria,1387892,Mar
2025-03-21,Sedanos Supermarkets #26,Credit Memo,008-05155,Varios:Promotional Allowance,Rice Snack:Rice Snack Salami Flavored DOS HERMANOS,-1.0,19.9,-19.9,4018574.68999999,Branded Rice,Keila Alfaro-Visvikis,RETAIL SEDANOS,1387893,Mar
2025-03-21,Sedanos Supermarkets #26,Credit Memo,008-05155,Varios:Promotional Allowance,Rice Snack:Rice Snack Ham Flavored DOS HERMANOS,-1.0,19.9,-19.9,4018554.79,Branded Rice,Keila Alfaro-Visvikis,RETAIL SEDANOS,1387894,Mar
2025-03-21,Sedanos Supermarkets #40,Credit Memo,008-05156,Varios:Promotional Allowance,Rice Snack:Rice Snack Salami Flavored DOS HERMANOS,-5.0,19.9,-99.5,4018455.29,Puffed Products,# Orlando 0024,RETAIL SEDANOS,1387895,Mar
2025-03-21,Sedanos Supermarkets #40,Credit Memo,008-05156,Varios:Promotional Allowance,Rice Snack:Rice Snack Ham Flavored DOS HERMANOS,-5.0,19.9,-99.5,4018355.79,Puffed Products,# Orlando 0024,RETAIL SEDANOS,1387896,Mar
2025-03-21,Sedanos Supermarkets #41,Credit Memo,008-05157,Varios:Promotional Allowance,Rice Snack:Rice Snack Salami Flavored DOS HERMANOS,-5.0,19.9,-99.5,4018256.29,Puffed Products,# Orlando 0024,RETAIL SEDANOS,1387897,Mar
2025-03-21,Sedanos Supermarkets #41,Credit Memo,008-05157,Varios:Promotional Allowance,Rice Snack:Rice Snack Ham Flavored DOS HERMANOS,-5.0,19.9,-99.5,4018156.79,Puffed Products,# Orlando 0024,RETAIL SEDANOS,1387898,Mar
2025-03-21,Sedanos Supermarkets #41,Credit Memo,008-05157,Varios:Promotional Allowance,Arroz Envasado:Parboiled 1kg Bolsa Dos Hermanos.,-1.0,19.9,-19.9,4018136.89,Branded Rice,# Orlando 0024,RETAIL SEDANOS,1387899,Mar
2025-03-21,Bravo Supermarkets Palm Bay,Credit Memo,008-05158,Varios:Promotional Allowance,Rice Snack:Rice Snack Salami Flavored DOS HERMANOS,-1.0,19.9,-19.9,4018116.99,Puffed Products,# Orlando 0024,RETAIL  DSD,1387900,Mar
2025-03-21,Bravo Supermarkets Palm Bay,Credit Memo,008-05158,Varios:Promotional Allowance,Rice Snack:Rice Snack Ham Flavored DOS HERMANOS,-1.0,19.9,-19.9,4018097.09,Puffed Products,# Orlando 0024,RETAIL  DSD,1387901,Mar
2025-03-21,Bravo Supermarkets Palm Bay,Credit Memo,008-05158,Varios:Promotional Allowance,Arroz Envasado:Parboiled 1kg Bolsa Dos Hermanos.,-1.0,19.9,-19.9,4018077.19,Puffed Products,# Orlando 0024,RETAIL  DSD,1387902,Mar
2025-03-21,Lissete Limpio,Credit Memo,008-05159,Varios:Promotional Allowance,Arroz Envasado:Largo Fino 1kg (Long grain rice) Dos Hermanos,-1.0,18.0,-18.0,4018059.19,Branded Rice,Lisset Limpio -020,OTHER,1387903,Mar
2025-03-21,Lissete Limpio,Credit Memo,008-05159,Varios:Promotional Allowance,Arroz Envasado:Parboiled 1kg Bolsa Dos Hermanos.,-1.0,19.9,-19.9,4018039.29,Branded Rice,Lisset Limpio -020,OTHER,1387904,Mar
2025-03-21,El Palacio de los jugos / Lita Foods Inc.,Credit Memo,008-05160,Varios:Promotional Allowance,Arroz a Granel:Parboiled 50 LB -Bolsa Dos Hermanos.,-1.0,27.75,-27.75,4018011.54,Bulk Rice,Lisset Limpio -020,Cafeteria,1387905,Mar
2025-03-21,ALS Foods,Credit Memo,008-05161,Varios:Promotional Allowance,Arroz a Granel:Parboiled 50 LB -Bolsa Dos Hermanos.,-1.0,27.75,-27.75,4017983.79,Bulk Rice,Lisset Limpio -020,CAFETERIA y RESTAURANTS,1387906,Mar
2025-03-23,El Palacio de los jugos /  Nanos Latin Foods,Invoice,008-05162,Arroz a Granel:Largo Fino 50 LB -Bolsa Dos Hermanos.,,8.0,27.85,222.8,4018206.59,Bulk Rice,Lisset Limpio -020,Cafeteria,1387907,Mar
2025-03-23,El Palacio de Los Jugos / Casa mía Food Restaurant inc,Invoice,008-05163,Dry Beans:Dry Beans - Black Beans 50,Dry Black Beans 50 lb,1.0,45.7,45.7,4018252.29,Dry Beans,Lisset Limpio -020,Cafeteria,1387908,Mar
2025-03-23,El Palacio de Los Jugos / Casa mía Food Restaurant inc,Invoice,008-05163,Arroz a Granel:Parboiled 50 LB -Bolsa Dos Hermanos.,,11.0,27.75,305.25,4018557.54,Bulk Rice,Lisset Limpio -020,Cafeteria,1387909,Mar
2025-03-23,El Palacio de Los Jugos / Casa mía Food Restaurant inc,Invoice,008-05163,Arroz a Granel:Parboiled 50 LB -Bolsa Dos Hermanos.,,1.0,27.75,27.75,4018585.29,Bulk Rice,Lisset Limpio -020,Cafeteria,1387910,Mar
2025-03-23,El Palacio de los jugos /  EMMA FOOD CORP,Invoice,008-05164,Arroz a Granel:Largo Fino 50 LB -Bolsa Dos Hermanos.,,8.0,27.85,222.8,4018808.09,Bulk Rice,Lisset Limpio -020,Cafeteria,1387911,Mar
2025-03-23,Aries Supermarket & Cafeteria,Invoice,008-05165,Dry Beans:Dry Beans - Black Beans 50,Dry Black Beans 50 lb,5.0,36.75,183.75,4018991.84,Dry Beans,Keila Alfaro-Visvikis,CAFETERIA y RESTAURANTS,1387912,Mar
2025-03-23,Aries Supermarket & Cafeteria,Invoice,008-05165,Arroz a Granel:Parboiled 50 LB -Bolsa Dos Hermanos.,,5.0,28.25,141.25,4019133.09,Bulk Rice,Keila Alfaro-Visvikis,CAFETERIA y RESTAURANTS,1387913,Mar
2025-03-23,Be Your Will LLC,Invoice,008-05166,Arroz a Granel:Largo Fino 50 LB -Bolsa Dos Hermanos.,,8.0,27.85,222.8,4019355.89,Bulk Rice,Lisset Limpio -020,CAFETERIA y RESTAURANTS,1387914,Mar
2025-03-23,Be Your Will LLC,Invoice,008-05166,Arroz a Granel:Parboiled 50 LB -Bolsa Dos Hermanos.,,14.0,26.75,374.5,4019730.39,Bulk Rice,Lisset Limpio -020,CAFETERIA y RESTAURANTS,1387915,Mar
2025-03-23,El Palacio de los jugos / Caribe Tropical,Invoice,008-05167,Arroz a Granel:Parboiled 50 LB -Bolsa Dos Hermanos.,,10.0,26.75,267.5,4019997.89,Bulk Rice,Lisset Limpio -020,Cafeteria,1387916,Mar
2025-03-23,El Palacio de los jugos / Rodriguez Foods,Invoice,008-05168,Arroz a Granel:Parboiled 50 LB -Bolsa Dos Hermanos.,,6.0,26.75,160.5,4020158.39,Bulk Rice,Lisset Limpio -020,Cafeteria,1387917,Mar
2025-03-23,JMN Dely Corp,Invoice,008-05169,Dry Beans:Dry Beans - Black Beans 50,Dry Black Beans 50 lb,1.0,45.7,45.7,4020204.09,Dry Beans,Keila Alfaro-Visvikis,CAFETERIA y RESTAURANTS,1387918,Mar
2025-03-23,JMN Dely Corp,Invoice,008-05169,Arroz a Granel:Largo Fino 50 LB -Bolsa Dos Hermanos.,,1.0,27.85,27.85,4020231.94,Bulk Rice,Keila Alfaro-Visvikis,CAFETERIA y RESTAURANTS,1387919,Mar
2025-03-23,JMN Dely Corp,Invoice,008-05169,Arroz a Granel:Parboiled 50 LB -Bolsa Dos Hermanos.,,2.0,28.25,56.5,4020288.44,Bulk Rice,Keila Alfaro-Visvikis,CAFETERIA y RESTAURANTS,1387920,Mar
2025-03-24,Bravo   Francisco Diaz,Invoice,008-05170,Liquids:AS White Vinegar,4/1 Gl.,2.0,10.0,20.0,4020308.44,American Spice,Lisset Limpio -020,RETAIL  DSD,1387921,Mar
2025-03-24,Bravo   Francisco Diaz,Invoice,008-05170,Arroz a Granel:Largo Fino 50 LB -Bolsa Dos Hermanos.,,5.0,27.85,139.25,4020447.69,Bulk Rice,Lisset Limpio -020,RETAIL  DSD,1387922,Mar
2025-03-24,Bravo   Francisco Diaz,Invoice,008-05170,Liquids:AS Marinating Sauce (Mojo),,4.0,18.5,74.0,4020521.69,American Spice,Lisset Limpio -020,RETAIL  DSD,1387923,Mar
2025-03-24,Bravo   Francisco Diaz,Invoice,008-05170,Spices:AS Chicken Base,1 / 30 lb. (box or pail),1.0,39.0,39.0,4020560.69,American Spice,Lisset Limpio -020,RETAIL  DSD,1387924,Mar
2025-03-24,Bravo   Francisco Diaz,Invoice,008-05170,Spices:AS Sazon (for all),1 / 30 lb (box or pail),1.0,59.0,59.0,4020619.69,American Spice,Lisset Limpio -020,RETAIL  DSD,1387925,Mar
2025-03-24,Bravo   Francisco Diaz,Invoice,008-05170,Spices:AS Meat Tenderizer,12 / 4.5 oz,1.0,12.95,12.95,4020632.64,American Spice,Lisset Limpio -020,RETAIL  DSD,1387926,Mar
2025-03-24,El Palacio de los jugos / Delicias Criollas (DIAGO FOOD_MILLER),Invoice,008-05171,Arroz a Granel:Largo Fino 50 LB -Bolsa Dos Hermanos.,,8.0,27.85,222.8,4020855.44,Bulk Rice,Lisset Limpio -020,Cafeteria,1387927,Mar
2025-03-24,El Palacio de los jugos / Delicias Criollas (DIAGO FOOD_MILLER),Credit Memo,008-05174,Varios:Promotional Allowance,Arroz a Granel:Parboiled 50 LB -Bolsa Dos Hermanos.,-1.0,27.75,-27.75,4020827.69,Bulk Rice,Lisset Limpio -020,Cafeteria,1387928,Mar
2025-03-24,El Palacio de los jugos / Lita Foods Inc.,Credit Memo,008-05175,Varios:Promotional Allowance,Arroz a Granel:Parboiled 50 LB -Bolsa Dos Hermanos.,-1.0,27.75,-27.75,4020799.94,Puffed Products,Lisset Limpio -020,Cafeteria,1387929,Mar
2025-03-25,El Palacio de Los Jugos / Casa mía Food Restaurant inc,Credit Memo,008-05172,Varios:Promotional Allowance,Arroz a Granel:Parboiled 50 LB -Bolsa Dos Hermanos.,-1.0,27.75,-27.75,4020772.19,Bulk Rice,Lisset Limpio -020,Cafeteria,1387930,Mar
2025-03-25,Sedanos Supermarkets #18,Credit Memo,008-05173,Varios:Promotional Allowance,Rice Snack:Rice Snack Ham Flavored DOS HERMANOS,-1.0,19.9,-19.9,4020752.29,Puffed Products,Keila Alfaro-Visvikis,RETAIL SEDANOS,1387931,Mar
2025-03-25,Sedanos Supermarkets #18,Credit Memo,008-05173,Varios:Promotional Allowance,Rice Snack:Rice Snack Salami Flavored DOS HERMANOS,-1.0,19.9,-19.9,4020732.39,Puffed Products,Keila Alfaro-Visvikis,RETAIL SEDANOS,1387932,Mar
2025-03-26,Ideal Food Basket Davie Cafeteria,Invoice,008-05176,Arroz a Granel:Largo Fino 50 LB -Bolsa Dos Hermanos.,,8.0,27.85,222.8,4020955.19,Bulk Rice,Keila Alfaro-Visvikis,CAFETERIA y RESTAURANTS,1387933,Mar
2025-03-26,Key Foods - 10301 Royal Palm Food Corp.,Invoice,008-05177,Arroz Envasado:Largo Fino 1kg (Long grain rice) Dos Hermanos,,20.0,18.0,360.0,4021315.19,Branded Rice,Keila Alfaro-Visvikis,RETAIL KEY FOOD,1387934,Mar
2025-03-26,Key Foods - 10301 Royal Palm Food Corp.,Invoice,008-05177,Arroz Envasado:Largo Fino 1kg (Long grain rice) Dos Hermanos,,4.0,18.0,72.0,4021387.19,Branded Rice,Keila Alfaro-Visvikis,RETAIL KEY FOOD,1387935,Mar
2025-03-26,Sedanos Supermarkets #27,Invoice,008-05178,Arroz a Granel:Parboiled 50 LB -Bolsa Dos Hermanos.,,6.0,28.25,169.5,4021556.69,Bulk Rice,Keila Alfaro-Visvikis,RETAIL SEDANOS,1387936,Mar
2025-03-26,Sedanos Supermarkets #27,Invoice,008-05178,,Discount,,,-3.39,4021553.3,,Keila Alfaro-Visvikis,RETAIL SEDANOS,1387937,Mar
2025-03-26,Sedanos Supermarkets #27,Invoice,008-05179,Arroz Envasado:Parboiled 5KG Dos Hermanos.,6  11lbs,5.0,40.5,202.5,4021755.8,Branded Rice,Keila Alfaro-Visvikis,RETAIL SEDANOS,1387938,Mar
2025-03-26,Sedanos Supermarkets #27,Invoice,008-05179,Varios:Promotional Allowance,,5.0,-11.15,-55.75,4021700.05,Branded Rice,Keila Alfaro-Visvikis,RETAIL SEDANOS,1387939,Mar
2025-03-26,Sedanos Supermarkets #27,Invoice,008-05179,,Discount,,,-2.94,4021697.11,,Keila Alfaro-Visvikis,RETAIL SEDANOS,1387940,Mar
2025-03-26,BRAVO - Flamingo #3,Invoice,008-05180,Arroz Envasado:Largo Fino 1kg (Long grain rice) Dos Hermanos,,5.0,18.0,90.0,4021787.11,Branded Rice,Keila Alfaro-Visvikis,RETAIL  DSD,1387941,Mar
2025-03-26,BRAVO - Flamingo #3,Invoice,008-05180,Arroz Envasado:Largo Fino 1kg (Long grain rice) Dos Hermanos,,1.0,18.0,18.0,4021805.11,Branded Rice,Keila Alfaro-Visvikis,RETAIL  DSD,1387942,Mar
2025-03-26,Sedanos Supermarkets #24,Invoice,008-05181,Arroz a Granel:Parboiled 50 LB -Bolsa Dos Hermanos.,,8.0,28.25,226.0,4022031.11,Bulk Rice,Keila Alfaro-Visvikis,RETAIL SEDANOS,1387943,Mar
2025-03-26,Sedanos Supermarkets #24,Invoice,008-05181,,Discount,,,-4.52,4022026.59,,Keila Alfaro-Visvikis,RETAIL SEDANOS,1387944,Mar
2025-03-26,Sedanos Supermarkets #33,Invoice,008-05182,Arroz a Granel:Parboiled 50 LB -Bolsa Dos Hermanos.,,5.0,28.25,141.25,4022167.84,Bulk Rice,Keila Alfaro-Visvikis,RETAIL SEDANOS,1387945,Mar
2025-03-26,Sedanos Supermarkets #33,Invoice,008-05182,,Discount,,,-2.83,4022165.01,,Keila Alfaro-Visvikis,RETAIL SEDANOS,1387946,Mar
2025-03-26,Gala Fresh Farms - Boca Ratón,Invoice,008-05183,Arroz Envasado:Parboiled 5KG Dos Hermanos.,6  11lbs,20.0,46.5,930.0,4023095.01,Branded Rice,Keila Alfaro-Visvikis,RETAIL  DSD,1387947,Mar
2025-03-26,Gala Fresh Farms - Boca Ratón,Invoice,008-05183,Arroz Envasado:Largo Fino 1kg (Long grain rice) Dos Hermanos,,5.0,18.0,90.0,4023185.01,Branded Rice,Keila Alfaro-Visvikis,RETAIL  DSD,1387948,Mar
2025-03-26,Gala Fresh Farms - Boca Ratón,Invoice,008-05183,Arroz Envasado:Sushi Rice Dos Hermanos.,.,1.0,20.0,20.0,4023205.01,Branded Rice,Keila Alfaro-Visvikis,RETAIL  DSD,1387949,Mar
2025-03-26,Gala Fresh Farms - Boca Ratón,Invoice,008-05183,Arroz Envasado:Parboiled 5KG Dos Hermanos.,6  11lbs,20.0,46.5,930.0,4024135.01,Branded Rice,Keila Alfaro-Visvikis,RETAIL  DSD,1387950,Mar
2025-03-26,Gala Fresh Farms - Boca Ratón,Invoice,008-05183,Arroz Envasado:Largo Fino 1kg (Long grain rice) Dos Hermanos,,1.0,18.0,18.0,4024153.01,Branded Rice,Keila Alfaro-Visvikis,RETAIL  DSD,1387951,Mar
2025-03-26,Gala Fresh Farms - Boca Ratón,Credit Memo,008-05184,Varios:Producto vencido/deteriorado (no impacta en inventario),,-10.0,1.49,-14.9,4024138.11,Puffed Products,Keila Alfaro-Visvikis,RETAIL  DSD,1387952,Mar
2025-03-27,El Palacio de los jugos / Leti Corp.,Invoice,008-05185,Arroz a Granel:Largo Fino 50 LB -Bolsa Dos Hermanos.,,5.0,27.85,139.25,4024277.36,Bulk Rice,Lisset Limpio -020,Cafeteria,1387953,Mar
2025-03-27,El Palacio de los jugos / Leti Corp.,Invoice,008-05185,Arroz a Granel:Parboiled 50 LB -Bolsa Dos Hermanos.,,4.0,26.75,107.0,4024384.36,Bulk Rice,Lisset Limpio -020,Cafeteria,1387954,Mar
2025-03-27,El Palacio de los jugos / Caribe Tropical,Invoice,008-05186,Arroz a Granel:Largo Fino 50 LB -Bolsa Dos Hermanos.,,2.0,27.85,55.7,4024440.06,Bulk Rice,Lisset Limpio -020,Cafeteria,1387955,Mar
2025-03-27,El Palacio de los jugos / Caribe Tropical,Invoice,008-05186,Arroz a Granel:Parboiled 50 LB -Bolsa Dos Hermanos.,,6.0,26.75,160.5,4024600.56,Bulk Rice,Lisset Limpio -020,Cafeteria,1387956,Mar
2025-03-27,El Palacio de los jugos / Delicias Criollas (DIAGO FOOD_MILLER),Invoice,008-05187,Dry Beans:Dry Beans - Black Beans 50,Dry Black Beans 50 lb,1.0,45.7,45.7,4024646.26,Dry Beans,Lisset Limpio -020,Cafeteria,1387957,Mar
2025-03-27,El Palacio de los jugos / Delicias Criollas (DIAGO FOOD_MILLER),Invoice,008-05187,Arroz a Granel:Parboiled 50 LB -Bolsa Dos Hermanos.,,11.0,27.75,305.25,4024951.51,Bulk Rice,Lisset Limpio -020,Cafeteria,1387958,Mar
2025-03-27,El Palacio de los jugos / Delicias Criollas (DIAGO FOOD_MILLER),Invoice,008-05187,Arroz a Granel:Parboiled 50 LB -Bolsa Dos Hermanos.,,1.0,27.75,27.75,4024979.26,Bulk Rice,Lisset Limpio -020,Cafeteria,1387959,Mar
2025-03-27,Panda Depot,Invoice,008-05188,Arroz a Granel:Largo Fino 50 LB -Bolsa Dos Hermanos.,,110.0,24.5,2695.0,4027674.26,Bulk Rice,Lisset Limpio -020,WHOLESALER,1387960,Mar
2025-03-27,Panda Depot,Invoice,008-05188,Arroz a Granel:Parboiled 50 LB -Bolsa Dos Hermanos.,,220.0,25.0,5500.0,4033174.26,Bulk Rice,Lisset Limpio -020,WHOLESALER,1387961,Mar
2025-03-27,"El Toro Loco Meat Distribution, LLC",Invoice,008-05189,Dry Beans:Dry Beans - Black Beans 50,Dry Black Beans 50 lb,40.0,36.75,1470.0,4034644.26,Dry Beans,Lisset Limpio -020,CAFETERIA y RESTAURANTS,1387962,Mar
2025-03-27,El Palacio de los jugos /  Nanos Latin Foods,Invoice,008-05190,Arroz a Granel:Parboiled 50 LB -Bolsa Dos Hermanos.,,10.0,26.75,267.5,4034911.76,Bulk Rice,Lisset Limpio -020,Cafeteria,1387963,Mar
2025-03-27,El Palacio de los jugos /  Nanos Latin Foods,Invoice,008-05190,Arroz a Granel:Largo Fino 50 LB -Bolsa Dos Hermanos.,,2.0,27.85,55.7,4034967.46,Bulk Rice,Lisset Limpio -020,Cafeteria,1387964,Mar
2025-03-27,El Palacio de Los Jugos / Casa mía Food Restaurant inc,Invoice,008-05191,Dry Beans:Dry Beans - Black Beans 50,Dry Black Beans 50 lb,1.0,45.7,45.7,4035013.16,Dry Beans,Lisset Limpio -020,Cafeteria,1387965,Mar
2025-03-27,El Palacio de Los Jugos / Casa mía Food Restaurant inc,Invoice,008-05191,Arroz a Granel:Parboiled 50 LB -Bolsa Dos Hermanos.,,11.0,27.75,305.25,4035318.41,Bulk Rice,Lisset Limpio -020,Cafeteria,1387966,Mar
2025-03-27,El Palacio de Los Jugos / Casa mía Food Restaurant inc,Invoice,008-05191,Arroz a Granel:Parboiled 50 LB -Bolsa Dos Hermanos.,,1.0,27.75,27.75,4035346.16,Bulk Rice,Lisset Limpio -020,Cafeteria,1387967,Mar
2025-03-27,Sedanos Supermarkets #18,Invoice,008-05192,Arroz a Granel:Parboiled 50 LB -Bolsa Dos Hermanos.,,10.0,28.25,282.5,4035628.66,Bulk Rice,Keila Alfaro-Visvikis,RETAIL SEDANOS,1387968,Mar
2025-03-27,Sedanos Supermarkets #18,Invoice,008-05192,,Discount,,,-5.65,4035623.01,,Keila Alfaro-Visvikis,RETAIL SEDANOS,1387969,Mar
2025-03-27,El Palacio de los jugos / Lita Foods Inc.,Invoice,008-05193,Dry Beans:Dry Beans - Black Beans 50,Dry Black Beans 50 lb,1.0,45.7,45.7,4035668.71,Dry Beans,Lisset Limpio -020,Cafeteria,1387970,Mar
2025-03-27,El Palacio de los jugos / Lita Foods Inc.,Invoice,008-05193,Arroz a Granel:Parboiled 50 LB -Bolsa Dos Hermanos.,,11.0,27.75,305.25,4035973.96,Bulk Rice,Lisset Limpio -020,Cafeteria,1387971,Mar
2025-03-27,El Palacio de los jugos / Lita Foods Inc.,Invoice,008-05193,Arroz a Granel:Parboiled 50 LB -Bolsa Dos Hermanos.,,1.0,27.75,27.75,4036001.71,Bulk Rice,Lisset Limpio -020,Cafeteria,1387972,Mar
2025-03-27,El Palacio de los jugos /  EMMA FOOD CORP,Invoice,008-05194,Arroz a Granel:Largo Fino 50 LB -Bolsa Dos Hermanos.,,5.0,27.85,139.25,4036140.96,Bulk Rice,Lisset Limpio -020,Cafeteria,1387973,Mar
2025-03-27,El Palacio de los jugos / Rodriguez Foods,Invoice,008-05195,Arroz a Granel:Parboiled 50 LB -Bolsa Dos Hermanos.,,6.0,26.75,160.5,4036301.46,Bulk Rice,Lisset Limpio -020,Cafeteria,1387974,Mar
2025-03-27,El Palacio de los jugos / J Mena Corp.,Invoice,008-05196,Dry Beans:Dry Beans - Black Beans 50,Dry Black Beans 50 lb,2.0,36.75,73.5,4036374.96,Dry Beans,Lisset Limpio -020,Cafeteria,1387975,Mar
2025-03-27,El Palacio de los jugos / J Mena Corp.,Invoice,008-05196,Arroz a Granel:Parboiled 50 LB -Bolsa Dos Hermanos.,,10.0,26.75,267.5,4036642.46,Bulk Rice,Lisset Limpio -020,Cafeteria,1387976,Mar
2025-03-27,Sedanos Supermarkets #32,Invoice,008-05197,Arroz a Granel:Parboiled 50 LB -Bolsa Dos Hermanos.,,5.0,28.25,141.25,4036783.71,Bulk Rice,Keila Alfaro-Visvikis,RETAIL SEDANOS,1387977,Mar
2025-03-27,Sedanos Supermarkets #32,Invoice,008-05197,Arroz a Granel:Largo Fino 50 LB -Bolsa Dos Hermanos.,,4.0,27.85,111.4,4036895.11,Bulk Rice,Keila Alfaro-Visvikis,RETAIL SEDANOS,1387978,Mar
2025-03-27,Sedanos Supermarkets #32,Invoice,008-05197,,Discount,,,-5.05,4036890.06,,Keila Alfaro-Visvikis,RETAIL SEDANOS,1387979,Mar
2025-03-27,Sedanos Supermarkets #16,Invoice,008-05198,Arroz a Granel:Parboiled 50 LB -Bolsa Dos Hermanos.,,4.0,28.25,113.0,4037003.06,Bulk Rice,Keila Alfaro-Visvikis,RETAIL SEDANOS,1387980,Mar
2025-03-27,Sedanos Supermarkets #16,Invoice,008-05198,,Discount,,,-2.26,4037000.8,,Keila Alfaro-Visvikis,RETAIL SEDANOS,1387981,Mar
2025-03-27,Los Caringas Latin America  Foods,Invoice,008-05199,Arroz a Granel:Largo Fino 50 LB -Bolsa Dos Hermanos.,,3.0,27.85,83.55,4037084.35,Bulk Rice,Lisset Limpio -020,CAFETERIA y RESTAURANTS,1387982,Mar
2025-03-27,Los Caringas Latin America  Foods,Invoice,008-05199,Arroz a Granel:Parboiled 50 LB -Bolsa Dos Hermanos.,,3.0,28.25,84.75,4037169.1,Bulk Rice,Lisset Limpio -020,CAFETERIA y RESTAURANTS,1387983,Mar
2025-03-28,Sedanos Supermarkets #14,Invoice,008-05200,Arroz a Granel:Parboiled 50 LB -Bolsa Dos Hermanos.,,2.0,28.25,56.5,4037225.6,Bulk Rice,Keila Alfaro-Visvikis,RETAIL SEDANOS,1387984,Mar
2025-03-28,Sedanos Supermarkets #14,Invoice,008-05200,,Discount,,,-1.13,4037224.47,,Keila Alfaro-Visvikis,RETAIL SEDANOS,1387985,Mar
2025-03-28,Sedanos Supermarkets #14,Invoice,008-05201,Arroz Envasado:Largo Fino 1kg (Long grain rice) Dos Hermanos,,2.0,17.5,35.0,4037259.47,Branded Rice,Keila Alfaro-Visvikis,RETAIL SEDANOS,1387986,Mar
2025-03-28,Sedanos Supermarkets #14,Invoice,008-05201,Rice Snack:Rice Snack Ham Flavored DOS HERMANOS,,1.0,19.9,19.9,4037279.37,Puffed Products,Keila Alfaro-Visvikis,RETAIL SEDANOS,1387987,Mar
2025-03-28,Sedanos Supermarkets #14,Invoice,008-05201,Varios:Promotional Allowance,,2.0,-2.5,-5.0,4037274.37,Branded Rice,Keila Alfaro-Visvikis,RETAIL SEDANOS,1387988,Mar
2025-03-28,Sedanos Supermarkets #14,Invoice,008-05201,,Discount,,,-1.0,4037273.37,,Keila Alfaro-Visvikis,RETAIL SEDANOS,1387989,Mar
2025-03-28,"American Spice Trading Co, Inc.",Invoice,008-05202,Arroz a Granel:Parboiled 50 LB -Bolsa Dos Hermanos.,,1100.0,26.0,28600.0,4065873.37,Bulk Rice,Armando Carpio - 017,WHOLESALER MANUFACTURY,1387990,Mar
2025-03-28,Key Foods - 10301 Royal Palm Food Corp.,Credit Memo,008-05203,Varios:Promotional Allowance,Arroz Envasado:Largo Fino 1kg (Long grain rice) Dos Hermanos,-4.0,18.0,-72.0,4065801.37,Branded Rice,Keila Alfaro-Visvikis,RETAIL KEY FOOD,1387991,Mar
2025-03-28,Gala Fresh Farms - Boca Ratón,Credit Memo,008-05204,Varios:Promotional Allowance,Arroz Envasado:Parboiled 5KG Dos Hermanos.,-20.0,46.5,-930.0,4064871.37,Branded Rice,Keila Alfaro-Visvikis,RETAIL  DSD,1387992,Mar
2025-03-28,Gala Fresh Farms - Boca Ratón,Credit Memo,008-05204,Varios:Promotional Allowance,Arroz Envasado:Largo Fino 1kg (Long grain rice) Dos Hermanos,-1.0,18.0,-18.0,4064853.37,Branded Rice,Keila Alfaro-Visvikis,RETAIL  DSD,1387993,Mar
2025-03-28,BRAVO - Flamingo #3,Credit Memo,008-05205,Varios:Promotional Allowance,Arroz Envasado:Largo Fino 1kg (Long grain rice) Dos Hermanos,-1.0,18.0,-18.0,4064835.37,Branded Rice,Keila Alfaro-Visvikis,RETAIL  DSD,1387994,Mar
2025-03-30,Hings Chinese,Invoice,008-05206,Arroz a Granel:Parboiled 50 LB -Bolsa Dos Hermanos.,,5.0,28.25,141.25,4064976.62,Bulk Rice,Lisset Limpio -020,CAFETERIA y RESTAURANTS,1387995,Mar
2025-03-30,El Palacio de los jugos /  Nanos Latin Foods,Invoice,008-05207,Arroz a Granel:Largo Fino 50 LB -Bolsa Dos Hermanos.,,4.0,27.85,111.4,4065088.02,Bulk Rice,Lisset Limpio -020,Cafeteria,1387996,Mar
2025-03-30,El Palacio de los jugos /  Nanos Latin Foods,Invoice,008-05207,Arroz a Granel:Parboiled 50 LB -Bolsa Dos Hermanos.,,10.0,26.75,267.5,4065355.52,Bulk Rice,Lisset Limpio -020,Cafeteria,1387997,Mar
2025-03-30,El Palacio de los jugos / Lita Foods Inc.,Invoice,008-05208,Dry Beans:Dry Beans - Black Beans 50,Dry Black Beans 50 lb,1.0,45.7,45.7,4065401.22,Dry Beans,Lisset Limpio -020,Cafeteria,1387998,Mar
2025-03-30,El Palacio de los jugos / Lita Foods Inc.,Invoice,008-05208,Arroz a Granel:Parboiled 50 LB -Bolsa Dos Hermanos.,,11.0,27.75,305.25,4065706.47,Bulk Rice,Lisset Limpio -020,Cafeteria,1387999,Mar
2025-03-30,El Palacio de los jugos / Lita Foods Inc.,Invoice,008-05208,Arroz a Granel:Parboiled 50 LB -Bolsa Dos Hermanos.,,1.0,27.75,27.75,4065734.22,Bulk Rice,Lisset Limpio -020,Cafeteria,1388000,Mar
2025-03-30,ALS Foods,Invoice,008-05209,Arroz a Granel:Largo Fino 50 LB -Bolsa Dos Hermanos.,,8.0,27.85,222.8,4065957.02,Bulk Rice,Lisset Limpio -020,CAFETERIA y RESTAURANTS,1388001,Mar
2025-03-30,ALS Foods,Invoice,008-05209,Arroz a Granel:Parboiled 50 LB -Bolsa Dos Hermanos.,,14.0,26.75,374.5,4066331.52,Bulk Rice,Lisset Limpio -020,CAFETERIA y RESTAURANTS,1388002,Mar
2025-03-30,ALS Foods,Invoice,008-05209,Dry Beans:Dry Beans - Black Beans 50,Dry Black Beans 50 lb,1.0,36.75,36.75,4066368.27,Dry Beans,Lisset Limpio -020,CAFETERIA y RESTAURANTS,1388003,Mar
2025-03-30,El Palacio de los jugos / Caribe Tropical,Invoice,008-05210,Arroz a Granel:Largo Fino 50 LB -Bolsa Dos Hermanos.,,2.0,27.85,55.7,4066423.97,Bulk Rice,Lisset Limpio -020,Cafeteria,1388004,Mar
2025-03-30,El Palacio de los jugos / Caribe Tropical,Invoice,008-05210,Arroz a Granel:Parboiled 50 LB -Bolsa Dos Hermanos.,,6.0,26.75,160.5,4066584.47,Bulk Rice,Lisset Limpio -020,Cafeteria,1388005,Mar
2025-03-30,Aries Supermarket & Cafeteria,Invoice,008-05211,Dry Beans:Dry Beans - Black Beans 50,Dry Black Beans 50 lb,3.0,36.75,110.25,4066694.72,Dry Beans,Keila Alfaro-Visvikis,CAFETERIA y RESTAURANTS,1388006,Mar
2025-03-30,Aries Supermarket & Cafeteria,Invoice,008-05211,Arroz a Granel:Parboiled 50 LB -Bolsa Dos Hermanos.,,5.0,28.25,141.25,4066835.97,Bulk Rice,Keila Alfaro-Visvikis,CAFETERIA y RESTAURANTS,1388007,Mar
2025-03-30,Aries Supermarket & Cafeteria,Invoice,008-05211,Spices:AS Oregano Ground,4 / 3.5 Lbs.,1.0,37.5,37.5,4066873.47,American Spice,Keila Alfaro-Visvikis,CAFETERIA y RESTAURANTS,1388008,Mar
2025-03-30,JMN Dely Corp,Invoice,008-05212,Arroz a Granel:Largo Fino 50 LB -Bolsa Dos Hermanos.,,2.0,27.85,55.7,4066929.17,Bulk Rice,Keila Alfaro-Visvikis,CAFETERIA y RESTAURANTS,1388009,Mar
2025-03-30,JMN Dely Corp,Invoice,008-05212,Arroz a Granel:Parboiled 50 LB -Bolsa Dos Hermanos.,,2.0,27.75,55.5,4066984.67,Bulk Rice,Keila Alfaro-Visvikis,CAFETERIA y RESTAURANTS,1388010,Mar
2025-03-30,JMN Dely Corp,Invoice,008-05212,Dry Beans:Dry Beans - Black Beans 50,Dry Black Beans 50 lb,1.0,45.7,45.7,4067030.37,Dry Beans,Keila Alfaro-Visvikis,CAFETERIA y RESTAURANTS,1388011,Mar
2025-03-30,El Gallego Supermarket,Invoice,008-05213,Liquids:AS Bitter Orange,,2.0,14.0,28.0,4067058.37,American Spice,Lisset Limpio -020,RETAIL  DSD,1388012,Mar
2025-03-30,El Gallego Supermarket,Invoice,008-05213,Dry Beans:Dry Beans - Black Beans 50,Dry Black Beans 50 lb,2.0,45.7,91.4,4067149.77,Dry Beans,Lisset Limpio -020,RETAIL  DSD,1388013,Mar
2025-03-30,El Gallego Supermarket,Invoice,008-05213,Arroz a Granel:Parboiled 50 LB -Bolsa Dos Hermanos.,,5.0,28.25,141.25,4067291.02,Bulk Rice,Lisset Limpio -020,RETAIL  DSD,1388014,Mar
2025-03-30,Sedanos Supermarkets #17,Invoice,008-05214,Arroz Envasado:Largo Fino 1kg (Long grain rice) Dos Hermanos,,1.0,17.5,17.5,4067308.52,Branded Rice,Keila Alfaro-Visvikis,RETAIL SEDANOS,1388015,Mar
2025-03-30,Sedanos Supermarkets #17,Invoice,008-05214,Varios:Promotional Allowance,,1.0,-2.5,-2.5,4067306.02,Branded Rice,Keila Alfaro-Visvikis,RETAIL SEDANOS,1388016,Mar
2025-03-30,Sedanos Supermarkets #17,Invoice,008-05214,,Discount,,,-0.3,4067305.72,,Keila Alfaro-Visvikis,RETAIL SEDANOS,1388017,Mar
2025-03-30,Rey Chavez Distributor #2,Invoice,008-05215,Arroz a Granel:Parboiled 50 LB -Bolsa Dos Hermanos.,,20.0,27.5,550.0,4067855.72,Bulk Rice,Lisset Limpio -020,WHOLESALER,1388018,Mar
2025-03-30,Sedanos Supermarkets #43,Invoice,008-05216,Rice Snack:Rice Snack Ham Flavored DOS HERMANOS,,1.0,19.9,19.9,4067875.62,Puffed Products,Keila Alfaro-Visvikis,RETAIL SEDANOS,1388019,Mar
2025-03-30,Sedanos Supermarkets #43,Invoice,008-05216,Rice Snack:Rice Snack Salami Flavored DOS HERMANOS,,1.0,19.9,19.9,4067895.52,Puffed Products,Keila Alfaro-Visvikis,RETAIL SEDANOS,1388020,Mar
2025-03-30,Sedanos Supermarkets #43,Invoice,008-05216,Rice Snack:Rice Snack Ham Flavored DOS HERMANOS,,1.0,19.9,19.9,4067915.42,Puffed Products,Keila Alfaro-Visvikis,RETAIL SEDANOS,1388021,Mar
2025-03-30,Sedanos Supermarkets #43,Invoice,008-05216,Varios:Sales,Rice Snack:Rice Snack Salami Flavored DOS HERMANOS,1.0,19.9,19.9,4067935.32,Puffed Products,Keila Alfaro-Visvikis,RETAIL SEDANOS,1388022,Mar
2025-03-30,Sedanos Supermarkets #43,Invoice,008-05216,,Discount,,,-3.0,4067932.32,,Keila Alfaro-Visvikis,RETAIL SEDANOS,1388023,Mar
2025-03-30,Sedanos Supermarkets #22,Invoice,008-05217,Arroz Envasado:Largo Fino 1kg (Long grain rice) Dos Hermanos,,1.0,17.5,17.5,4067949.82,Branded Rice,Keila Alfaro-Visvikis,RETAIL SEDANOS,1388024,Mar
2025-03-30,Sedanos Supermarkets #22,Invoice,008-05217,Rice Snack:Rice Snack Ham Flavored DOS HERMANOS,,2.0,19.9,39.8,4067989.62,Puffed Products,Keila Alfaro-Visvikis,RETAIL SEDANOS,1388025,Mar
2025-03-30,Sedanos Supermarkets #22,Invoice,008-05217,Rice Snack:Rice Snack Ham Flavored DOS HERMANOS,,1.0,19.9,19.9,4068009.52,Puffed Products,Keila Alfaro-Visvikis,RETAIL SEDANOS,1388026,Mar
2025-03-30,Sedanos Supermarkets #22,Invoice,008-05217,,Discount,,,-0.73,4068008.79,,Keila Alfaro-Visvikis,RETAIL SEDANOS,1388027,Mar
2025-03-31,Bravo   Francisco Diaz,Invoice,008-05218,Arroz a Granel:Largo Fino 50 LB -Bolsa Dos Hermanos.,,5.0,27.85,139.25,4068148.04,Bulk Rice,Lisset Limpio -020,RETAIL  DSD,1388028,Mar
2025-03-31,El Palacio de los jugos / Rodriguez Foods,Invoice,008-05219,Arroz a Granel:Parboiled 50 LB -Bolsa Dos Hermanos.,,6.0,26.75,160.5,4068308.54,Bulk Rice,Lisset Limpio -020,Cafeteria,1388029,Mar
2025-03-31,El Palacio de los jugos /  EMMA FOOD CORP,Invoice,008-05220,Arroz a Granel:Largo Fino 50 LB -Bolsa Dos Hermanos.,,5.0,27.85,139.25,4068447.79,Bulk Rice,Lisset Limpio -020,Cafeteria,1388030,Mar
2025-03-31,El Palacio de Los Jugos / Casa mía Food Restaurant inc,Credit Memo,008-05221,Varios:Promotional Allowance,Arroz a Granel:Parboiled 50 LB -Bolsa Dos Hermanos.,-1.0,27.75,-27.75,4068420.04,Bulk Rice,Lisset Limpio -020,Cafeteria,1388031,Mar
2025-03-31,El Palacio de los jugos / Lita Foods Inc.,Credit Memo,008-05222,Varios:Promotional Allowance,Arroz a Granel:Parboiled 50 LB -Bolsa Dos Hermanos.,-1.0,27.75,-27.75,4068392.29,Bulk Rice,Lisset Limpio -020,Cafeteria,1388032,Mar
2025-03-31,El Palacio de los jugos / Delicias Criollas (DIAGO FOOD_MILLER),Credit Memo,008-05223,Varios:Promotional Allowance,Arroz a Granel:Parboiled 50 LB -Bolsa Dos Hermanos.,-1.0,27.75,-27.75,4068364.54,,Lisset Limpio -020,Cafeteria,1388033,Mar
2025-03-31,Soriano Brothers PB,Invoice,008-05224,Spices:AS Sazon (for all),1 / 30 lb (box or pail),1.0,51.0,51.0,4068415.54,American Spice,Lisset Limpio -020,CAFETERIA y RESTAURANTS,1388034,Mar
2025-03-31,Soriano Brothers PB,Invoice,008-05224,Arroz a Granel:Largo Fino 50 LB -Bolsa Dos Hermanos.,,10.0,27.85,278.5,4068694.04,Bulk Rice,Lisset Limpio -020,CAFETERIA y RESTAURANTS,1388035,Mar
2025-03-31,Soriano Brothers PB,Invoice,008-05224,Arroz a Granel:Parboiled 50 LB -Bolsa Dos Hermanos.,,15.0,26.75,401.25,4069095.29,Bulk Rice,Lisset Limpio -020,CAFETERIA y RESTAURANTS,1388036,Mar
2025-03-31,Sedanos Supermarkets #31,Invoice,008-05225,Arroz a Granel:Parboiled 50 LB -Bolsa Dos Hermanos.,,5.0,28.25,141.25,4069236.54,Bulk Rice,Keila Alfaro-Visvikis,RETAIL SEDANOS,1388037,Mar
2025-03-31,Sedanos Supermarkets #31,Invoice,008-05225,,Discount,,,-2.83,4069233.71,,Keila Alfaro-Visvikis,RETAIL SEDANOS,1388038,Mar
2025-03-31,Sedanos Supermarkets #31,Invoice,008-05226,Arroz Envasado:Parboiled 5KG Dos Hermanos.,6  11lbs,20.0,40.5,810.0,4070043.71,Branded Rice,Keila Alfaro-Visvikis,RETAIL SEDANOS,1388039,Mar
2025-03-31,Sedanos Supermarkets #31,Invoice,008-05226,Arroz Envasado:Parboiled 5KG Dos Hermanos.,6  11lbs,20.0,40.5,810.0,4070853.71,Branded Rice,Keila Alfaro-Visvikis,RETAIL SEDANOS,1388040,Mar
2025-03-31,Sedanos Supermarkets #31,Invoice,008-05226,Arroz Envasado:Largo Fino 1kg (Long grain rice) Dos Hermanos,,1.0,17.5,17.5,4070871.21,Branded Rice,Keila Alfaro-Visvikis,RETAIL SEDANOS,1388041,Mar
2025-03-31,Sedanos Supermarkets #31,Invoice,008-05226,,Discount,,,-16.55,4070854.66,,Keila Alfaro-Visvikis,RETAIL SEDANOS,1388042,Mar
2025-03-31,Sabor Tropical Supermarket #3,Invoice,008-05227,Arroz Envasado:Largo Fino 1kg (Long grain rice) Dos Hermanos,,2.0,18.0,36.0,4070890.66,Branded Rice,Keila Alfaro-Visvikis,RETAIL KEY FOOD,1388043,Mar
2025-03-31,Sabor Tropical Supermarket #3,Invoice,008-05227,Arroz Envasado:Parboiled 1kg Bolsa Dos Hermanos.,.,3.0,19.9,59.7,4070950.36,Branded Rice,Keila Alfaro-Visvikis,RETAIL KEY FOOD,1388044,Mar
2025-03-31,Sabor Tropical Supermarket #3,Invoice,008-05227,Arroz Envasado:Largo Fino 1kg (Long grain rice) Dos Hermanos,,1.0,18.0,18.0,4070968.36,Branded Rice,Keila Alfaro-Visvikis,RETAIL KEY FOOD,1388045,Mar
2025-03-31,Sedanos Supermarkets #43,Credit Memo,008-05228,Varios:Promotional Allowance,Rice Snack:Rice Snack Ham Flavored DOS HERMANOS,-1.0,19.9,-19.9,4070948.46,Puffed Products,Keila Alfaro-Visvikis,RETAIL SEDANOS,1388046,Mar
2025-03-31,Sedanos Supermarkets #43,Credit Memo,008-05228,Varios:Promotional Allowance,Rice Snack:Rice Snack Ham Flavored DOS HERMANOS,-1.0,19.9,-19.9,4070928.56,Puffed Products,Keila Alfaro-Visvikis,RETAIL SEDANOS,1388047,Mar
2025-03-31,El Palacio de los jugos / Lita Foods Inc.,Credit Memo,008-05229,Varios:Promotional Allowance,Arroz a Granel:Parboiled 50 LB -Bolsa Dos Hermanos.,-1.0,27.75,-27.75,4070900.81,Bulk Rice,Lisset Limpio -020,Cafeteria,1388048,Mar
2025-03-31,Sedanos Supermarkets #22,Credit Memo,008-05230,Varios:Promotional Allowance,Rice Snack:Rice Snack Ham Flavored DOS HERMANOS,-1.0,19.9,-19.9,4070880.91,Puffed Products,Keila Alfaro-Visvikis,RETAIL SEDANOS,1388049,Mar
2025-03-31,Sabor Tropical Supermarket #3,Credit Memo,008-05257,Varios:Promotional Allowance,Arroz Envasado:Largo Fino 1kg (Long grain rice) Dos Hermanos,-1.0,18.0,-18.0,4070862.91,Branded Rice,Keila Alfaro-Visvikis,RETAIL KEY FOOD,1388050,Mar
2025-03-31,Sedanos Supermarkets #31,Credit Memo,008-05258,Varios:Promotional Allowance,Arroz Envasado:Parboiled 5KG Dos Hermanos.,-20.0,40.5,-810.0,4070052.91,Branded Rice,Keila Alfaro-Visvikis,RETAIL SEDANOS,1388051,Mar
2025-04-02,Ideal Food Basket Davie Cafeteria,Invoice,008-05231,Arroz a Granel:Largo Fino 50 LB -Bolsa Dos Hermanos.,,6.0,27.85,167.1,4070220.01,Bulk Rice,Keila Alfaro-Visvikis,CAFETERIA y RESTAURANTS,1388052,Apr
2025-04-02,Sedanos Supermarkets #26,Invoice,008-05232,Arroz a Granel:Parboiled 50 LB -Bolsa Dos Hermanos.,,5.0,28.25,141.25,4070361.26,Bulk Rice,Keila Alfaro-Visvikis,RETAIL SEDANOS,1388053,Apr
2025-04-02,Sedanos Supermarkets #26,Invoice,008-05232,,Discount,,,-2.83,4070358.43,,Keila Alfaro-Visvikis,RETAIL SEDANOS,1388054,Apr
2025-04-02,Key Food / Holywood,Invoice,008-05233,Arroz Envasado:Parboiled 5KG Dos Hermanos.,6  11lbs,15.0,46.5,697.5,4071055.93,Branded Rice,Keila Alfaro-Visvikis,RETAIL  DSD,1388055,Apr
2025-04-02,Key Food / Holywood,Invoice,008-05233,Arroz Envasado:Parboiled 5KG Dos Hermanos.,6  11lbs,7.0,46.5,325.5,4071381.43,Branded Rice,Keila Alfaro-Visvikis,RETAIL  DSD,1388056,Apr
2025-04-02,Sedanos Supermarkets #24,Invoice,008-05234,Arroz Envasado:Largo Fino 1kg (Long grain rice) Dos Hermanos,,1.0,17.5,17.5,4071398.93,Branded Rice,Keila Alfaro-Visvikis,RETAIL SEDANOS,1388057,Apr
2025-04-02,Sedanos Supermarkets #24,Invoice,008-05234,Arroz Envasado:Parboiled 5KG Dos Hermanos.,6  11lbs,5.0,40.5,202.5,4071601.43,Branded Rice,Keila Alfaro-Visvikis,RETAIL SEDANOS,1388058,Apr
2025-04-02,Sedanos Supermarkets #24,Invoice,008-05234,Arroz Envasado:Parboiled 5KG Dos Hermanos.,6  11lbs,2.0,40.5,81.0,4071682.43,Branded Rice,Keila Alfaro-Visvikis,RETAIL SEDANOS,1388059,Apr
2025-04-02,Sedanos Supermarkets #24,Invoice,008-05234,,Discount,,,-4.4,4071678.03,,Keila Alfaro-Visvikis,RETAIL SEDANOS,1388060,Apr
2025-04-02,Sedanos Supermarkets #24,Invoice,008-05235,Arroz a Granel:Parboiled 50 LB -Bolsa Dos Hermanos.,,8.0,28.25,226.0,4071904.03,Bulk Rice,Keila Alfaro-Visvikis,RETAIL SEDANOS,1388061,Apr
2025-04-02,Sedanos Supermarkets #24,Invoice,008-05235,,Discount,,,-4.52,4071899.51,,Keila Alfaro-Visvikis,RETAIL SEDANOS,1388062,Apr
2025-04-02,Sedanos Supermarkets #34,Invoice,008-05236,Arroz a Granel:Parboiled 50 LB -Bolsa Dos Hermanos.,,6.0,28.25,169.5,4072069.01,Bulk Rice,Keila Alfaro-Visvikis,RETAIL SEDANOS,1388063,Apr
2025-04-02,Sedanos Supermarkets #34,Invoice,008-05236,,Discount,,,-3.39,4072065.62,,Keila Alfaro-Visvikis,RETAIL SEDANOS,1388064,Apr
2025-04-02,Sedanos Supermarkets #34,Invoice,008-05237,Arroz Envasado:Largo Fino 1kg (Long grain rice) Dos Hermanos,,1.0,17.5,17.5,4072083.12,Branded Rice,Keila Alfaro-Visvikis,RETAIL SEDANOS,1388065,Apr
2025-04-02,Sedanos Supermarkets #34,Invoice,008-05237,Arroz Envasado:Parboiled 5KG Dos Hermanos.,6  11lbs,1.0,40.5,40.5,4072123.62,Branded Rice,Keila Alfaro-Visvikis,RETAIL SEDANOS,1388066,Apr
2025-04-02,Sedanos Supermarkets #34,Invoice,008-05237,,Discount,,,-1.16,4072122.46,,Keila Alfaro-Visvikis,RETAIL SEDANOS,1388067,Apr
2025-04-02,Sedanos Supermarkets #28,Invoice,008-05238,Arroz Envasado:Parboiled 5KG Dos Hermanos.,6  11lbs,15.0,40.5,607.5,4072729.96,Branded Rice,Keila Alfaro-Visvikis,RETAIL SEDANOS,1388068,Apr
2025-04-02,Sedanos Supermarkets #28,Invoice,008-05238,Arroz Envasado:Parboiled 5KG Dos Hermanos.,6  11lbs,3.0,40.5,121.5,4072851.46,Branded Rice,Keila Alfaro-Visvikis,RETAIL SEDANOS,1388069,Apr
2025-04-02,Sedanos Supermarkets #28,Invoice,008-05238,,Discount,,,-12.15,4072839.31,,Keila Alfaro-Visvikis,RETAIL SEDANOS,1388070,Apr
2025-04-02,Food Giant Market  10 Ave.,Invoice,008-05239,Arroz Envasado:Largo Fino 1kg (Long grain rice) Dos Hermanos,,1.0,18.0,18.0,4072857.31,Branded Rice,Keila Alfaro-Visvikis,RETAIL  DSD,1388071,Apr
2025-04-02,Food Giant Market  10 Ave.,Invoice,008-05239,Arroz Envasado:Parboiled 1kg Bolsa Dos Hermanos.,.,1.0,19.9,19.9,4072877.21,Branded Rice,Keila Alfaro-Visvikis,RETAIL  DSD,1388072,Apr
2025-04-02,Food Giant Market  10 Ave.,Invoice,008-05239,Arroz Envasado:Parboiled 5KG Dos Hermanos.,6  11lbs,2.0,46.5,93.0,4072970.21,Branded Rice,Keila Alfaro-Visvikis,RETAIL  DSD,1388073,Apr
2025-04-02,Food Giant Market  10 Ave.,Invoice,008-05239,Rice Snack:Rice Snack Ham Flavored DOS HERMANOS,,1.0,19.9,19.9,4072990.11,Puffed Products,Keila Alfaro-Visvikis,RETAIL  DSD,1388074,Apr
2025-04-02,Food Giant Market  10 Ave.,Invoice,008-05239,Rice Snack:Rice Snack Salami Flavored DOS HERMANOS,,1.0,19.9,19.9,4073010.01,Puffed Products,Keila Alfaro-Visvikis,RETAIL  DSD,1388075,Apr
2025-04-02,Food Giant Market  10 Ave.,Invoice,008-05239,Arroz Envasado:Largo Fino 1kg (Long grain rice) Dos Hermanos,,1.0,18.0,18.0,4073028.01,Branded Rice,Keila Alfaro-Visvikis,RETAIL  DSD,1388076,Apr
2025-04-02,Food Giant Market  10 Ave.,Invoice,008-05239,Rice Snack:Rice Snack Ham Flavored DOS HERMANOS,,1.0,19.9,19.9,4073047.91,Puffed Products,Keila Alfaro-Visvikis,RETAIL  DSD,1388077,Apr
2025-04-02,Food Giant Market  10 Ave.,Invoice,008-05239,Rice Snack:Rice Snack Salami Flavored DOS HERMANOS,,1.0,19.9,19.9,4073067.81,Puffed Products,Keila Alfaro-Visvikis,RETAIL  DSD,1388078,Apr
2025-04-02,Food Giant Market  10 Ave.,Invoice,008-05239,Arroz Envasado:Parboiled 5KG Dos Hermanos.,6  11lbs,1.0,19.9,19.9,4073087.71,Branded Rice,Keila Alfaro-Visvikis,RETAIL  DSD,1388079,Apr
2025-04-02,Mei Chang,Invoice,008-05240,Arroz a Granel:Parboiled 50 LB -Bolsa Dos Hermanos.,,10.0,28.25,282.5,4073370.21,Bulk Rice,Lisset Limpio -020,CAFETERIA y RESTAURANTS,1388080,Apr
2025-04-02,Sedanos Supermarkets #16,Invoice,008-05241,Arroz a Granel:Parboiled 50 LB -Bolsa Dos Hermanos.,,3.0,28.25,84.75,4073454.96,Bulk Rice,Keila Alfaro-Visvikis,RETAIL SEDANOS,1388081,Apr
2025-04-02,Sedanos Supermarkets #16,Invoice,008-05241,,Discount,,,-1.7,4073453.26,,Keila Alfaro-Visvikis,RETAIL SEDANOS,1388082,Apr
2025-04-02,Sedanos Supermarkets #22,Invoice,008-05242,Arroz a Granel:Parboiled 50 LB -Bolsa Dos Hermanos.,,4.0,28.25,113.0,4073566.26,Bulk Rice,Keila Alfaro-Visvikis,RETAIL SEDANOS,1388083,Apr
2025-04-02,Sedanos Supermarkets #22,Invoice,008-05242,,Discount,,,-2.26,4073564.0,,Keila Alfaro-Visvikis,RETAIL SEDANOS,1388084,Apr
2025-04-02,Sedanos Supermarkets #43,Invoice,008-05243,Arroz a Granel:Parboiled 50 LB -Bolsa Dos Hermanos.,,4.0,28.25,113.0,4073677.0,Bulk Rice,Keila Alfaro-Visvikis,RETAIL SEDANOS,1388085,Apr
2025-04-02,Sedanos Supermarkets #43,Invoice,008-05243,,Discount,,,-2.22,4073674.78,,Keila Alfaro-Visvikis,RETAIL SEDANOS,1388086,Apr
2025-04-03,El Palacio de los jugos /  Nanos Latin Foods,Invoice,008-05244,Arroz a Granel:Largo Fino 50 LB -Bolsa Dos Hermanos.,,5.0,27.85,139.25,4073814.03,Bulk Rice,Lisset Limpio -020,Cafeteria,1388087,Apr
2025-04-03,El Palacio de los jugos /  Nanos Latin Foods,Invoice,008-05244,Arroz a Granel:Parboiled 50 LB -Bolsa Dos Hermanos.,,5.0,26.75,133.75,4073947.78,Bulk Rice,Lisset Limpio -020,Cafeteria,1388088,Apr
2025-04-03,El Palacio de los jugos / Delicias Criollas (DIAGO FOOD_MILLER),Invoice,008-05245,Dry Beans:Dry Beans - Black Beans 50,Dry Black Beans 50 lb,1.0,45.7,45.7,4073993.48,Dry Beans,Lisset Limpio -020,Cafeteria,1388089,Apr
2025-04-03,El Palacio de los jugos / Delicias Criollas (DIAGO FOOD_MILLER),Invoice,008-05245,Arroz a Granel:Parboiled 50 LB -Bolsa Dos Hermanos.,,11.0,27.75,305.25,4074298.73,Bulk Rice,Lisset Limpio -020,Cafeteria,1388090,Apr
2025-04-03,El Palacio de los jugos / Delicias Criollas (DIAGO FOOD_MILLER),Invoice,008-05245,Arroz a Granel:Parboiled 50 LB -Bolsa Dos Hermanos.,,1.0,0.0,0.0,4074298.73,Bulk Rice,Lisset Limpio -020,Cafeteria,1388091,Apr
2025-04-03,El Palacio de los jugos /  EMMA FOOD CORP,Invoice,008-05246,Arroz a Granel:Largo Fino 50 LB -Bolsa Dos Hermanos.,,8.0,27.85,222.8,4074521.53,Bulk Rice,Lisset Limpio -020,Cafeteria,1388092,Apr
2025-04-03,El Palacio de los jugos / Caribe Tropical,Invoice,008-05247,Arroz a Granel:Parboiled 50 LB -Bolsa Dos Hermanos.,,8.0,26.75,214.0,4074735.53,Bulk Rice,Lisset Limpio -020,Cafeteria,1388093,Apr
2025-04-03,El Palacio de Los Jugos / Casa mía Food Restaurant inc,Invoice,008-05248,Dry Beans:Dry Beans - Black Beans 50,Dry Black Beans 50 lb,1.0,45.7,45.7,4074781.23,Dry Beans,Lisset Limpio -020,Cafeteria,1388094,Apr
2025-04-03,El Palacio de Los Jugos / Casa mía Food Restaurant inc,Invoice,008-05248,Arroz a Granel:Parboiled 50 LB -Bolsa Dos Hermanos.,,11.0,27.75,305.25,4075086.48,Bulk Rice,Lisset Limpio -020,Cafeteria,1388095,Apr
2025-04-03,El Palacio de Los Jugos / Casa mía Food Restaurant inc,Invoice,008-05248,Arroz a Granel:Parboiled 50 LB -Bolsa Dos Hermanos.,,1.0,0.0,0.0,4075086.48,Bulk Rice,Lisset Limpio -020,Cafeteria,1388096,Apr
2025-04-03,El Palacio de los jugos / J Mena Corp.,Invoice,008-05249,Arroz a Granel:Parboiled 50 LB -Bolsa Dos Hermanos.,,10.0,26.75,267.5,4075353.98,Bulk Rice,Lisset Limpio -020,Cafeteria,1388097,Apr
2025-04-03,El Palacio de los jugos / J Mena Corp.,Invoice,008-05249,Dry Beans:Dry Beans - Black Beans 50,Dry Black Beans 50 lb,2.0,36.75,73.5,4075427.48,Dry Beans,Lisset Limpio -020,Cafeteria,1388098,Apr
2025-04-03,Be Your Will LLC,Invoice,008-05250,Liquids:AS Cooking Wine,4 1 Gl.,2.0,17.5,35.0,4075462.48,American Spice,Lisset Limpio -020,CAFETERIA y RESTAURANTS,1388099,Apr
2025-04-03,Be Your Will LLC,Invoice,008-05250,Arroz a Granel:Largo Fino 50 LB -Bolsa Dos Hermanos.,,4.0,27.85,111.4,4075573.88,Bulk Rice,Lisset Limpio -020,CAFETERIA y RESTAURANTS,1388100,Apr
2025-04-03,Be Your Will LLC,Invoice,008-05250,Arroz a Granel:Parboiled 50 LB -Bolsa Dos Hermanos.,,11.0,26.75,294.25,4075868.13,Bulk Rice,Lisset Limpio -020,CAFETERIA y RESTAURANTS,1388101,Apr
2025-04-03,Sedanos Supermarkets #32,Invoice,008-05251,Arroz a Granel:Largo Fino 50 LB -Bolsa Dos Hermanos.,,5.0,27.85,139.25,4076007.38,Bulk Rice,Keila Alfaro-Visvikis,RETAIL SEDANOS,1388102,Apr
2025-04-03,Sedanos Supermarkets #32,Invoice,008-05251,Arroz a Granel:Parboiled 50 LB -Bolsa Dos Hermanos.,,3.0,28.25,84.75,4076092.13,Bulk Rice,Keila Alfaro-Visvikis,RETAIL SEDANOS,1388103,Apr
2025-04-03,Sedanos Supermarkets #32,Invoice,008-05251,,Discount,,,-4.48,4076087.65,,Keila Alfaro-Visvikis,RETAIL SEDANOS,1388104,Apr
2025-04-03,El Palacio de los jugos / Rodriguez Foods,Invoice,008-05252,Arroz a Granel:Parboiled 50 LB -Bolsa Dos Hermanos.,,8.0,26.75,214.0,4076301.65,Bulk Rice,Lisset Limpio -020,Cafeteria,1388105,Apr
2025-04-03,Sedanos Supermarkets #33,Invoice,008-05253,Arroz a Granel:Parboiled 50 LB -Bolsa Dos Hermanos.,,5.0,28.25,141.25,4076442.9,Bulk Rice,Keila Alfaro-Visvikis,RETAIL SEDANOS,1388106,Apr
2025-04-03,Sedanos Supermarkets #33,Invoice,008-05253,,Discount,,,-2.83,4076440.07,,Keila Alfaro-Visvikis,RETAIL SEDANOS,1388107,Apr
2025-04-03,Max Food Distributors,Invoice,008-05254,Dry Beans:Dry Beans - Black Beans 50,Dry Black Beans 50 lb,10.0,36.0,360.0,4076800.07,Dry Beans,Lisset Limpio -020,WHOLESALER,1388108,Apr
2025-04-03,El Palacio de los jugos / La sabrosa salsa cubana Corp,Invoice,008-05255,Arroz a Granel:Largo Fino 50 LB -Bolsa Dos Hermanos.,,5.0,27.85,139.25,4076939.32,Bulk Rice,Lisset Limpio -020,Cafeteria,1388109,Apr
2025-04-03,Bravo   Francisco Diaz,Invoice,008-05256,Liquids:AS Cooking Wine,4 1 Gl.,4.0,17.5,70.0,4077009.32,American Spice,Lisset Limpio -020,RETAIL  DSD,1388110,Apr
2025-04-03,Bravo   Francisco Diaz,Invoice,008-05256,Arroz a Granel:Largo Fino 50 LB -Bolsa Dos Hermanos.,,2.0,27.85,55.7,4077065.02,Bulk Rice,Lisset Limpio -020,RETAIL  DSD,1388111,Apr
2025-04-03,El Palacio de los jugos / Leti Corp.,Invoice,008-05259,Arroz a Granel:Largo Fino 50 LB -Bolsa Dos Hermanos.,,4.0,27.85,111.4,4077176.42,Bulk Rice,Lisset Limpio -020,Cafeteria,1388112,Apr
2025-04-03,El Palacio de los jugos / Leti Corp.,Invoice,008-05259,Arroz a Granel:Parboiled 50 LB -Bolsa Dos Hermanos.,,8.0,26.75,214.0,4077390.42,Bulk Rice,Lisset Limpio -020,Cafeteria,1388113,Apr
2025-04-03,El Palacio de los jugos /  Mires Restaurants,Invoice,008-05260,Liquids:AS Marinating Sauce (Mojo),,1.0,18.5,18.5,4077408.92,American Spice,Lisset Limpio -020,Cafeteria,1388114,Apr
2025-04-03,El Palacio de los jugos /  Mires Restaurants,Invoice,008-05260,Arroz a Granel:Parboiled 50 LB -Bolsa Dos Hermanos.,,11.0,27.75,305.25,4077714.17,Bulk Rice,Lisset Limpio -020,Cafeteria,1388115,Apr
2025-04-03,El Palacio de los jugos /  Mires Restaurants,Invoice,008-05260,Arroz a Granel:Parboiled 50 LB -Bolsa Dos Hermanos.,,1.0,27.75,27.75,4077741.92,Bulk Rice,Lisset Limpio -020,Cafeteria,1388116,Apr
2025-04-03,Fritanga Momotombo,Invoice,008-05261,Dry Beans:Dry Beans - Small Red Beans 50 lbs.,Small Red Beans 50 lbs,1.0,42.0,42.0,4077783.92,Dry Beans,Lisset Limpio -020,CAFETERIA y RESTAURANTS,1388117,Apr
2025-04-03,Fritanga Momotombo,Invoice,008-05261,Arroz a Granel:Largo Fino 50 LB -Bolsa Dos Hermanos.,,6.0,27.85,167.1,4077951.02,Bulk Rice,Lisset Limpio -020,CAFETERIA y RESTAURANTS,1388118,Apr
2025-04-03,Key Food / Holywood,Credit Memo,008-05262,Varios:Promotional Allowance,Arroz Envasado:Parboiled 5KG Dos Hermanos.,-7.0,46.5,-325.5,4077625.52,Branded Rice,Keila Alfaro-Visvikis,RETAIL  DSD,1388119,Apr
2025-04-03,Food Giant Market  10 Ave.,Credit Memo,008-05263,Varios:Promotional Allowance,Arroz Envasado:Largo Fino 1kg (Long grain rice) Dos Hermanos,-1.0,18.0,-18.0,4077607.52,Branded Rice,Keila Alfaro-Visvikis,RETAIL  DSD,1388120,Apr
2025-04-03,Food Giant Market  10 Ave.,Credit Memo,008-05263,Varios:Promotional Allowance,Rice Snack:Rice Snack Ham Flavored DOS HERMANOS,-1.0,19.9,-19.9,4077587.62,Puffed Products,Keila Alfaro-Visvikis,RETAIL  DSD,1388121,Apr
2025-04-03,Food Giant Market  10 Ave.,Credit Memo,008-05263,Varios:Promotional Allowance,Rice Snack:Rice Snack Salami Flavored DOS HERMANOS,-1.0,19.9,-19.9,4077567.72,Puffed Products,Keila Alfaro-Visvikis,RETAIL  DSD,1388122,Apr
2025-04-03,Food Giant Market  10 Ave.,Credit Memo,008-05263,Varios:Promotional Allowance,Arroz Envasado:Parboiled 5KG Dos Hermanos.,-1.0,19.9,-19.9,4077547.82,Branded Rice,Keila Alfaro-Visvikis,RETAIL  DSD,1388123,Apr
2025-04-03,Sedanos Supermarkets #28,Credit Memo,008-05264,Varios:Promotional Allowance,Arroz Envasado:Parboiled 5KG Dos Hermanos.,-3.0,40.5,-121.5,4077426.32,Branded Rice,Keila Alfaro-Visvikis,RETAIL SEDANOS,1388124,Apr
2025-04-06,El Palacio de los jugos /  Nanos Latin Foods,Invoice,008-05265,Arroz a Granel:Largo Fino 50 LB -Bolsa Dos Hermanos.,,5.0,27.85,139.25,4077565.57,Bulk Rice,Lisset Limpio -020,Cafeteria,1388125,Apr
2025-04-06,El Palacio de los jugos /  Nanos Latin Foods,Invoice,008-05265,Arroz a Granel:Parboiled 50 LB -Bolsa Dos Hermanos.,,3.0,26.75,80.25,4077645.82,Bulk Rice,Lisset Limpio -020,Cafeteria,1388126,Apr
2025-04-06,El Palacio de los jugos / Lita Foods Inc.,Invoice,008-05266,Dry Beans:Dry Beans - Black Beans 50,Dry Black Beans 50 lb,1.0,45.7,45.7,4077691.52,Dry Beans,Lisset Limpio -020,Cafeteria,1388127,Apr
2025-04-06,El Palacio de los jugos / Lita Foods Inc.,Invoice,008-05266,Arroz a Granel:Parboiled 50 LB -Bolsa Dos Hermanos.,,11.0,27.75,305.25,4077996.77,Bulk Rice,Lisset Limpio -020,Cafeteria,1388128,Apr
2025-04-06,El Palacio de los jugos / Lita Foods Inc.,Invoice,008-05266,Arroz a Granel:Parboiled 50 LB -Bolsa Dos Hermanos.,,1.0,27.75,27.75,4078024.52,Bulk Rice,Lisset Limpio -020,Cafeteria,1388129,Apr
2025-04-06,El Palacio de los jugos /  EMMA FOOD CORP,Invoice,008-05267,Arroz a Granel:Largo Fino 50 LB -Bolsa Dos Hermanos.,,6.0,27.85,167.1,4078191.62,Bulk Rice,Lisset Limpio -020,Cafeteria,1388130,Apr
2025-04-06,El Palacio de los jugos /  EMMA FOOD CORP,Invoice,008-05267,Arroz a Granel:Parboiled 50 LB -Bolsa Dos Hermanos.,,1.0,26.75,26.75,4078218.37,Bulk Rice,Lisset Limpio -020,Cafeteria,1388131,Apr
2025-04-06,El Palacio de los jugos / Caribe Tropical,Invoice,008-05268,Arroz a Granel:Largo Fino 50 LB -Bolsa Dos Hermanos.,,4.0,27.85,111.4,4078329.77,Bulk Rice,Lisset Limpio -020,Cafeteria,1388132,Apr
2025-04-06,El Palacio de los jugos / Caribe Tropical,Invoice,008-05268,Arroz a Granel:Parboiled 50 LB -Bolsa Dos Hermanos.,,6.0,26.75,160.5,4078490.27,Bulk Rice,Lisset Limpio -020,Cafeteria,1388133,Apr
2025-04-06,Los Mejores Tamales de Miami,Invoice,008-05269,Arroz a Granel:Parboiled 50 LB -Bolsa Dos Hermanos.,,5.0,28.25,141.25,4078631.52,Bulk Rice,Lisset Limpio -020,CAFETERIA y RESTAURANTS,1388134,Apr
2025-04-06,JMN Dely Corp,Invoice,008-05270,Arroz a Granel:Largo Fino 50 LB -Bolsa Dos Hermanos.,,2.0,27.85,55.7,4078687.22,Bulk Rice,Keila Alfaro-Visvikis,CAFETERIA y RESTAURANTS,1388135,Apr
2025-04-06,JMN Dely Corp,Invoice,008-05270,Arroz a Granel:Parboiled 50 LB -Bolsa Dos Hermanos.,,2.0,27.75,55.5,4078742.72,Bulk Rice,Keila Alfaro-Visvikis,CAFETERIA y RESTAURANTS,1388136,Apr
2025-04-06,JMN Dely Corp,Invoice,008-05270,Dry Beans:Dry Beans - Black Beans 50,Dry Black Beans 50 lb,1.0,45.7,45.7,4078788.42,Dry Beans,Keila Alfaro-Visvikis,CAFETERIA y RESTAURANTS,1388137,Apr
2025-04-06,Aries Supermarket & Cafeteria,Invoice,008-05271,Arroz a Granel:Parboiled 50 LB -Bolsa Dos Hermanos.,,10.0,28.25,282.5,4079070.92,Bulk Rice,Keila Alfaro-Visvikis,CAFETERIA y RESTAURANTS,1388138,Apr
2025-04-06,Aries Supermarket & Cafeteria,Invoice,008-05271,Dry Beans:Dry Beans - Black Beans 50,Dry Black Beans 50 lb,5.0,36.75,183.75,4079254.67,Dry Beans,Keila Alfaro-Visvikis,CAFETERIA y RESTAURANTS,1388139,Apr
2025-04-06,Aries Supermarket & Cafeteria,Invoice,008-05271,Spices:AS Whole Bay Leaves,4/12 OZ,1.0,25.3,25.3,4079279.97,American Spice,Keila Alfaro-Visvikis,CAFETERIA y RESTAURANTS,1388140,Apr
2025-04-06,Aries Supermarket & Cafeteria,Invoice,008-05271,Spices:AS Oregano Ground,4 / 3.5 Lbs.,1.0,37.5,37.5,4079317.47,American Spice,Keila Alfaro-Visvikis,CAFETERIA y RESTAURANTS,1388141,Apr
2025-04-06,Aries Supermarket & Cafeteria,Invoice,008-05271,Liquids:AS Cooking Wine,4 1 Gl.,4.0,17.5,70.0,4079387.47,American Spice,Keila Alfaro-Visvikis,CAFETERIA y RESTAURANTS,1388142,Apr
2025-04-06,Aries Supermarket & Cafeteria,Invoice,008-05271,Spices:AS Chicken Base,1 / 30 lb. (box or pail),1.0,39.0,39.0,4079426.47,American Spice,Keila Alfaro-Visvikis,CAFETERIA y RESTAURANTS,1388143,Apr
2025-04-06,Aries Supermarket & Cafeteria,Invoice,008-05271,Spices:AS Cumin Ground,4 / 4 lb,1.0,50.25,50.25,4079476.72,American Spice,Keila Alfaro-Visvikis,CAFETERIA y RESTAURANTS,1388144,Apr
2025-04-06,Sedanos Supermarkets #38,Invoice,008-05272,Arroz Envasado:Largo Fino 1kg (Long grain rice) Dos Hermanos,,1.0,17.5,17.5,4079494.22,Branded Rice,Keila Alfaro-Visvikis,RETAIL SEDANOS,1388145,Apr
2025-04-06,Sedanos Supermarkets #38,Invoice,008-05272,Arroz Envasado:Parboiled 1kg Bolsa Dos Hermanos.,.,1.0,19.9,19.9,4079514.12,Branded Rice,Keila Alfaro-Visvikis,RETAIL SEDANOS,1388146,Apr
2025-04-06,Sedanos Supermarkets #38,Invoice,008-05272,Rice Snack:Rice Snack Ham Flavored DOS HERMANOS,,1.0,19.9,19.9,4079534.02,Puffed Products,Keila Alfaro-Visvikis,RETAIL SEDANOS,1388147,Apr
2025-04-06,Sedanos Supermarkets #38,Invoice,008-05272,Rice Snack:Rice Snack Salami Flavored DOS HERMANOS,,1.0,19.9,19.9,4079553.92,Puffed Products,Keila Alfaro-Visvikis,RETAIL SEDANOS,1388148,Apr
2025-04-06,Sedanos Supermarkets #38,Invoice,008-05272,Rice Snack:Rice Snack Ham Flavored DOS HERMANOS,,1.0,19.9,19.9,4079573.82,Puffed Products,Keila Alfaro-Visvikis,RETAIL SEDANOS,1388149,Apr
2025-04-06,Sedanos Supermarkets #38,Invoice,008-05272,Rice Snack:Rice Snack Salami Flavored DOS HERMANOS,,1.0,19.9,19.9,4079593.72,Puffed Products,Keila Alfaro-Visvikis,RETAIL SEDANOS,1388150,Apr
2025-04-06,Sedanos Supermarkets #38,Invoice,008-05272,,Discount,,,-1.54,4079592.18,,Keila Alfaro-Visvikis,RETAIL SEDANOS,1388151,Apr
2025-04-07,El Palacio de los jugos / Rodriguez Foods,Invoice,008-05273,Arroz a Granel:Parboiled 50 LB -Bolsa Dos Hermanos.,,8.0,26.75,214.0,4079806.18,Bulk Rice,Lisset Limpio -020,Cafeteria,1388152,Apr
2025-04-07,El Palacio de los jugos /  Mires Restaurants,Credit Memo,008-05274,Varios:Promotional Allowance,Arroz a Granel:Parboiled 50 LB -Bolsa Dos Hermanos.,-1.0,27.75,-27.75,4079778.43,Bulk Rice,Lisset Limpio -020,Cafeteria,1388153,Apr
2025-04-07,El Palacio de los jugos / Delicias Criollas (DIAGO FOOD_MILLER),Invoice,008-05275,Arroz a Granel:Largo Fino 50 LB -Bolsa Dos Hermanos.,,8.0,27.85,222.8,4080001.23,Bulk Rice,Lisset Limpio -020,Cafeteria,1388154,Apr
2025-04-07,Soriano Brothers PB,Invoice,008-05276,Arroz a Granel:Largo Fino 50 LB -Bolsa Dos Hermanos.,,15.0,27.85,417.75,4080418.98,Bulk Rice,Lisset Limpio -020,CAFETERIA y RESTAURANTS,1388155,Apr
2025-04-07,Soriano Brothers PB,Invoice,008-05276,Arroz a Granel:Parboiled 50 LB -Bolsa Dos Hermanos.,,10.0,26.75,267.5,4080686.48,Bulk Rice,Lisset Limpio -020,CAFETERIA y RESTAURANTS,1388156,Apr
2025-04-07,Soriano Brothers PB,Invoice,008-05276,Spices:AS Sazon (for all),1 / 30 lb (box or pail),2.0,52.0,104.0,4080790.48,American Spice,Lisset Limpio -020,CAFETERIA y RESTAURANTS,1388157,Apr
2025-04-07,Los Caringas Latin America  Foods,Invoice,008-05277,Arroz a Granel:Largo Fino 50 LB -Bolsa Dos Hermanos.,,3.0,27.85,83.55,4080874.03,Bulk Rice,Lisset Limpio -020,CAFETERIA y RESTAURANTS,1388158,Apr
2025-04-07,Los Caringas Latin America  Foods,Invoice,008-05277,Arroz a Granel:Parboiled 50 LB -Bolsa Dos Hermanos.,,3.0,28.25,84.75,4080958.78,Bulk Rice,Lisset Limpio -020,CAFETERIA y RESTAURANTS,1388159,Apr
2025-04-08,El Palacio de los jugos / Lita Foods Inc.,Credit Memo,008-05278,Varios:Promotional Allowance,Arroz a Granel:Parboiled 50 LB -Bolsa Dos Hermanos.,-1.0,27.75,-27.75,4080931.03,Bulk Rice,Lisset Limpio -020,Cafeteria,1388160,Apr
2025-04-08,Sedanos Supermarkets #38,Credit Memo,008-05279,Varios:Promotional Allowance,Rice Snack:Rice Snack Ham Flavored DOS HERMANOS,-1.0,19.9,-19.9,4080911.13,Puffed Products,Keila Alfaro-Visvikis,RETAIL SEDANOS,1388161,Apr
2025-04-08,Sedanos Supermarkets #38,Credit Memo,008-05279,Varios:Promotional Allowance,Rice Snack:Rice Snack Salami Flavored DOS HERMANOS,-1.0,19.9,-19.9,4080891.23,Puffed Products,Keila Alfaro-Visvikis,RETAIL SEDANOS,1388162,Apr
2025-04-09,Sedanos Supermarkets #22,Credit Memo,008-05280,Varios:Producto vencido/deteriorado (no impacta en inventario),"14 unidades pizza, salame y jamon",-14.0,1.49,-20.86,4080870.37,Puffed Products,Keila Alfaro-Visvikis,RETAIL SEDANOS,1388163,Apr
2025-04-09,Festival Supermarket Margate,Invoice,008-05281,Arroz Envasado:Parboiled 5KG Dos Hermanos.,6  11lbs,10.0,46.5,465.0,4081335.37,Branded Rice,Keila Alfaro-Visvikis,RETAIL  DSD,1388164,Apr
2025-04-09,Festival Supermarket Margate,Invoice,008-05281,Arroz Envasado:Parboiled 5KG Dos Hermanos.,6  11lbs,10.0,46.5,465.0,4081800.37,Branded Rice,Keila Alfaro-Visvikis,RETAIL  DSD,1388165,Apr
2025-04-09,Festival Supermarket #35- Southgate,Invoice,008-05282,Arroz Envasado:Parboiled 5KG Dos Hermanos.,6  11lbs,20.0,46.5,930.0,4082730.37,Branded Rice,Keila Alfaro-Visvikis,RETAIL  DSD,1388166,Apr
2025-04-09,Festival Supermarket #35- Southgate,Invoice,008-05282,Arroz Envasado:Largo Fino 1kg (Long grain rice) Dos Hermanos,,2.0,18.0,36.0,4082766.37,Branded Rice,Keila Alfaro-Visvikis,RETAIL  DSD,1388167,Apr
2025-04-09,Festival Supermarket #35- Southgate,Invoice,008-05282,Arroz Envasado:Parboiled 5KG Dos Hermanos.,6  11lbs,20.0,46.5,930.0,4083696.37,Branded Rice,Keila Alfaro-Visvikis,RETAIL  DSD,1388168,Apr
2025-04-09,Sabor Tropical Supermarket #4,Invoice,008-05283,Arroz Envasado:Parboiled 5KG Dos Hermanos.,6  11lbs,5.0,46.5,232.5,4083928.87,Branded Rice,Keila Alfaro-Visvikis,RETAIL  DSD,1388169,Apr
2025-04-09,Sabor Tropical Supermarket #4,Invoice,008-05283,Arroz Envasado:Parboiled 5KG Dos Hermanos.,6  11lbs,2.0,46.5,93.0,4084021.87,Branded Rice,Keila Alfaro-Visvikis,RETAIL  DSD,1388170,Apr
2025-04-09,Sedanos Supermarkets #22,Invoice,008-05284,Spices:AS Chicken Base,1 / 30 lb. (box or pail),1.0,39.0,39.0,4084060.87,American Spice,Keila Alfaro-Visvikis,RETAIL SEDANOS,1388171,Apr
2025-04-09,Sedanos Supermarkets #22,Invoice,008-05284,Arroz a Granel:Parboiled 50 LB -Bolsa Dos Hermanos.,,2.0,28.25,56.5,4084117.37,Bulk Rice,Keila Alfaro-Visvikis,RETAIL SEDANOS,1388172,Apr
2025-04-09,Sedanos Supermarkets #22,Invoice,008-05284,,Discount,,,-1.91,4084115.46,,Keila Alfaro-Visvikis,RETAIL SEDANOS,1388173,Apr
2025-04-09,Sedanos Supermarkets #26,Invoice,008-05285,Arroz a Granel:Parboiled 50 LB -Bolsa Dos Hermanos.,,3.0,28.25,84.75,4084200.21,Bulk Rice,Keila Alfaro-Visvikis,RETAIL SEDANOS,1388174,Apr
2025-04-09,Sedanos Supermarkets #26,Invoice,008-05285,,Discount,,,-1.7,4084198.51,,Keila Alfaro-Visvikis,RETAIL SEDANOS,1388175,Apr
2025-04-09,Sedanos Supermarkets #24,Invoice,008-05286,Arroz a Granel:Parboiled 50 LB -Bolsa Dos Hermanos.,,6.0,28.25,169.5,4084368.01,Bulk Rice,Keila Alfaro-Visvikis,RETAIL SEDANOS,1388176,Apr
2025-04-09,Sedanos Supermarkets #24,Invoice,008-05286,,Discount,,,-3.39,4084364.62,,Keila Alfaro-Visvikis,RETAIL SEDANOS,1388177,Apr
2025-04-09,Sedanos Supermarkets #27,Invoice,008-05287,Arroz a Granel:Parboiled 50 LB -Bolsa Dos Hermanos.,,5.0,28.25,141.25,4084505.87,Bulk Rice,Keila Alfaro-Visvikis,RETAIL SEDANOS,1388178,Apr
2025-04-09,Sedanos Supermarkets #43,Invoice,008-05288,Arroz a Granel:Parboiled 50 LB -Bolsa Dos Hermanos.,,4.0,28.25,113.0,4084618.87,Bulk Rice,Keila Alfaro-Visvikis,RETAIL SEDANOS,1388179,Apr
2025-04-09,Sedanos Supermarkets #43,Invoice,008-05288,,Discount,,,-2.26,4084616.61,,Keila Alfaro-Visvikis,RETAIL SEDANOS,1388180,Apr
2025-04-09,Sedanos Supermarkets #16,Invoice,008-05289,Arroz a Granel:Parboiled 50 LB -Bolsa Dos Hermanos.,,4.0,28.25,113.0,4084729.61,Bulk Rice,Keila Alfaro-Visvikis,RETAIL SEDANOS,1388181,Apr
2025-04-09,Sedanos Supermarkets #16,Invoice,008-05289,,Discount,,,-2.26,4084727.35,,Keila Alfaro-Visvikis,RETAIL SEDANOS,1388182,Apr
2025-04-09,Pacifico Chinese Restaurant,Invoice,008-05290,Arroz a Granel:Parboiled 50 LB -Bolsa Dos Hermanos.,,10.0,28.25,282.5,4085009.85,Bulk Rice,Lisset Limpio -020,CAFETERIA y RESTAURANTS,1388183,Apr
2025-04-09,Ideal Food Basket Davie Cafeteria,Invoice,008-05291,Arroz a Granel:Largo Fino 50 LB -Bolsa Dos Hermanos.,,8.0,27.85,222.8,4085232.65,Bulk Rice,Keila Alfaro-Visvikis,CAFETERIA y RESTAURANTS,1388184,Apr
2025-04-10,El Palacio de los jugos /  Nanos Latin Foods,Invoice,008-05292,Arroz a Granel:Largo Fino 50 LB -Bolsa Dos Hermanos.,,2.0,27.85,55.7,4085288.35,Bulk Rice,Lisset Limpio -020,Cafeteria,1388185,Apr
2025-04-10,El Palacio de los jugos /  Nanos Latin Foods,Invoice,008-05292,Arroz a Granel:Parboiled 50 LB -Bolsa Dos Hermanos.,,11.0,26.75,294.25,4085582.6,Bulk Rice,Lisset Limpio -020,Cafeteria,1388186,Apr
2025-04-10,El Palacio de los jugos / Rodriguez Foods,Invoice,008-05293,Arroz a Granel:Parboiled 50 LB -Bolsa Dos Hermanos.,,8.0,26.75,214.0,4085796.6,Bulk Rice,Lisset Limpio -020,Cafeteria,1388187,Apr
2025-04-10,El Palacio de los jugos / Leti Corp.,Invoice,008-05294,Arroz a Granel:Largo Fino 50 LB -Bolsa Dos Hermanos.,,4.0,27.85,111.4,4085908.0,Bulk Rice,Lisset Limpio -020,Cafeteria,1388188,Apr
2025-04-10,El Palacio de los jugos / Leti Corp.,Invoice,008-05294,Arroz a Granel:Parboiled 50 LB -Bolsa Dos Hermanos.,,4.0,26.75,107.0,4086015.0,Bulk Rice,Lisset Limpio -020,Cafeteria,1388189,Apr
2025-04-10,El Palacio de Los Jugos / Casa mía Food Restaurant inc,Invoice,008-05295,Dry Beans:Dry Beans - Black Beans 50,Dry Black Beans 50 lb,1.0,36.0,36.0,4086051.0,Dry Beans,Lisset Limpio -020,Cafeteria,1388190,Apr
2025-04-10,El Palacio de Los Jugos / Casa mía Food Restaurant inc,Invoice,008-05295,Arroz a Granel:Parboiled 50 LB -Bolsa Dos Hermanos.,,11.0,27.75,305.25,4086356.25,Bulk Rice,Lisset Limpio -020,Cafeteria,1388191,Apr
2025-04-10,El Palacio de Los Jugos / Casa mía Food Restaurant inc,Invoice,008-05295,Arroz a Granel:Parboiled 50 LB -Bolsa Dos Hermanos.,,1.0,27.75,27.75,4086384.0,Bulk Rice,Lisset Limpio -020,Cafeteria,1388192,Apr
2025-04-10,El Palacio de los jugos / Caribe Tropical,Invoice,008-05296,Arroz a Granel:Parboiled 50 LB -Bolsa Dos Hermanos.,,6.0,26.75,160.5,4086544.5,Bulk Rice,Lisset Limpio -020,Cafeteria,1388193,Apr
2025-04-10,Sedanos Supermarkets #18,Invoice,008-05297,Arroz Envasado:Largo Fino 1kg (Long grain rice) Dos Hermanos,,2.0,17.5,35.0,4086579.5,Branded Rice,Keila Alfaro-Visvikis,RETAIL SEDANOS,1388194,Apr
2025-04-10,Sedanos Supermarkets #18,Invoice,008-05298,Arroz a Granel:Parboiled 50 LB -Bolsa Dos Hermanos.,,8.0,28.25,226.0,4086805.5,Bulk Rice,Keila Alfaro-Visvikis,RETAIL SEDANOS,1388195,Apr
2025-04-10,El Palacio de los jugos /  EMMA FOOD CORP,Invoice,008-05299,Arroz a Granel:Largo Fino 50 LB -Bolsa Dos Hermanos.,,8.0,27.85,222.8,4087028.3,Bulk Rice,Lisset Limpio -020,Cafeteria,1388196,Apr
2025-04-10,El Palacio de los jugos / Delicias Criollas (DIAGO FOOD_MILLER),Invoice,008-05300,Dry Beans:Dry Beans - Black Beans 50,Dry Black Beans 50 lb,1.0,36.75,36.75,4087065.05,Dry Beans,Lisset Limpio -020,Cafeteria,1388197,Apr
2025-04-10,El Palacio de los jugos / Delicias Criollas (DIAGO FOOD_MILLER),Invoice,008-05300,Arroz a Granel:Parboiled 50 LB -Bolsa Dos Hermanos.,,12.0,26.75,321.0,4087386.05,Bulk Rice,Lisset Limpio -020,Cafeteria,1388198,Apr
2025-04-10,ALS Foods,Invoice,008-05301,Liquids:AS Cooking Wine,4 1 Gl.,2.0,17.5,35.0,4087421.05,American Spice,Lisset Limpio -020,CAFETERIA y RESTAURANTS,1388199,Apr
2025-04-10,ALS Foods,Invoice,008-05301,Arroz a Granel:Largo Fino 50 LB -Bolsa Dos Hermanos.,,5.0,27.85,139.25,4087560.3,Bulk Rice,Lisset Limpio -020,CAFETERIA y RESTAURANTS,1388200,Apr
2025-04-10,ALS Foods,Invoice,008-05301,Arroz a Granel:Parboiled 50 LB -Bolsa Dos Hermanos.,,11.0,26.75,294.25,4087854.55,Bulk Rice,Lisset Limpio -020,CAFETERIA y RESTAURANTS,1388201,Apr
2025-04-10,ALS Foods,Invoice,008-05301,Dry Beans:Dry Beans - Black Beans 50,Dry Black Beans 50 lb,1.0,36.75,36.75,4087891.3,Dry Beans,Lisset Limpio -020,CAFETERIA y RESTAURANTS,1388202,Apr
2025-04-10,Sedanos Supermarkets #38,Invoice,008-05302,Arroz Envasado:Largo Fino 1kg (Long grain rice) Dos Hermanos,,3.0,17.5,52.5,4087943.8,Branded Rice,Keila Alfaro-Visvikis,RETAIL SEDANOS,1388203,Apr
2025-04-10,Sedanos Supermarkets #38,Invoice,008-05302,Arroz Envasado:Parboiled 1kg Bolsa Dos Hermanos.,.,2.0,19.9,39.8,4087983.6,Branded Rice,Keila Alfaro-Visvikis,RETAIL SEDANOS,1388204,Apr
2025-04-10,Sedanos Supermarkets #38,Invoice,008-05302,Arroz Envasado:Parboiled 5KG Dos Hermanos.,6  11lbs,20.0,40.5,810.0,4088793.6,Branded Rice,Keila Alfaro-Visvikis,RETAIL SEDANOS,1388205,Apr
2025-04-10,Sedanos Supermarkets #38,Invoice,008-05302,Arroz Envasado:Parboiled 5KG Dos Hermanos.,6  11lbs,20.0,40.5,810.0,4089603.6,Branded Rice,Keila Alfaro-Visvikis,RETAIL SEDANOS,1388206,Apr
2025-04-10,Sedanos Supermarkets #38,Invoice,008-05302,Arroz Envasado:Largo Fino 1kg (Long grain rice) Dos Hermanos,,1.0,17.5,17.5,4089621.1,Branded Rice,Keila Alfaro-Visvikis,RETAIL SEDANOS,1388207,Apr
2025-04-10,Sedanos Supermarkets #38,Invoice,008-05302,,Discount,,,-18.05,4089603.05,,Keila Alfaro-Visvikis,RETAIL SEDANOS,1388208,Apr
2025-04-10,El Palacio de los jugos / J Mena Corp.,Invoice,008-05303,Dry Beans:Dry Beans - Black Beans 50,Dry Black Beans 50 lb,2.0,36.75,73.5,4089676.55,Dry Beans,Lisset Limpio -020,Cafeteria,1388209,Apr
2025-04-10,El Palacio de los jugos / J Mena Corp.,Invoice,008-05303,Arroz a Granel:Parboiled 50 LB -Bolsa Dos Hermanos.,,10.0,26.75,267.5,4089944.05,Bulk Rice,Lisset Limpio -020,Cafeteria,1388210,Apr
2025-04-10,El Gallego Supermarket,Invoice,008-05304,Arroz Envasado:Largo Fino 1kg (Long grain rice) Dos Hermanos,,1.0,18.0,18.0,4089962.05,Branded Rice,Lisset Limpio -020,RETAIL  DSD,1388211,Apr
2025-04-10,El Gallego Supermarket,Invoice,008-05304,Dry Beans:Dry Beans - Small Red Beans 50 lbs.,Small Red Beans 50 lbs,1.0,42.0,42.0,4090004.05,Dry Beans,Lisset Limpio -020,RETAIL  DSD,1388212,Apr
2025-04-10,El Gallego Supermarket,Invoice,008-05304,Dry Beans:Dry Beans - Black Beans 50,Dry Black Beans 50 lb,2.0,36.75,73.5,4090077.55,Dry Beans,Lisset Limpio -020,RETAIL  DSD,1388213,Apr
2025-04-10,El Gallego Supermarket,Invoice,008-05304,Arroz a Granel:Parboiled 50 LB -Bolsa Dos Hermanos.,,4.0,28.25,113.0,4090190.55,Bulk Rice,Lisset Limpio -020,RETAIL  DSD,1388214,Apr
2025-04-10,El Gallego Supermarket,Invoice,008-05304,Liquids:AS Cooking Wine,4 1 Gl.,2.0,17.5,35.0,4090225.55,American Spice,Lisset Limpio -020,RETAIL  DSD,1388215,Apr
2025-04-10,Bake Mark USA LLC,Invoice,008-05305,Arroz a Granel:Parboiled 50 LB -Bolsa Dos Hermanos.,,1100.0,24.15,26565.0,4116790.55,Bulk Rice,Armando Carpio - 017,WHOLESALER MANUFACTURY,1388216,Apr
2025-04-11,Festival Supermarket #35- Southgate,Credit Memo,008-05306,Varios:Promotional Allowance,Arroz Envasado:Parboiled 5KG Dos Hermanos.,-20.0,46.5,-930.0,4115860.55,Branded Rice,Keila Alfaro-Visvikis,RETAIL  DSD,1388217,Apr
2025-04-11,Sedanos Supermarkets #24,Credit Memo,008-05307,Varios:Promotional Allowance,Arroz Envasado:Parboiled 5KG Dos Hermanos.,-2.0,40.5,-81.0,4115779.55,Branded Rice,Keila Alfaro-Visvikis,RETAIL SEDANOS,1388218,Apr
2025-04-11,Festival Supermarket Margate,Credit Memo,008-05308,Varios:Promotional Allowance,Arroz Envasado:Parboiled 5KG Dos Hermanos.,-10.0,46.5,-465.0,4115314.55,Branded Rice,Keila Alfaro-Visvikis,RETAIL  DSD,1388219,Apr
2025-04-13,"Virtue Distributor, Inc",Invoice,008-05309,Arroz a Granel:Parboiled 50 LB -Bolsa Dos Hermanos.,,55.0,27.75,1526.25,4116840.8,Bulk Rice,Armando Carpio - 017,Distributor,1388220,Apr
2025-04-13,"Virtue Distributor, Inc",Invoice,008-05309,Arroz a Granel:Largo Fino 50 LB -Bolsa Dos Hermanos.,,55.0,27.85,1531.75,4118372.55,Bulk Rice,Armando Carpio - 017,Distributor,1388221,Apr
2025-04-13,Fritanga Momotombo,Invoice,008-05310,Dry Beans:Dry Beans - Small Red Beans 50 lbs.,Small Red Beans 50 lbs,2.0,42.0,84.0,4118456.55,Dry Beans,Lisset Limpio -020,CAFETERIA y RESTAURANTS,1388222,Apr
2025-04-13,Fritanga Momotombo,Invoice,008-05310,Arroz a Granel:Largo Fino 50 LB -Bolsa Dos Hermanos.,,5.0,27.85,139.25,4118595.8,Bulk Rice,Lisset Limpio -020,CAFETERIA y RESTAURANTS,1388223,Apr
2025-04-13,Fritanga Momotombo,Invoice,008-05310,Spices:AS Chicken Base,1 / 30 lb. (box or pail),2.0,39.0,78.0,4118673.8,American Spice,Lisset Limpio -020,CAFETERIA y RESTAURANTS,1388224,Apr
2025-04-13,El Palacio de los jugos /  Nanos Latin Foods,Invoice,008-05311,Arroz a Granel:Parboiled 50 LB -Bolsa Dos Hermanos.,,10.0,26.75,267.5,4118941.3,Bulk Rice,Lisset Limpio -020,Cafeteria,1388225,Apr
2025-04-13,El Palacio de Los Jugos / Casa mía Food Restaurant inc,Invoice,008-05312,Dry Beans:Dry Beans - Black Beans 50,Dry Black Beans 50 lb,1.0,36.75,36.75,4118978.05,Dry Beans,Lisset Limpio -020,Cafeteria,1388226,Apr
2025-04-13,El Palacio de Los Jugos / Casa mía Food Restaurant inc,Invoice,008-05312,Arroz a Granel:Parboiled 50 LB -Bolsa Dos Hermanos.,,11.0,27.75,305.25,4119283.3,Bulk Rice,Lisset Limpio -020,Cafeteria,1388227,Apr
2025-04-13,El Palacio de Los Jugos / Casa mía Food Restaurant inc,Invoice,008-05312,Arroz a Granel:Parboiled 50 LB -Bolsa Dos Hermanos.,,1.0,27.75,27.75,4119311.05,Bulk Rice,Lisset Limpio -020,Cafeteria,1388228,Apr
2025-04-13,El Palacio de los jugos / Lita Foods Inc.,Invoice,008-05313,Dry Beans:Dry Beans - Black Beans 50,Dry Black Beans 50 lb,1.0,36.75,36.75,4119347.8,Dry Beans,Lisset Limpio -020,Cafeteria,1388229,Apr
2025-04-13,El Palacio de los jugos / Lita Foods Inc.,Invoice,008-05313,Arroz a Granel:Parboiled 50 LB -Bolsa Dos Hermanos.,,11.0,27.75,305.25,4119653.05,Bulk Rice,Lisset Limpio -020,Cafeteria,1388230,Apr
2025-04-13,El Palacio de los jugos / Lita Foods Inc.,Invoice,008-05313,Arroz a Granel:Parboiled 50 LB -Bolsa Dos Hermanos.,,1.0,27.75,27.75,4119680.8,Bulk Rice,Lisset Limpio -020,Cafeteria,1388231,Apr
2025-04-13,El Palacio de los jugos / Caribe Tropical,Invoice,008-05314,Arroz a Granel:Parboiled 50 LB -Bolsa Dos Hermanos.,,10.0,26.75,267.5,4119948.3,Bulk Rice,Lisset Limpio -020,Cafeteria,1388232,Apr
2025-04-13,El Palacio de los jugos /  EMMA FOOD CORP,Invoice,008-05315,Arroz a Granel:Largo Fino 50 LB -Bolsa Dos Hermanos.,,8.0,27.85,222.8,4120171.1,Bulk Rice,Lisset Limpio -020,Cafeteria,1388233,Apr
2025-04-13,Price Choice 5 YNTO Food Corp.,Invoice,008-05316,Rice Snack:Rice Snack Ham Flavored DOS HERMANOS,,1.0,19.9,19.9,4120191.0,Puffed Products,Keila Alfaro-Visvikis,RETAIL  DSD,1388234,Apr
2025-04-13,Price Choice 5 YNTO Food Corp.,Invoice,008-05316,Rice Snack:Rice Snack Salami Flavored DOS HERMANOS,,1.0,19.9,19.9,4120210.9,Puffed Products,Keila Alfaro-Visvikis,RETAIL  DSD,1388235,Apr
2025-04-13,JMN Dely Corp,Invoice,008-05317,Dry Beans:Dry Beans - Black Beans 50,Dry Black Beans 50 lb,1.0,45.7,45.7,4120256.6,Dry Beans,Keila Alfaro-Visvikis,CAFETERIA y RESTAURANTS,1388236,Apr
2025-04-13,JMN Dely Corp,Invoice,008-05317,Arroz a Granel:Largo Fino 50 LB -Bolsa Dos Hermanos.,,2.0,27.85,55.7,4120312.3,Bulk Rice,Keila Alfaro-Visvikis,CAFETERIA y RESTAURANTS,1388237,Apr
2025-04-13,JMN Dely Corp,Invoice,008-05317,Arroz a Granel:Parboiled 50 LB -Bolsa Dos Hermanos.,,2.0,28.25,56.5,4120368.8,Bulk Rice,Keila Alfaro-Visvikis,CAFETERIA y RESTAURANTS,1388238,Apr
2025-04-13,Sabor Tropical Supermarket #2,Invoice,008-05318,Arroz Envasado:Parboiled 5KG Dos Hermanos.,6  11lbs,40.0,46.5,1860.0,4122228.8,Branded Rice,Keila Alfaro-Visvikis,RETAIL  DSD,1388239,Apr
2025-04-13,Sabor Tropical Supermarket #2,Invoice,008-05318,Arroz Envasado:Parboiled 5KG Dos Hermanos.,6  11lbs,40.0,46.5,1860.0,4124088.8,Branded Rice,Keila Alfaro-Visvikis,RETAIL  DSD,1388240,Apr
2025-04-14,Bravo   Francisco Diaz,Invoice,008-05319,Liquids:AS Cooking Wine,4 1 Gl.,3.0,17.5,52.5,4124141.3,American Spice,Lisset Limpio -020,RETAIL  DSD,1388241,Apr
2025-04-14,Bravo   Francisco Diaz,Invoice,008-05319,Arroz a Granel:Largo Fino 50 LB -Bolsa Dos Hermanos.,,5.0,27.85,139.25,4124280.55,Bulk Rice,Lisset Limpio -020,RETAIL  DSD,1388242,Apr
2025-04-14,Bravo   Francisco Diaz,Invoice,008-05319,Liquids:AS White Vinegar,4/1 Gl.,2.0,8.75,17.5,4124298.05,American Spice,Lisset Limpio -020,RETAIL  DSD,1388243,Apr
2025-04-14,Bravo   Francisco Diaz,Invoice,008-05319,Liquids:AS Marinating Sauce (Mojo),,1.0,18.5,18.5,4124316.55,American Spice,Lisset Limpio -020,RETAIL  DSD,1388244,Apr
2025-04-14,Bravo   Francisco Diaz,Invoice,008-05319,Spices:AS Chicken Base,1 / 30 lb. (box or pail),1.0,39.0,39.0,4124355.55,American Spice,Lisset Limpio -020,RETAIL  DSD,1388245,Apr
2025-04-14,El Palacio de los jugos / Rodriguez Foods,Invoice,008-05320,Arroz a Granel:Parboiled 50 LB -Bolsa Dos Hermanos.,,6.0,26.75,160.5,4124516.05,Bulk Rice,Lisset Limpio -020,Cafeteria,1388246,Apr
2025-04-14,Sabor Tropical Supermarket #4,Credit Memo,008-05321,Varios:Promotional Allowance,Arroz Envasado:Parboiled 5KG Dos Hermanos.,-2.0,46.5,-93.0,4124423.05,Branded Rice,Keila Alfaro-Visvikis,RETAIL  DSD,1388247,Apr
2025-04-14,El Palacio de Los Jugos / Casa mía Food Restaurant inc,Credit Memo,008-05322,Varios:Promotional Allowance,Arroz a Granel:Parboiled 50 LB -Bolsa Dos Hermanos.,-1.0,27.75,-27.75,4124395.3,Branded Rice,Lisset Limpio -020,Cafeteria,1388248,Apr
2025-04-14,Sedanos Supermarkets #38,Credit Memo,008-05323,Varios:Promotional Allowance,Arroz Envasado:Parboiled 5KG Dos Hermanos.,-20.0,40.5,-810.0,4123585.3,Branded Rice,Keila Alfaro-Visvikis,RETAIL SEDANOS,1388249,Apr
2025-04-14,Sedanos Supermarkets #38,Credit Memo,008-05323,Varios:Promotional Allowance,Arroz Envasado:Largo Fino 1kg (Long grain rice) Dos Hermanos,-1.0,17.5,-17.5,4123567.8,Branded Rice,Keila Alfaro-Visvikis,RETAIL SEDANOS,1388250,Apr
2025-04-15,Sabor Tropical Supermarket #2,Credit Memo,008-05324,Varios:Promotional Allowance,Arroz Envasado:Parboiled 5KG Dos Hermanos.,-40.0,46.5,-1860.0,4121707.8,Branded Rice,Keila Alfaro-Visvikis,RETAIL  DSD,1388251,Apr
2025-04-15,El Palacio de los jugos / Lita Foods Inc.,Credit Memo,008-05325,Varios:Promotional Allowance,Arroz a Granel:Parboiled 50 LB -Bolsa Dos Hermanos.,-1.0,27.75,-27.75,4121680.05,Bulk Rice,Lisset Limpio -020,Cafeteria,1388252,Apr
2025-04-15,El Palacio de Los Jugos / Casa mía Food Restaurant inc,Credit Memo,008-05326,Varios:Promotional Allowance,Arroz a Granel:Parboiled 50 LB -Bolsa Dos Hermanos.,-1.0,27.75,-27.75,4121652.3,Bulk Rice,Lisset Limpio -020,Cafeteria,1388253,Apr
2025-04-15,Price Choice 5 YNTO Food Corp.,Credit Memo,008-05327,Varios:Promotional Allowance,Rice Snack:Rice Snack Salami Flavored DOS HERMANOS,-1.0,19.9,-19.9,4121632.4,Puffed Products,Keila Alfaro-Visvikis,RETAIL  DSD,1388254,Apr
2025-04-16,Aries Supermarket & Cafeteria,Invoice,008-05328,Spices:AS Chicken Base,1 / 30 lb. (box or pail),2.0,39.0,78.0,4121710.4,American Spice,Keila Alfaro-Visvikis,CAFETERIA y RESTAURANTS,1388255,Apr
2025-04-16,Aries Supermarket & Cafeteria,Invoice,008-05328,Arroz a Granel:Parboiled 50 LB -Bolsa Dos Hermanos.,,10.0,28.25,282.5,4121992.9,Bulk Rice,Keila Alfaro-Visvikis,CAFETERIA y RESTAURANTS,1388256,Apr
2025-04-16,Aries Supermarket & Cafeteria,Invoice,008-05328,Dry Beans:Dry Beans - Black Beans 50,Dry Black Beans 50 lb,3.0,36.75,110.25,4122103.15,Dry Beans,Keila Alfaro-Visvikis,CAFETERIA y RESTAURANTS,1388257,Apr
2025-04-16,Aries Supermarket & Cafeteria,Invoice,008-05328,Liquids:AS Cooking Wine,4 1 Gl.,2.0,17.5,35.0,4122138.15,American Spice,Keila Alfaro-Visvikis,CAFETERIA y RESTAURANTS,1388258,Apr
2025-04-16,Rey Chavez Distributor Corp,Invoice,008-05329,Arroz a Granel:Parboiled 50 LB -Bolsa Dos Hermanos.,,110.0,27.5,3025.0,4125163.15,Bulk Rice,Lisset Limpio -020,WHOLESALER,1388259,Apr
2025-04-16,Sedanos Supermarkets #43,Invoice,008-05330,Arroz a Granel:Parboiled 50 LB -Bolsa Dos Hermanos.,,4.0,28.25,113.0,4125276.15,Bulk Rice,Keila Alfaro-Visvikis,RETAIL SEDANOS,1388260,Apr
2025-04-16,Sedanos Supermarkets #43,Invoice,008-05330,,Discount,,,-2.26,4125273.89,,Keila Alfaro-Visvikis,RETAIL SEDANOS,1388261,Apr
2025-04-16,Chavez Distributors Inc.,Invoice,008-05331,Arroz a Granel:Parboiled 50 LB -Bolsa Dos Hermanos.,,55.0,27.75,1526.25,4126800.14,Bulk Rice,Keila Alfaro-Visvikis,WHOLESALER,1388262,Apr
2025-04-16,Sedanos Supermarkets #16,Invoice,008-05332,Arroz a Granel:Parboiled 50 LB -Bolsa Dos Hermanos.,,6.0,28.25,169.5,4126969.64,Bulk Rice,Keila Alfaro-Visvikis,RETAIL SEDANOS,1388263,Apr
2025-04-16,Sedanos Supermarkets #16,Invoice,008-05332,,Discount,,,-3.39,4126966.25,,Keila Alfaro-Visvikis,RETAIL SEDANOS,1388264,Apr
2025-04-16,Sedanos Supermarkets #24,Invoice,008-05333,Arroz a Granel:Parboiled 50 LB -Bolsa Dos Hermanos.,,10.0,28.25,282.5,4127248.75,Bulk Rice,Keila Alfaro-Visvikis,RETAIL SEDANOS,1388265,Apr
2025-04-16,Sedanos Supermarkets #24,Invoice,008-05333,,Discount,,,-5.65,4127243.1,,Keila Alfaro-Visvikis,RETAIL SEDANOS,1388266,Apr
2025-04-16,Rey Chavez Distributor #2,Invoice,008-05334,Arroz a Granel:Parboiled 50 LB -Bolsa Dos Hermanos.,,20.0,27.5,550.0,4127793.1,Bulk Rice,Lisset Limpio -020,WHOLESALER,1388267,Apr
2025-04-16,Los Mejores Tamales de Miami,Invoice,008-05335,Arroz a Granel:Largo Fino 50 LB -Bolsa Dos Hermanos.,,3.0,27.85,83.55,4127876.65,Bulk Rice,Lisset Limpio -020,CAFETERIA y RESTAURANTS,1388268,Apr
2025-04-16,Los Mejores Tamales de Miami,Invoice,008-05335,Arroz a Granel:Parboiled 50 LB -Bolsa Dos Hermanos.,,4.0,28.25,113.0,4127989.65,Bulk Rice,Lisset Limpio -020,CAFETERIA y RESTAURANTS,1388269,Apr
2025-04-16,Festival Supermarket,Invoice,008-05336,Arroz Envasado:Parboiled 5KG Dos Hermanos.,6  11lbs,15.0,46.5,697.5,4128687.15,Branded Rice,Keila Alfaro-Visvikis,RETAIL  DSD,1388270,Apr
2025-04-16,Festival Supermarket,Invoice,008-05336,Arroz Envasado:Parboiled 5KG Dos Hermanos.,6  11lbs,15.0,46.5,697.5,4129384.65,Branded Rice,Keila Alfaro-Visvikis,RETAIL  DSD,1388271,Apr
2025-04-16,Ideal Food Basket Davie Cafeteria,Invoice,008-05337,Arroz a Granel:Largo Fino 50 LB -Bolsa Dos Hermanos.,,10.0,27.85,278.5,4129663.15,Bulk Rice,Keila Alfaro-Visvikis,CAFETERIA y RESTAURANTS,1388272,Apr
2025-04-16,Sedanos Supermarkets #34,Invoice,008-05338,Arroz a Granel:Parboiled 50 LB -Bolsa Dos Hermanos.,,12.0,28.25,339.0,4130002.15,Bulk Rice,Keila Alfaro-Visvikis,RETAIL SEDANOS,1388273,Apr
2025-04-16,Sedanos Supermarkets #34,Invoice,008-05338,,Discount,,,-6.78,4129995.37,,Keila Alfaro-Visvikis,RETAIL SEDANOS,1388274,Apr
2025-04-16,"El Toro Loco Meat Distribution, LLC",Invoice,008-05339,Dry Beans:Dry Beans - Small Red Beans 50 lbs.,Small Red Beans 50 lbs,12.0,42.0,504.0,4130499.37,Dry Beans,Lisset Limpio -020,CAFETERIA y RESTAURANTS,1388275,Apr
2025-04-16,"El Toro Loco Meat Distribution, LLC",Invoice,008-05339,Arroz a Granel:Largo Fino 50 LB -Bolsa Dos Hermanos.,,55.0,27.85,1531.75,4132031.12,Bulk Rice,Lisset Limpio -020,CAFETERIA y RESTAURANTS,1388276,Apr
2025-04-16,"El Toro Loco Meat Distribution, LLC",Invoice,008-05339,Dry Beans:Dry Beans - Black Beans 50,Dry Black Beans 50 lb,55.0,36.85,2026.75,4134057.87,Dry Beans,Lisset Limpio -020,CAFETERIA y RESTAURANTS,1388277,Apr
2025-04-17,Key Foods  / Ivan,Invoice,008-05340,Arroz Envasado:Parboiled 5KG Dos Hermanos.,6  11lbs,15.0,46.5,697.5,4134755.37,Branded Rice,Keila Alfaro-Visvikis,RETAIL  DSD,1388278,Apr
2025-04-17,Key Foods  / Ivan,Invoice,008-05340,Arroz Envasado:Parboiled 5KG Dos Hermanos.,6  11lbs,7.0,46.5,325.5,4135080.87,Branded Rice,Keila Alfaro-Visvikis,RETAIL  DSD,1388279,Apr
2025-04-17,Sedanos Supermarkets #33,Invoice,008-05341,Arroz a Granel:Parboiled 50 LB -Bolsa Dos Hermanos.,,6.0,28.25,169.5,4135250.37,Bulk Rice,Keila Alfaro-Visvikis,RETAIL SEDANOS,1388280,Apr
2025-04-17,Sedanos Supermarkets #33,Invoice,008-05341,,Discount,,,-3.39,4135246.98,,Keila Alfaro-Visvikis,RETAIL SEDANOS,1388281,Apr
2025-04-17,Hings Chinese,Invoice,008-05342,Arroz a Granel:Parboiled 50 LB -Bolsa Dos Hermanos.,,5.0,28.25,141.25,4135388.23,Bulk Rice,Lisset Limpio -020,CAFETERIA y RESTAURANTS,1388282,Apr
2025-04-17,Sedanos Supermarkets #32,Invoice,008-05343,Arroz Envasado:Largo Fino 1kg (Long grain rice) Dos Hermanos,,0.0,,0.0,4135388.23,Branded Rice,Keila Alfaro-Visvikis,RETAIL SEDANOS,1388283,Apr
2025-04-17,"Soriano Brothers Diaz Food Service,Inc",Invoice,008-05344,Dry Beans:Dry Beans - Small Red Beans 50 lbs.,Small Red Beans 50 lbs,4.0,42.0,168.0,4135556.23,Dry Beans,Lisset Limpio -020,CAFETERIA y RESTAURANTS,1388284,Apr
2025-04-17,"Soriano Brothers Diaz Food Service,Inc",Invoice,008-05344,Dry Beans:Dry Beans - Black Beans 50,Dry Black Beans 50 lb,5.0,36.75,183.75,4135739.98,Dry Beans,Lisset Limpio -020,CAFETERIA y RESTAURANTS,1388285,Apr
2025-04-17,"Soriano Brothers Diaz Food Service,Inc",Invoice,008-05344,Arroz a Granel:Parboiled 50 LB -Bolsa Dos Hermanos.,,40.0,26.75,1070.0,4136809.98,Bulk Rice,Lisset Limpio -020,CAFETERIA y RESTAURANTS,1388286,Apr
2025-04-17,Sedanos Supermarkets #31,Invoice,008-05345,Arroz a Granel:Parboiled 50 LB -Bolsa Dos Hermanos.,,5.0,28.25,141.25,4136951.23,Bulk Rice,Keila Alfaro-Visvikis,RETAIL SEDANOS,1388287,Apr
2025-04-17,Sedanos Supermarkets #31,Invoice,008-05345,,Discount,,,-2.83,4136948.4,,Keila Alfaro-Visvikis,RETAIL SEDANOS,1388288,Apr
2025-04-17,Sedanos Supermarkets #32,Invoice,008-05346,Arroz a Granel:Parboiled 50 LB -Bolsa Dos Hermanos.,,5.0,28.25,141.25,4137089.65,Bulk Rice,Keila Alfaro-Visvikis,RETAIL SEDANOS,1388289,Apr
2025-04-17,Sedanos Supermarkets #32,Invoice,008-05346,Arroz a Granel:Largo Fino 50 LB -Bolsa Dos Hermanos.,,5.0,27.85,139.25,4137228.9,Bulk Rice,Keila Alfaro-Visvikis,RETAIL SEDANOS,1388290,Apr
2025-04-17,Sedanos Supermarkets #32,Invoice,008-05346,Spices:AS Chicken Base,1 / 30 lb. (box or pail),1.0,39.0,39.0,4137267.9,American Spice,Keila Alfaro-Visvikis,RETAIL SEDANOS,1388291,Apr
2025-04-17,Sedanos Supermarkets #32,Invoice,008-05346,,Discount,,,-6.39,4137261.51,,Keila Alfaro-Visvikis,RETAIL SEDANOS,1388292,Apr
2025-04-17,El Palacio de los jugos / Leti Corp.,Invoice,008-05347,Arroz a Granel:Largo Fino 50 LB -Bolsa Dos Hermanos.,,3.0,27.85,83.55,4137345.06,Bulk Rice,Lisset Limpio -020,Cafeteria,1388293,Apr
2025-04-17,El Palacio de los jugos / Leti Corp.,Invoice,008-05347,Arroz a Granel:Parboiled 50 LB -Bolsa Dos Hermanos.,,6.0,26.75,160.5,4137505.56,Bulk Rice,Lisset Limpio -020,Cafeteria,1388294,Apr
2025-04-17,El Palacio de los jugos / Rodriguez Foods,Invoice,008-05348,Arroz a Granel:Parboiled 50 LB -Bolsa Dos Hermanos.,,6.0,26.75,160.5,4137666.06,Bulk Rice,Lisset Limpio -020,Cafeteria,1388295,Apr
2025-04-17,Be Your Will LLC,Invoice,008-05349,Liquids:AS Cooking Wine,4 1 Gl.,1.0,17.5,17.5,4137683.56,American Spice,Lisset Limpio -020,CAFETERIA y RESTAURANTS,1388296,Apr
2025-04-17,Be Your Will LLC,Invoice,008-05349,Arroz a Granel:Largo Fino 50 LB -Bolsa Dos Hermanos.,,6.0,27.85,167.1,4137850.66,Bulk Rice,Lisset Limpio -020,CAFETERIA y RESTAURANTS,1388297,Apr
2025-04-17,Be Your Will LLC,Invoice,008-05349,Arroz a Granel:Parboiled 50 LB -Bolsa Dos Hermanos.,,11.0,26.75,294.25,4138144.91,Bulk Rice,Lisset Limpio -020,CAFETERIA y RESTAURANTS,1388298,Apr
2025-04-17,El Palacio de los jugos /  Nanos Latin Foods,Invoice,008-05350,Arroz a Granel:Largo Fino 50 LB -Bolsa Dos Hermanos.,,5.0,27.85,139.25,4138284.16,Bulk Rice,Lisset Limpio -020,Cafeteria,1388299,Apr
2025-04-17,El Palacio de los jugos /  Nanos Latin Foods,Invoice,008-05350,Arroz a Granel:Parboiled 50 LB -Bolsa Dos Hermanos.,,10.0,26.75,267.5,4138551.66,Bulk Rice,Lisset Limpio -020,Cafeteria,1388300,Apr
2025-04-17,El Palacio de los jugos / Lita Foods Inc.,Invoice,008-05351,Dry Beans:Dry Beans - Black Beans 50,Dry Black Beans 50 lb,1.0,35.0,35.0,4138586.66,Dry Beans,Lisset Limpio -020,Cafeteria,1388301,Apr
2025-04-17,El Palacio de los jugos / Lita Foods Inc.,Invoice,008-05351,Arroz a Granel:Parboiled 50 LB -Bolsa Dos Hermanos.,,11.0,26.75,294.25,4138880.91,Bulk Rice,Lisset Limpio -020,Cafeteria,1388302,Apr
2025-04-17,Sabor Tropical #1 - Supermarket,Invoice,008-05352,Arroz Envasado:Largo Fino 1kg (Long grain rice) Dos Hermanos,,2.0,18.0,36.0,4138916.91,Branded Rice,Keila Alfaro-Visvikis,RETAIL  DSD,1388303,Apr
2025-04-17,El Palacio de los jugos / Caribe Tropical,Invoice,008-05353,Arroz a Granel:Parboiled 50 LB -Bolsa Dos Hermanos.,,6.0,26.75,160.5,4139077.41,Bulk Rice,Lisset Limpio -020,Cafeteria,1388304,Apr
2025-04-17,El Palacio de los jugos / Delicias Criollas (DIAGO FOOD_MILLER),Invoice,008-05354,Dry Beans:Dry Beans - Black Beans 50,Dry Black Beans 50 lb,1.0,35.0,35.0,4139112.41,Dry Beans,Lisset Limpio -020,Cafeteria,1388305,Apr
2025-04-17,El Palacio de los jugos / Delicias Criollas (DIAGO FOOD_MILLER),Invoice,008-05354,Arroz a Granel:Parboiled 50 LB -Bolsa Dos Hermanos.,,12.0,26.75,321.0,4139433.41,Bulk Rice,Lisset Limpio -020,Cafeteria,1388306,Apr
2025-04-17,El Palacio de los jugos / Delicias Criollas (DIAGO FOOD_MILLER),Invoice,008-05354,Arroz a Granel:Largo Fino 50 LB -Bolsa Dos Hermanos.,,4.0,27.85,111.4,4139544.81,Bulk Rice,Lisset Limpio -020,Cafeteria,1388307,Apr
2025-04-17,Soriano Brothers PB,Invoice,008-05355,Spices:AS Sazon (for all),1 / 30 lb (box or pail),1.0,51.0,51.0,4139595.81,American Spice,Lisset Limpio -020,CAFETERIA y RESTAURANTS,1388308,Apr
2025-04-17,Soriano Brothers PB,Invoice,008-05355,Arroz a Granel:Largo Fino 50 LB -Bolsa Dos Hermanos.,,15.0,27.85,417.75,4140013.56,Bulk Rice,Lisset Limpio -020,CAFETERIA y RESTAURANTS,1388309,Apr
2025-04-17,Soriano Brothers PB,Invoice,008-05355,Arroz a Granel:Parboiled 50 LB -Bolsa Dos Hermanos.,,10.0,26.75,267.5,4140281.06,Bulk Rice,Lisset Limpio -020,CAFETERIA y RESTAURANTS,1388310,Apr
2025-04-17,Soriano Brothers PB,Invoice,008-05355,Dry Beans:Dry Beans - Black Beans 50,Dry Black Beans 50 lb,1.0,35.0,35.0,4140316.06,Dry Beans,Lisset Limpio -020,CAFETERIA y RESTAURANTS,1388311,Apr
2025-04-17,China Tokyo,Invoice,008-05356,Arroz a Granel:Parboiled 50 LB -Bolsa Dos Hermanos.,,10.0,28.25,282.5,4140598.56,Bulk Rice,Lisset Limpio -020,CAFETERIA y RESTAURANTS,1388312,Apr
2025-04-17,Bravo   Francisco Diaz,Invoice,008-05357,Arroz a Granel:Largo Fino 50 LB -Bolsa Dos Hermanos.,,5.0,27.85,139.25,4140737.81,Bulk Rice,Lisset Limpio -020,RETAIL  DSD,1388313,Apr
2025-04-17,Bravo   Francisco Diaz,Invoice,008-05357,Liquids:AS Cooking Wine,4 1 Gl.,3.0,17.5,52.5,4140790.31,American Spice,Lisset Limpio -020,RETAIL  DSD,1388314,Apr
2025-04-17,Bravo   Francisco Diaz,Invoice,008-05357,Liquids:AS Marinating Sauce (Mojo),,1.0,18.5,18.5,4140808.81,American Spice,Lisset Limpio -020,RETAIL  DSD,1388315,Apr
2025-04-21,El Palacio de los jugos / J Mena Corp.,Invoice,008-05358,Arroz a Granel:Parboiled 50 LB -Bolsa Dos Hermanos.,,6.0,26.75,160.5,4140969.31,Bulk Rice,Lisset Limpio -020,Cafeteria,1388316,Apr
2025-04-21,El Palacio de los jugos / Rodriguez Foods,Invoice,008-05359,Arroz a Granel:Parboiled 50 LB -Bolsa Dos Hermanos.,,8.0,26.75,214.0,4141183.31,Bulk Rice,Lisset Limpio -020,Cafeteria,1388317,Apr
2025-04-21,El Palacio de los jugos /  Mires Restaurants,Invoice,008-05360,Liquids:AS Marinating Sauce (Mojo),,1.0,18.5,18.5,4141201.81,American Spice,Lisset Limpio -020,Cafeteria,1388318,Apr
2025-04-21,El Palacio de los jugos /  Mires Restaurants,Invoice,008-05360,Arroz a Granel:Parboiled 50 LB -Bolsa Dos Hermanos.,,12.0,26.75,321.0,4141522.81,Bulk Rice,Lisset Limpio -020,Cafeteria,1388319,Apr
2025-04-21,El Palacio de Los Jugos / Casa mía Food Restaurant inc,Invoice,008-05361,Dry Beans:Dry Beans - Black Beans 50,Dry Black Beans 50 lb,1.0,35.0,35.0,4141557.81,Dry Beans,Lisset Limpio -020,Cafeteria,1388320,Apr
2025-04-21,El Palacio de Los Jugos / Casa mía Food Restaurant inc,Invoice,008-05361,Arroz a Granel:Parboiled 50 LB -Bolsa Dos Hermanos.,,11.0,26.75,294.25,4141852.06,Bulk Rice,Lisset Limpio -020,Cafeteria,1388321,Apr
2025-04-21,ALS Foods,Invoice,008-05362,Liquids:AS Cooking Wine,4 1 Gl.,2.0,17.5,35.0,4141887.06,American Spice,Lisset Limpio -020,CAFETERIA y RESTAURANTS,1388322,Apr
2025-04-21,ALS Foods,Invoice,008-05362,Arroz a Granel:Parboiled 50 LB -Bolsa Dos Hermanos.,,11.0,27.75,305.25,4142192.31,Bulk Rice,Lisset Limpio -020,CAFETERIA y RESTAURANTS,1388323,Apr
2025-04-21,ALS Foods,Invoice,008-05362,Arroz a Granel:Largo Fino 50 LB -Bolsa Dos Hermanos.,,5.0,27.85,139.25,4142331.56,Bulk Rice,Lisset Limpio -020,CAFETERIA y RESTAURANTS,1388324,Apr
2025-04-21,ALS Foods,Invoice,008-05362,Arroz a Granel:Parboiled 50 LB -Bolsa Dos Hermanos.,,1.0,27.75,27.75,4142359.31,Bulk Rice,Lisset Limpio -020,CAFETERIA y RESTAURANTS,1388325,Apr
2025-04-21,El Palacio de los jugos / Caribe Tropical,Invoice,008-05363,Arroz a Granel:Parboiled 50 LB -Bolsa Dos Hermanos.,,9.0,26.75,240.75,4142600.06,Bulk Rice,Lisset Limpio -020,Cafeteria,1388326,Apr
2025-04-21,El Palacio de los jugos / Caribe Tropical,Invoice,008-05363,Dry Beans:Dry Beans - Black Beans 50,Dry Black Beans 50 lb,3.0,35.0,105.0,4142705.06,Dry Beans,Lisset Limpio -020,Cafeteria,1388327,Apr
2025-04-21,El Palacio de los jugos /  EMMA FOOD CORP,Invoice,008-05364,Arroz a Granel:Largo Fino 50 LB -Bolsa Dos Hermanos.,,8.0,27.85,222.8,4142927.86,Bulk Rice,Lisset Limpio -020,Cafeteria,1388328,Apr
2025-04-21,Sedanos Supermarkets #14,Invoice,008-05365,Arroz Envasado:Largo Fino 1kg (Long grain rice) Dos Hermanos,,4.0,17.5,70.0,4142997.86,Branded Rice,Keila Alfaro-Visvikis,RETAIL SEDANOS,1388329,Apr
2025-04-21,Sedanos Supermarkets #14,Invoice,008-05365,Arroz Envasado:Parboiled 1kg Bolsa Dos Hermanos.,.,1.0,19.9,19.9,4143017.76,Branded Rice,Keila Alfaro-Visvikis,RETAIL SEDANOS,1388330,Apr
2025-04-21,Sedanos Supermarkets #14,Invoice,008-05365,Arroz Envasado:Parboiled 5KG Dos Hermanos.,6  11lbs,10.0,40.5,405.0,4143422.76,Branded Rice,Keila Alfaro-Visvikis,RETAIL SEDANOS,1388331,Apr
2025-04-21,Sedanos Supermarkets #14,Invoice,008-05365,Arroz Envasado:Largo Fino 1kg (Long grain rice) Dos Hermanos,,1.0,17.5,17.5,4143440.26,Branded Rice,Keila Alfaro-Visvikis,RETAIL SEDANOS,1388332,Apr
2025-04-21,Sedanos Supermarkets #14,Invoice,008-05365,Arroz Envasado:Parboiled 5KG Dos Hermanos.,6  11lbs,2.0,19.9,39.8,4143480.06,Branded Rice,Keila Alfaro-Visvikis,RETAIL SEDANOS,1388333,Apr
2025-04-21,JMN Dely Corp,Invoice,008-05366,Dry Beans:Dry Beans - Black Beans 50,Dry Black Beans 50 lb,1.0,45.7,45.7,4143525.76,Dry Beans,Keila Alfaro-Visvikis,CAFETERIA y RESTAURANTS,1388334,Apr
2025-04-21,JMN Dely Corp,Invoice,008-05366,Arroz a Granel:Largo Fino 50 LB -Bolsa Dos Hermanos.,,2.0,27.85,55.7,4143581.46,Bulk Rice,Keila Alfaro-Visvikis,CAFETERIA y RESTAURANTS,1388335,Apr
2025-04-21,JMN Dely Corp,Invoice,008-05366,Arroz a Granel:Parboiled 50 LB -Bolsa Dos Hermanos.,,2.0,27.75,55.5,4143636.96,Bulk Rice,Keila Alfaro-Visvikis,CAFETERIA y RESTAURANTS,1388336,Apr
2025-04-21,Festival Supermarket,Credit Memo,008-05367,Varios:Promotional Allowance,Arroz Envasado:Parboiled 5KG Dos Hermanos.,-15.0,46.5,-697.5,4142939.46,Branded Rice,Keila Alfaro-Visvikis,RETAIL  DSD,1388337,Apr
2025-04-22,Sedanos Supermarkets #14,Credit Memo,008-05368,Varios:Promotional Allowance,Arroz Envasado:Largo Fino 1kg (Long grain rice) Dos Hermanos,-1.0,17.5,-17.5,4142921.96,Branded Rice,Keila Alfaro-Visvikis,RETAIL SEDANOS,1388338,Apr
2025-04-22,Sedanos Supermarkets #14,Credit Memo,008-05368,Varios:Promotional Allowance,Arroz Envasado:Parboiled 5KG Dos Hermanos.,-2.0,19.9,-39.8,4142882.16,Branded Rice,Keila Alfaro-Visvikis,RETAIL SEDANOS,1388339,Apr
2025-04-22,Key Foods  / Ivan,Credit Memo,008-05369,Varios:Promotional Allowance,Arroz Envasado:Parboiled 5KG Dos Hermanos.,-7.0,46.5,-325.5,4142556.66,Branded Rice,Keila Alfaro-Visvikis,RETAIL  DSD,1388340,Apr
2025-04-22,ALS Foods,Credit Memo,008-05370,Varios:Promotional Allowance,Arroz a Granel:Parboiled 50 LB -Bolsa Dos Hermanos.,-1.0,27.75,-27.75,4142528.91,Bulk Rice,Lisset Limpio -020,CAFETERIA y RESTAURANTS,1388341,Apr
2025-04-23,Los Mejores Tamales de Miami,Invoice,008-05371,Arroz a Granel:Parboiled 50 LB -Bolsa Dos Hermanos.,,4.0,28.25,113.0,4142641.91,Bulk Rice,Lisset Limpio -020,CAFETERIA y RESTAURANTS,1388342,Apr
2025-04-23,Sedanos Supermarkets #22,Invoice,008-05372,Arroz a Granel:Parboiled 50 LB -Bolsa Dos Hermanos.,,4.0,28.25,113.0,4142754.91,Bulk Rice,Keila Alfaro-Visvikis,RETAIL SEDANOS,1388343,Apr
2025-04-23,Sedanos Supermarkets #22,Invoice,008-05372,,Discount,,,-2.26,4142752.65,,Keila Alfaro-Visvikis,RETAIL SEDANOS,1388344,Apr
2025-04-23,Sedanos Supermarkets #26,Invoice,008-05373,Arroz a Granel:Parboiled 50 LB -Bolsa Dos Hermanos.,,5.0,28.25,141.25,4142893.9,Bulk Rice,Keila Alfaro-Visvikis,RETAIL SEDANOS,1388345,Apr
2025-04-23,Sedanos Supermarkets #26,Invoice,008-05373,Spices:AS Chicken Base,1 / 30 lb. (box or pail),2.0,39.0,78.0,4142971.9,American Spice,Keila Alfaro-Visvikis,RETAIL SEDANOS,1388346,Apr
2025-04-23,Sedanos Supermarkets #26,Invoice,008-05373,,Discount,,,-4.39,4142967.51,,Keila Alfaro-Visvikis,RETAIL SEDANOS,1388347,Apr
2025-04-23,Sedanos Supermarkets #16,Invoice,008-05374,Arroz a Granel:Parboiled 50 LB -Bolsa Dos Hermanos.,,4.0,28.25,113.0,4143080.51,Bulk Rice,Keila Alfaro-Visvikis,RETAIL SEDANOS,1388348,Apr
2025-04-23,Sedanos Supermarkets #16,Invoice,008-05374,,Discount,,,-2.26,4143078.25,,Keila Alfaro-Visvikis,RETAIL SEDANOS,1388349,Apr
2025-04-23,Mei Chang,Invoice,008-05375,Arroz a Granel:Parboiled 50 LB -Bolsa Dos Hermanos.,,7.0,28.25,197.75,4143276.0,Bulk Rice,Lisset Limpio -020,CAFETERIA y RESTAURANTS,1388350,Apr
2025-04-23,El Palacio de los jugos /  Nanos Latin Foods,Invoice,008-05376,Dry Beans:Dry Beans - Black Beans 50,Dry Black Beans 50 lb,1.0,35.0,35.0,4143311.0,Dry Beans,Lisset Limpio -020,Cafeteria,1388351,Apr
2025-04-23,El Palacio de los jugos /  Nanos Latin Foods,Invoice,008-05376,Arroz a Granel:Largo Fino 50 LB -Bolsa Dos Hermanos.,,5.0,27.85,139.25,4143450.25,Bulk Rice,Lisset Limpio -020,Cafeteria,1388352,Apr
2025-04-23,El Palacio de los jugos /  Nanos Latin Foods,Invoice,008-05376,Arroz a Granel:Parboiled 50 LB -Bolsa Dos Hermanos.,,10.0,26.75,267.5,4143717.75,Bulk Rice,Lisset Limpio -020,Cafeteria,1388353,Apr
2025-04-23,Price Choice Food Market # 2,Invoice,008-05377,Arroz Envasado:Parboiled 5KG Dos Hermanos.,6  11lbs,15.0,46.5,697.5,4144415.25,Branded Rice,Keila Alfaro-Visvikis,RETAIL  DSD,1388354,Apr
2025-04-23,Price Choice Food Market # 2,Invoice,008-05377,Arroz Envasado:Parboiled 5KG Dos Hermanos.,6  11lbs,7.0,46.5,325.5,4144740.75,Branded Rice,Keila Alfaro-Visvikis,RETAIL  DSD,1388355,Apr
2025-04-23,Sedanos Supermarkets #27,Invoice,008-05378,Arroz Envasado:Parboiled 5KG Dos Hermanos.,6  11lbs,5.0,40.5,202.5,4144943.25,Branded Rice,Keila Alfaro-Visvikis,RETAIL SEDANOS,1388356,Apr
2025-04-23,Sedanos Supermarkets #27,Invoice,008-05379,Arroz Envasado:Parboiled 5KG Dos Hermanos.,6  11lbs,5.0,40.5,202.5,4145145.75,Branded Rice,Keila Alfaro-Visvikis,RETAIL SEDANOS,1388357,Apr
2025-04-23,Sedanos Supermarkets #27,Invoice,008-05379,Arroz Envasado:Parboiled 5KG Dos Hermanos.,6  11lbs,1.0,40.5,40.5,4145186.25,Branded Rice,Keila Alfaro-Visvikis,RETAIL SEDANOS,1388358,Apr
2025-04-23,Sedanos Supermarkets #27,Invoice,008-05379,,Discount,,,-4.05,4145182.2,,Keila Alfaro-Visvikis,RETAIL SEDANOS,1388359,Apr
2025-04-23,Sedanos Supermarkets #24,Invoice,008-05380,Arroz a Granel:Parboiled 50 LB -Bolsa Dos Hermanos.,,8.0,28.25,226.0,4145408.2,Bulk Rice,Keila Alfaro-Visvikis,RETAIL SEDANOS,1388360,Apr
2025-04-23,Sedanos Supermarkets #24,Invoice,008-05380,,Discount,,,-4.52,4145403.68,,Keila Alfaro-Visvikis,RETAIL SEDANOS,1388361,Apr
2025-04-23,Ideal Food Basket Davie Grocery,Invoice,008-05381,Arroz Envasado:Largo Fino 1kg (Long grain rice) Dos Hermanos,,2.0,18.0,36.0,4145439.68,Branded Rice,Keila Alfaro-Visvikis,RETAIL  DSD,1388362,Apr
2025-04-23,Ideal Food Basket Davie Grocery,Invoice,008-05381,Arroz Envasado:Parboiled 1kg Bolsa Dos Hermanos.,.,3.0,19.9,59.7,4145499.38,Branded Rice,Keila Alfaro-Visvikis,RETAIL  DSD,1388363,Apr
2025-04-23,Ideal Food Basket Davie Grocery,Invoice,008-05381,Arroz Envasado:Largo Fino 1kg (Long grain rice) Dos Hermanos,,1.0,18.0,18.0,4145517.38,Branded Rice,Keila Alfaro-Visvikis,RETAIL  DSD,1388364,Apr
2025-04-23,Ideal Food Basket Davie Cafeteria,Invoice,008-05382,Arroz a Granel:Largo Fino 50 LB -Bolsa Dos Hermanos.,,6.0,27.85,167.1,4145684.48,Bulk Rice,Keila Alfaro-Visvikis,CAFETERIA y RESTAURANTS,1388365,Apr
2025-04-23,Los Caringas Latin America  Foods,Invoice,008-05383,Arroz a Granel:Largo Fino 50 LB -Bolsa Dos Hermanos.,,3.0,27.85,83.55,4145768.03,Bulk Rice,Lisset Limpio -020,CAFETERIA y RESTAURANTS,1388366,Apr
2025-04-23,Los Caringas Latin America  Foods,Invoice,008-05383,Arroz a Granel:Parboiled 50 LB -Bolsa Dos Hermanos.,,3.0,28.25,84.75,4145852.78,Bulk Rice,Lisset Limpio -020,CAFETERIA y RESTAURANTS,1388367,Apr
2025-04-23,Los Caringas Latin America  Foods,Invoice,008-05383,Dry Beans:Dry Beans - Black Beans 50,Dry Black Beans 50 lb,1.0,36.0,36.0,4145888.78,Dry Beans,Lisset Limpio -020,CAFETERIA y RESTAURANTS,1388368,Apr
2025-04-23,Sedanos Supermarkets #43,Invoice,008-05384,Arroz a Granel:Parboiled 50 LB -Bolsa Dos Hermanos.,,4.0,28.25,113.0,4146001.78,Bulk Rice,Keila Alfaro-Visvikis,RETAIL SEDANOS,1388369,Apr
2025-04-23,Sedanos Supermarkets #43,Invoice,008-05384,,Discount,,,-2.26,4145999.52,,Keila Alfaro-Visvikis,RETAIL SEDANOS,1388370,Apr
2025-04-24,Panda Depot,Invoice,008-05385,Arroz a Granel:Largo Fino 50 LB -Bolsa Dos Hermanos.,,110.0,24.25,2667.5,4148667.02,Bulk Rice,Lisset Limpio -020,WHOLESALER,1388371,Apr
2025-04-24,Panda Depot,Invoice,008-05385,Arroz a Granel:Parboiled 50 LB -Bolsa Dos Hermanos.,,550.0,24.5,13475.0,4162142.02,Bulk Rice,Lisset Limpio -020,WHOLESALER,1388372,Apr
2025-04-24,"American Spice Trading Co, Inc.",Invoice,008-05386,Arroz a Granel:Parboiled 50 LB -Bolsa Dos Hermanos.,,1100.0,26.0,28600.0,4190742.02,Bulk Rice,Armando Carpio - 017,WHOLESALER MANUFACTURY,1388373,Apr
2025-04-24,Sedanos Supermarkets #32,Invoice,008-05387,Arroz a Granel:Largo Fino 50 LB -Bolsa Dos Hermanos.,,5.0,27.85,139.25,4190881.27,Bulk Rice,Keila Alfaro-Visvikis,RETAIL SEDANOS,1388374,Apr
2025-04-24,Sedanos Supermarkets #32,Invoice,008-05387,Arroz a Granel:Parboiled 50 LB -Bolsa Dos Hermanos.,,4.0,28.25,113.0,4190994.27,Bulk Rice,Keila Alfaro-Visvikis,RETAIL SEDANOS,1388375,Apr
2025-04-24,Sedanos Supermarkets #32,Invoice,008-05387,,Discount,,,-5.05,4190989.22,,Keila Alfaro-Visvikis,RETAIL SEDANOS,1388376,Apr
2025-04-24,Sedanos Supermarkets #18,Invoice,008-05388,Arroz a Granel:Parboiled 50 LB -Bolsa Dos Hermanos.,,10.0,28.25,282.5,4191271.72,Bulk Rice,Keila Alfaro-Visvikis,RETAIL SEDANOS,1388377,Apr
2025-04-24,Sedanos Supermarkets #18,Invoice,008-05388,Spices:AS Chicken Base,1 / 30 lb. (box or pail),1.0,39.0,39.0,4191310.72,American Spice,Keila Alfaro-Visvikis,RETAIL SEDANOS,1388378,Apr
2025-04-24,Sedanos Supermarkets #18,Invoice,008-05388,,Discount,,,-6.43,4191304.29,,Keila Alfaro-Visvikis,RETAIL SEDANOS,1388379,Apr
2025-04-24,Sedanos Supermarkets #5,Invoice,008-05389,Arroz Envasado:Parboiled 5KG Dos Hermanos.,6  11lbs,5.0,40.5,202.5,4191506.79,Branded Rice,Keila Alfaro-Visvikis,RETAIL SEDANOS,1388380,Apr
2025-04-24,Sedanos Supermarkets #5,Invoice,008-05389,Arroz Envasado:Parboiled 1kg Bolsa Dos Hermanos.,.,1.0,19.9,19.9,4191526.69,Branded Rice,Keila Alfaro-Visvikis,RETAIL SEDANOS,1388381,Apr
2025-04-24,Sedanos Supermarkets #5,Invoice,008-05389,Arroz Envasado:Parboiled 5KG Dos Hermanos.,6  11lbs,2.0,19.9,39.8,4191566.49,Branded Rice,Keila Alfaro-Visvikis,RETAIL SEDANOS,1388382,Apr
2025-04-24,Sedanos Supermarkets #5,Invoice,008-05389,,Discount,,,-4.45,4191562.04,,Keila Alfaro-Visvikis,RETAIL SEDANOS,1388383,Apr
2025-04-24,El Palacio de los jugos / Rodriguez Foods,Invoice,008-05390,Arroz a Granel:Parboiled 50 LB -Bolsa Dos Hermanos.,,6.0,26.75,160.5,4191722.54,Bulk Rice,Lisset Limpio -020,Cafeteria,1388384,Apr
2025-04-24,El Palacio de los jugos / Delicias Criollas (DIAGO FOOD_MILLER),Invoice,008-05391,Arroz a Granel:Largo Fino 50 LB -Bolsa Dos Hermanos.,,5.0,27.85,139.25,4191861.79,Bulk Rice,Lisset Limpio -020,Cafeteria,1388385,Apr
2025-04-24,El Palacio de los jugos / Delicias Criollas (DIAGO FOOD_MILLER),Invoice,008-05391,Arroz a Granel:Parboiled 50 LB -Bolsa Dos Hermanos.,,12.0,26.75,321.0,4192182.79,Bulk Rice,Lisset Limpio -020,Cafeteria,1388386,Apr
2025-04-24,El Palacio de los jugos / Delicias Criollas (DIAGO FOOD_MILLER),Invoice,008-05391,Liquids:AS White Vinegar,4/1 Gl.,1.0,9.5,9.5,4192192.29,American Spice,Lisset Limpio -020,Cafeteria,1388387,Apr
2025-04-24,El Palacio de Los Jugos / Casa mía Food Restaurant inc,Invoice,008-05392,Dry Beans:Dry Beans - Black Beans 50,Dry Black Beans 50 lb,1.0,35.0,35.0,4192227.29,Dry Beans,Lisset Limpio -020,Cafeteria,1388388,Apr
2025-04-24,El Palacio de Los Jugos / Casa mía Food Restaurant inc,Invoice,008-05392,Arroz a Granel:Parboiled 50 LB -Bolsa Dos Hermanos.,,12.0,26.75,321.0,4192548.29,Bulk Rice,Lisset Limpio -020,Cafeteria,1388389,Apr
2025-04-24,El Palacio de los jugos / Lita Foods Inc.,Invoice,008-05393,Dry Beans:Dry Beans - Black Beans 50,Dry Black Beans 50 lb,1.0,35.0,35.0,4192583.29,Dry Beans,Lisset Limpio -020,Cafeteria,1388390,Apr
2025-04-24,El Palacio de los jugos / Lita Foods Inc.,Invoice,008-05393,Arroz a Granel:Parboiled 50 LB -Bolsa Dos Hermanos.,,12.0,26.75,321.0,4192904.29,Bulk Rice,Lisset Limpio -020,Cafeteria,1388391,Apr
2025-04-24,Be Your Will LLC,Invoice,008-05394,Liquids:AS Cooking Wine,4 1 Gl.,1.0,17.5,17.5,4192921.79,American Spice,Lisset Limpio -020,CAFETERIA y RESTAURANTS,1388392,Apr
2025-04-24,Be Your Will LLC,Invoice,008-05394,Arroz a Granel:Largo Fino 50 LB -Bolsa Dos Hermanos.,,4.0,27.85,111.4,4193033.19,Bulk Rice,Lisset Limpio -020,CAFETERIA y RESTAURANTS,1388393,Apr
2025-04-24,Be Your Will LLC,Invoice,008-05394,Arroz a Granel:Parboiled 50 LB -Bolsa Dos Hermanos.,,6.0,27.75,166.5,4193199.69,Bulk Rice,Lisset Limpio -020,CAFETERIA y RESTAURANTS,1388394,Apr
2025-04-24,El Palacio de los jugos / Leti Corp.,Invoice,008-05395,Arroz a Granel:Parboiled 50 LB -Bolsa Dos Hermanos.,,8.0,26.75,214.0,4193413.69,Bulk Rice,Lisset Limpio -020,Cafeteria,1388395,Apr
2025-04-24,El Palacio de los jugos / Leti Corp.,Invoice,008-05395,Dry Beans:Dry Beans - Black Beans 50,Dry Black Beans 50 lb,1.0,35.0,35.0,4193448.69,Dry Beans,Lisset Limpio -020,Cafeteria,1388396,Apr
2025-04-24,Fritanga Momotombo,Invoice,008-05396,Dry Beans:Dry Beans - Small Red Beans 50 lbs.,Small Red Beans 50 lbs,2.0,42.0,84.0,4193532.69,Dry Beans,Lisset Limpio -020,CAFETERIA y RESTAURANTS,1388397,Apr
2025-04-24,Fritanga Momotombo,Invoice,008-05396,Arroz a Granel:Largo Fino 50 LB -Bolsa Dos Hermanos.,,5.0,27.85,139.25,4193671.94,Bulk Rice,Lisset Limpio -020,CAFETERIA y RESTAURANTS,1388398,Apr
2025-04-24,Fritanga Momotombo,Invoice,008-05396,Spices:AS Chicken Base,1 / 30 lb. (box or pail),2.0,39.0,78.0,4193749.94,American Spice,Lisset Limpio -020,CAFETERIA y RESTAURANTS,1388399,Apr
2025-04-24,El Palacio de los jugos / Caribe Tropical,Invoice,008-05397,Arroz a Granel:Parboiled 50 LB -Bolsa Dos Hermanos.,,8.0,26.75,214.0,4193963.94,Bulk Rice,Lisset Limpio -020,Cafeteria,1388400,Apr
2025-04-24,El Gallego Supermarket,Invoice,008-05398,Arroz a Granel:Parboiled 50 LB -Bolsa Dos Hermanos.,,5.0,28.25,141.25,4194105.19,Bulk Rice,Lisset Limpio -020,RETAIL  DSD,1388401,Apr
2025-04-24,El Gallego Supermarket,Invoice,008-05398,Dry Beans:Dry Beans - Black Beans 50,Dry Black Beans 50 lb,1.0,35.0,35.0,4194140.19,Dry Beans,Lisset Limpio -020,RETAIL  DSD,1388402,Apr
2025-04-24,El Gallego Supermarket,Invoice,008-05398,Liquids:AS Bitter Orange,,2.0,14.0,28.0,4194168.19,American Spice,Lisset Limpio -020,RETAIL  DSD,1388403,Apr
2025-04-24,El Gallego Supermarket,Invoice,008-05398,Liquids:AS Cooking Wine,4 1 Gl.,1.0,17.5,17.5,4194185.69,American Spice,Lisset Limpio -020,RETAIL  DSD,1388404,Apr
2025-04-24,VIÑA & SONS FOOD DIST.CORP,Invoice,008-05399,Arroz a Granel:Parboiled 50 LB -Bolsa Dos Hermanos.,,10.0,27.75,277.5,4194463.19,Bulk Rice,Keila Alfaro-Visvikis,CAFETERIA y RESTAURANTS,1388405,Apr
2025-04-24,VIÑA & SONS FOOD DIST.CORP,Invoice,008-05399,Arroz Envasado:Parboiled 1kg Bolsa Dos Hermanos.,.,3.0,19.9,59.7,4194522.89,Branded Rice,Keila Alfaro-Visvikis,CAFETERIA y RESTAURANTS,1388406,Apr
2025-04-24,VIÑA & SONS FOOD DIST.CORP,Invoice,008-05399,Arroz Envasado:Largo Fino 1kg (Long grain rice) Dos Hermanos,,2.0,18.0,36.0,4194558.89,Branded Rice,Keila Alfaro-Visvikis,CAFETERIA y RESTAURANTS,1388407,Apr
2025-04-24,VIÑA & SONS FOOD DIST.CORP,Invoice,008-05399,Arroz Envasado:Largo Fino 1kg (Long grain rice) Dos Hermanos,,1.0,18.0,18.0,4194576.89,Branded Rice,Keila Alfaro-Visvikis,CAFETERIA y RESTAURANTS,1388408,Apr
2025-04-24,Sedanos Supermarkets #29,Invoice,008-05401,Arroz Envasado:Parboiled 5KG Dos Hermanos.,6  11lbs,15.0,40.5,607.5,4195184.39,Branded Rice,Keila Alfaro-Visvikis,RETAIL SEDANOS,1388409,Apr
2025-04-24,Sedanos Supermarkets #29,Invoice,008-05401,Arroz Envasado:Parboiled 5KG Dos Hermanos.,6  11lbs,3.0,40.5,121.5,4195305.89,Branded Rice,Keila Alfaro-Visvikis,RETAIL SEDANOS,1388410,Apr
2025-04-24,Sedanos Supermarkets #29,Invoice,008-05401,,Discount,,,-12.15,4195293.74,,Keila Alfaro-Visvikis,RETAIL SEDANOS,1388411,Apr
2025-04-25,Price Choice Food Market # 2,Credit Memo,008-05417,Varios:Promotional Allowance,Arroz Envasado:Parboiled 5KG Dos Hermanos.,-7.0,46.5,-325.5,4194968.24,Branded Rice,Keila Alfaro-Visvikis,RETAIL  DSD,1388412,Apr
2025-04-25,Sedanos Supermarkets #27,Credit Memo,008-05418,Varios:Promotional Allowance,Arroz Envasado:Parboiled 5KG Dos Hermanos.,-1.0,40.5,-40.5,4194927.74,Branded Rice,Keila Alfaro-Visvikis,RETAIL SEDANOS,1388413,Apr
2025-04-25,Ideal Food Basket Davie Grocery,Credit Memo,008-05419,Varios:Promotional Allowance,Arroz Envasado:Largo Fino 1kg (Long grain rice) Dos Hermanos,-1.0,18.0,-18.0,4194909.74,Branded Rice,Keila Alfaro-Visvikis,RETAIL  DSD,1388414,Apr
2025-04-25,Sedanos Supermarkets #5,Credit Memo,008-05420,Varios:Promotional Allowance,Arroz Envasado:Parboiled 5KG Dos Hermanos.,-2.0,19.9,-39.8,4194869.94,Branded Rice,Keila Alfaro-Visvikis,RETAIL SEDANOS,1388415,Apr
2025-04-25,VIÑA & SONS FOOD DIST.CORP,Credit Memo,008-05421,Varios:Promotional Allowance,Arroz Envasado:Largo Fino 1kg (Long grain rice) Dos Hermanos,-1.0,18.0,-18.0,4194851.94,Branded Rice,Keila Alfaro-Visvikis,CAFETERIA y RESTAURANTS,1388416,Apr
2025-04-25,Sedanos Supermarkets #29,Credit Memo,008-05422,Varios:Promotional Allowance,Arroz Envasado:Parboiled 5KG Dos Hermanos.,-3.0,40.5,-121.5,4194730.44,Branded Rice,Keila Alfaro-Visvikis,RETAIL SEDANOS,1388417,Apr
2025-04-25,Key Foods 40 St,Credit Memo,008-05423,Varios:Promotional Allowance,Arroz Envasado:Parboiled 5KG Dos Hermanos.,-7.0,46.5,-325.5,4194404.94,Branded Rice,Keila Alfaro-Visvikis,RETAIL  DSD,1388418,Apr
2025-04-26,Food Giant Market  10 Ave.,Invoice,008-05402,Liquids:AS Cooking Wine,4 1 Gl.,3.0,17.5,52.5,4194457.44,American Spice,Keila Alfaro-Visvikis,RETAIL  DSD,1388419,Apr
2025-04-26,Food Giant Market  10 Ave.,Invoice,008-05402,Liquids:AS Lemon Juice 4/1 Gl,,2.0,14.95,29.9,4194487.34,American Spice,Keila Alfaro-Visvikis,RETAIL  DSD,1388420,Apr
2025-04-26,Food Giant Market  10 Ave.,Invoice,008-05402,Arroz a Granel:Parboiled 50 LB -Bolsa Dos Hermanos.,,2.0,28.25,56.5,4194543.84,Bulk Rice,Keila Alfaro-Visvikis,RETAIL  DSD,1388421,Apr
2025-04-27,El Palacio de los jugos / Lita Foods Inc.,Invoice,008-05403,Dry Beans:Dry Beans - Black Beans 50,Dry Black Beans 50 lb,1.0,35.0,35.0,4194578.84,Dry Beans,Lisset Limpio -020,Cafeteria,1388422,Apr
2025-04-27,El Palacio de los jugos / Lita Foods Inc.,Invoice,008-05403,Arroz a Granel:Parboiled 50 LB -Bolsa Dos Hermanos.,,12.0,26.75,321.0,4194899.84,Bulk Rice,Lisset Limpio -020,Cafeteria,1388423,Apr
2025-04-27,El Palacio de los jugos /  Nanos Latin Foods,Invoice,008-05404,Arroz a Granel:Parboiled 50 LB -Bolsa Dos Hermanos.,,10.0,26.75,267.5,4195167.34,Bulk Rice,Lisset Limpio -020,Cafeteria,1388424,Apr
2025-04-27,ALS Foods,Invoice,008-05405,Liquids:AS Cooking Wine,4 1 Gl.,2.0,17.5,35.0,4195202.34,American Spice,Lisset Limpio -020,CAFETERIA y RESTAURANTS,1388425,Apr
2025-04-27,ALS Foods,Invoice,008-05405,Arroz a Granel:Largo Fino 50 LB -Bolsa Dos Hermanos.,,4.0,27.85,111.4,4195313.74,Bulk Rice,Lisset Limpio -020,CAFETERIA y RESTAURANTS,1388426,Apr
2025-04-27,ALS Foods,Invoice,008-05405,Arroz a Granel:Parboiled 50 LB -Bolsa Dos Hermanos.,,6.0,26.75,160.5,4195474.24,Bulk Rice,Lisset Limpio -020,CAFETERIA y RESTAURANTS,1388427,Apr
2025-04-27,El Palacio de los jugos /  EMMA FOOD CORP,Invoice,008-05406,Arroz a Granel:Largo Fino 50 LB -Bolsa Dos Hermanos.,,8.0,27.85,222.8,4195697.04,Bulk Rice,Lisset Limpio -020,Cafeteria,1388428,Apr
2025-04-27,Aries Supermarket & Cafeteria,Invoice,008-05407,Dry Beans:Dry Beans - Black Beans 50,Dry Black Beans 50 lb,10.0,36.75,367.5,4196064.54,Dry Beans,Keila Alfaro-Visvikis,CAFETERIA y RESTAURANTS,1388429,Apr
2025-04-27,Aries Supermarket & Cafeteria,Invoice,008-05407,Arroz a Granel:Parboiled 50 LB -Bolsa Dos Hermanos.,,10.0,28.25,282.5,4196347.04,Bulk Rice,Keila Alfaro-Visvikis,CAFETERIA y RESTAURANTS,1388430,Apr
2025-04-27,Aries Supermarket & Cafeteria,Invoice,008-05407,Spices:AS Chicken Base,1 / 30 lb. (box or pail),3.0,39.0,117.0,4196464.04,American Spice,Keila Alfaro-Visvikis,CAFETERIA y RESTAURANTS,1388431,Apr
2025-04-27,Aries Supermarket & Cafeteria,Invoice,008-05407,Liquids:AS Cooking Wine,4 1 Gl.,2.0,17.5,35.0,4196499.04,American Spice,Keila Alfaro-Visvikis,CAFETERIA y RESTAURANTS,1388432,Apr
2025-04-27,JMN Dely Corp,Invoice,008-05408,Dry Beans:Dry Beans - Black Beans 50,Dry Black Beans 50 lb,1.0,45.7,45.7,4196544.74,Dry Beans,Keila Alfaro-Visvikis,CAFETERIA y RESTAURANTS,1388433,Apr
2025-04-27,JMN Dely Corp,Invoice,008-05408,Arroz a Granel:Largo Fino 50 LB -Bolsa Dos Hermanos.,,2.0,27.85,55.7,4196600.44,Bulk Rice,Keila Alfaro-Visvikis,CAFETERIA y RESTAURANTS,1388434,Apr
2025-04-27,JMN Dely Corp,Invoice,008-05408,Arroz a Granel:Parboiled 50 LB -Bolsa Dos Hermanos.,,2.0,27.75,55.5,4196655.94,Bulk Rice,Keila Alfaro-Visvikis,CAFETERIA y RESTAURANTS,1388435,Apr
2025-04-27,Bravo   Francisco Diaz,Invoice,008-05409,Arroz a Granel:Largo Fino 50 LB -Bolsa Dos Hermanos.,,5.0,27.85,139.25,4196795.19,Bulk Rice,Lisset Limpio -020,RETAIL  DSD,1388436,Apr
2025-04-27,Bravo   Francisco Diaz,Invoice,008-05409,Liquids:AS Cooking Wine,4 1 Gl.,4.0,17.5,70.0,4196865.19,American Spice,Lisset Limpio -020,RETAIL  DSD,1388437,Apr
2025-04-27,Bravo   Francisco Diaz,Invoice,008-05409,Liquids:AS White Vinegar,4/1 Gl.,2.0,10.0,20.0,4196885.19,American Spice,Lisset Limpio -020,RETAIL  DSD,1388438,Apr
2025-04-27,Bravo   Francisco Diaz,Invoice,008-05409,Spices:AS Chicken Base,1 / 30 lb. (box or pail),1.0,39.0,39.0,4196924.19,American Spice,Lisset Limpio -020,RETAIL  DSD,1388439,Apr
2025-04-27,Bravo   Francisco Diaz,Invoice,008-05409,Liquids:AS Marinating Sauce (Mojo),,1.0,18.5,18.5,4196942.69,American Spice,Lisset Limpio -020,RETAIL  DSD,1388440,Apr
2025-04-27,Bravo   Francisco Diaz,Invoice,008-05409,Spices:AS Sazon (for all),1 / 30 lb (box or pail),1.0,59.0,59.0,4197001.69,American Spice,Lisset Limpio -020,RETAIL  DSD,1388441,Apr
2025-04-27,Bravo   Francisco Diaz,Invoice,008-05409,Liquids:AS Lemon Juice 4/1 Gl,,1.0,14.95,14.95,4197016.64,American Spice,Lisset Limpio -020,RETAIL  DSD,1388442,Apr
2025-04-27,Bravo   Francisco Diaz,Invoice,008-05409,Spices:AS Meat Tenderizer,12 / 4.5 oz,1.0,12.95,12.95,4197029.59,American Spice,Lisset Limpio -020,RETAIL  DSD,1388443,Apr
2025-04-27,Key Foods 40 St,Invoice,008-05410,Arroz Envasado:Parboiled 5KG Dos Hermanos.,6  11lbs,15.0,46.5,697.5,4197727.09,Branded Rice,Keila Alfaro-Visvikis,RETAIL  DSD,1388444,Apr
2025-04-27,Key Foods 40 St,Invoice,008-05410,Arroz Envasado:Parboiled 5KG Dos Hermanos.,6  11lbs,7.0,46.5,325.5,4198052.59,Branded Rice,Keila Alfaro-Visvikis,RETAIL  DSD,1388445,Apr
2025-04-27,Soriano Brothers PB,Invoice,008-05412,Arroz a Granel:Largo Fino 50 LB -Bolsa Dos Hermanos.,,12.0,27.85,334.2,4198386.79,Bulk Rice,Lisset Limpio -020,CAFETERIA y RESTAURANTS,1388446,Apr
2025-04-27,Soriano Brothers PB,Invoice,008-05412,Arroz a Granel:Parboiled 50 LB -Bolsa Dos Hermanos.,,15.0,26.75,401.25,4198788.04,Bulk Rice,Lisset Limpio -020,CAFETERIA y RESTAURANTS,1388447,Apr
2025-04-27,Soriano Brothers PB,Invoice,008-05412,Spices:AS Sazon (for all),1 / 30 lb (box or pail),2.0,52.0,104.0,4198892.04,American Spice,Lisset Limpio -020,CAFETERIA y RESTAURANTS,1388448,Apr
2025-04-27,Soriano Brothers PB,Invoice,008-05412,Dry Beans:Dry Beans - Black Beans 50,Dry Black Beans 50 lb,2.0,35.0,70.0,4198962.04,Dry Beans,Lisset Limpio -020,CAFETERIA y RESTAURANTS,1388449,Apr
2025-04-28,El Palacio de los jugos / Caribe Tropical,Invoice,008-05413,Arroz a Granel:Parboiled 50 LB -Bolsa Dos Hermanos.,,8.0,26.75,214.0,4199176.04,Bulk Rice,Lisset Limpio -020,Cafeteria,1388450,Apr
2025-04-28,El Palacio de los jugos / Rodriguez Foods,Invoice,008-05414,Arroz a Granel:Parboiled 50 LB -Bolsa Dos Hermanos.,,8.0,26.75,214.0,4199390.04,Bulk Rice,Lisset Limpio -020,Cafeteria,1388451,Apr
2025-04-28,El Palacio de los jugos / J Mena Corp.,Invoice,008-05416,Dry Beans:Dry Beans - Black Beans 50,Dry Black Beans 50 lb,2.0,35.0,70.0,4199460.04,Dry Beans,Lisset Limpio -020,Cafeteria,1388452,Apr
2025-04-28,El Palacio de los jugos / J Mena Corp.,Invoice,008-05416,Arroz a Granel:Parboiled 50 LB -Bolsa Dos Hermanos.,,5.0,26.75,133.75,4199593.79,Bulk Rice,Lisset Limpio -020,Cafeteria,1388453,Apr
2025-04-30,"American Spice Trading Co, Inc.",Invoice,008-05424,Arroz a Granel:Parboiled 50 LB -Bolsa Dos Hermanos.,,1100.0,26.0,28600.0,4228193.79,Bulk Rice,Armando Carpio - 017,WHOLESALER MANUFACTURY,1388454,Apr
2025-04-30,Ideal Food Basket Davie Cafeteria,Invoice,008-05425,Arroz a Granel:Largo Fino 50 LB -Bolsa Dos Hermanos.,,8.0,27.85,222.8,4228416.59,Bulk Rice,Keila Alfaro-Visvikis,CAFETERIA y RESTAURANTS,1388455,Apr
2025-04-30,Sedanos Supermarkets #24,Invoice,008-05426,Arroz a Granel:Parboiled 50 LB -Bolsa Dos Hermanos.,,6.0,28.25,169.5,4228586.09,Bulk Rice,Keila Alfaro-Visvikis,RETAIL SEDANOS,1388456,Apr
2025-04-30,Sedanos Supermarkets #24,Invoice,008-05426,,Discount,,,-3.39,4228582.7,,Keila Alfaro-Visvikis,RETAIL SEDANOS,1388457,Apr
2025-04-30,Los Caringas Latin America  Foods,Invoice,008-05427,Arroz a Granel:Largo Fino 50 LB -Bolsa Dos Hermanos.,,3.0,27.85,83.55,4228666.25,Bulk Rice,Lisset Limpio -020,CAFETERIA y RESTAURANTS,1388458,Apr
2025-04-30,Los Caringas Latin America  Foods,Invoice,008-05427,Arroz a Granel:Parboiled 50 LB -Bolsa Dos Hermanos.,,3.0,28.25,84.75,4228751.0,Bulk Rice,Lisset Limpio -020,CAFETERIA y RESTAURANTS,1388459,Apr
2025-04-30,Sedanos Supermarkets #34,Invoice,008-05428,Arroz a Granel:Parboiled 50 LB -Bolsa Dos Hermanos.,,4.0,28.25,113.0,4228864.0,Bulk Rice,Keila Alfaro-Visvikis,RETAIL SEDANOS,1388460,Apr
2025-04-30,Sedanos Supermarkets #34,Invoice,008-05428,,Discount,,,-1.72,4228862.28,,Keila Alfaro-Visvikis,RETAIL SEDANOS,1388461,Apr
2025-04-30,Sedanos Supermarkets #43,Invoice,008-05429,Arroz a Granel:Parboiled 50 LB -Bolsa Dos Hermanos.,,4.0,28.25,113.0,4228975.28,Bulk Rice,Keila Alfaro-Visvikis,RETAIL SEDANOS,1388462,Apr
2025-04-30,Sedanos Supermarkets #43,Invoice,008-05429,,Discount,,,-2.26,4228973.02,,Keila Alfaro-Visvikis,RETAIL SEDANOS,1388463,Apr
2025-04-30,Sedanos Supermarkets #33,Invoice,008-05430,Arroz a Granel:Parboiled 50 LB -Bolsa Dos Hermanos.,,5.0,28.25,141.25,4229114.27,Bulk Rice,Keila Alfaro-Visvikis,RETAIL SEDANOS,1388464,Apr
2025-04-30,Sedanos Supermarkets #33,Invoice,008-05430,,Discount,,,-2.83,4229111.44,,Keila Alfaro-Visvikis,RETAIL SEDANOS,1388465,Apr
2025-04-30,Sedanos Supermarkets #16,Invoice,008-05431,Arroz a Granel:Parboiled 50 LB -Bolsa Dos Hermanos.,,6.0,28.25,169.5,4229280.94,Bulk Rice,Keila Alfaro-Visvikis,RETAIL SEDANOS,1388466,Apr
2025-04-30,Sedanos Supermarkets #16,Invoice,008-05431,,Discount,,,-3.39,4229277.55,,Keila Alfaro-Visvikis,RETAIL SEDANOS,1388467,Apr
2025-05-01,El Palacio de los jugos / Caribe Tropical,Invoice,008-05432,Arroz a Granel:Parboiled 50 LB -Bolsa Dos Hermanos.,,6.0,26.75,160.5,4229438.05,Bulk Rice,Lisset Limpio -020,Cafeteria,1388468,May
2025-05-01,Hings Chinese,Invoice,008-05433,Arroz a Granel:Parboiled 50 LB -Bolsa Dos Hermanos.,,5.0,28.25,141.25,4229579.3,Bulk Rice,Lisset Limpio -020,CAFETERIA y RESTAURANTS,1388469,May
2025-05-01,El Palacio de los jugos / Rodriguez Foods,Invoice,008-05434,Arroz a Granel:Parboiled 50 LB -Bolsa Dos Hermanos.,,6.0,26.75,160.5,4229739.8,Bulk Rice,Lisset Limpio -020,Cafeteria,1388470,May
2025-05-01,El Palacio de los jugos /  Nanos Latin Foods,Invoice,008-05435,Arroz a Granel:Largo Fino 50 LB -Bolsa Dos Hermanos.,,6.0,27.85,167.1,4229906.9,Bulk Rice,Lisset Limpio -020,Cafeteria,1388471,May
2025-05-01,El Palacio de los jugos /  Nanos Latin Foods,Invoice,008-05435,Arroz a Granel:Parboiled 50 LB -Bolsa Dos Hermanos.,,10.0,26.75,267.5,4230174.4,Bulk Rice,Lisset Limpio -020,Cafeteria,1388472,May
2025-05-01,Price Choice Food Market # 6,Invoice,008-05436,Arroz Envasado:Parboiled 5KG Dos Hermanos.,6  11lbs,5.0,46.5,232.5,4230406.9,Branded Rice,Lisset Limpio -020,RETAIL  DSD,1388473,May
2025-05-01,Price Choice Food Market # 6,Invoice,008-05436,Arroz Envasado:Parboiled 5KG Dos Hermanos.,6  11lbs,5.0,46.5,232.5,4230639.4,Branded Rice,Lisset Limpio -020,RETAIL  DSD,1388474,May
2025-05-01,El Palacio de Los Jugos / Casa mía Food Restaurant inc,Invoice,008-05437,Dry Beans:Dry Beans - Black Beans 50,Dry Black Beans 50 lb,1.0,35.0,35.0,4230674.4,Dry Beans,Lisset Limpio -020,Cafeteria,1388475,May
2025-05-01,El Palacio de Los Jugos / Casa mía Food Restaurant inc,Invoice,008-05437,Arroz a Granel:Parboiled 50 LB -Bolsa Dos Hermanos.,,12.0,26.75,321.0,4230995.4,Bulk Rice,Lisset Limpio -020,Cafeteria,1388476,May
2025-05-01,Sedanos Supermarkets #18,Invoice,008-05438,Arroz Envasado:Largo Fino 1kg (Long grain rice) Dos Hermanos,,2.0,17.5,35.0,4231030.4,Branded Rice,Keila Alfaro-Visvikis,RETAIL SEDANOS,1388477,May
2025-05-01,Sedanos Supermarkets #32,Invoice,008-05439,Arroz Envasado:Largo Fino 1kg (Long grain rice) Dos Hermanos,,1.0,17.5,17.5,4231047.9,Branded Rice,Keila Alfaro-Visvikis,RETAIL SEDANOS,1388478,May
2025-05-01,Sedanos Supermarkets #32,Invoice,008-05439,,Discount,,,-0.35,4231047.55,,Keila Alfaro-Visvikis,RETAIL SEDANOS,1388479,May
2025-05-01,Sedanos Supermarkets #32,Invoice,008-05440,Arroz a Granel:Largo Fino 50 LB -Bolsa Dos Hermanos.,,2.0,27.85,55.7,4231103.25,Bulk Rice,Keila Alfaro-Visvikis,RETAIL SEDANOS,1388480,May
2025-05-01,Sedanos Supermarkets #32,Invoice,008-05440,Arroz a Granel:Parboiled 50 LB -Bolsa Dos Hermanos.,,2.0,28.25,56.5,4231159.75,Bulk Rice,Keila Alfaro-Visvikis,RETAIL SEDANOS,1388481,May
2025-05-01,Sedanos Supermarkets #32,Invoice,008-05440,,Discount,,,-2.24,4231157.51,,Keila Alfaro-Visvikis,RETAIL SEDANOS,1388482,May
2025-05-01,Pacifico Chinese Restaurant,Invoice,008-05441,Arroz a Granel:Parboiled 50 LB -Bolsa Dos Hermanos.,,10.0,28.25,282.5,4231440.01,Bulk Rice,Lisset Limpio -020,CAFETERIA y RESTAURANTS,1388483,May
2025-05-01,Be Your Will LLC,Invoice,008-05442,Arroz a Granel:Largo Fino 50 LB -Bolsa Dos Hermanos.,,6.0,27.85,167.1,4231607.11,Bulk Rice,Lisset Limpio -020,CAFETERIA y RESTAURANTS,1388484,May
2025-05-01,Be Your Will LLC,Invoice,008-05442,Arroz a Granel:Parboiled 50 LB -Bolsa Dos Hermanos.,,6.0,26.75,160.5,4231767.61,Bulk Rice,Lisset Limpio -020,CAFETERIA y RESTAURANTS,1388485,May
2025-05-01,Be Your Will LLC,Invoice,008-05442,Liquids:AS Cooking Wine,4 1 Gl.,2.0,17.5,35.0,4231802.61,American Spice,Lisset Limpio -020,CAFETERIA y RESTAURANTS,1388486,May
2025-05-01,El Palacio de los jugos / Delicias Criollas (DIAGO FOOD_MILLER),Invoice,008-05443,Arroz a Granel:Parboiled 50 LB -Bolsa Dos Hermanos.,,12.0,26.75,321.0,4232123.61,Bulk Rice,Lisset Limpio -020,Cafeteria,1388487,May
2025-05-01,El Palacio de los jugos / Delicias Criollas (DIAGO FOOD_MILLER),Invoice,008-05443,Liquids:AS Cooking Wine,4 1 Gl.,1.0,17.5,17.5,4232141.11,American Spice,Lisset Limpio -020,Cafeteria,1388488,May
2025-05-01,El Palacio de los jugos / Leti Corp.,Invoice,008-05444,Arroz a Granel:Largo Fino 50 LB -Bolsa Dos Hermanos.,,6.0,27.85,167.1,4232308.21,Bulk Rice,Lisset Limpio -020,Cafeteria,1388489,May
2025-05-01,El Palacio de los jugos / Leti Corp.,Invoice,008-05444,Arroz a Granel:Parboiled 50 LB -Bolsa Dos Hermanos.,,6.0,26.75,160.5,4232468.71,Bulk Rice,Lisset Limpio -020,Cafeteria,1388490,May
2025-05-04,El Palacio de los jugos / Rodriguez Foods,Invoice,008-05445,Arroz a Granel:Parboiled 50 LB -Bolsa Dos Hermanos.,,6.0,26.75,160.5,4232629.21,Bulk Rice,Lisset Limpio -020,Cafeteria,1388491,May
2025-05-04,Bravo   Francisco Diaz,Invoice,008-05446,Liquids:AS Cooking Wine,4 1 Gl.,3.0,17.5,52.5,4232681.71,American Spice,Lisset Limpio -020,RETAIL  DSD,1388492,May
2025-05-04,Bravo   Francisco Diaz,Invoice,008-05446,Arroz a Granel:Largo Fino 50 LB -Bolsa Dos Hermanos.,,5.0,27.85,139.25,4232820.96,Bulk Rice,Lisset Limpio -020,RETAIL  DSD,1388493,May
2025-05-04,Fritanga Momotombo,Invoice,008-05447,Dry Beans:Dry Beans - Small Red Beans 50 lbs.,Small Red Beans 50 lbs,2.0,42.0,84.0,4232904.96,Dry Beans,Lisset Limpio -020,CAFETERIA y RESTAURANTS,1388494,May
2025-05-04,Fritanga Momotombo,Invoice,008-05447,Arroz a Granel:Largo Fino 50 LB -Bolsa Dos Hermanos.,,5.0,27.85,139.25,4233044.21,Bulk Rice,Lisset Limpio -020,CAFETERIA y RESTAURANTS,1388495,May
2025-05-04,El Palacio de los jugos /  Mires Restaurants,Invoice,008-05448,Liquids:AS Marinating Sauce (Mojo),,1.0,18.5,18.5,4233062.71,American Spice,Lisset Limpio -020,Cafeteria,1388496,May
2025-05-04,El Palacio de los jugos /  Mires Restaurants,Invoice,008-05448,Arroz a Granel:Parboiled 50 LB -Bolsa Dos Hermanos.,,12.0,26.75,321.0,4233383.71,Bulk Rice,Lisset Limpio -020,Cafeteria,1388497,May
2025-05-04,El Palacio de los jugos /  Nanos Latin Foods,Invoice,008-05449,Arroz a Granel:Largo Fino 50 LB -Bolsa Dos Hermanos.,,6.0,27.85,167.1,4233550.81,Bulk Rice,Lisset Limpio -020,Cafeteria,1388498,May
2025-05-04,El Palacio de los jugos /  Nanos Latin Foods,Invoice,008-05449,Arroz a Granel:Parboiled 50 LB -Bolsa Dos Hermanos.,,15.0,26.75,401.25,4233952.06,Bulk Rice,Lisset Limpio -020,Cafeteria,1388499,May
2025-05-04,El Palacio de Los Jugos / Casa mía Food Restaurant inc,Invoice,008-05450,Arroz a Granel:Parboiled 50 LB -Bolsa Dos Hermanos.,,12.0,26.75,321.0,4234273.06,Bulk Rice,Lisset Limpio -020,Cafeteria,1388500,May
2025-05-04,El Palacio de Los Jugos / Casa mía Food Restaurant inc,Invoice,008-05450,Dry Beans:Dry Beans - Black Beans 50,Dry Black Beans 50 lb,1.0,35.0,35.0,4234308.06,Dry Beans,Lisset Limpio -020,Cafeteria,1388501,May
2025-05-04,ALS Foods,Invoice,008-05451,Liquids:AS Cooking Wine,4 1 Gl.,2.0,17.5,35.0,4234343.06,American Spice,Lisset Limpio -020,CAFETERIA y RESTAURANTS,1388502,May
2025-05-04,ALS Foods,Invoice,008-05451,Arroz a Granel:Largo Fino 50 LB -Bolsa Dos Hermanos.,,2.0,27.85,55.7,4234398.76,Bulk Rice,Lisset Limpio -020,CAFETERIA y RESTAURANTS,1388503,May
2025-05-04,ALS Foods,Invoice,008-05451,Arroz a Granel:Parboiled 50 LB -Bolsa Dos Hermanos.,,11.0,26.75,294.25,4234693.01,Bulk Rice,Lisset Limpio -020,CAFETERIA y RESTAURANTS,1388504,May
2025-05-04,El Palacio de los jugos / Caribe Tropical,Invoice,008-05452,Arroz a Granel:Parboiled 50 LB -Bolsa Dos Hermanos.,,8.0,26.75,214.0,4234907.01,Bulk Rice,Lisset Limpio -020,Cafeteria,1388505,May
2025-05-04,El Palacio de los jugos / Caribe Tropical,Invoice,008-05452,Dry Beans:Dry Beans - Black Beans 50,Dry Black Beans 50 lb,5.0,35.0,175.0,4235082.01,Dry Beans,Lisset Limpio -020,Cafeteria,1388506,May
2025-05-04,El Palacio de los jugos / Caribe Tropical,Invoice,008-05452,Dry Beans:Dry Beans - Small Red Beans 50 lbs.,Small Red Beans 50 lbs,3.0,42.0,126.0,4235208.01,Dry Beans,Lisset Limpio -020,Cafeteria,1388507,May
2025-05-04,El Palacio de los jugos / Lita Foods Inc.,Invoice,008-05453,Dry Beans:Dry Beans - Black Beans 50,Dry Black Beans 50 lb,1.0,35.0,35.0,4235243.01,Dry Beans,Lisset Limpio -020,Cafeteria,1388508,May
2025-05-04,El Palacio de los jugos / Lita Foods Inc.,Invoice,008-05453,Arroz a Granel:Parboiled 50 LB -Bolsa Dos Hermanos.,,12.0,26.75,321.0,4235564.01,Bulk Rice,Lisset Limpio -020,Cafeteria,1388509,May
2025-05-04,JMN Dely Corp,Invoice,008-05454,Dry Beans:Dry Beans - Small Red Beans 50 lbs.,Small Red Beans 50 lbs,1.0,45.7,45.7,4235609.71,Dry Beans,Keila Alfaro-Visvikis,CAFETERIA y RESTAURANTS,1388510,May
2025-05-04,JMN Dely Corp,Invoice,008-05454,Arroz a Granel:Largo Fino 50 LB -Bolsa Dos Hermanos.,,1.0,27.85,27.85,4235637.56,Bulk Rice,Keila Alfaro-Visvikis,CAFETERIA y RESTAURANTS,1388511,May
2025-05-04,JMN Dely Corp,Invoice,008-05454,Arroz a Granel:Parboiled 50 LB -Bolsa Dos Hermanos.,,1.0,28.25,28.25,4235665.81,Bulk Rice,Keila Alfaro-Visvikis,CAFETERIA y RESTAURANTS,1388512,May
2025-05-04,Aries Supermarket & Cafeteria,Invoice,008-05455,Arroz a Granel:Parboiled 50 LB -Bolsa Dos Hermanos.,,10.0,28.25,282.5,4235948.31,Bulk Rice,Keila Alfaro-Visvikis,CAFETERIA y RESTAURANTS,1388513,May
2025-05-04,Aries Supermarket & Cafeteria,Invoice,008-05455,Dry Beans:Dry Beans - Black Beans 50,Dry Black Beans 50 lb,10.0,36.5,365.0,4236313.31,Dry Beans,Keila Alfaro-Visvikis,CAFETERIA y RESTAURANTS,1388514,May
2025-05-04,Aries Supermarket & Cafeteria,Invoice,008-05455,Spices:AS Chicken Base,1 / 30 lb. (box or pail),2.0,39.0,78.0,4236391.31,American Spice,Keila Alfaro-Visvikis,CAFETERIA y RESTAURANTS,1388515,May
2025-05-04,Aries Supermarket & Cafeteria,Invoice,008-05455,Spices:AS Oregano Ground,4 / 3.5 Lbs.,2.0,37.5,75.0,4236466.31,American Spice,Keila Alfaro-Visvikis,CAFETERIA y RESTAURANTS,1388516,May
2025-05-04,Aries Supermarket & Cafeteria,Invoice,008-05455,Spices:AS Whole Bay Leaves,4/12 OZ,1.0,25.3,25.3,4236491.61,American Spice,Keila Alfaro-Visvikis,CAFETERIA y RESTAURANTS,1388517,May
2025-05-04,Food-Star Supermarket,Invoice,008-05456,Arroz Envasado:Parboiled 5KG Dos Hermanos.,6  11lbs,10.0,46.5,465.0,4236956.61,Branded Rice,Lisset Limpio -020,RETAIL  DSD,1388518,May
2025-05-04,Food-Star Supermarket,Invoice,008-05456,Arroz Envasado:Parboiled 5KG Dos Hermanos.,6  11lbs,10.0,46.5,465.0,4237421.61,Branded Rice,Lisset Limpio -020,RETAIL  DSD,1388519,May
2025-05-04,"Meat Club Market, LLC.",Invoice,008-05457,Arroz Envasado:Largo Fino 1kg (Long grain rice) Dos Hermanos,,1.0,18.0,18.0,4237439.61,Branded Rice,Lisset Limpio -020,RETAIL  DSD,1388520,May
2025-05-04,"Meat Club Market, LLC.",Invoice,008-05457,Arroz Envasado:Parboiled 1kg Bolsa Dos Hermanos.,.,1.0,19.9,19.9,4237459.51,Branded Rice,Lisset Limpio -020,RETAIL  DSD,1388521,May
2025-05-04,"Meat Club Market, LLC.",Invoice,008-05457,Arroz Envasado:Sushi Rice Dos Hermanos.,.,2.0,25.5,51.0,4237510.51,Branded Rice,Lisset Limpio -020,RETAIL  DSD,1388522,May
2025-05-04,"Meat Club Market, LLC.",Invoice,008-05457,Arroz Envasado:Sushi Rice Dos Hermanos 5kg.,,2.0,60.0,120.0,4237630.51,Branded Rice,Lisset Limpio -020,RETAIL  DSD,1388523,May
2025-05-04,Sedanos Supermarkets #31,Invoice,008-05458,Spices:AS Chicken Base,1 / 30 lb. (box or pail),1.0,39.0,39.0,4237669.51,American Spice,Keila Alfaro-Visvikis,RETAIL SEDANOS,1388524,May
2025-05-04,Sedanos Supermarkets #31,Invoice,008-05458,Arroz a Granel:Parboiled 50 LB -Bolsa Dos Hermanos.,,7.0,28.25,197.75,4237867.26,Bulk Rice,Keila Alfaro-Visvikis,RETAIL SEDANOS,1388525,May
2025-05-04,Sedanos Supermarkets #31,Invoice,008-05458,,Discount,,,-4.74,4237862.52,,Keila Alfaro-Visvikis,RETAIL SEDANOS,1388526,May
2025-05-05,Food-Star Supermarket,Credit Memo,008-05479,Varios:Promotional Allowance,Arroz Envasado:Parboiled 5KG Dos Hermanos.,-10.0,46.5,-465.0,4237397.52,Branded Rice,Lisset Limpio -020,RETAIL  DSD,1388527,May
2025-05-06,Key Foods - 10301 Royal Palm Food Corp.,Invoice,008-05459,Arroz Envasado:Parboiled 1kg Bolsa Dos Hermanos.,.,50.0,19.9,995.0,4238392.52,Branded Rice,Keila Alfaro-Visvikis,RETAIL KEY FOOD,1388528,May
2025-05-06,Key Foods - 10301 Royal Palm Food Corp.,Invoice,008-05459,Varios:Promotional Allowance,,50.0,-6.0,-300.0,4238092.52,Branded Rice,Keila Alfaro-Visvikis,RETAIL KEY FOOD,1388529,May
2025-05-06,Soriano Brothers PB,Invoice,008-05460,Spices:AS Sazon (for all),1 / 30 lb (box or pail),1.0,52.0,52.0,4238144.52,American Spice,Lisset Limpio -020,CAFETERIA y RESTAURANTS,1388530,May
2025-05-06,Soriano Brothers PB,Invoice,008-05460,Arroz a Granel:Largo Fino 50 LB -Bolsa Dos Hermanos.,,12.0,27.85,334.2,4238478.72,Bulk Rice,Lisset Limpio -020,CAFETERIA y RESTAURANTS,1388531,May
2025-05-06,Soriano Brothers PB,Invoice,008-05460,Arroz a Granel:Parboiled 50 LB -Bolsa Dos Hermanos.,,15.0,26.75,401.25,4238879.97,Bulk Rice,Lisset Limpio -020,CAFETERIA y RESTAURANTS,1388532,May
2025-05-06,Soriano Brothers PB,Invoice,008-05460,Dry Beans:Dry Beans - Black Beans 50,Dry Black Beans 50 lb,4.0,34.0,136.0,4239015.97,Dry Beans,Lisset Limpio -020,CAFETERIA y RESTAURANTS,1388533,May
2025-05-06,Soriano Brothers PB,Invoice,008-05460,Dry Beans:Dry Beans - Small Red Beans 50 lbs.,Small Red Beans 50 lbs,2.0,41.0,82.0,4239097.97,Dry Beans,Lisset Limpio -020,CAFETERIA y RESTAURANTS,1388534,May
2025-05-06,"Soriano Brothers Diaz Food Service,Inc",Invoice,008-05461,Arroz a Granel:Parboiled 50 LB -Bolsa Dos Hermanos.,,40.0,26.75,1070.0,4240167.97,Bulk Rice,Lisset Limpio -020,CAFETERIA y RESTAURANTS,1388535,May
2025-05-06,"Soriano Brothers Diaz Food Service,Inc",Invoice,008-05461,Dry Beans:Dry Beans - Black Beans 50,Dry Black Beans 50 lb,6.0,35.0,210.0,4240377.97,Dry Beans,Lisset Limpio -020,CAFETERIA y RESTAURANTS,1388536,May
2025-05-06,Bravo   Francisco Diaz,Invoice,008-05462,Liquids:AS Cooking Wine,4 1 Gl.,0.0,,0.0,4240377.97,American Spice,Lisset Limpio -020,RETAIL  DSD,1388537,May
2025-05-06,Bravo   Francisco Diaz,Invoice,008-05462,Spices:AS Chicken Base,1 / 30 lb. (box or pail),0.0,,0.0,4240377.97,American Spice,Lisset Limpio -020,RETAIL  DSD,1388538,May
2025-05-06,Bravo   Francisco Diaz,Invoice,008-05462,Liquids:AS Marinating Sauce (Mojo),,0.0,,0.0,4240377.97,American Spice,Lisset Limpio -020,RETAIL  DSD,1388539,May
2025-05-06,Los Mejores Tamales de Miami,Invoice,008-05463,Arroz a Granel:Parboiled 50 LB -Bolsa Dos Hermanos.,,6.0,28.25,169.5,4240547.47,Bulk Rice,Lisset Limpio -020,CAFETERIA y RESTAURANTS,1388540,May
2025-05-07,Bake Mark USA LLC,Invoice,008-05464,Arroz a Granel:Parboiled 50 LB -Bolsa Dos Hermanos.,White,1100.0,24.15,26565.0,4267112.47,Bulk Rice,Armando Carpio - 017,WHOLESALER MANUFACTURY,1388541,May
2025-05-07,Bake Mark USA LLC,Credit Memo,008-05465,Arroz a Granel:Parboiled 50 LB -Bolsa Dos Hermanos.,,-755.0,24.15,-18233.25,4248879.22,Bulk Rice,Armando Carpio - 017,WHOLESALER MANUFACTURY,1388542,May
2025-05-07,Sedanos Supermarkets #26,Invoice,008-05466,Arroz a Granel:Parboiled 50 LB -Bolsa Dos Hermanos.,,5.0,28.25,141.25,4249020.47,Bulk Rice,Keila Alfaro-Visvikis,RETAIL SEDANOS,1388543,May
2025-05-07,Sedanos Supermarkets #26,Invoice,008-05466,,Discount,,,-2.83,4249017.64,,Keila Alfaro-Visvikis,RETAIL SEDANOS,1388544,May
2025-05-07,Sedanos Supermarkets #28,Invoice,008-05467,Arroz Envasado:Parboiled 5KG Dos Hermanos.,6  11lbs,15.0,40.5,607.5,4249625.14,Branded Rice,Keila Alfaro-Visvikis,RETAIL SEDANOS,1388545,May
2025-05-07,Sedanos Supermarkets #28,Invoice,008-05467,Arroz Envasado:Parboiled 5KG Dos Hermanos.,6  11lbs,3.0,40.5,121.5,4249746.64,Branded Rice,Keila Alfaro-Visvikis,RETAIL SEDANOS,1388546,May
2025-05-07,Sedanos Supermarkets #28,Invoice,008-05467,,Discount,,,-12.15,4249734.49,,Keila Alfaro-Visvikis,RETAIL SEDANOS,1388547,May
2025-05-07,Sedanos Supermarkets #16,Invoice,008-05468,Arroz a Granel:Parboiled 50 LB -Bolsa Dos Hermanos.,,6.0,28.25,169.5,4249903.99,Bulk Rice,Keila Alfaro-Visvikis,RETAIL SEDANOS,1388548,May
2025-05-07,Sedanos Supermarkets #16,Invoice,008-05468,,Discount,,,-3.39,4249900.6,,Keila Alfaro-Visvikis,RETAIL SEDANOS,1388549,May
2025-05-07,Sedanos Supermarkets #24,Invoice,008-05469,Arroz a Granel:Parboiled 50 LB -Bolsa Dos Hermanos.,,8.0,28.25,226.0,4250126.6,Bulk Rice,Keila Alfaro-Visvikis,RETAIL SEDANOS,1388550,May
2025-05-07,Sedanos Supermarkets #24,Invoice,008-05469,,Discount,,,-4.52,4250122.08,,Keila Alfaro-Visvikis,RETAIL SEDANOS,1388551,May
2025-05-07,Sedanos Supermarkets #27,Invoice,008-05470,Arroz a Granel:Parboiled 50 LB -Bolsa Dos Hermanos.,,6.0,28.25,169.5,4250291.58,Bulk Rice,Keila Alfaro-Visvikis,RETAIL SEDANOS,1388552,May
2025-05-07,Sedanos Supermarkets #27,Invoice,008-05470,,Discount,,,-3.39,4250288.19,,Keila Alfaro-Visvikis,RETAIL SEDANOS,1388553,May
2025-05-07,Ideal Food Basket Davie Cafeteria,Invoice,008-05471,Arroz a Granel:Largo Fino 50 LB -Bolsa Dos Hermanos.,,10.0,27.85,278.5,4250566.69,Bulk Rice,Keila Alfaro-Visvikis,CAFETERIA y RESTAURANTS,1388554,May
2025-05-07,Festival Supermarket,Invoice,008-05472,Arroz Envasado:Parboiled 5KG Dos Hermanos.,6  11lbs,41.0,46.5,1906.5,4252473.19,Branded Rice,Keila Alfaro-Visvikis,RETAIL  DSD,1388555,May
2025-05-07,Festival Supermarket,Invoice,008-05472,Arroz Envasado:Parboiled 5KG Dos Hermanos.,6  11lbs,41.0,46.5,1906.5,4254379.69,Branded Rice,Keila Alfaro-Visvikis,RETAIL  DSD,1388556,May
2025-05-07,Festival Supermarket #35- Southgate,Invoice,008-05473,Arroz Envasado:Parboiled 5KG Dos Hermanos.,6  11lbs,20.0,46.5,930.0,4255309.69,Branded Rice,Keila Alfaro-Visvikis,RETAIL  DSD,1388557,May
2025-05-07,Festival Supermarket #35- Southgate,Invoice,008-05473,Arroz Envasado:Parboiled 5KG Dos Hermanos.,6  11lbs,20.0,46.5,930.0,4256239.69,Branded Rice,Keila Alfaro-Visvikis,RETAIL  DSD,1388558,May
2025-05-07,Festival Supermarket Margate,Invoice,008-05474,Arroz Envasado:Parboiled 5KG Dos Hermanos.,6  11lbs,10.0,46.5,465.0,4256704.69,Branded Rice,Keila Alfaro-Visvikis,RETAIL  DSD,1388559,May
2025-05-07,Festival Supermarket Margate,Invoice,008-05474,Arroz Envasado:Parboiled 5KG Dos Hermanos.,6  11lbs,10.0,46.5,465.0,4257169.69,Branded Rice,Keila Alfaro-Visvikis,RETAIL  DSD,1388560,May
2025-05-07,Sedanos Supermarkets #34,Credit Memo,008-05475,Varios:Producto vencido/deteriorado (no impacta en inventario),18 snack pizz ay salame,-18.0,1.49,-26.82,4257142.87,Puffed Products,Keila Alfaro-Visvikis,RETAIL SEDANOS,1388561,May
2025-05-07,Sedanos Supermarkets #34,Invoice,008-05476,Arroz Envasado:Parboiled 5KG Dos Hermanos.,6  11lbs,15.0,40.5,607.5,4257750.37,Branded Rice,Keila Alfaro-Visvikis,RETAIL SEDANOS,1388562,May
2025-05-07,Sedanos Supermarkets #34,Invoice,008-05476,Arroz Envasado:Parboiled 5KG Dos Hermanos.,6  11lbs,3.0,40.5,121.5,4257871.87,Branded Rice,Keila Alfaro-Visvikis,RETAIL SEDANOS,1388563,May
2025-05-07,Sedanos Supermarkets #34,Invoice,008-05476,,Discount,,,-12.15,4257859.72,,Keila Alfaro-Visvikis,RETAIL SEDANOS,1388564,May
2025-05-07,Arias Supermarket,Invoice,008-05477,Spices:AS Oregano Ground,4 / 3.5 Lbs.,2.0,37.5,75.0,4257934.72,American Spice,Keila Alfaro-Visvikis,CAFETERIA y RESTAURANTS,1388565,May
2025-05-07,Arias Supermarket,Invoice,008-05477,Liquids:AS Cooking Wine,4 1 Gl.,1.0,17.5,17.5,4257952.22,American Spice,Keila Alfaro-Visvikis,CAFETERIA y RESTAURANTS,1388566,May
2025-05-08,Price Choice Food Market # 6,Credit Memo,008-05478,Varios:Promotional Allowance,Arroz Envasado:Parboiled 5KG Dos Hermanos.,-5.0,46.5,-232.5,4257719.72,Branded Rice,Lisset Limpio -020,RETAIL  DSD,1388567,May
2025-05-08,Bravo   Francisco Diaz,Invoice,008-05480,Arroz a Granel:Largo Fino 50 LB -Bolsa Dos Hermanos.,,5.0,27.85,139.25,4257858.97,Bulk Rice,Lisset Limpio -020,RETAIL  DSD,1388568,May
2025-05-08,Bravo   Francisco Diaz,Invoice,008-05480,Liquids:AS Cooking Wine,4 1 Gl.,3.0,17.5,52.5,4257911.47,American Spice,Lisset Limpio -020,RETAIL  DSD,1388569,May
2025-05-08,Bravo   Francisco Diaz,Invoice,008-05480,Spices:AS Chicken Base,1 / 30 lb. (box or pail),1.0,39.0,39.0,4257950.47,American Spice,Lisset Limpio -020,RETAIL  DSD,1388570,May
2025-05-08,Bravo   Francisco Diaz,Invoice,008-05480,Liquids:AS Marinating Sauce (Mojo),,1.0,18.5,18.5,4257968.97,American Spice,Lisset Limpio -020,RETAIL  DSD,1388571,May
2025-05-08,El Palacio de los jugos / Leti Corp.,Invoice,008-05481,Arroz a Granel:Largo Fino 50 LB -Bolsa Dos Hermanos.,,3.0,27.85,83.55,4258052.52,Bulk Rice,Lisset Limpio -020,Cafeteria,1388572,May
2025-05-08,El Palacio de los jugos / Leti Corp.,Invoice,008-05481,Arroz a Granel:Parboiled 50 LB -Bolsa Dos Hermanos.,,6.0,26.75,160.5,4258213.02,Bulk Rice,Lisset Limpio -020,Cafeteria,1388573,May
2025-05-08,El Palacio de los jugos / La sabrosa salsa cubana Corp,Invoice,008-05482,Arroz a Granel:Largo Fino 50 LB -Bolsa Dos Hermanos.,,5.0,27.85,139.25,4258352.27,Bulk Rice,Lisset Limpio -020,Cafeteria,1388574,May
2025-05-08,Sedanos Supermarkets #32,Invoice,008-05483,Arroz a Granel:Parboiled 50 LB -Bolsa Dos Hermanos.,,3.0,28.25,84.75,4258437.02,Bulk Rice,Keila Alfaro-Visvikis,RETAIL SEDANOS,1388575,May
2025-05-08,Sedanos Supermarkets #32,Invoice,008-05483,Arroz a Granel:Largo Fino 50 LB -Bolsa Dos Hermanos.,,3.0,27.85,83.55,4258520.57,Bulk Rice,Keila Alfaro-Visvikis,RETAIL SEDANOS,1388576,May
2025-05-08,Sedanos Supermarkets #32,Invoice,008-05483,,Discount,,,-3.37,4258517.2,,Keila Alfaro-Visvikis,RETAIL SEDANOS,1388577,May
2025-05-08,El Palacio de los jugos / Caribe Tropical,Invoice,008-05484,Arroz a Granel:Parboiled 50 LB -Bolsa Dos Hermanos.,,10.0,26.75,267.5,4258784.7,Bulk Rice,Lisset Limpio -020,Cafeteria,1388578,May
2025-05-08,El Palacio de los jugos / Caribe Tropical,Invoice,008-05484,Dry Beans:Dry Beans - Black Beans 50,Dry Black Beans 50 lb,2.0,35.0,70.0,4258854.7,Dry Beans,Lisset Limpio -020,Cafeteria,1388579,May
2025-05-08,Be Your Will LLC,Invoice,008-05485,Liquids:AS Cooking Wine,4 1 Gl.,2.0,17.5,35.0,4258889.7,American Spice,Lisset Limpio -020,CAFETERIA y RESTAURANTS,1388580,May
2025-05-08,Be Your Will LLC,Invoice,008-05485,Arroz a Granel:Largo Fino 50 LB -Bolsa Dos Hermanos.,,6.0,27.85,167.1,4259056.8,Bulk Rice,Lisset Limpio -020,CAFETERIA y RESTAURANTS,1388581,May
2025-05-08,Be Your Will LLC,Invoice,008-05485,Arroz a Granel:Parboiled 50 LB -Bolsa Dos Hermanos.,,6.0,26.75,160.5,4259217.3,Bulk Rice,Lisset Limpio -020,CAFETERIA y RESTAURANTS,1388582,May
2025-05-08,El Palacio de los jugos / Rodriguez Foods,Invoice,008-05486,Arroz a Granel:Parboiled 50 LB -Bolsa Dos Hermanos.,,15.0,26.75,401.25,4259618.55,Bulk Rice,Lisset Limpio -020,Cafeteria,1388583,May
2025-05-08,Sedanos Supermarkets #18,Invoice,008-05487,Arroz a Granel:Parboiled 50 LB -Bolsa Dos Hermanos.,,10.0,28.25,282.5,4259901.05,Bulk Rice,Keila Alfaro-Visvikis,RETAIL SEDANOS,1388584,May
2025-05-08,Sedanos Supermarkets #18,Invoice,008-05487,,Discount,,,-5.65,4259895.4,,Keila Alfaro-Visvikis,RETAIL SEDANOS,1388585,May
2025-05-08,Sedanos Supermarkets #33,Invoice,008-05488,Arroz a Granel:Parboiled 50 LB -Bolsa Dos Hermanos.,,4.0,28.25,113.0,4260008.4,Bulk Rice,Keila Alfaro-Visvikis,RETAIL SEDANOS,1388586,May
2025-05-08,Sedanos Supermarkets #33,Invoice,008-05488,,Discount,,,-2.26,4260006.14,,Keila Alfaro-Visvikis,RETAIL SEDANOS,1388587,May
2025-05-08,Rey Chavez Distributor #2,Invoice,008-05489,Arroz a Granel:Parboiled 50 LB -Bolsa Dos Hermanos.,,20.0,27.5,550.0,4260556.14,Bulk Rice,Lisset Limpio -020,WHOLESALER,1388588,May
2025-05-08,Rey Chavez Distributor #2,Invoice,008-05490,Arroz a Granel:Parboiled 50 LB -Bolsa Dos Hermanos.,,0.0,,0.0,4260556.14,Bulk Rice,Lisset Limpio -020,WHOLESALER,1388589,May
2025-05-08,Sedanos Supermarkets  #37,Invoice,008-05491,Arroz a Granel:Parboiled 50 LB -Bolsa Dos Hermanos.,,5.0,28.25,141.25,4260697.39,Bulk Rice,Keila Alfaro-Visvikis,RETAIL SEDANOS,1388590,May
2025-05-08,Sedanos Supermarkets  #37,Invoice,008-05491,,Discount,,,-2.62,4260694.77,,Keila Alfaro-Visvikis,RETAIL SEDANOS,1388591,May
2025-05-08,Panda Depot,Credit Memo,008-05492,Varios:Producto vencido/deteriorado (no impacta en inventario),,-2.0,25.0,-50.0,4260644.77,Bulk Rice,Lisset Limpio -020,WHOLESALER,1388592,May
2025-05-08,Sedanos Supermarkets  #37,Credit Memo,008-05493,Varios:Producto vencido/deteriorado (no impacta en inventario),7 unidades Ham @ $1.49,-7.0,1.49,-10.43,4260634.34,Puffed Products,Keila Alfaro-Visvikis,RETAIL SEDANOS,1388593,May
2025-05-08,El Palacio de los jugos /  Nanos Latin Foods,Invoice,008-05494,Dry Beans:Dry Beans - Black Beans 50,Dry Black Beans 50 lb,1.0,35.0,35.0,4260669.34,Dry Beans,Lisset Limpio -020,Cafeteria,1388594,May
2025-05-08,El Palacio de los jugos /  Nanos Latin Foods,Invoice,008-05494,Arroz a Granel:Largo Fino 50 LB -Bolsa Dos Hermanos.,,5.0,27.85,139.25,4260808.59,Bulk Rice,Lisset Limpio -020,Cafeteria,1388595,May
2025-05-08,El Palacio de los jugos / Delicias Criollas (DIAGO FOOD_MILLER),Invoice,008-05495,Liquids:AS Lemon Juice 4/1 Gl,,1.0,14.95,14.95,4260823.54,American Spice,Lisset Limpio -020,Cafeteria,1388596,May
2025-05-08,El Palacio de los jugos / Delicias Criollas (DIAGO FOOD_MILLER),Invoice,008-05495,Arroz a Granel:Largo Fino 50 LB -Bolsa Dos Hermanos.,,7.0,27.85,194.95,4261018.49,Bulk Rice,Lisset Limpio -020,Cafeteria,1388597,May
2025-05-08,El Palacio de los jugos / Delicias Criollas (DIAGO FOOD_MILLER),Invoice,008-05495,Arroz a Granel:Parboiled 50 LB -Bolsa Dos Hermanos.,,12.0,26.75,321.0,4261339.49,Bulk Rice,Lisset Limpio -020,Cafeteria,1388598,May
2025-05-08,Soriano Brothers PB,Invoice,008-05496,Spices:AS Sazon (for all),1 / 30 lb (box or pail),3.0,52.0,156.0,4261495.49,American Spice,Lisset Limpio -020,CAFETERIA y RESTAURANTS,1388599,May
2025-05-08,El Gallego Supermarket,Invoice,008-05497,Liquids:AS Bitter Orange,,2.0,14.0,28.0,4261523.49,American Spice,Lisset Limpio -020,RETAIL  DSD,1388600,May
2025-05-08,El Gallego Supermarket,Invoice,008-05497,Liquids:AS Marinating Sauce (Mojo),,1.0,18.5,18.5,4261541.99,American Spice,Lisset Limpio -020,RETAIL  DSD,1388601,May
2025-05-08,El Gallego Supermarket,Invoice,008-05497,Liquids:AS Cooking Wine,4 1 Gl.,1.0,17.5,17.5,4261559.49,American Spice,Lisset Limpio -020,RETAIL  DSD,1388602,May
2025-05-08,El Gallego Supermarket,Invoice,008-05497,Arroz a Granel:Parboiled 50 LB -Bolsa Dos Hermanos.,,4.0,28.25,113.0,4261672.49,Bulk Rice,Lisset Limpio -020,RETAIL  DSD,1388603,May
2025-05-08,El Gallego Supermarket,Invoice,008-05497,Dry Beans:Dry Beans - Small Red Beans 50 lbs.,Small Red Beans 50 lbs,1.0,42.0,42.0,4261714.49,Dry Beans,Lisset Limpio -020,RETAIL  DSD,1388604,May
2025-05-08,El Gallego Supermarket,Invoice,008-05497,Dry Beans:Dry Beans - Black Beans 50,Dry Black Beans 50 lb,2.0,35.0,70.0,4261784.49,Dry Beans,Lisset Limpio -020,RETAIL  DSD,1388605,May
2025-05-08,El Gallego Supermarket,Invoice,008-05497,Arroz Envasado:Parboiled 5KG Dos Hermanos.,6  11lbs,1.0,46.5,46.5,4261830.99,Branded Rice,Lisset Limpio -020,RETAIL  DSD,1388606,May
2025-05-08,Sedanos Supermarkets #28,Credit Memo,008-05505,Varios:Promotional Allowance,Arroz Envasado:Parboiled 5KG Dos Hermanos.,-3.0,40.5,-121.5,4261709.49,Branded Rice,Keila Alfaro-Visvikis,RETAIL SEDANOS,1388607,May
2025-05-08,Sedanos Supermarkets #34,Credit Memo,008-05506,Varios:Promotional Allowance,Arroz Envasado:Parboiled 5KG Dos Hermanos.,-3.0,40.5,-121.5,4261587.99,Branded Rice,Keila Alfaro-Visvikis,RETAIL SEDANOS,1388608,May
2025-05-08,Festival Supermarket,Credit Memo,008-05507,Varios:Promotional Allowance,Arroz Envasado:Parboiled 5KG Dos Hermanos.,-41.0,46.5,-1906.5,4259681.49,Branded Rice,Keila Alfaro-Visvikis,RETAIL  DSD,1388609,May
2025-05-08,Festival Supermarket Margate,Credit Memo,008-05508,Varios:Promotional Allowance,Arroz Envasado:Parboiled 5KG Dos Hermanos.,-10.0,46.5,-465.0,4259216.49,Branded Rice,Keila Alfaro-Visvikis,RETAIL  DSD,1388610,May
2025-05-08,Festival Supermarket #35- Southgate,Credit Memo,008-05509,Varios:Promotional Allowance,Arroz Envasado:Parboiled 5KG Dos Hermanos.,-20.0,46.5,-930.0,4258286.49,Branded Rice,Keila Alfaro-Visvikis,RETAIL  DSD,1388611,May
2025-05-12,Hings Chinese,Invoice,008-05498,Arroz a Granel:Parboiled 50 LB -Bolsa Dos Hermanos.,,5.0,28.25,141.25,4258427.74,Bulk Rice,Lisset Limpio -020,CAFETERIA y RESTAURANTS,1388612,May
2025-05-12,El Palacio de los jugos / Delicias Criollas (DIAGO FOOD_MILLER),Invoice,008-05499,Dry Beans:Dry Beans - Black Beans 50,Dry Black Beans 50 lb,1.0,35.0,35.0,4258462.74,Dry Beans,Lisset Limpio -020,Cafeteria,1388613,May
2025-05-12,El Palacio de los jugos / Delicias Criollas (DIAGO FOOD_MILLER),Invoice,008-05499,Arroz a Granel:Parboiled 50 LB -Bolsa Dos Hermanos.,,12.0,26.75,321.0,4258783.74,Bulk Rice,Lisset Limpio -020,Cafeteria,1388614,May
2025-05-12,El Palacio de los jugos / Caribe Tropical,Invoice,008-05500,Arroz a Granel:Parboiled 50 LB -Bolsa Dos Hermanos.,,8.0,26.75,214.0,4258997.74,Bulk Rice,Lisset Limpio -020,Cafeteria,1388615,May
2025-05-12,El Palacio de Los Jugos / Casa mía Food Restaurant inc,Invoice,008-05501,Arroz a Granel:Parboiled 50 LB -Bolsa Dos Hermanos.,,12.0,26.75,321.0,4259318.74,Bulk Rice,Lisset Limpio -020,Cafeteria,1388616,May
2025-05-12,El Palacio de Los Jugos / Casa mía Food Restaurant inc,Invoice,008-05501,Dry Beans:Dry Beans - Black Beans 50,Dry Black Beans 50 lb,1.0,35.0,35.0,4259353.74,Dry Beans,Lisset Limpio -020,Cafeteria,1388617,May
2025-05-12,El Palacio de los jugos / Lita Foods Inc.,Invoice,008-05502,Dry Beans:Dry Beans - Black Beans 50,Dry Black Beans 50 lb,1.0,35.0,35.0,4259388.74,Dry Beans,Lisset Limpio -020,Cafeteria,1388618,May
2025-05-12,El Palacio de los jugos / Lita Foods Inc.,Invoice,008-05502,Arroz a Granel:Parboiled 50 LB -Bolsa Dos Hermanos.,,12.0,26.75,321.0,4259709.74,Bulk Rice,Lisset Limpio -020,Cafeteria,1388619,May
2025-05-12,JMN Dely Corp,Invoice,008-05503,Arroz a Granel:Largo Fino 50 LB -Bolsa Dos Hermanos.,,4.0,27.85,111.4,4259821.14,Bulk Rice,Keila Alfaro-Visvikis,CAFETERIA y RESTAURANTS,1388620,May
2025-05-12,JMN Dely Corp,Invoice,008-05503,Dry Beans:Dry Beans - Black Beans 50,Dry Black Beans 50 lb,1.0,45.7,45.7,4259866.84,Dry Beans,Keila Alfaro-Visvikis,CAFETERIA y RESTAURANTS,1388621,May
2025-05-12,Aries Supermarket & Cafeteria,Invoice,008-05504,Arroz a Granel:Parboiled 50 LB -Bolsa Dos Hermanos.,,5.0,28.25,141.25,4260008.09,Bulk Rice,Keila Alfaro-Visvikis,CAFETERIA y RESTAURANTS,1388622,May
2025-05-14,Sedanos Supermarkets #24,Invoice,008-05510,Arroz a Granel:Parboiled 50 LB -Bolsa Dos Hermanos.,,8.0,28.25,226.0,4260234.09,Bulk Rice,Keila Alfaro-Visvikis,RETAIL SEDANOS,1388623,May
2025-05-14,Sedanos Supermarkets #24,Invoice,008-05510,,Discount,,,-4.52,4260229.57,,Keila Alfaro-Visvikis,RETAIL SEDANOS,1388624,May
2025-05-14,BRAVO - Flamingo #3,Invoice,008-05511,Arroz Envasado:Parboiled 5KG Dos Hermanos.,6  11lbs,15.0,46.5,697.5,4260927.07,Branded Rice,Keila Alfaro-Visvikis,RETAIL  DSD,1388625,May
2025-05-14,BRAVO - Flamingo #3,Invoice,008-05511,Arroz Envasado:Parboiled 5KG Dos Hermanos.,6  11lbs,8.0,46.5,372.0,4261299.07,Branded Rice,Keila Alfaro-Visvikis,RETAIL  DSD,1388626,May
2025-05-14,Ideal Food Basket Davie Cafeteria,Invoice,008-05512,Arroz a Granel:Largo Fino 50 LB -Bolsa Dos Hermanos.,,8.0,27.85,222.8,4261521.87,Bulk Rice,Keila Alfaro-Visvikis,CAFETERIA y RESTAURANTS,1388627,May
2025-05-14,Sedanos Supermarkets #16,Invoice,008-05513,Arroz a Granel:Parboiled 50 LB -Bolsa Dos Hermanos.,,3.0,28.25,84.75,4261606.62,Bulk Rice,Keila Alfaro-Visvikis,RETAIL SEDANOS,1388628,May
2025-05-14,Sedanos Supermarkets #16,Invoice,008-05513,,Discount,,,-1.7,4261604.92,,Keila Alfaro-Visvikis,RETAIL SEDANOS,1388629,May
2025-05-14,Sedanos Supermarkets #22,Invoice,008-05514,Arroz Envasado:Parboiled 5KG Dos Hermanos.,6  11lbs,15.0,40.5,607.5,4262212.42,Branded Rice,Keila Alfaro-Visvikis,RETAIL SEDANOS,1388630,May
2025-05-14,Sedanos Supermarkets #22,Invoice,008-05514,Arroz Envasado:Largo Fino 1kg (Long grain rice) Dos Hermanos,,1.0,17.5,17.5,4262229.92,Branded Rice,Keila Alfaro-Visvikis,RETAIL SEDANOS,1388631,May
2025-05-14,Sedanos Supermarkets #22,Invoice,008-05514,Arroz Envasado:Parboiled 5KG Dos Hermanos.,6  11lbs,3.0,40.5,121.5,4262351.42,Branded Rice,Keila Alfaro-Visvikis,RETAIL SEDANOS,1388632,May
2025-05-14,Sedanos Supermarkets #22,Invoice,008-05514,,Discount,,,-12.5,4262338.92,,Keila Alfaro-Visvikis,RETAIL SEDANOS,1388633,May
2025-05-14,Sedanos Supermarkets #43,Invoice,008-05515,Arroz a Granel:Parboiled 50 LB -Bolsa Dos Hermanos.,,5.0,28.25,141.25,4262480.17,Bulk Rice,Keila Alfaro-Visvikis,RETAIL SEDANOS,1388634,May
2025-05-14,Sedanos Supermarkets #43,Invoice,008-05515,,Discount,,,-2.83,4262477.34,,Keila Alfaro-Visvikis,RETAIL SEDANOS,1388635,May
2025-05-14,Los Caringas Latin America  Foods,Invoice,008-05516,Arroz a Granel:Largo Fino 50 LB -Bolsa Dos Hermanos.,,3.0,27.85,83.55,4262560.89,Bulk Rice,Lisset Limpio -020,CAFETERIA y RESTAURANTS,1388636,May
2025-05-14,Los Caringas Latin America  Foods,Invoice,008-05516,Arroz a Granel:Parboiled 50 LB -Bolsa Dos Hermanos.,,3.0,28.25,84.75,4262645.64,Bulk Rice,Lisset Limpio -020,CAFETERIA y RESTAURANTS,1388637,May
2025-05-14,Mei Chang,Invoice,008-05517,Arroz a Granel:Parboiled 50 LB -Bolsa Dos Hermanos.,,9.0,28.25,254.25,4262899.89,Bulk Rice,Lisset Limpio -020,CAFETERIA y RESTAURANTS,1388638,May
2025-05-14,Los Mejores Tamales de Miami,Invoice,008-05518,Arroz a Granel:Parboiled 50 LB -Bolsa Dos Hermanos.,,7.0,28.25,197.75,4263097.64,Bulk Rice,Lisset Limpio -020,CAFETERIA y RESTAURANTS,1388639,May
2025-05-14,ALS Foods,Invoice,008-05519,Liquids:AS Cooking Wine,4 1 Gl.,2.0,17.5,35.0,4263132.64,American Spice,Lisset Limpio -020,CAFETERIA y RESTAURANTS,1388640,May
2025-05-14,ALS Foods,Invoice,008-05519,Arroz a Granel:Largo Fino 50 LB -Bolsa Dos Hermanos.,,6.0,27.85,167.1,4263299.74,Bulk Rice,Lisset Limpio -020,CAFETERIA y RESTAURANTS,1388641,May
2025-05-14,ALS Foods,Invoice,008-05519,Arroz a Granel:Parboiled 50 LB -Bolsa Dos Hermanos.,,11.0,26.75,294.25,4263593.99,Bulk Rice,Lisset Limpio -020,CAFETERIA y RESTAURANTS,1388642,May
2025-05-14,El Palacio de los jugos /  Nanos Latin Foods,Invoice,008-05520,Arroz a Granel:Parboiled 50 LB -Bolsa Dos Hermanos.,,15.0,26.75,401.25,4263995.24,Bulk Rice,Lisset Limpio -020,Cafeteria,1388643,May
2025-05-14,El Palacio de los jugos /  Nanos Latin Foods,Invoice,008-05520,Arroz a Granel:Largo Fino 50 LB -Bolsa Dos Hermanos.,,5.0,27.85,139.25,4264134.49,Bulk Rice,Lisset Limpio -020,Cafeteria,1388644,May
2025-05-14,Bravo Flamingo Cooper City,Invoice,008-05521,Arroz Envasado:Largo Fino 1kg (Long grain rice) Dos Hermanos,,1.0,17.0,17.0,4264151.49,Branded Rice,Keila Alfaro-Visvikis,RETAIL  DSD,1388645,May
2025-05-14,Bravo Flamingo Cooper City,Invoice,008-05521,Arroz Envasado:Parboiled 1kg Bolsa Dos Hermanos.,.,1.0,19.9,19.9,4264171.39,Branded Rice,Keila Alfaro-Visvikis,RETAIL  DSD,1388646,May
2025-05-14,Bravo Flamingo Cooper City,Invoice,008-05521,Arroz Envasado:Parboiled 5KG Dos Hermanos.,6  11lbs,1.0,46.5,46.5,4264217.89,Branded Rice,Keila Alfaro-Visvikis,RETAIL  DSD,1388647,May
2025-05-14,Bravo Flamingo Cooper City,Invoice,008-05521,Arroz Envasado:Sushi Rice Dos Hermanos.,.,1.0,60.0,60.0,4264277.89,Branded Rice,Keila Alfaro-Visvikis,RETAIL  DSD,1388648,May
2025-05-15,Bravo   Francisco Diaz,Invoice,008-05522,Liquids:AS Lemon Juice 4/1 Gl,,1.0,14.95,14.95,4264292.84,American Spice,Lisset Limpio -020,RETAIL  DSD,1388649,May
2025-05-15,Bravo   Francisco Diaz,Invoice,008-05522,Arroz a Granel:Largo Fino 50 LB -Bolsa Dos Hermanos.,,8.0,27.85,222.8,4264515.64,Bulk Rice,Lisset Limpio -020,RETAIL  DSD,1388650,May
2025-05-15,Bravo   Francisco Diaz,Invoice,008-05522,,Discount,,,-0.2,4264515.44,,Lisset Limpio -020,RETAIL  DSD,1388651,May
2025-05-15,Bravo   Francisco Diaz,Invoice,008-05522,Liquids:AS Marinating Sauce (Mojo),,1.0,17.0,17.0,4264532.44,American Spice,Lisset Limpio -020,RETAIL  DSD,1388652,May
2025-05-15,Soriano Brothers PB,Invoice,008-05523,Spices:AS Sazon (for all),1 / 30 lb (box or pail),2.0,51.0,102.0,4264634.44,American Spice,Lisset Limpio -020,CAFETERIA y RESTAURANTS,1388653,May
2025-05-15,Soriano Brothers PB,Invoice,008-05523,Dry Beans:Dry Beans - Black Beans 50,Dry Black Beans 50 lb,1.0,34.0,34.0,4264668.44,Dry Beans,Lisset Limpio -020,CAFETERIA y RESTAURANTS,1388654,May
2025-05-15,Soriano Brothers PB,Invoice,008-05523,Dry Beans:Dry Beans - Small Red Beans 50 lbs.,Small Red Beans 50 lbs,1.0,42.0,42.0,4264710.44,Dry Beans,Lisset Limpio -020,CAFETERIA y RESTAURANTS,1388655,May
2025-05-15,Soriano Brothers PB,Invoice,008-05523,Arroz a Granel:Parboiled 50 LB -Bolsa Dos Hermanos.,,17.0,26.75,454.75,4265165.19,Bulk Rice,Lisset Limpio -020,CAFETERIA y RESTAURANTS,1388656,May
2025-05-15,Soriano Brothers PB,Invoice,008-05523,Arroz a Granel:Largo Fino 50 LB -Bolsa Dos Hermanos.,,10.0,27.85,278.5,4265443.69,Bulk Rice,Lisset Limpio -020,CAFETERIA y RESTAURANTS,1388657,May
2025-05-15,El Palacio de los jugos / Delicias Criollas (DIAGO FOOD_MILLER),Invoice,008-05524,Arroz a Granel:Parboiled 50 LB -Bolsa Dos Hermanos.,,7.0,26.75,187.25,4265630.94,Bulk Rice,Lisset Limpio -020,Cafeteria,1388658,May
2025-05-15,El Palacio de Los Jugos / Casa mía Food Restaurant inc,Invoice,008-05525,Liquids:AS Bitter Orange,,1.0,14.0,14.0,4265644.94,American Spice,Lisset Limpio -020,Cafeteria,1388659,May
2025-05-15,El Palacio de Los Jugos / Casa mía Food Restaurant inc,Invoice,008-05525,Liquids:AS Cooking Wine,4 1 Gl.,1.0,16.5,16.5,4265661.44,American Spice,Lisset Limpio -020,Cafeteria,1388660,May
2025-05-15,El Palacio de Los Jugos / Casa mía Food Restaurant inc,Invoice,008-05525,Liquids:AS Lemon Juice 4/1 Gl,,1.0,14.95,14.95,4265676.39,American Spice,Lisset Limpio -020,Cafeteria,1388661,May
2025-05-15,El Palacio de Los Jugos / Casa mía Food Restaurant inc,Invoice,008-05525,Liquids:AS Marinating Sauce (Mojo),,1.0,17.0,17.0,4265693.39,American Spice,Lisset Limpio -020,Cafeteria,1388662,May
2025-05-15,El Palacio de Los Jugos / Casa mía Food Restaurant inc,Invoice,008-05525,Spices:AS Sazon (for all),1 / 30 lb (box or pail),1.0,51.0,51.0,4265744.39,American Spice,Lisset Limpio -020,Cafeteria,1388663,May
2025-05-15,El Palacio de Los Jugos / Casa mía Food Restaurant inc,Invoice,008-05525,Spices:AS Chicken Base,1 / 30 lb. (box or pail),1.0,39.0,39.0,4265783.39,American Spice,Lisset Limpio -020,Cafeteria,1388664,May
2025-05-15,El Palacio de Los Jugos / Casa mía Food Restaurant inc,Invoice,008-05525,Arroz a Granel:Parboiled 50 LB -Bolsa Dos Hermanos.,,5.0,26.75,133.75,4265917.14,Bulk Rice,Lisset Limpio -020,Cafeteria,1388665,May
2025-05-15,Sedanos Supermarkets #32,Invoice,008-05526,Arroz a Granel:Parboiled 50 LB -Bolsa Dos Hermanos.,,4.0,28.25,113.0,4266030.14,Bulk Rice,Keila Alfaro-Visvikis,RETAIL SEDANOS,1388666,May
2025-05-15,Sedanos Supermarkets #32,Invoice,008-05526,,Discount,,,-2.26,4266027.88,,Keila Alfaro-Visvikis,RETAIL SEDANOS,1388667,May
2025-05-15,El Palacio de los jugos / Leti Corp.,Invoice,008-05527,Arroz a Granel:Largo Fino 50 LB -Bolsa Dos Hermanos.,,5.0,27.85,139.25,4266167.13,Bulk Rice,Lisset Limpio -020,Cafeteria,1388668,May
2025-05-15,El Palacio de los jugos / Leti Corp.,Invoice,008-05527,Arroz a Granel:Parboiled 50 LB -Bolsa Dos Hermanos.,,6.0,26.75,160.5,4266327.63,Bulk Rice,Lisset Limpio -020,Cafeteria,1388669,May
2025-05-15,El Palacio de los jugos / Caribe Tropical,Invoice,008-05528,Arroz a Granel:Parboiled 50 LB -Bolsa Dos Hermanos.,,10.0,26.75,267.5,4266595.13,Bulk Rice,Lisset Limpio -020,Cafeteria,1388670,May
2025-05-15,El Palacio de los jugos / Caribe Tropical,Invoice,008-05528,Dry Beans:Dry Beans - Small Red Beans 50 lbs.,Small Red Beans 50 lbs,2.0,41.0,82.0,4266677.13,Dry Beans,Lisset Limpio -020,Cafeteria,1388671,May
2025-05-15,El Palacio de los jugos / Caribe Tropical,Invoice,008-05528,Dry Beans:Dry Beans - Black Beans 50,Dry Black Beans 50 lb,2.0,35.0,70.0,4266747.13,Dry Beans,Lisset Limpio -020,Cafeteria,1388672,May
2025-05-15,Sedanos Supermarkets #38,Invoice,008-05529,Arroz Envasado:Parboiled 5KG Dos Hermanos.,6  11lbs,20.0,40.5,810.0,4267557.13,Branded Rice,Keila Alfaro-Visvikis,RETAIL SEDANOS,1388673,May
2025-05-15,Sedanos Supermarkets #38,Invoice,008-05529,Arroz Envasado:Parboiled 5KG Dos Hermanos.,6  11lbs,20.0,40.5,810.0,4268367.13,Branded Rice,Keila Alfaro-Visvikis,RETAIL SEDANOS,1388674,May
2025-05-15,Sedanos Supermarkets #38,Invoice,008-05529,Spanish Style Yellow Rice:AS Spanish Style Yellow Rice,AS Spanish Style Yellow Rice 6 / 3.25 oz,1.0,34.5,34.5,4268401.63,American Spice,Keila Alfaro-Visvikis,RETAIL SEDANOS,1388675,May
2025-05-15,Sedanos Supermarkets #38,Invoice,008-05529,,Discount,,,-16.89,4268384.74,,Keila Alfaro-Visvikis,RETAIL SEDANOS,1388676,May
2025-05-15,El Palacio de los jugos / J Mena Corp.,Invoice,008-05530,Arroz a Granel:Parboiled 50 LB -Bolsa Dos Hermanos.,,10.0,26.75,267.5,4268652.24,Bulk Rice,Lisset Limpio -020,Cafeteria,1388677,May
2025-05-15,Sabor Tropical Supermarket #3,Invoice,008-05531,Arroz Envasado:Largo Fino 1kg (Long grain rice) Dos Hermanos,,2.0,18.0,36.0,4268688.24,Branded Rice,Keila Alfaro-Visvikis,RETAIL KEY FOOD,1388678,May
2025-05-15,Sedanos Supermarkets #31,Invoice,008-05532,Arroz Envasado:Largo Fino 1kg (Long grain rice) Dos Hermanos,,0.0,,0.0,4268688.24,Branded Rice,Keila Alfaro-Visvikis,RETAIL SEDANOS,1388679,May
2025-05-15,Sedanos Supermarkets #31,Invoice,008-05533,Arroz a Granel:Parboiled 50 LB -Bolsa Dos Hermanos.,,5.0,28.25,141.25,4268829.49,Bulk Rice,Keila Alfaro-Visvikis,RETAIL SEDANOS,1388680,May
2025-05-15,Sedanos Supermarkets #31,Invoice,008-05533,,Discount,,,-2.83,4268826.66,,Keila Alfaro-Visvikis,RETAIL SEDANOS,1388681,May
2025-05-15,El Palacio de los jugos / Rodriguez Foods,Invoice,008-05534,Arroz a Granel:Parboiled 50 LB -Bolsa Dos Hermanos.,,6.0,26.75,160.5,4268987.16,Bulk Rice,Lisset Limpio -020,Cafeteria,1388682,May
2025-05-15,Sedanos Supermarkets #22,Credit Memo,008-05550,Varios:Promotional Allowance,Arroz Envasado:Parboiled 5KG Dos Hermanos.,-3.0,40.5,-121.5,4268865.66,Branded Rice,Keila Alfaro-Visvikis,RETAIL SEDANOS,1388683,May
2025-05-15,BRAVO - Flamingo #3,Credit Memo,008-05551,Varios:Promotional Allowance,Arroz Envasado:Parboiled 5KG Dos Hermanos.,-8.0,46.5,-372.0,4268493.66,Branded Rice,Keila Alfaro-Visvikis,RETAIL  DSD,1388684,May
2025-05-15,Bravo Flamingo Cooper City,Credit Memo,008-05552,Varios:Promotional Allowance,Arroz Envasado:Largo Fino 1kg (Long grain rice) Dos Hermanos,-1.0,17.0,-17.0,4268476.66,Branded Rice,Keila Alfaro-Visvikis,RETAIL  DSD,1388685,May
2025-05-15,Bravo Flamingo Cooper City,Credit Memo,008-05552,Varios:Promotional Allowance,Arroz Envasado:Parboiled 1kg Bolsa Dos Hermanos.,-1.0,19.9,-19.9,4268456.76,Branded Rice,Keila Alfaro-Visvikis,RETAIL  DSD,1388686,May
2025-05-15,Bravo Flamingo Cooper City,Credit Memo,008-05552,Varios:Promotional Allowance,Arroz Envasado:Parboiled 5KG Dos Hermanos.,-1.0,46.5,-46.5,4268410.26,Branded Rice,Keila Alfaro-Visvikis,RETAIL  DSD,1388687,May
2025-05-15,Bravo Flamingo Cooper City,Credit Memo,008-05552,Varios:Promotional Allowance,Arroz Envasado:Sushi Rice Dos Hermanos.,-1.0,60.0,-60.0,4268350.26,Branded Rice,Keila Alfaro-Visvikis,RETAIL  DSD,1388688,May
2025-05-16,Armando Carpio,Invoice,008-05535,Arroz Envasado:Largo Fino 1kg (Long grain rice) Dos Hermanos,,2.0,18.0,36.0,4268386.26,Branded Rice,Armando Carpio - 017,OTHER,1388689,May
2025-05-18,El Palacio de los jugos /  Mires Restaurants,Invoice,008-05537,Arroz a Granel:Parboiled 50 LB -Bolsa Dos Hermanos.,,12.0,26.75,321.0,4268707.26,Bulk Rice,Lisset Limpio -020,Cafeteria,1388690,May
2025-05-18,El Palacio de los jugos /  Nanos Latin Foods,Invoice,008-05538,Arroz a Granel:Largo Fino 50 LB -Bolsa Dos Hermanos.,,6.0,27.85,167.1,4268874.36,Bulk Rice,Lisset Limpio -020,Cafeteria,1388691,May
2025-05-18,El Palacio de los jugos /  Nanos Latin Foods,Invoice,008-05538,Arroz a Granel:Parboiled 50 LB -Bolsa Dos Hermanos.,,5.0,26.75,133.75,4269008.11,Bulk Rice,Lisset Limpio -020,Cafeteria,1388692,May
2025-05-18,Fritanga Momotombo,Invoice,008-05539,Spices:AS Chicken Base,1 / 30 lb. (box or pail),2.0,39.0,78.0,4269086.11,American Spice,Lisset Limpio -020,CAFETERIA y RESTAURANTS,1388693,May
2025-05-18,Fritanga Momotombo,Invoice,008-05539,Dry Beans:Dry Beans - Small Red Beans 50 lbs.,Small Red Beans 50 lbs,2.0,42.0,84.0,4269170.11,Dry Beans,Lisset Limpio -020,CAFETERIA y RESTAURANTS,1388694,May
2025-05-18,Fritanga Momotombo,Invoice,008-05539,Arroz a Granel:Largo Fino 50 LB -Bolsa Dos Hermanos.,,6.0,27.85,167.1,4269337.21,Bulk Rice,Lisset Limpio -020,CAFETERIA y RESTAURANTS,1388695,May
2025-05-18,El Palacio de los jugos / Lita Foods Inc.,Invoice,008-05540,Dry Beans:Dry Beans - Black Beans 50,Dry Black Beans 50 lb,1.0,35.0,35.0,4269372.21,Dry Beans,Lisset Limpio -020,Cafeteria,1388696,May
2025-05-18,El Palacio de los jugos / Lita Foods Inc.,Invoice,008-05540,Arroz a Granel:Parboiled 50 LB -Bolsa Dos Hermanos.,,12.0,26.75,321.0,4269693.21,Bulk Rice,Lisset Limpio -020,Cafeteria,1388697,May
2025-05-18,Be Your Will LLC,Invoice,008-05541,Liquids:AS Cooking Wine,4 1 Gl.,2.0,17.5,35.0,4269728.21,American Spice,Lisset Limpio -020,CAFETERIA y RESTAURANTS,1388698,May
2025-05-18,Be Your Will LLC,Invoice,008-05541,Arroz a Granel:Largo Fino 50 LB -Bolsa Dos Hermanos.,,6.0,27.85,167.1,4269895.31,Bulk Rice,Lisset Limpio -020,CAFETERIA y RESTAURANTS,1388699,May
2025-05-18,Be Your Will LLC,Invoice,008-05541,Arroz a Granel:Parboiled 50 LB -Bolsa Dos Hermanos.,,11.0,26.75,294.25,4270189.56,Bulk Rice,Lisset Limpio -020,CAFETERIA y RESTAURANTS,1388700,May
2025-05-18,El Palacio de los jugos / Delicias Criollas (DIAGO FOOD_MILLER),Invoice,008-05542,Arroz a Granel:Largo Fino 50 LB -Bolsa Dos Hermanos.,,5.0,27.85,139.25,4270328.81,Bulk Rice,Lisset Limpio -020,Cafeteria,1388701,May
2025-05-18,El Palacio de los jugos / Delicias Criollas (DIAGO FOOD_MILLER),Invoice,008-05542,Arroz a Granel:Parboiled 50 LB -Bolsa Dos Hermanos.,,6.0,26.75,160.5,4270489.31,Bulk Rice,Lisset Limpio -020,Cafeteria,1388702,May
2025-05-18,El Palacio de los jugos / Caribe Tropical,Invoice,008-05543,Arroz a Granel:Parboiled 50 LB -Bolsa Dos Hermanos.,,8.0,26.75,214.0,4270703.31,Bulk Rice,Lisset Limpio -020,Cafeteria,1388703,May
2025-05-18,El Palacio de los jugos / Caribe Tropical,Invoice,008-05543,Dry Beans:Dry Beans - Small Red Beans 50 lbs.,Small Red Beans 50 lbs,1.0,41.0,41.0,4270744.31,Dry Beans,Lisset Limpio -020,Cafeteria,1388704,May
2025-05-18,El Palacio de los jugos / Caribe Tropical,Invoice,008-05543,Dry Beans:Dry Beans - Black Beans 50,Dry Black Beans 50 lb,2.0,34.0,68.0,4270812.31,Dry Beans,Lisset Limpio -020,Cafeteria,1388705,May
2025-05-18,China Tokyo,Invoice,008-05544,Arroz a Granel:Parboiled 50 LB -Bolsa Dos Hermanos.,,10.0,28.25,282.5,4271094.81,Bulk Rice,Lisset Limpio -020,CAFETERIA y RESTAURANTS,1388706,May
2025-05-18,JMN Dely Corp,Invoice,008-05545,Dry Beans:Dry Beans - Black Beans 50,Dry Black Beans 50 lb,1.0,45.7,45.7,4271140.51,Dry Beans,Keila Alfaro-Visvikis,CAFETERIA y RESTAURANTS,1388707,May
2025-05-18,JMN Dely Corp,Invoice,008-05545,Arroz a Granel:Largo Fino 50 LB -Bolsa Dos Hermanos.,,2.0,27.85,55.7,4271196.21,Bulk Rice,Keila Alfaro-Visvikis,CAFETERIA y RESTAURANTS,1388708,May
2025-05-18,JMN Dely Corp,Invoice,008-05545,Arroz a Granel:Parboiled 50 LB -Bolsa Dos Hermanos.,,2.0,27.75,55.5,4271251.71,Bulk Rice,Keila Alfaro-Visvikis,CAFETERIA y RESTAURANTS,1388709,May
2025-05-18,Aries Supermarket & Cafeteria,Invoice,008-05546,Arroz a Granel:Parboiled 50 LB -Bolsa Dos Hermanos.,,10.0,28.25,282.5,4271534.21,Bulk Rice,Keila Alfaro-Visvikis,CAFETERIA y RESTAURANTS,1388710,May
2025-05-18,Aries Supermarket & Cafeteria,Invoice,008-05546,Liquids:AS Cooking Wine,4 1 Gl.,1.0,17.5,17.5,4271551.71,American Spice,Keila Alfaro-Visvikis,CAFETERIA y RESTAURANTS,1388711,May
2025-05-18,Aries Supermarket & Cafeteria,Invoice,008-05546,Spices:AS Sazon (for all),1 / 30 lb (box or pail),1.0,59.0,59.0,4271610.71,American Spice,Keila Alfaro-Visvikis,CAFETERIA y RESTAURANTS,1388712,May
2025-05-18,Aries Supermarket & Cafeteria,Invoice,008-05546,Spices:AS Oregano Ground,4 / 3.5 Lbs.,1.0,37.5,37.5,4271648.21,American Spice,Keila Alfaro-Visvikis,CAFETERIA y RESTAURANTS,1388713,May
2025-05-18,Aries Supermarket & Cafeteria,Invoice,008-05546,Spices:AS Cumin Ground,4 / 4 lb,1.0,50.25,50.25,4271698.46,American Spice,Keila Alfaro-Visvikis,CAFETERIA y RESTAURANTS,1388714,May
2025-05-19,El Palacio de Los Jugos / Casa mía Food Restaurant inc,Invoice,008-05547,Arroz a Granel:Parboiled 50 LB -Bolsa Dos Hermanos.,,8.0,26.75,214.0,4271912.46,Bulk Rice,Lisset Limpio -020,Cafeteria,1388715,May
2025-05-19,El Palacio de los jugos / Rodriguez Foods,Invoice,008-05548,Arroz a Granel:Parboiled 50 LB -Bolsa Dos Hermanos.,,6.0,26.75,160.5,4272072.96,Bulk Rice,Lisset Limpio -020,Cafeteria,1388716,May
2025-05-19,Sedanos Supermarkets  #37,Credit Memo,008-05549,Varios:Producto vencido/deteriorado (no impacta en inventario),5 bolsas de 5kg,-5.0,3.37,-16.85,4272056.11,Branded Rice,Keila Alfaro-Visvikis,RETAIL SEDANOS,1388717,May
2025-05-20,Sedanos Supermarkets #38,Credit Memo,008-05553,Varios:Promotional Allowance,Arroz Envasado:Parboiled 5KG Dos Hermanos.,-20.0,40.5,-810.0,4271246.11,Branded Rice,Keila Alfaro-Visvikis,RETAIL SEDANOS,1388718,May
2025-05-21,American Produce Distributors CO,Invoice,008-05554,Arroz a Granel:Parboiled 50 LB -Bolsa Dos Hermanos.,,20.0,25.5,510.0,4271756.11,Bulk Rice,Keila Alfaro-Visvikis,Distributor,1388719,May
2025-05-21,Pacifico Chinese Restaurant,Invoice,008-05555,Arroz a Granel:Parboiled 50 LB -Bolsa Dos Hermanos.,,10.0,28.25,282.5,4272038.61,Bulk Rice,Lisset Limpio -020,CAFETERIA y RESTAURANTS,1388720,May
2025-05-21,Sedanos Supermarkets #26,Invoice,008-05556,Arroz a Granel:Parboiled 50 LB -Bolsa Dos Hermanos.,,5.0,28.25,141.25,4272179.86,Bulk Rice,Keila Alfaro-Visvikis,RETAIL SEDANOS,1388721,May
2025-05-21,Sedanos Supermarkets #26,Invoice,008-05556,,Discount,,,-2.83,4272177.03,,Keila Alfaro-Visvikis,RETAIL SEDANOS,1388722,May
2025-05-21,Neighbors Food Market / Luis Diaz,Invoice,008-05557,Arroz Envasado:Largo Fino 1kg (Long grain rice) Dos Hermanos,,5.0,18.0,90.0,4272267.03,Branded Rice,Keila Alfaro-Visvikis,RETAIL  DSD,1388723,May
2025-05-21,Neighbors Food Market / Luis Diaz,Invoice,008-05557,Arroz Envasado:Parboiled 5KG Dos Hermanos.,6  11lbs,15.0,46.5,697.5,4272964.53,Branded Rice,Keila Alfaro-Visvikis,RETAIL  DSD,1388724,May
2025-05-21,Neighbors Food Market / Luis Diaz,Invoice,008-05557,Arroz Envasado:Parboiled 5KG Dos Hermanos.,6  11lbs,7.0,46.5,325.5,4273290.03,Branded Rice,Keila Alfaro-Visvikis,RETAIL  DSD,1388725,May
2025-05-21,Neighbors Food Market / Luis Diaz,Invoice,008-05557,Arroz Envasado:Largo Fino 1kg (Long grain rice) Dos Hermanos,,1.0,18.0,18.0,4273308.03,Branded Rice,Keila Alfaro-Visvikis,RETAIL  DSD,1388726,May
2025-05-21,Ideal Food Basket Davie Grocery,Invoice,008-05558,Arroz Envasado:Largo Fino 1kg (Long grain rice) Dos Hermanos,,2.0,18.0,36.0,4273344.03,Branded Rice,Keila Alfaro-Visvikis,RETAIL  DSD,1388727,May
2025-05-21,Ideal Food Basket Davie Grocery,Invoice,008-05558,Arroz Envasado:Parboiled 1kg Bolsa Dos Hermanos.,.,3.0,19.9,59.7,4273403.73,Branded Rice,Keila Alfaro-Visvikis,RETAIL  DSD,1388728,May
2025-05-21,Ideal Food Basket Davie Grocery,Invoice,008-05558,Arroz Envasado:Largo Fino 1kg (Long grain rice) Dos Hermanos,,1.0,18.0,18.0,4273421.73,Branded Rice,Keila Alfaro-Visvikis,RETAIL  DSD,1388729,May
2025-05-21,Ideal Food Basket Davie Cafeteria,Invoice,008-05559,Arroz a Granel:Largo Fino 50 LB -Bolsa Dos Hermanos.,,9.0,27.85,250.65,4273672.38,Bulk Rice,Keila Alfaro-Visvikis,CAFETERIA y RESTAURANTS,1388730,May
2025-05-21,Key Food / Holywood,Invoice,008-05560,Arroz Envasado:Largo Fino 1kg (Long grain rice) Dos Hermanos,,10.0,18.0,180.0,4273852.38,Branded Rice,Keila Alfaro-Visvikis,RETAIL  DSD,1388731,May
2025-05-21,Key Food / Holywood,Invoice,008-05560,Arroz Envasado:Largo Fino 1kg (Long grain rice) Dos Hermanos,,2.0,18.0,36.0,4273888.38,Branded Rice,Keila Alfaro-Visvikis,RETAIL  DSD,1388732,May
2025-05-21,Sedanos Supermarkets #24,Invoice,008-05561,Arroz a Granel:Parboiled 50 LB -Bolsa Dos Hermanos.,,8.0,28.25,226.0,4274114.38,Bulk Rice,Keila Alfaro-Visvikis,RETAIL SEDANOS,1388733,May
2025-05-21,Sedanos Supermarkets #24,Invoice,008-05561,,Discount,,,-4.52,4274109.86,,Keila Alfaro-Visvikis,RETAIL SEDANOS,1388734,May
2025-05-21,Price Choice Food Market # 6,Invoice,008-05562,Arroz Envasado:Parboiled 5KG Dos Hermanos.,6  11lbs,10.0,46.5,465.0,4274574.86,Branded Rice,Lisset Limpio -020,RETAIL  DSD,1388735,May
2025-05-21,Price Choice Food Market # 6,Invoice,008-05562,Arroz Envasado:Parboiled 5KG Dos Hermanos.,6  11lbs,10.0,46.5,465.0,4275039.86,Branded Rice,Lisset Limpio -020,RETAIL  DSD,1388736,May
2025-05-21,Food Fair Plantation Corp,Credit Memo,008-05563,Varios:Producto vencido/deteriorado (no impacta en inventario),2 sacos rtos,-2.0,27.75,-55.5,4274984.36,Bulk Rice,Keila Alfaro-Visvikis,RETAIL  DSD,1388737,May
2025-05-21,Food Fair Plantation Corp,Credit Memo,008-05563,Varios:Producto vencido/deteriorado (no impacta en inventario),9 11lb vencidos 9*5.28,-1.0,47.52,-47.52,4274936.84,Branded Rice,Keila Alfaro-Visvikis,RETAIL  DSD,1388738,May
2025-05-21,Key Food / Holywood,Credit Memo,008-05564,Varios:Producto vencido/deteriorado (no impacta en inventario),1 units 5kg parboil,-1.0,5.28,-5.28,4274931.56,Branded Rice,Keila Alfaro-Visvikis,RETAIL  DSD,1388739,May
2025-05-21,Sedanos Supermarkets #16,Invoice,008-05565,Arroz a Granel:Parboiled 50 LB -Bolsa Dos Hermanos.,,5.0,28.25,141.25,4275072.81,Bulk Rice,Keila Alfaro-Visvikis,RETAIL SEDANOS,1388740,May
2025-05-21,Sedanos Supermarkets #16,Invoice,008-05565,,Discount,,,-2.83,4275069.98,,Keila Alfaro-Visvikis,RETAIL SEDANOS,1388741,May
2025-05-21,Sedanos Supermarkets #43,Invoice,008-05566,Arroz a Granel:Parboiled 50 LB -Bolsa Dos Hermanos.,,4.0,28.25,113.0,4275182.98,Bulk Rice,Keila Alfaro-Visvikis,RETAIL SEDANOS,1388742,May
2025-05-21,Sedanos Supermarkets #43,Invoice,008-05566,,Discount,,,-2.26,4275180.72,,Keila Alfaro-Visvikis,RETAIL SEDANOS,1388743,May
2025-05-21,Food Fair Plantation Corp,Invoice,008-05567,Arroz a Granel:Parboiled 50 LB -Bolsa Dos Hermanos.,,55.0,27.75,1526.25,4276706.97,Bulk Rice,Keila Alfaro-Visvikis,RETAIL  DSD,1388744,May
2025-05-22,Sedanos Supermarkets #27,Invoice,008-05568,Arroz Envasado:Parboiled 5KG Dos Hermanos.,6  11lbs,15.0,46.5,697.5,4277404.47,Branded Rice,Keila Alfaro-Visvikis,RETAIL SEDANOS,1388745,May
2025-05-22,Sedanos Supermarkets #27,Invoice,008-05568,Arroz Envasado:Parboiled 5KG Dos Hermanos.,6  11lbs,3.0,46.5,139.5,4277543.97,Branded Rice,Keila Alfaro-Visvikis,RETAIL SEDANOS,1388746,May
2025-05-22,Sedanos Supermarkets #27,Invoice,008-05568,,Discount,,,-13.95,4277530.02,,Keila Alfaro-Visvikis,RETAIL SEDANOS,1388747,May
2025-05-22,Bravo   Francisco Diaz,Invoice,008-05569,Liquids:AS Cooking Wine,4 1 Gl.,3.0,17.5,52.5,4277582.52,American Spice,Lisset Limpio -020,RETAIL  DSD,1388748,May
2025-05-22,Bravo   Francisco Diaz,Invoice,008-05569,Arroz a Granel:Largo Fino 50 LB -Bolsa Dos Hermanos.,,5.0,27.85,139.25,4277721.77,Bulk Rice,Lisset Limpio -020,RETAIL  DSD,1388749,May
2025-05-22,El Palacio de los jugos / Rodriguez Foods,Invoice,008-05570,Arroz a Granel:Parboiled 50 LB -Bolsa Dos Hermanos.,,6.0,26.75,160.5,4277882.27,Bulk Rice,Lisset Limpio -020,Cafeteria,1388750,May
2025-05-22,Sedanos Supermarkets #33,Invoice,008-05571,Spanish Style Yellow Rice:AS Spanish Style Yellow Rice,AS Spanish Style Yellow Rice 6 / 3.25 oz,1.0,34.5,34.5,4277916.77,American Spice,Keila Alfaro-Visvikis,RETAIL SEDANOS,1388751,May
2025-05-22,Sedanos Supermarkets #33,Invoice,008-05571,,Discount,,,-0.69,4277916.08,,Keila Alfaro-Visvikis,RETAIL SEDANOS,1388752,May
2025-05-22,Sedanos Supermarkets #33,Invoice,008-05572,Arroz a Granel:Parboiled 50 LB -Bolsa Dos Hermanos.,,6.0,28.25,169.5,4278085.58,Bulk Rice,Keila Alfaro-Visvikis,RETAIL SEDANOS,1388753,May
2025-05-22,Sedanos Supermarkets #33,Invoice,008-05572,,Discount,,,-3.39,4278082.19,,Keila Alfaro-Visvikis,RETAIL SEDANOS,1388754,May
2025-05-22,El Palacio de los jugos /  Nanos Latin Foods,Invoice,008-05573,Arroz a Granel:Largo Fino 50 LB -Bolsa Dos Hermanos.,,5.0,27.85,139.25,4278221.44,Bulk Rice,Lisset Limpio -020,Cafeteria,1388755,May
2025-05-22,El Palacio de los jugos /  Nanos Latin Foods,Invoice,008-05573,Arroz a Granel:Parboiled 50 LB -Bolsa Dos Hermanos.,,10.0,26.75,267.5,4278488.94,Bulk Rice,Lisset Limpio -020,Cafeteria,1388756,May
2025-05-22,El Palacio de los jugos / Leti Corp.,Invoice,008-05574,Arroz a Granel:Parboiled 50 LB -Bolsa Dos Hermanos.,,6.0,26.75,160.5,4278649.44,Bulk Rice,Lisset Limpio -020,Cafeteria,1388757,May
2025-05-22,El Palacio de Los Jugos / Casa mía Food Restaurant inc,Invoice,008-05575,Arroz a Granel:Parboiled 50 LB -Bolsa Dos Hermanos.,,8.0,26.75,214.0,4278863.44,Bulk Rice,Lisset Limpio -020,Cafeteria,1388758,May
2025-05-22,El Palacio de los jugos / Lita Foods Inc.,Invoice,008-05576,Arroz a Granel:Parboiled 50 LB -Bolsa Dos Hermanos.,,8.0,26.75,214.0,4279077.44,Bulk Rice,Lisset Limpio -020,Cafeteria,1388759,May
2025-05-22,El Palacio de los jugos / Caribe Tropical,Invoice,008-05577,Arroz a Granel:Parboiled 50 LB -Bolsa Dos Hermanos.,,8.0,26.75,214.0,4279291.44,Bulk Rice,Lisset Limpio -020,Cafeteria,1388760,May
2025-05-22,Sedanos Supermarkets #17,Invoice,008-05578,Arroz Envasado:Parboiled 1kg Bolsa Dos Hermanos.,.,1.0,19.9,19.9,4279311.34,Branded Rice,Keila Alfaro-Visvikis,RETAIL SEDANOS,1388761,May
2025-05-22,Sedanos Supermarkets #17,Invoice,008-05578,,Discount,,,-0.4,4279310.94,,Keila Alfaro-Visvikis,RETAIL SEDANOS,1388762,May
2025-05-22,Sedanos Supermarkets #18,Invoice,008-05579,Spices:AS Chicken Base,1 / 30 lb. (box or pail),1.0,39.0,39.0,4279349.94,American Spice,Keila Alfaro-Visvikis,RETAIL SEDANOS,1388763,May
2025-05-22,Sedanos Supermarkets #18,Invoice,008-05579,Arroz a Granel:Parboiled 50 LB -Bolsa Dos Hermanos.,,10.0,28.25,282.5,4279632.44,Bulk Rice,Keila Alfaro-Visvikis,RETAIL SEDANOS,1388764,May
2025-05-22,Sedanos Supermarkets #18,Invoice,008-05579,,Discount,,,-6.43,4279626.01,,Keila Alfaro-Visvikis,RETAIL SEDANOS,1388765,May
2025-05-22,Sedanos Supermarkets  #37,Invoice,008-05580,Arroz a Granel:Parboiled 50 LB -Bolsa Dos Hermanos.,,6.0,28.25,169.5,4279795.51,Bulk Rice,Keila Alfaro-Visvikis,RETAIL SEDANOS,1388766,May
2025-05-22,Sedanos Supermarkets  #37,Invoice,008-05580,,Discount,,,-3.39,4279792.12,,Keila Alfaro-Visvikis,RETAIL SEDANOS,1388767,May
2025-05-22,ALS Foods,Invoice,008-05581,Liquids:AS Cooking Wine,4 1 Gl.,2.0,17.5,35.0,4279827.12,American Spice,Lisset Limpio -020,CAFETERIA y RESTAURANTS,1388768,May
2025-05-22,ALS Foods,Invoice,008-05581,Arroz a Granel:Largo Fino 50 LB -Bolsa Dos Hermanos.,,6.0,27.85,167.1,4279994.22,Bulk Rice,Lisset Limpio -020,CAFETERIA y RESTAURANTS,1388769,May
2025-05-22,ALS Foods,Invoice,008-05581,Arroz a Granel:Parboiled 50 LB -Bolsa Dos Hermanos.,,11.0,26.75,294.25,4280288.47,Bulk Rice,Lisset Limpio -020,CAFETERIA y RESTAURANTS,1388770,May
2025-05-22,El Gallego Supermarket,Invoice,008-05582,Liquids:AS Bitter Orange,,1.0,14.0,14.0,4280302.47,American Spice,Lisset Limpio -020,RETAIL  DSD,1388771,May
2025-05-22,El Gallego Supermarket,Invoice,008-05582,Liquids:AS Cooking Wine,4 1 Gl.,1.0,17.5,17.5,4280319.97,American Spice,Lisset Limpio -020,RETAIL  DSD,1388772,May
2025-05-22,El Gallego Supermarket,Invoice,008-05582,Arroz a Granel:Parboiled 50 LB -Bolsa Dos Hermanos.,,5.0,27.75,138.75,4280458.72,Bulk Rice,Lisset Limpio -020,RETAIL  DSD,1388773,May
2025-05-22,El Gallego Supermarket,Invoice,008-05582,Dry Beans:Dry Beans - Black Beans 50,Dry Black Beans 50 lb,2.0,35.0,70.0,4280528.72,Dry Beans,Lisset Limpio -020,RETAIL  DSD,1388774,May
2025-05-22,El Gallego Supermarket,Invoice,008-05582,Dry Beans:Dry Beans - Small Red Beans 50 lbs.,Small Red Beans 50 lbs,1.0,41.0,41.0,4280569.72,Dry Beans,Lisset Limpio -020,RETAIL  DSD,1388775,May
2025-05-22,Rey Chavez Distributor Corp,Invoice,008-05583,Arroz a Granel:Parboiled 50 LB -Bolsa Dos Hermanos.,,55.0,27.5,1512.5,4282082.22,Bulk Rice,Lisset Limpio -020,WHOLESALER,1388776,May
2025-05-22,Los Caringas Latin America  Foods,Invoice,008-05584,Arroz a Granel:Largo Fino 50 LB -Bolsa Dos Hermanos.,,3.0,27.85,83.55,4282165.77,Bulk Rice,Lisset Limpio -020,CAFETERIA y RESTAURANTS,1388777,May
2025-05-22,Los Caringas Latin America  Foods,Invoice,008-05584,Arroz a Granel:Parboiled 50 LB -Bolsa Dos Hermanos.,,3.0,28.25,84.75,4282250.52,Bulk Rice,Lisset Limpio -020,CAFETERIA y RESTAURANTS,1388778,May
2025-05-22,Food-Star Supermarket,Invoice,008-05585,Arroz Envasado:Largo Fino 1kg (Long grain rice) Dos Hermanos,,10.0,18.0,180.0,4282430.52,Branded Rice,Lisset Limpio -020,RETAIL  DSD,1388779,May
2025-05-22,Food-Star Supermarket,Invoice,008-05585,Arroz Envasado:Largo Fino 1kg (Long grain rice) Dos Hermanos,,2.0,18.0,36.0,4282466.52,Branded Rice,Lisset Limpio -020,RETAIL  DSD,1388780,May
2025-05-22,Sedanos Supermarkets #32,Invoice,008-05586,Arroz a Granel:Largo Fino 50 LB -Bolsa Dos Hermanos.,,4.0,27.85,111.4,4282577.92,Bulk Rice,Keila Alfaro-Visvikis,RETAIL SEDANOS,1388781,May
2025-05-22,Sedanos Supermarkets #32,Invoice,008-05586,Arroz a Granel:Parboiled 50 LB -Bolsa Dos Hermanos.,,6.0,28.25,169.5,4282747.42,Bulk Rice,Keila Alfaro-Visvikis,RETAIL SEDANOS,1388782,May
2025-05-22,Sedanos Supermarkets #32,Invoice,008-05586,,Discount,,,-5.62,4282741.8,,Keila Alfaro-Visvikis,RETAIL SEDANOS,1388783,May
2025-05-22,Bravo   Francisco Diaz,Invoice,008-05587,Arroz Envasado:Parboiled 5KG Dos Hermanos.,6  11lbs,5.0,40.5,202.5,4282944.3,Branded Rice,Lisset Limpio -020,RETAIL  DSD,1388784,May
2025-05-22,Bravo   Francisco Diaz,Invoice,008-05587,Arroz Envasado:Parboiled 5KG Dos Hermanos.,6  11lbs,5.0,40.5,202.5,4283146.8,Branded Rice,Lisset Limpio -020,RETAIL  DSD,1388785,May
2025-05-22,El Palacio de los jugos / Delicias Criollas (DIAGO FOOD_MILLER),Invoice,008-05588,Arroz a Granel:Parboiled 50 LB -Bolsa Dos Hermanos.,,8.0,26.75,214.0,4283360.8,Bulk Rice,Lisset Limpio -020,Cafeteria,1388786,May
2025-05-22,Bravo supermarket Coral Way 26 th,Invoice,008-05589,Dry Beans:Dry Beans - Black Beans 50,Dry Black Beans 50 lb,2.0,36.75,73.5,4283434.3,Dry Beans,Lisset Limpio -020,RETAIL  DSD,1388787,May
2025-05-22,Bravo supermarket Coral Way 26 th,Invoice,008-05589,Dry Beans:Dry Beans - Small Red Beans 50 lbs.,Small Red Beans 50 lbs,1.0,42.0,42.0,4283476.3,Dry Beans,Lisset Limpio -020,RETAIL  DSD,1388788,May
2025-05-22,Bravo supermarket Coral Way 26 th,Invoice,008-05589,Spices:AS Whole Bay Leaves,4/12 OZ,1.0,25.3,25.3,4283501.6,American Spice,Lisset Limpio -020,RETAIL  DSD,1388789,May
2025-05-22,Sedanos Supermarkets #32,Invoice,008-05590,Spanish Style Yellow Rice:AS Spanish Style Yellow Rice,AS Spanish Style Yellow Rice 6 / 3.25 oz,1.0,34.5,34.5,4283536.1,American Spice,Keila Alfaro-Visvikis,RETAIL SEDANOS,1388790,May
2025-05-22,Sedanos Supermarkets #32,Invoice,008-05590,,Discount,,,-0.69,4283535.41,,Keila Alfaro-Visvikis,RETAIL SEDANOS,1388791,May
2025-05-23,Food-Star Supermarket,Credit Memo,008-05597,Varios:Promotional Allowance,Arroz Envasado:Largo Fino 1kg (Long grain rice) Dos Hermanos,-2.0,18.0,-36.0,4283499.41,Branded Rice,Lisset Limpio -020,RETAIL  DSD,1388792,May
2025-05-23,Bravo   Francisco Diaz,Credit Memo,008-05598,Varios:Promotional Allowance,Arroz Envasado:Parboiled 5KG Dos Hermanos.,-5.0,40.5,-202.5,4283296.91,Branded Rice,Lisset Limpio -020,RETAIL  DSD,1388793,May
2025-05-24,Soriano Brothers PB,Invoice,008-05591,Arroz a Granel:Largo Fino 50 LB -Bolsa Dos Hermanos.,,5.0,27.85,139.25,4283436.16,Bulk Rice,Lisset Limpio -020,CAFETERIA y RESTAURANTS,1388794,May
2025-05-26,Key Food / Holywood,Credit Memo,008-05592,Varios:Promotional Allowance,Arroz Envasado:Largo Fino 1kg (Long grain rice) Dos Hermanos,-2.0,18.0,-36.0,4283400.16,Branded Rice,Keila Alfaro-Visvikis,RETAIL  DSD,1388795,May
2025-05-26,Neighbors Food Market / Luis Diaz,Credit Memo,008-05593,Varios:Promotional Allowance,Arroz Envasado:Parboiled 5KG Dos Hermanos.,-7.0,46.5,-325.5,4283074.66,Branded Rice,Keila Alfaro-Visvikis,RETAIL  DSD,1388796,May
2025-05-26,Neighbors Food Market / Luis Diaz,Credit Memo,008-05593,Varios:Promotional Allowance,Arroz Envasado:Largo Fino 1kg (Long grain rice) Dos Hermanos,-1.0,18.0,-18.0,4283056.66,Branded Rice,Keila Alfaro-Visvikis,RETAIL  DSD,1388797,May
2025-05-26,Price Choice Food Market # 6,Credit Memo,008-05594,Varios:Promotional Allowance,Arroz Envasado:Parboiled 5KG Dos Hermanos.,-10.0,46.5,-465.0,4282591.66,Branded Rice,Lisset Limpio -020,RETAIL  DSD,1388798,May
2025-05-26,Ideal Food Basket Davie Grocery,Credit Memo,008-05595,Varios:Promotional Allowance,Arroz Envasado:Largo Fino 1kg (Long grain rice) Dos Hermanos,-1.0,18.0,-18.0,4282573.66,Branded Rice,Keila Alfaro-Visvikis,RETAIL  DSD,1388799,May
2025-05-26,Sedanos Supermarkets #27,Credit Memo,008-05596,Varios:Promotional Allowance,Arroz Envasado:Parboiled 5KG Dos Hermanos.,-3.0,46.5,-139.5,4282434.16,Branded Rice,Keila Alfaro-Visvikis,RETAIL SEDANOS,1388800,May
2025-05-26,Sedanos Supermarkets #14,Invoice,008-05599,Arroz a Granel:Parboiled 50 LB -Bolsa Dos Hermanos.,,2.0,28.25,56.5,4282490.66,Bulk Rice,Keila Alfaro-Visvikis,RETAIL SEDANOS,1388801,May
2025-05-26,Sedanos Supermarkets #14,Invoice,008-05599,,Discount,,,-1.13,4282489.53,,Keila Alfaro-Visvikis,RETAIL SEDANOS,1388802,May
2025-05-26,Sedanos Supermarkets #14,Invoice,008-05600,Arroz Envasado:Parboiled 1kg Bolsa Dos Hermanos.,.,1.0,19.9,19.9,4282509.43,Branded Rice,Keila Alfaro-Visvikis,RETAIL SEDANOS,1388803,May
2025-05-26,Sedanos Supermarkets #14,Invoice,008-05600,Spanish Style Yellow Rice:AS Spanish Style Yellow Rice,AS Spanish Style Yellow Rice 6 / 3.25 oz,1.0,34.5,34.5,4282543.93,American Spice,Keila Alfaro-Visvikis,RETAIL SEDANOS,1388804,May
2025-05-26,Sedanos Supermarkets #14,Invoice,008-05600,,Discount,,,-1.09,4282542.84,,Keila Alfaro-Visvikis,RETAIL SEDANOS,1388805,May
2025-05-26,Sedanos Supermarkets #42,Invoice,008-05601,Spanish Style Yellow Rice:AS Spanish Style Yellow Rice,AS Spanish Style Yellow Rice 6 / 3.25 oz,1.0,34.5,34.5,4282577.34,American Spice,Keila Alfaro-Visvikis,RETAIL SEDANOS,1388806,May
2025-05-26,Sedanos Supermarkets #42,Invoice,008-05601,Arroz Envasado:Largo Fino 1kg (Long grain rice) Dos Hermanos,,1.0,17.5,17.5,4282594.84,Branded Rice,Keila Alfaro-Visvikis,RETAIL SEDANOS,1388807,May
2025-05-26,Sedanos Supermarkets #42,Invoice,008-05601,,Discount,,,-1.04,4282593.8,,Keila Alfaro-Visvikis,RETAIL SEDANOS,1388808,May
2025-05-26,Sedanos Supermarkets  #4,Invoice,008-05602,Spanish Style Yellow Rice:AS Spanish Style Yellow Rice,AS Spanish Style Yellow Rice 6 / 3.25 oz,1.0,34.5,34.5,4282628.3,American Spice,Keila Alfaro-Visvikis,RETAIL SEDANOS,1388809,May
2025-05-26,Sedanos Supermarkets  #4,Invoice,008-05602,,Discount,,,-0.69,4282627.61,,Keila Alfaro-Visvikis,RETAIL SEDANOS,1388810,May
2025-05-26,Sedanos Supermarkets #5,Invoice,008-05603,Arroz Envasado:Parboiled 5KG Dos Hermanos.,6  11lbs,5.0,40.5,202.5,4282830.11,Branded Rice,Keila Alfaro-Visvikis,RETAIL SEDANOS,1388811,May
2025-05-26,Sedanos Supermarkets #5,Invoice,008-05603,Spanish Style Yellow Rice:AS Spanish Style Yellow Rice,AS Spanish Style Yellow Rice 6 / 3.25 oz,1.0,34.5,34.5,4282864.61,American Spice,Keila Alfaro-Visvikis,RETAIL SEDANOS,1388812,May
2025-05-26,Sedanos Supermarkets #5,Invoice,008-05603,Arroz Envasado:Parboiled 5KG Dos Hermanos.,6  11lbs,2.0,40.5,81.0,4282945.61,Branded Rice,Keila Alfaro-Visvikis,RETAIL SEDANOS,1388813,May
2025-05-26,Sedanos Supermarkets #5,Invoice,008-05603,,Discount,,,-4.74,4282940.87,,Keila Alfaro-Visvikis,RETAIL SEDANOS,1388814,May
2025-05-26,China Tokyo,Invoice,008-05604,Arroz a Granel:Parboiled 50 LB -Bolsa Dos Hermanos.,,7.0,28.25,197.75,4283138.62,Bulk Rice,Lisset Limpio -020,CAFETERIA y RESTAURANTS,1388815,May
2025-05-26,Be Your Will LLC,Invoice,008-05605,Arroz a Granel:Largo Fino 50 LB -Bolsa Dos Hermanos.,,3.0,27.85,83.55,4283222.17,Bulk Rice,Lisset Limpio -020,CAFETERIA y RESTAURANTS,1388816,May
2025-05-26,Be Your Will LLC,Invoice,008-05605,Arroz a Granel:Parboiled 50 LB -Bolsa Dos Hermanos.,,11.0,26.75,294.25,4283516.42,Bulk Rice,Lisset Limpio -020,CAFETERIA y RESTAURANTS,1388817,May
2025-05-26,El Palacio de los jugos / Delicias Criollas (DIAGO FOOD_MILLER),Invoice,008-05606,Arroz a Granel:Largo Fino 50 LB -Bolsa Dos Hermanos.,,6.0,27.85,167.1,4283683.52,Bulk Rice,Lisset Limpio -020,Cafeteria,1388818,May
2025-05-26,El Palacio de los jugos / Delicias Criollas (DIAGO FOOD_MILLER),Invoice,008-05606,Arroz a Granel:Parboiled 50 LB -Bolsa Dos Hermanos.,,6.0,26.75,160.5,4283844.02,Bulk Rice,Lisset Limpio -020,Cafeteria,1388819,May
2025-05-26,El Palacio de los jugos / Rodriguez Foods,Invoice,008-05607,Arroz a Granel:Parboiled 50 LB -Bolsa Dos Hermanos.,,6.0,26.75,160.5,4284004.52,Bulk Rice,Lisset Limpio -020,Cafeteria,1388820,May
2025-05-26,El Palacio de los jugos / Caribe Tropical,Invoice,008-05608,Arroz a Granel:Parboiled 50 LB -Bolsa Dos Hermanos.,,10.0,26.75,267.5,4284272.02,Bulk Rice,Lisset Limpio -020,Cafeteria,1388821,May
2025-05-26,Los Mejores Tamales de Miami,Invoice,008-05609,Arroz a Granel:Parboiled 50 LB -Bolsa Dos Hermanos.,,3.0,28.25,84.75,4284356.77,Bulk Rice,Lisset Limpio -020,CAFETERIA y RESTAURANTS,1388822,May
2025-05-26,Sedanos Supermarkets #22,Invoice,008-05610,Spices:AS Chicken Base,1 / 30 lb. (box or pail),2.0,39.0,78.0,4284434.77,American Spice,Keila Alfaro-Visvikis,RETAIL SEDANOS,1388823,May
2025-05-26,Sedanos Supermarkets #22,Invoice,008-05610,,Discount,,,-1.56,4284433.21,,Keila Alfaro-Visvikis,RETAIL SEDANOS,1388824,May
2025-05-26,Aries Supermarket & Cafeteria,Invoice,008-05611,Arroz a Granel:Parboiled 50 LB -Bolsa Dos Hermanos.,,10.0,28.25,282.5,4284715.71,Bulk Rice,Keila Alfaro-Visvikis,CAFETERIA y RESTAURANTS,1388825,May
2025-05-26,Aries Supermarket & Cafeteria,Invoice,008-05611,Dry Beans:Dry Beans - Black Beans 50,Dry Black Beans 50 lb,5.0,36.5,182.5,4284898.21,Dry Beans,Keila Alfaro-Visvikis,CAFETERIA y RESTAURANTS,1388826,May
2025-05-26,El Palacio de los jugos / J Mena Corp.,Invoice,008-05612,Arroz a Granel:Parboiled 50 LB -Bolsa Dos Hermanos.,,10.0,26.75,267.5,4285165.71,Bulk Rice,Lisset Limpio -020,Cafeteria,1388827,May
2025-05-26,El Palacio de Los Jugos / Casa mía Food Restaurant inc,Invoice,008-05613,Liquids:AS Bitter Orange,,2.0,14.0,28.0,4285193.71,American Spice,Lisset Limpio -020,Cafeteria,1388828,May
2025-05-26,El Palacio de Los Jugos / Casa mía Food Restaurant inc,Invoice,008-05613,Liquids:AS Marinating Sauce (Mojo),,1.0,17.0,17.0,4285210.71,American Spice,Lisset Limpio -020,Cafeteria,1388829,May
2025-05-26,El Palacio de Los Jugos / Casa mía Food Restaurant inc,Invoice,008-05613,Arroz a Granel:Parboiled 50 LB -Bolsa Dos Hermanos.,,7.0,26.75,187.25,4285397.96,Bulk Rice,Lisset Limpio -020,Cafeteria,1388830,May
2025-05-26,Soriano Brothers PB,Invoice,008-05614,Spices:AS Sazon (for all),1 / 30 lb (box or pail),2.0,51.0,102.0,4285499.96,American Spice,Lisset Limpio -020,CAFETERIA y RESTAURANTS,1388831,May
2025-05-26,Soriano Brothers PB,Invoice,008-05614,Arroz a Granel:Largo Fino 50 LB -Bolsa Dos Hermanos.,,12.0,27.85,334.2,4285834.16,Bulk Rice,Lisset Limpio -020,CAFETERIA y RESTAURANTS,1388832,May
2025-05-26,Soriano Brothers PB,Invoice,008-05614,Arroz a Granel:Parboiled 50 LB -Bolsa Dos Hermanos.,,9.0,26.75,240.75,4286074.91,Bulk Rice,Lisset Limpio -020,CAFETERIA y RESTAURANTS,1388833,May
2025-05-26,Soriano Brothers PB,Invoice,008-05614,Dry Beans:Dry Beans - Black Beans 50,Dry Black Beans 50 lb,2.0,34.0,68.0,4286142.91,Dry Beans,Lisset Limpio -020,CAFETERIA y RESTAURANTS,1388834,May
2025-05-26,HONG KONG,Invoice,008-05615,Arroz a Granel:Parboiled 50 LB -Bolsa Dos Hermanos.,,5.0,28.25,141.25,4286284.16,Bulk Rice,Lisset Limpio -020,CAFETERIA y RESTAURANTS,1388835,May
2025-05-26,Price Choice 5 YNTO Food Corp.,Invoice,008-05616,Arroz Envasado:Largo Fino 1kg (Long grain rice) Dos Hermanos,,3.0,18.0,54.0,4286338.16,Branded Rice,Keila Alfaro-Visvikis,RETAIL  DSD,1388836,May
2025-05-26,Price Choice 5 YNTO Food Corp.,Invoice,008-05616,Arroz Envasado:Parboiled 1kg Bolsa Dos Hermanos.,.,2.0,19.9,39.8,4286377.96,Branded Rice,Keila Alfaro-Visvikis,RETAIL  DSD,1388837,May
2025-05-26,Price Choice 5 YNTO Food Corp.,Invoice,008-05616,Arroz Envasado:Largo Fino 1kg (Long grain rice) Dos Hermanos,,1.0,19.9,19.9,4286397.86,Branded Rice,Keila Alfaro-Visvikis,RETAIL  DSD,1388838,May
2025-05-26,JMN Dely Corp,Invoice,008-05617,Dry Beans:Dry Beans - Black Beans 50,Dry Black Beans 50 lb,1.0,45.7,45.7,4286443.56,Dry Beans,Keila Alfaro-Visvikis,CAFETERIA y RESTAURANTS,1388839,May
2025-05-26,JMN Dely Corp,Invoice,008-05617,Arroz a Granel:Largo Fino 50 LB -Bolsa Dos Hermanos.,,2.0,27.85,55.7,4286499.26,Bulk Rice,Keila Alfaro-Visvikis,CAFETERIA y RESTAURANTS,1388840,May
2025-05-26,JMN Dely Corp,Invoice,008-05617,Arroz a Granel:Parboiled 50 LB -Bolsa Dos Hermanos.,,2.0,27.75,55.5,4286554.76,Bulk Rice,Keila Alfaro-Visvikis,CAFETERIA y RESTAURANTS,1388841,May
2025-05-26,Sedanos Supermarkets #5,Credit Memo,008-05665,Varios:Promotional Allowance,Arroz Envasado:Parboiled 5KG Dos Hermanos.,-2.0,40.5,-81.0,4286473.76,Branded Rice,Keila Alfaro-Visvikis,RETAIL SEDANOS,1388842,May
2025-05-26,Price Choice 5 YNTO Food Corp.,Credit Memo,008-05666,Varios:Promotional Allowance,Arroz Envasado:Largo Fino 1kg (Long grain rice) Dos Hermanos,-1.0,19.9,-19.9,4286453.86,Branded Rice,Keila Alfaro-Visvikis,RETAIL  DSD,1388843,May
2025-05-28,Bake Mark USA LLC,Invoice,008-05536,Arroz a Granel:Parboiled 50 LB -Bolsa Dos Hermanos.,,1100.0,22.9,25190.0,4311643.86,Bulk Rice,Armando Carpio - 017,WHOLESALER MANUFACTURY,1388844,May
2025-05-28,Sedanos Supermarkets #24,Invoice,008-05618,Arroz Envasado:Largo Fino 1kg (Long grain rice) Dos Hermanos,,1.0,17.5,17.5,4311661.36,Branded Rice,Keila Alfaro-Visvikis,RETAIL SEDANOS,1388845,May
2025-05-28,Sedanos Supermarkets #24,Invoice,008-05618,Spanish Style Yellow Rice:AS Spanish Style Yellow Rice,AS Spanish Style Yellow Rice 6 / 3.25 oz,1.0,34.5,34.5,4311695.86,American Spice,Keila Alfaro-Visvikis,RETAIL SEDANOS,1388846,May
2025-05-28,Sedanos Supermarkets #24,Invoice,008-05618,,Discount,,,-1.04,4311694.82,,Keila Alfaro-Visvikis,RETAIL SEDANOS,1388847,May
2025-05-28,Sedanos Supermarkets #24,Invoice,008-05619,Arroz a Granel:Parboiled 50 LB -Bolsa Dos Hermanos.,,8.0,28.25,226.0,4311920.82,Bulk Rice,Keila Alfaro-Visvikis,RETAIL SEDANOS,1388848,May
2025-05-28,Sedanos Supermarkets #24,Invoice,008-05619,,Discount,,,-4.52,4311916.3,,Keila Alfaro-Visvikis,RETAIL SEDANOS,1388849,May
2025-05-28,Food Giant Market  10 Ave.,Invoice,008-05620,Arroz Envasado:Parboiled 5KG Dos Hermanos.,6  11lbs,15.0,46.5,697.5,4312613.8,Branded Rice,Keila Alfaro-Visvikis,RETAIL  DSD,1388850,May
2025-05-28,Food Giant Market  10 Ave.,Invoice,008-05620,Arroz Envasado:Parboiled 5KG Dos Hermanos.,6  11lbs,7.0,46.5,325.5,4312939.3,Branded Rice,Keila Alfaro-Visvikis,RETAIL  DSD,1388851,May
2025-05-28,El Palacio de los jugos / Leti Corp.,Invoice,008-05621,Arroz a Granel:Largo Fino 50 LB -Bolsa Dos Hermanos.,,6.0,27.85,167.1,4313106.4,Bulk Rice,Lisset Limpio -020,Cafeteria,1388852,May
2025-05-28,El Palacio de los jugos / Leti Corp.,Invoice,008-05621,Arroz a Granel:Parboiled 50 LB -Bolsa Dos Hermanos.,,6.0,26.75,160.5,4313266.9,Bulk Rice,Lisset Limpio -020,Cafeteria,1388853,May
2025-05-28,La Ranchera Meat Market #3,Invoice,008-05622,Arroz a Granel:Largo Fino 50 LB -Bolsa Dos Hermanos.,,20.0,27.85,557.0,4313823.9,Bulk Rice,Keila Alfaro-Visvikis,CAFETERIA y RESTAURANTS,1388854,May
2025-05-28,Ideal Food Basket Davie Cafeteria,Invoice,008-05623,Arroz a Granel:Largo Fino 50 LB -Bolsa Dos Hermanos.,,8.0,27.85,222.8,4314046.7,Bulk Rice,Keila Alfaro-Visvikis,CAFETERIA y RESTAURANTS,1388855,May
2025-05-28,El Palacio de los jugos /  Nanos Latin Foods,Invoice,008-05624,Arroz a Granel:Largo Fino 50 LB -Bolsa Dos Hermanos.,,5.0,27.85,139.25,4314185.95,Bulk Rice,Lisset Limpio -020,Cafeteria,1388856,May
2025-05-28,El Palacio de los jugos /  Nanos Latin Foods,Invoice,008-05624,Arroz a Granel:Parboiled 50 LB -Bolsa Dos Hermanos.,,9.0,26.75,240.75,4314426.7,Bulk Rice,Lisset Limpio -020,Cafeteria,1388857,May
2025-05-28,El Palacio de los jugos /  Nanos Latin Foods,Invoice,008-05624,Dry Beans:Dry Beans - Black Beans 50,Dry Black Beans 50 lb,1.0,34.0,34.0,4314460.7,Dry Beans,Lisset Limpio -020,Cafeteria,1388858,May
2025-05-28,Rey Chavez Distributor #2,Invoice,008-05625,Arroz a Granel:Parboiled 50 LB -Bolsa Dos Hermanos.,,20.0,27.5,550.0,4315010.7,Bulk Rice,Lisset Limpio -020,WHOLESALER,1388859,May
2025-05-28,Sedanos Supermarkets #16,Invoice,008-05626,Arroz a Granel:Parboiled 50 LB -Bolsa Dos Hermanos.,,5.0,28.25,141.25,4315151.95,Bulk Rice,Keila Alfaro-Visvikis,RETAIL SEDANOS,1388860,May
2025-05-28,Sedanos Supermarkets #16,Invoice,008-05626,,Discount,,,-2.83,4315149.12,,Keila Alfaro-Visvikis,RETAIL SEDANOS,1388861,May
2025-05-28,"El Toro Loco Meat Distribution, LLC",Invoice,008-05627,Arroz a Granel:Largo Fino 50 LB -Bolsa Dos Hermanos.,,55.0,27.85,1531.75,4316680.87,Bulk Rice,Lisset Limpio -020,CAFETERIA y RESTAURANTS,1388862,May
2025-05-28,"El Toro Loco Meat Distribution, LLC",Invoice,008-05627,Dry Beans:Dry Beans - Black Beans 50,Dry Black Beans 50 lb,55.0,36.0,1980.0,4318660.87,Dry Beans,Lisset Limpio -020,CAFETERIA y RESTAURANTS,1388863,May
2025-05-28,"El Toro Loco Meat Distribution, LLC",Invoice,008-05627,Dry Beans:Dry Beans - Small Red Beans 50 lbs.,Small Red Beans 50 lbs,2.0,41.0,82.0,4318742.87,Dry Beans,Lisset Limpio -020,CAFETERIA y RESTAURANTS,1388864,May
2025-05-28,Sabor Tropical Supermarket #4,Invoice,008-05628,Arroz Envasado:Parboiled 5KG Dos Hermanos.,6  11lbs,15.0,46.5,697.5,4319440.37,Branded Rice,Keila Alfaro-Visvikis,RETAIL  DSD,1388865,May
2025-05-28,Sabor Tropical Supermarket #4,Invoice,008-05628,Arroz Envasado:Parboiled 5KG Dos Hermanos.,6  11lbs,8.0,46.5,372.0,4319812.37,Branded Rice,Keila Alfaro-Visvikis,RETAIL  DSD,1388866,May
2025-05-28,Sedanos Supermarkets #8,Invoice,008-05629,Spanish Style Yellow Rice:AS Spanish Style Yellow Rice,AS Spanish Style Yellow Rice 6 / 3.25 oz,1.0,34.5,34.5,4319846.87,American Spice,Keila Alfaro-Visvikis,RETAIL SEDANOS,1388867,May
2025-05-28,Sedanos Supermarkets #8,Invoice,008-05629,Arroz Envasado:Parboiled 5KG Dos Hermanos.,6  11lbs,10.0,40.5,405.0,4320251.87,Branded Rice,Keila Alfaro-Visvikis,RETAIL SEDANOS,1388868,May
2025-05-28,Sedanos Supermarkets #8,Invoice,008-05629,Arroz Envasado:Parboiled 5KG Dos Hermanos.,6  11lbs,2.0,40.5,81.0,4320332.87,Branded Rice,Keila Alfaro-Visvikis,RETAIL SEDANOS,1388869,May
2025-05-28,Sedanos Supermarkets #8,Invoice,008-05629,,Discount,,,-8.79,4320324.08,,Keila Alfaro-Visvikis,RETAIL SEDANOS,1388870,May
2025-05-28,Food Giant Market  10 Ave.,Credit Memo,008-05630,Varios:Producto vencido/deteriorado (no impacta en inventario),19 salami         y 19 ham,-38.0,0.99,-37.62,4320286.46,Puffed Products,Keila Alfaro-Visvikis,RETAIL  DSD,1388871,May
2025-05-28,Food Giant Market  10 Ave.,Credit Memo,008-05667,Varios:Promotional Allowance,Arroz Envasado:Parboiled 5KG Dos Hermanos.,-7.0,46.5,-325.5,4319960.96,Branded Rice,Keila Alfaro-Visvikis,RETAIL  DSD,1388872,May
2025-05-28,Sabor Tropical Supermarket #4,Credit Memo,008-05668,Varios:Promotional Allowance,Arroz Envasado:Parboiled 5KG Dos Hermanos.,-8.0,46.5,-372.0,4319588.96,Branded Rice,Keila Alfaro-Visvikis,RETAIL  DSD,1388873,May
2025-05-28,Sedanos Supermarkets #8,Credit Memo,008-05669,Varios:Promotional Allowance,Arroz Envasado:Parboiled 5KG Dos Hermanos.,-2.0,40.5,-81.0,4319507.96,Branded Rice,Keila Alfaro-Visvikis,RETAIL SEDANOS,1388874,May
2025-05-29,Bravo   Francisco Diaz,Invoice,008-05631,Spices:AS Chicken Base,1 / 30 lb. (box or pail),1.0,39.0,39.0,4319546.96,American Spice,Lisset Limpio -020,RETAIL  DSD,1388875,May
2025-05-29,Bravo   Francisco Diaz,Invoice,008-05631,Spices:AS Meat Tenderizer,12 / 4.5 oz,1.0,25.0,25.0,4319571.96,American Spice,Lisset Limpio -020,RETAIL  DSD,1388876,May
2025-05-29,Bravo   Francisco Diaz,Invoice,008-05631,Arroz a Granel:Largo Fino 50 LB -Bolsa Dos Hermanos.,,3.0,27.85,83.55,4319655.51,Bulk Rice,Lisset Limpio -020,RETAIL  DSD,1388877,May
2025-05-29,Bravo   Francisco Diaz,Invoice,008-05631,Spices:AS Sazon (for all),1 / 30 lb (box or pail),1.0,51.0,51.0,4319706.51,American Spice,Lisset Limpio -020,RETAIL  DSD,1388878,May
2025-05-29,Sedanos Supermarkets #33,Invoice,008-05632,Arroz a Granel:Parboiled 50 LB -Bolsa Dos Hermanos.,,4.0,28.25,113.0,4319819.51,Bulk Rice,Keila Alfaro-Visvikis,RETAIL SEDANOS,1388879,May
2025-05-29,Sedanos Supermarkets #33,Invoice,008-05632,,Discount,,,-2.26,4319817.25,,Keila Alfaro-Visvikis,RETAIL SEDANOS,1388880,May
2025-05-29,El Palacio de los jugos / Divan and Denise Food,Invoice,008-05633,Arroz a Granel:Largo Fino 50 LB -Bolsa Dos Hermanos.,,2.0,27.85,55.7,4319872.95,Bulk Rice,Lisset Limpio -020,Cafeteria,1388881,May
2025-05-29,El Palacio de los jugos / Divan and Denise Food,Invoice,008-05633,Arroz a Granel:Parboiled 50 LB -Bolsa Dos Hermanos.,,4.0,26.75,107.0,4319979.95,Bulk Rice,Lisset Limpio -020,Cafeteria,1388882,May
2025-05-29,El Palacio de los jugos / Divan and Denise Food,Invoice,008-05633,Dry Beans:Dry Beans - Black Beans 50,Dry Black Beans 50 lb,1.0,34.0,34.0,4320013.95,Dry Beans,Lisset Limpio -020,Cafeteria,1388883,May
2025-05-29,El Palacio de los jugos / Lita Foods Inc.,Invoice,008-05634,Dry Beans:Dry Beans - Black Beans 50,Dry Black Beans 50 lb,1.0,34.0,34.0,4320047.95,Dry Beans,Lisset Limpio -020,Cafeteria,1388884,May
2025-05-29,El Palacio de los jugos / Lita Foods Inc.,Invoice,008-05634,Arroz a Granel:Parboiled 50 LB -Bolsa Dos Hermanos.,,12.0,26.75,321.0,4320368.95,Bulk Rice,Lisset Limpio -020,Cafeteria,1388885,May
2025-05-29,Sedanos Supermarkets #18,Invoice,008-05635,Arroz a Granel:Parboiled 50 LB -Bolsa Dos Hermanos.,,10.0,28.25,282.5,4320651.45,Bulk Rice,Keila Alfaro-Visvikis,RETAIL SEDANOS,1388886,May
2025-05-29,Sedanos Supermarkets #18,Invoice,008-05635,,Discount,,,-5.65,4320645.8,,Keila Alfaro-Visvikis,RETAIL SEDANOS,1388887,May
2025-05-29,Sedanos Supermarkets  #37,Invoice,008-05636,Spanish Style Yellow Rice:AS Spanish Style Yellow Rice,AS Spanish Style Yellow Rice 6 / 3.25 oz,1.0,34.5,34.5,4320680.3,American Spice,Keila Alfaro-Visvikis,RETAIL SEDANOS,1388888,May
2025-05-29,Sedanos Supermarkets  #37,Invoice,008-05636,Arroz Envasado:Largo Fino 1kg (Long grain rice) Dos Hermanos,,1.0,17.5,17.5,4320697.8,Branded Rice,Keila Alfaro-Visvikis,RETAIL SEDANOS,1388889,May
2025-05-29,Sedanos Supermarkets  #37,Invoice,008-05636,Arroz Envasado:Parboiled 5KG Dos Hermanos.,6  11lbs,15.0,40.5,607.5,4321305.3,Branded Rice,Keila Alfaro-Visvikis,RETAIL SEDANOS,1388890,May
2025-05-29,Sedanos Supermarkets  #37,Invoice,008-05636,Arroz Envasado:Parboiled 5KG Dos Hermanos.,6  11lbs,3.0,40.5,121.5,4321426.8,Branded Rice,Keila Alfaro-Visvikis,RETAIL SEDANOS,1388891,May
2025-05-29,Sedanos Supermarkets  #37,Invoice,008-05636,,Discount,,,-13.19,4321413.61,,Keila Alfaro-Visvikis,RETAIL SEDANOS,1388892,May
2025-05-29,El Palacio de Los Jugos / Casa mía Food Restaurant inc,Invoice,008-05637,Spices:AS Sazon (for all),1 / 30 lb (box or pail),2.0,51.0,102.0,4321515.61,American Spice,Lisset Limpio -020,Cafeteria,1388893,May
2025-05-29,El Palacio de Los Jugos / Casa mía Food Restaurant inc,Invoice,008-05637,Spices:AS Chicken Base,1 / 30 lb. (box or pail),1.0,39.0,39.0,4321554.61,American Spice,Lisset Limpio -020,Cafeteria,1388894,May
2025-05-29,El Palacio de Los Jugos / Casa mía Food Restaurant inc,Invoice,008-05637,Arroz a Granel:Parboiled 50 LB -Bolsa Dos Hermanos.,,8.0,26.75,214.0,4321768.61,Bulk Rice,Lisset Limpio -020,Cafeteria,1388895,May
2025-05-29,Sedanos Supermarkets #32,Invoice,008-05638,Arroz a Granel:Largo Fino 50 LB -Bolsa Dos Hermanos.,,4.0,27.85,111.4,4321880.01,Bulk Rice,Keila Alfaro-Visvikis,RETAIL SEDANOS,1388896,May
2025-05-29,Sedanos Supermarkets #32,Invoice,008-05638,,Discount,,,-2.23,4321877.78,,Keila Alfaro-Visvikis,RETAIL SEDANOS,1388897,May
2025-05-29,El Palacio de los jugos / Caribe Tropical,Invoice,008-05639,Arroz a Granel:Parboiled 50 LB -Bolsa Dos Hermanos.,,6.0,26.75,160.5,4322038.28,Bulk Rice,Lisset Limpio -020,Cafeteria,1388898,May
2025-05-29,El Palacio de los jugos / Rodriguez Foods,Invoice,008-05640,Arroz a Granel:Parboiled 50 LB -Bolsa Dos Hermanos.,,6.0,26.75,160.5,4322198.78,Bulk Rice,Lisset Limpio -020,Cafeteria,1388899,May
2025-05-29,Bravo   Francisco Diaz,Invoice,008-05641,Spanish Style Yellow Rice:AS Spanish Style Yellow Rice,AS Spanish Style Yellow Rice 6 / 3.25 oz,1.0,34.5,34.5,4322233.28,American Spice,Lisset Limpio -020,RETAIL  DSD,1388900,May
2025-05-29,El Gallego Supermarket,Invoice,008-05642,Dry Beans:Dry Beans - Black Beans 50,Dry Black Beans 50 lb,2.0,35.0,70.0,4322303.28,Dry Beans,Lisset Limpio -020,RETAIL  DSD,1388901,May
2025-05-29,El Gallego Supermarket,Invoice,008-05642,Liquids:AS Bitter Orange,,2.0,14.0,28.0,4322331.28,American Spice,Lisset Limpio -020,RETAIL  DSD,1388902,May
2025-05-29,El Gallego Supermarket,Invoice,008-05642,Liquids:AS Cooking Wine,4 1 Gl.,1.0,17.5,17.5,4322348.78,American Spice,Lisset Limpio -020,RETAIL  DSD,1388903,May
2025-05-29,El Gallego Supermarket,Invoice,008-05642,Arroz a Granel:Parboiled 50 LB -Bolsa Dos Hermanos.,,3.0,28.25,84.75,4322433.53,Bulk Rice,Lisset Limpio -020,RETAIL  DSD,1388904,May
2025-05-29,VIÑA & SONS FOOD DIST.CORP,Invoice,008-05643,Arroz a Granel:Parboiled 50 LB -Bolsa Dos Hermanos.,,25.0,27.75,693.75,4323127.28,Bulk Rice,Keila Alfaro-Visvikis,CAFETERIA y RESTAURANTS,1388905,May
2025-05-29,VIÑA & SONS FOOD DIST.CORP,Invoice,008-05643,Arroz Envasado:Parboiled 5KG Dos Hermanos.,6  11lbs,2.0,40.5,81.0,4323208.28,Branded Rice,Keila Alfaro-Visvikis,CAFETERIA y RESTAURANTS,1388906,May
2025-05-29,Sedanos Supermarkets #42,Invoice,008-05644,Arroz a Granel:Parboiled 50 LB -Bolsa Dos Hermanos.,,5.0,28.25,141.25,4323349.53,Bulk Rice,Keila Alfaro-Visvikis,RETAIL SEDANOS,1388907,May
2025-05-29,Sedanos Supermarkets #42,Invoice,008-05644,,Discount,,,-2.83,4323346.7,,Keila Alfaro-Visvikis,RETAIL SEDANOS,1388908,May
2025-05-29,Sedanos Supermarkets #42,Credit Memo,008-05645,Varios:Producto vencido/deteriorado (no impacta en inventario),13 salami 6 ham,-19.0,1.32,-25.08,4323321.62,Puffed Products,Keila Alfaro-Visvikis,RETAIL SEDANOS,1388909,May
2025-05-29,Sedanos Supermarkets #42,Credit Memo,008-05645,Varios:Producto vencido/deteriorado (no impacta en inventario),12 units parboiled 5k,-12.0,3.37,-40.44,4323281.18,Branded Rice,Keila Alfaro-Visvikis,RETAIL SEDANOS,1388910,May
2025-05-29,Sedanos Supermarkets  #37,Credit Memo,008-05670,Varios:Promotional Allowance,Arroz Envasado:Parboiled 5KG Dos Hermanos.,-3.0,40.5,-121.5,4323159.68,Branded Rice,Keila Alfaro-Visvikis,RETAIL SEDANOS,1388911,May
2025-05-30,"American Spice Trading Co, Inc.",Invoice,008-05646,Arroz a Granel:Parboiled 50 LB -Bolsa Dos Hermanos.,,1100.0,26.0,28600.0,4351759.68,Bulk Rice,Armando Carpio - 017,WHOLESALER MANUFACTURY,1388912,May
2025-05-30,"American Spice Trading Co, Inc.",Invoice,008-05647,Arroz a Granel:Parboiled 50 LB -Bolsa Dos Hermanos.,,1100.0,26.0,28600.0,4380359.68,Bulk Rice,Armando Carpio - 017,WHOLESALER MANUFACTURY,1388913,May
2025-05-30,Sedanos Supermarkets #29,Invoice,008-05648,Arroz Envasado:Parboiled 5KG Dos Hermanos.,6  11lbs,15.0,40.5,607.5,4380967.18,Branded Rice,Keila Alfaro-Visvikis,RETAIL SEDANOS,1388914,May
2025-05-30,Sedanos Supermarkets #29,Invoice,008-05648,Spanish Style Yellow Rice:AS Spanish Style Yellow Rice,AS Spanish Style Yellow Rice 6 / 3.25 oz,1.0,34.5,34.5,4381001.68,American Spice,Keila Alfaro-Visvikis,RETAIL SEDANOS,1388915,May
2025-05-30,Sedanos Supermarkets #29,Invoice,008-05648,Arroz Envasado:Parboiled 5KG Dos Hermanos.,6  11lbs,4.0,40.5,162.0,4381163.68,Branded Rice,Keila Alfaro-Visvikis,RETAIL SEDANOS,1388916,May
2025-05-30,Sedanos Supermarkets #29,Invoice,008-05648,,Discount,,,-12.84,4381150.84,,Keila Alfaro-Visvikis,RETAIL SEDANOS,1388917,May
2025-05-30,Sedanos Supermarkets #21,Invoice,008-05649,Spanish Style Yellow Rice:AS Spanish Style Yellow Rice,AS Spanish Style Yellow Rice 6 / 3.25 oz,1.0,34.5,34.5,4381185.34,American Spice,Keila Alfaro-Visvikis,RETAIL SEDANOS,1388918,May
2025-05-30,Sedanos Supermarkets #21,Invoice,008-05649,,Discount,,,-0.69,4381184.65,,Keila Alfaro-Visvikis,RETAIL SEDANOS,1388919,May
2025-05-30,Sedanos Supermarkets #31,Invoice,008-05650,Arroz a Granel:Parboiled 50 LB -Bolsa Dos Hermanos.,,6.0,28.25,169.5,4381354.15,Bulk Rice,Keila Alfaro-Visvikis,RETAIL SEDANOS,1388920,May
2025-05-30,Sedanos Supermarkets #31,Invoice,008-05650,,Discount,,,-3.39,4381350.76,,Keila Alfaro-Visvikis,RETAIL SEDANOS,1388921,May
2025-05-30,Sedanos Supermarkets #31,Invoice,008-05651,Arroz Envasado:Largo Fino 1kg (Long grain rice) Dos Hermanos,,2.0,17.5,35.0,4381385.76,Branded Rice,Keila Alfaro-Visvikis,RETAIL SEDANOS,1388922,May
2025-05-30,Sedanos Supermarkets #31,Invoice,008-05651,Spanish Style Yellow Rice:AS Spanish Style Yellow Rice,AS Spanish Style Yellow Rice 6 / 3.25 oz,1.0,34.5,34.5,4381420.26,American Spice,Keila Alfaro-Visvikis,RETAIL SEDANOS,1388923,May
2025-05-30,Sedanos Supermarkets #31,Invoice,008-05651,,Discount,,,-1.05,4381419.21,,Keila Alfaro-Visvikis,RETAIL SEDANOS,1388924,May
2025-05-30,Sedanos Supermarkets #29,Credit Memo,008-05671,Varios:Promotional Allowance,Arroz Envasado:Parboiled 5KG Dos Hermanos.,-4.0,40.5,-162.0,4381257.21,Branded Rice,Keila Alfaro-Visvikis,RETAIL SEDANOS,1388925,May
2025-06-01,El Palacio de los jugos / J Mena Corp.,Invoice,008-05652,Dry Beans:Dry Beans - Black Beans 50,Dry Black Beans 50 lb,1.0,34.0,34.0,4381291.21,Dry Beans,Lisset Limpio -020,Cafeteria,1388926,Jun
2025-06-01,El Palacio de los jugos / J Mena Corp.,Invoice,008-05652,Arroz a Granel:Parboiled 50 LB -Bolsa Dos Hermanos.,,10.0,26.75,267.5,4381558.71,Bulk Rice,Lisset Limpio -020,Cafeteria,1388927,Jun
2025-06-01,Bravo   Francisco Diaz,Invoice,008-05653,Arroz a Granel:Largo Fino 50 LB -Bolsa Dos Hermanos.,,3.0,27.85,83.55,4381642.26,Bulk Rice,Lisset Limpio -020,RETAIL  DSD,1388928,Jun
2025-06-01,Bravo   Francisco Diaz,Invoice,008-05653,Dry Beans:Dry Beans - Black Beans 50,Dry Black Beans 50 lb,1.0,35.0,35.0,4381677.26,Dry Beans,Lisset Limpio -020,RETAIL  DSD,1388929,Jun
2025-06-01,Soriano Brothers PB,Invoice,008-05654,Spices:AS Sazon (for all),1 / 30 lb (box or pail),2.0,51.0,102.0,4381779.26,American Spice,Lisset Limpio -020,CAFETERIA y RESTAURANTS,1388930,Jun
2025-06-01,Soriano Brothers PB,Invoice,008-05654,Arroz a Granel:Largo Fino 50 LB -Bolsa Dos Hermanos.,,12.0,27.85,334.2,4382113.46,Bulk Rice,Lisset Limpio -020,CAFETERIA y RESTAURANTS,1388931,Jun
2025-06-01,Soriano Brothers PB,Invoice,008-05654,Arroz a Granel:Parboiled 50 LB -Bolsa Dos Hermanos.,,17.0,26.75,454.75,4382568.21,Bulk Rice,Lisset Limpio -020,CAFETERIA y RESTAURANTS,1388932,Jun
2025-06-01,Soriano Brothers PB,Invoice,008-05654,Dry Beans:Dry Beans - Black Beans 50,Dry Black Beans 50 lb,2.0,34.0,68.0,4382636.21,Dry Beans,Lisset Limpio -020,CAFETERIA y RESTAURANTS,1388933,Jun
2025-06-01,Fritanga Momotombo,Invoice,008-05655,Arroz a Granel:Largo Fino 50 LB -Bolsa Dos Hermanos.,,5.0,27.85,139.25,4382775.46,Bulk Rice,Lisset Limpio -020,CAFETERIA y RESTAURANTS,1388934,Jun
2025-06-01,Fritanga Momotombo,Invoice,008-05655,Spices:AS Chicken Base,1 / 30 lb. (box or pail),1.0,39.0,39.0,4382814.46,American Spice,Lisset Limpio -020,CAFETERIA y RESTAURANTS,1388935,Jun
2025-06-01,ALS Foods,Invoice,008-05656,Liquids:AS Cooking Wine,4 1 Gl.,2.0,17.5,35.0,4382849.46,American Spice,Lisset Limpio -020,CAFETERIA y RESTAURANTS,1388936,Jun
2025-06-01,ALS Foods,Invoice,008-05656,Arroz a Granel:Largo Fino 50 LB -Bolsa Dos Hermanos.,,7.0,27.85,194.95,4383044.41,Bulk Rice,Lisset Limpio -020,CAFETERIA y RESTAURANTS,1388937,Jun
2025-06-01,ALS Foods,Invoice,008-05656,Arroz a Granel:Parboiled 50 LB -Bolsa Dos Hermanos.,,11.0,26.75,294.25,4383338.66,Bulk Rice,Lisset Limpio -020,CAFETERIA y RESTAURANTS,1388938,Jun
2025-06-01,El Palacio de Los Jugos / Casa mía Food Restaurant inc,Invoice,008-05657,Liquids:AS Marinating Sauce (Mojo),,1.0,17.0,17.0,4383355.66,American Spice,Lisset Limpio -020,Cafeteria,1388939,Jun
2025-06-01,El Palacio de Los Jugos / Casa mía Food Restaurant inc,Invoice,008-05657,Liquids:AS Lemon Juice 4/1 Gl,,1.0,14.95,14.95,4383370.61,American Spice,Lisset Limpio -020,Cafeteria,1388940,Jun
2025-06-01,El Palacio de Los Jugos / Casa mía Food Restaurant inc,Invoice,008-05657,Arroz a Granel:Parboiled 50 LB -Bolsa Dos Hermanos.,,8.0,26.75,214.0,4383584.61,Bulk Rice,Lisset Limpio -020,Cafeteria,1388941,Jun
2025-06-01,El Palacio de los jugos /  Nanos Latin Foods,Invoice,008-05658,Arroz a Granel:Largo Fino 50 LB -Bolsa Dos Hermanos.,,5.0,27.85,139.25,4383723.86,Bulk Rice,Lisset Limpio -020,Cafeteria,1388942,Jun
2025-06-01,El Palacio de los jugos /  Nanos Latin Foods,Invoice,008-05658,Arroz a Granel:Parboiled 50 LB -Bolsa Dos Hermanos.,,10.0,26.75,267.5,4383991.36,Bulk Rice,Lisset Limpio -020,Cafeteria,1388943,Jun
2025-06-01,El Palacio de los jugos / Rodriguez Foods,Invoice,008-05659,Arroz a Granel:Parboiled 50 LB -Bolsa Dos Hermanos.,,6.0,26.75,160.5,4384151.86,Bulk Rice,Lisset Limpio -020,Cafeteria,1388944,Jun
2025-06-01,El Palacio de los jugos / Delicias Criollas (DIAGO FOOD_MILLER),Invoice,008-05660,Arroz a Granel:Parboiled 50 LB -Bolsa Dos Hermanos.,,14.0,26.75,374.5,4384526.36,Bulk Rice,Lisset Limpio -020,Cafeteria,1388945,Jun
2025-06-01,El Palacio de los jugos / Delicias Criollas (DIAGO FOOD_MILLER),Invoice,008-05660,Dry Beans:Dry Beans - Black Beans 50,Dry Black Beans 50 lb,1.0,34.0,34.0,4384560.36,Dry Beans,Lisset Limpio -020,Cafeteria,1388946,Jun
2025-06-01,El Palacio de los jugos / Caribe Tropical,Invoice,008-05661,Dry Beans:Dry Beans - Black Beans 50,Dry Black Beans 50 lb,3.0,34.0,102.0,4384662.36,Dry Beans,Lisset Limpio -020,Cafeteria,1388947,Jun
2025-06-01,El Palacio de los jugos / Caribe Tropical,Invoice,008-05661,Arroz a Granel:Parboiled 50 LB -Bolsa Dos Hermanos.,,8.0,26.75,214.0,4384876.36,Bulk Rice,Lisset Limpio -020,Cafeteria,1388948,Jun
2025-06-01,El Palacio de los jugos / Divan and Denise Food,Invoice,008-05662,Dry Beans:Dry Beans - Black Beans 50,Dry Black Beans 50 lb,1.0,34.0,34.0,4384910.36,Dry Beans,Lisset Limpio -020,Cafeteria,1388949,Jun
2025-06-01,El Palacio de los jugos / Divan and Denise Food,Invoice,008-05662,Arroz a Granel:Largo Fino 50 LB -Bolsa Dos Hermanos.,,9.0,27.85,250.65,4385161.01,Bulk Rice,Lisset Limpio -020,Cafeteria,1388950,Jun
2025-06-01,El Palacio de los jugos / Divan and Denise Food,Invoice,008-05662,Arroz a Granel:Parboiled 50 LB -Bolsa Dos Hermanos.,,7.0,26.75,187.25,4385348.26,Bulk Rice,Lisset Limpio -020,Cafeteria,1388951,Jun
2025-06-01,JMN Dely Corp,Invoice,008-05663,Dry Beans:Dry Beans - Black Beans 50,Dry Black Beans 50 lb,1.0,45.7,45.7,4385393.96,Dry Beans,Keila Alfaro-Visvikis,CAFETERIA y RESTAURANTS,1388952,Jun
2025-06-01,JMN Dely Corp,Invoice,008-05663,Arroz a Granel:Largo Fino 50 LB -Bolsa Dos Hermanos.,,2.0,27.85,55.7,4385449.66,Bulk Rice,Keila Alfaro-Visvikis,CAFETERIA y RESTAURANTS,1388953,Jun
2025-06-01,JMN Dely Corp,Invoice,008-05663,Arroz a Granel:Parboiled 50 LB -Bolsa Dos Hermanos.,,2.0,27.75,55.5,4385505.16,Bulk Rice,Keila Alfaro-Visvikis,CAFETERIA y RESTAURANTS,1388954,Jun
2025-06-01,Sedanos Supermarkets #31,Credit Memo,008-05664,Varios:Producto vencido/deteriorado (no impacta en inventario),5 unid 5kg,-5.0,3.37,-16.85,4385488.31,Branded Rice,Keila Alfaro-Visvikis,RETAIL SEDANOS,1388955,Jun
2025-06-04,Ideal Food Basket Davie Cafeteria,Invoice,008-05672,Arroz a Granel:Largo Fino 50 LB -Bolsa Dos Hermanos.,,8.0,27.85,222.8,4385711.11,Bulk Rice,Keila Alfaro-Visvikis,CAFETERIA y RESTAURANTS,1388956,Jun
2025-06-04,Key Food Pembroke,Invoice,008-05673,Arroz Envasado:Largo Fino 1kg (Long grain rice) Dos Hermanos,,1.0,18.0,18.0,4385729.11,Branded Rice,Keila Alfaro-Visvikis,RETAIL  DSD,1388957,Jun
2025-06-04,Key Food Pembroke,Invoice,008-05673,Arroz Envasado:Parboiled 1kg Bolsa Dos Hermanos.,.,1.0,19.9,19.9,4385749.01,Branded Rice,Keila Alfaro-Visvikis,RETAIL  DSD,1388958,Jun
2025-06-04,Sedanos Supermarkets #24,Invoice,008-05674,Arroz a Granel:Parboiled 50 LB -Bolsa Dos Hermanos.,,8.0,28.25,226.0,4385975.01,Bulk Rice,Keila Alfaro-Visvikis,RETAIL SEDANOS,1388959,Jun
2025-06-04,Sedanos Supermarkets #24,Invoice,008-05674,,Discount,,,-4.52,4385970.49,,Keila Alfaro-Visvikis,RETAIL SEDANOS,1388960,Jun
2025-06-04,Chavez Distributors Inc.,Invoice,008-05675,Arroz a Granel:Parboiled 50 LB -Bolsa Dos Hermanos.,,55.0,27.75,1526.25,4387496.74,Bulk Rice,Keila Alfaro-Visvikis,WHOLESALER,1388961,Jun
2025-06-04,Los Caringas Latin America  Foods,Invoice,008-05676,Arroz a Granel:Largo Fino 50 LB -Bolsa Dos Hermanos.,,3.0,27.85,83.55,4387580.29,Bulk Rice,Lisset Limpio -020,CAFETERIA y RESTAURANTS,1388962,Jun
2025-06-04,Los Caringas Latin America  Foods,Invoice,008-05676,Arroz a Granel:Parboiled 50 LB -Bolsa Dos Hermanos.,,3.0,28.25,84.75,4387665.04,Bulk Rice,Lisset Limpio -020,CAFETERIA y RESTAURANTS,1388963,Jun
2025-06-04,Los Mejores Tamales de Miami,Invoice,008-05677,Arroz a Granel:Parboiled 50 LB -Bolsa Dos Hermanos.,,5.0,28.25,141.25,4387806.29,Bulk Rice,Lisset Limpio -020,CAFETERIA y RESTAURANTS,1388964,Jun
2025-06-04,Aries Supermarket & Cafeteria,Invoice,008-05678,Arroz a Granel:Parboiled 50 LB -Bolsa Dos Hermanos.,,10.0,28.25,282.5,4388088.79,Bulk Rice,Keila Alfaro-Visvikis,CAFETERIA y RESTAURANTS,1388965,Jun
2025-06-04,Aries Supermarket & Cafeteria,Invoice,008-05678,Dry Beans:Dry Beans - Black Beans 50,Dry Black Beans 50 lb,5.0,45.7,228.5,4388317.29,Dry Beans,Keila Alfaro-Visvikis,CAFETERIA y RESTAURANTS,1388966,Jun
2025-06-04,Sedanos Supermarkets #43,Invoice,008-05679,Arroz a Granel:Parboiled 50 LB -Bolsa Dos Hermanos.,,5.0,28.25,141.25,4388458.54,Bulk Rice,Keila Alfaro-Visvikis,RETAIL SEDANOS,1388967,Jun
2025-06-04,Sedanos Supermarkets #43,Invoice,008-05679,,Discount,,,-2.83,4388455.71,,Keila Alfaro-Visvikis,RETAIL SEDANOS,1388968,Jun
2025-06-04,Sedanos Supermarkets #26,Invoice,008-05680,Arroz a Granel:Parboiled 50 LB -Bolsa Dos Hermanos.,,5.0,28.25,141.25,4388596.96,Bulk Rice,Keila Alfaro-Visvikis,RETAIL SEDANOS,1388969,Jun
2025-06-04,El Palacio de los jugos /  EMMA FOOD CORP,Invoice,008-05681,Arroz a Granel:Parboiled 50 LB -Bolsa Dos Hermanos.,,6.0,26.75,160.5,4388757.46,Bulk Rice,Lisset Limpio -020,Cafeteria,1388970,Jun
2025-06-04,El Palacio de los jugos /  EMMA FOOD CORP,Invoice,008-05681,Arroz a Granel:Largo Fino 50 LB -Bolsa Dos Hermanos.,,6.0,27.85,167.1,4388924.56,Bulk Rice,Lisset Limpio -020,Cafeteria,1388971,Jun
2025-06-05,"Soriano Brothers Diaz Food Service,Inc",Invoice,008-05682,Dry Beans:Dry Beans - Black Beans 50,Dry Black Beans 50 lb,5.0,36.75,183.75,4389108.31,Dry Beans,Lisset Limpio -020,CAFETERIA y RESTAURANTS,1388972,Jun
2025-06-05,"Soriano Brothers Diaz Food Service,Inc",Invoice,008-05682,Arroz a Granel:Parboiled 50 LB -Bolsa Dos Hermanos.,,40.0,26.75,1070.0,4390178.31,Bulk Rice,Lisset Limpio -020,CAFETERIA y RESTAURANTS,1388973,Jun
2025-06-05,Sedanos Supermarkets  #11,Invoice,008-05683,Arroz Envasado:Parboiled 5KG Dos Hermanos.,6  11lbs,5.0,40.5,202.5,4390380.81,Branded Rice,Keila Alfaro-Visvikis,RETAIL SEDANOS,1388974,Jun
2025-06-05,Sedanos Supermarkets  #11,Invoice,008-05683,Arroz Envasado:Largo Fino 1kg (Long grain rice) Dos Hermanos,,1.0,17.5,17.5,4390398.31,Branded Rice,Keila Alfaro-Visvikis,RETAIL SEDANOS,1388975,Jun
2025-06-05,Sedanos Supermarkets  #11,Invoice,008-05683,Spanish Style Yellow Rice:AS Spanish Style Yellow Rice,AS Spanish Style Yellow Rice 6 / 3.25 oz,1.0,34.5,34.5,4390432.81,American Spice,Keila Alfaro-Visvikis,RETAIL SEDANOS,1388976,Jun
2025-06-05,Sedanos Supermarkets  #11,Invoice,008-05683,Arroz Envasado:Parboiled 5KG Dos Hermanos.,6  11lbs,2.0,40.5,81.0,4390513.81,Branded Rice,Keila Alfaro-Visvikis,RETAIL SEDANOS,1388977,Jun
2025-06-05,Sedanos Supermarkets  #11,Invoice,008-05683,,Discount,,,-5.09,4390508.72,,Keila Alfaro-Visvikis,RETAIL SEDANOS,1388978,Jun
2025-06-05,"Diaz Grocers, Inc",Invoice,008-05684,Arroz Envasado:Parboiled 5KG Dos Hermanos.,6  11lbs,10.0,46.5,465.0,4390973.72,Branded Rice,Lisset Limpio -020,RETAIL  DSD,1388979,Jun
2025-06-05,"Diaz Grocers, Inc",Invoice,008-05684,Arroz Envasado:Parboiled 5KG Dos Hermanos.,6  11lbs,2.0,46.5,93.0,4391066.72,Branded Rice,Lisset Limpio -020,RETAIL  DSD,1388980,Jun
2025-06-05,El Palacio de los jugos /  Mires Restaurants,Invoice,008-05685,Liquids:AS Marinating Sauce (Mojo),,1.0,18.5,18.5,4391085.22,American Spice,Lisset Limpio -020,Cafeteria,1388981,Jun
2025-06-05,El Palacio de los jugos /  Mires Restaurants,Invoice,008-05685,Arroz a Granel:Parboiled 50 LB -Bolsa Dos Hermanos.,,11.0,27.75,305.25,4391390.47,Bulk Rice,Lisset Limpio -020,Cafeteria,1388982,Jun
2025-06-05,El Palacio de los jugos /  Mires Restaurants,Invoice,008-05685,Arroz a Granel:Parboiled 50 LB -Bolsa Dos Hermanos.,,1.0,27.75,27.75,4391418.22,Bulk Rice,Lisset Limpio -020,Cafeteria,1388983,Jun
2025-06-05,El Palacio de los jugos / Rodriguez Foods,Invoice,008-05686,Arroz a Granel:Parboiled 50 LB -Bolsa Dos Hermanos.,,6.0,26.75,160.5,4391578.72,Bulk Rice,Lisset Limpio -020,Cafeteria,1388984,Jun
2025-06-05,El Palacio de los jugos /  EMMA FOOD CORP,Invoice,008-05687,Arroz a Granel:Largo Fino 50 LB -Bolsa Dos Hermanos.,,5.0,27.85,139.25,4391717.97,Bulk Rice,Lisset Limpio -020,Cafeteria,1388985,Jun
2025-06-05,El Palacio de los jugos /  EMMA FOOD CORP,Invoice,008-05687,Arroz a Granel:Parboiled 50 LB -Bolsa Dos Hermanos.,,6.0,26.75,160.5,4391878.47,Bulk Rice,Lisset Limpio -020,Cafeteria,1388986,Jun
2025-06-05,El Palacio de los jugos / Leti Corp.,Invoice,008-05688,Arroz a Granel:Parboiled 50 LB -Bolsa Dos Hermanos.,,8.0,26.75,214.0,4392092.47,Bulk Rice,Lisset Limpio -020,Cafeteria,1388987,Jun
2025-06-05,El Palacio de los jugos /  Nanos Latin Foods,Invoice,008-05689,Arroz a Granel:Parboiled 50 LB -Bolsa Dos Hermanos.,,12.0,26.75,321.0,4392413.47,Bulk Rice,Lisset Limpio -020,Cafeteria,1388988,Jun
2025-06-05,El Palacio de los jugos /  Nanos Latin Foods,Invoice,008-05689,Dry Beans:Dry Beans - Black Beans 50,Dry Black Beans 50 lb,1.0,34.0,34.0,4392447.47,Dry Beans,Lisset Limpio -020,Cafeteria,1388989,Jun
2025-06-05,Sedanos Supermarkets #18,Invoice,008-05690,Spanish Style Yellow Rice:AS Spanish Style Yellow Rice,AS Spanish Style Yellow Rice 6 / 3.25 oz,1.0,34.5,34.5,4392481.97,American Spice,Keila Alfaro-Visvikis,RETAIL SEDANOS,1388990,Jun
2025-06-05,Sedanos Supermarkets #18,Invoice,008-05690,Arroz Envasado:Parboiled 1kg Bolsa Dos Hermanos.,.,1.0,19.9,19.9,4392501.87,Branded Rice,Keila Alfaro-Visvikis,RETAIL SEDANOS,1388991,Jun
2025-06-05,Sedanos Supermarkets #18,Invoice,008-05690,Arroz Envasado:Largo Fino 1kg (Long grain rice) Dos Hermanos,,1.0,17.5,17.5,4392519.37,Branded Rice,Keila Alfaro-Visvikis,RETAIL SEDANOS,1388992,Jun
2025-06-05,Sedanos Supermarkets #18,Invoice,008-05690,,Discount,,,-1.44,4392517.93,,Keila Alfaro-Visvikis,RETAIL SEDANOS,1388993,Jun
2025-06-05,Sedanos Supermarkets #18,Invoice,008-05691,Spices:AS Chicken Base,1 / 30 lb. (box or pail),1.0,39.0,39.0,4392556.93,American Spice,Keila Alfaro-Visvikis,RETAIL SEDANOS,1388994,Jun
2025-06-05,Sedanos Supermarkets #18,Invoice,008-05691,,Discount,,,-0.78,4392556.15,,Keila Alfaro-Visvikis,RETAIL SEDANOS,1388995,Jun
2025-06-05,Sedanos Supermarkets #32,Invoice,008-05692,Arroz a Granel:Largo Fino 50 LB -Bolsa Dos Hermanos.,,4.0,27.85,111.4,4392667.55,Bulk Rice,Keila Alfaro-Visvikis,RETAIL SEDANOS,1388996,Jun
2025-06-05,Sedanos Supermarkets #32,Invoice,008-05692,Arroz a Granel:Parboiled 50 LB -Bolsa Dos Hermanos.,,6.0,28.25,169.5,4392837.05,Bulk Rice,Keila Alfaro-Visvikis,RETAIL SEDANOS,1388997,Jun
2025-06-05,Sedanos Supermarkets #32,Invoice,008-05692,,Discount,,,-5.62,4392831.43,,Keila Alfaro-Visvikis,RETAIL SEDANOS,1388998,Jun
2025-06-05,El Palacio de los jugos / Lita Foods Inc.,Invoice,008-05693,Dry Beans:Dry Beans - Black Beans 50,Dry Black Beans 50 lb,1.0,34.0,34.0,4392865.43,Dry Beans,Lisset Limpio -020,Cafeteria,1388999,Jun
2025-06-05,El Palacio de los jugos / Lita Foods Inc.,Invoice,008-05693,Arroz a Granel:Parboiled 50 LB -Bolsa Dos Hermanos.,,12.0,26.75,321.0,4393186.43,Bulk Rice,Lisset Limpio -020,Cafeteria,1389000,Jun
2025-06-05,El Palacio de los jugos / Caribe Tropical,Invoice,008-05694,Arroz a Granel:Parboiled 50 LB -Bolsa Dos Hermanos.,,8.0,26.75,214.0,4393400.43,Bulk Rice,Lisset Limpio -020,Cafeteria,1389001,Jun
2025-06-05,El Palacio de los jugos / Caribe Tropical,Invoice,008-05694,Dry Beans:Dry Beans - Black Beans 50,Dry Black Beans 50 lb,2.0,34.0,68.0,4393468.43,Dry Beans,Lisset Limpio -020,Cafeteria,1389002,Jun
2025-06-05,El Palacio de los jugos / Divan and Denise Food,Invoice,008-05695,Arroz a Granel:Largo Fino 50 LB -Bolsa Dos Hermanos.,,5.0,27.85,139.25,4393607.68,Bulk Rice,Lisset Limpio -020,Cafeteria,1389003,Jun
2025-06-05,El Palacio de los jugos / Divan and Denise Food,Invoice,008-05695,Arroz a Granel:Parboiled 50 LB -Bolsa Dos Hermanos.,,9.0,26.75,240.75,4393848.43,Bulk Rice,Lisset Limpio -020,Cafeteria,1389004,Jun
2025-06-05,El Palacio de los jugos / Divan and Denise Food,Invoice,008-05695,,Discount,,,-3.8,4393844.63,,Lisset Limpio -020,Cafeteria,1389005,Jun
2025-06-05,Mei Chang,Invoice,008-05696,Arroz a Granel:Parboiled 50 LB -Bolsa Dos Hermanos.,,6.0,28.25,169.5,4394014.13,Bulk Rice,Lisset Limpio -020,CAFETERIA y RESTAURANTS,1389006,Jun
2025-06-05,Sedanos Supermarkets #33,Invoice,008-05697,Arroz a Granel:Parboiled 50 LB -Bolsa Dos Hermanos.,,4.0,28.25,113.0,4394127.13,Bulk Rice,Keila Alfaro-Visvikis,RETAIL SEDANOS,1389007,Jun
2025-06-05,Sedanos Supermarkets #33,Invoice,008-05697,,Discount,,,-2.26,4394124.87,,Keila Alfaro-Visvikis,RETAIL SEDANOS,1389008,Jun
2025-06-05,El Palacio de Los Jugos / Casa mía Food Restaurant inc,Invoice,008-05698,Dry Beans:Dry Beans - Black Beans 50,Dry Black Beans 50 lb,1.0,34.0,34.0,4394158.87,Dry Beans,Lisset Limpio -020,Cafeteria,1389009,Jun
2025-06-05,El Palacio de Los Jugos / Casa mía Food Restaurant inc,Invoice,008-05698,Spices:AS Chicken Base,1 / 30 lb. (box or pail),1.0,39.0,39.0,4394197.87,American Spice,Lisset Limpio -020,Cafeteria,1389010,Jun
2025-06-05,El Palacio de Los Jugos / Casa mía Food Restaurant inc,Invoice,008-05698,Spices:AS Sazon (for all),1 / 30 lb (box or pail),1.0,59.0,59.0,4394256.87,American Spice,Lisset Limpio -020,Cafeteria,1389011,Jun
2025-06-05,El Palacio de Los Jugos / Casa mía Food Restaurant inc,Invoice,008-05698,Arroz a Granel:Parboiled 50 LB -Bolsa Dos Hermanos.,,12.0,26.75,321.0,4394577.87,Bulk Rice,Lisset Limpio -020,Cafeteria,1389012,Jun
2025-06-05,El Palacio de Los Jugos / Casa mía Food Restaurant inc,Invoice,008-05698,Liquids:AS Marinating Sauce (Mojo),,1.0,17.0,17.0,4394594.87,American Spice,Lisset Limpio -020,Cafeteria,1389013,Jun
2025-06-05,El Palacio de Los Jugos / Casa mía Food Restaurant inc,Invoice,008-05698,Liquids:AS Lemon Juice 4/1 Gl,,1.0,14.95,14.95,4394609.82,American Spice,Lisset Limpio -020,Cafeteria,1389014,Jun
2025-06-06,Sedanos Supermarkets #38,Credit Memo,008-05699,Varios:Producto vencido/deteriorado (no impacta en inventario),10 salami,-10.0,0.99,-9.9,4394599.92,Puffed Products,Keila Alfaro-Visvikis,RETAIL SEDANOS,1389015,Jun
2025-06-06,Sedanos Supermarkets #42,Invoice,008-05700,Arroz a Granel:Parboiled 50 LB -Bolsa Dos Hermanos.,,5.0,28.25,141.25,4394741.17,Bulk Rice,Keila Alfaro-Visvikis,RETAIL SEDANOS,1389016,Jun
2025-06-06,Sedanos Supermarkets #42,Invoice,008-05700,,Discount,,,-2.83,4394738.34,,Keila Alfaro-Visvikis,RETAIL SEDANOS,1389017,Jun
2025-06-08,El Palacio de los jugos /  Nanos Latin Foods,Invoice,008-05701,Arroz a Granel:Largo Fino 50 LB -Bolsa Dos Hermanos.,,7.0,27.85,194.95,4394933.29,Bulk Rice,Lisset Limpio -020,Cafeteria,1389018,Jun
2025-06-08,El Palacio de los jugos /  Nanos Latin Foods,Invoice,008-05701,Arroz a Granel:Parboiled 50 LB -Bolsa Dos Hermanos.,,8.0,26.75,214.0,4395147.29,Bulk Rice,Lisset Limpio -020,Cafeteria,1389019,Jun
2025-06-08,El Palacio de Los Jugos / Casa mía Food Restaurant inc,Invoice,008-05702,Spices:AS Chicken Base,1 / 30 lb. (box or pail),1.0,39.0,39.0,4395186.29,American Spice,Lisset Limpio -020,Cafeteria,1389020,Jun
2025-06-08,El Palacio de Los Jugos / Casa mía Food Restaurant inc,Invoice,008-05702,Arroz a Granel:Parboiled 50 LB -Bolsa Dos Hermanos.,,8.0,26.75,214.0,4395400.29,Bulk Rice,Lisset Limpio -020,Cafeteria,1389021,Jun
2025-06-08,El Palacio de los Jugos / Bird Road Restaurant,Invoice,008-05703,Arroz a Granel:Parboiled 50 LB -Bolsa Dos Hermanos.,,11.0,27.75,305.25,4395705.54,Bulk Rice,,Cafeteria,1389022,Jun
2025-06-08,El Palacio de los Jugos / Bird Road Restaurant,Invoice,008-05703,Dry Beans:Dry Beans - Black Beans 50,Dry Black Beans 50 lb,1.0,34.0,34.0,4395739.54,Dry Beans,,Cafeteria,1389023,Jun
2025-06-08,El Palacio de los Jugos / Bird Road Restaurant,Invoice,008-05703,Arroz a Granel:Largo Fino 50 LB -Bolsa Dos Hermanos.,,1.0,27.75,27.75,4395767.29,Bulk Rice,,Cafeteria,1389024,Jun
2025-06-08,Be Your Will LLC,Invoice,008-05704,Liquids:AS Cooking Wine,4 1 Gl.,2.0,17.5,35.0,4395802.29,American Spice,Lisset Limpio -020,CAFETERIA y RESTAURANTS,1389025,Jun
2025-06-08,Be Your Will LLC,Invoice,008-05704,Arroz a Granel:Largo Fino 50 LB -Bolsa Dos Hermanos.,,7.0,27.85,194.95,4395997.24,Bulk Rice,Lisset Limpio -020,CAFETERIA y RESTAURANTS,1389026,Jun
2025-06-08,Be Your Will LLC,Invoice,008-05704,Arroz a Granel:Parboiled 50 LB -Bolsa Dos Hermanos.,,14.0,26.75,374.5,4396371.74,Bulk Rice,Lisset Limpio -020,CAFETERIA y RESTAURANTS,1389027,Jun
2025-06-08,El Palacio de los jugos / Divan and Denise Food,Invoice,008-05705,Arroz a Granel:Parboiled 50 LB -Bolsa Dos Hermanos.,,5.0,26.75,133.75,4396505.49,Bulk Rice,Lisset Limpio -020,Cafeteria,1389028,Jun
2025-06-08,El Palacio de los jugos / Rodriguez Foods,Invoice,008-05706,Arroz a Granel:Parboiled 50 LB -Bolsa Dos Hermanos.,,6.0,26.75,160.5,4396665.99,Bulk Rice,Lisset Limpio -020,Cafeteria,1389029,Jun
2025-06-08,El Palacio de los jugos / Delicias Criollas (DIAGO FOOD_MILLER),Invoice,008-05707,Arroz a Granel:Largo Fino 50 LB -Bolsa Dos Hermanos.,,6.0,27.85,167.1,4396833.09,Bulk Rice,Lisset Limpio -020,Cafeteria,1389030,Jun
2025-06-08,El Palacio de los jugos / Delicias Criollas (DIAGO FOOD_MILLER),Invoice,008-05707,Arroz a Granel:Parboiled 50 LB -Bolsa Dos Hermanos.,,11.0,26.75,294.25,4397127.34,Bulk Rice,Lisset Limpio -020,Cafeteria,1389031,Jun
2025-06-08,El Palacio de los jugos / Caribe Tropical,Invoice,008-05708,Dry Beans:Dry Beans - Black Beans 50,Dry Black Beans 50 lb,3.0,34.0,102.0,4397229.34,Dry Beans,Lisset Limpio -020,Cafeteria,1389032,Jun
2025-06-08,El Palacio de los jugos / Caribe Tropical,Invoice,008-05708,Arroz a Granel:Parboiled 50 LB -Bolsa Dos Hermanos.,,8.0,26.75,214.0,4397443.34,Bulk Rice,Lisset Limpio -020,Cafeteria,1389033,Jun
2025-06-08,JMN Dely Corp,Invoice,008-05709,Dry Beans:Dry Beans - Black Beans 50,Dry Black Beans 50 lb,1.0,45.7,45.7,4397489.04,Dry Beans,Keila Alfaro-Visvikis,CAFETERIA y RESTAURANTS,1389034,Jun
2025-06-08,JMN Dely Corp,Invoice,008-05709,Arroz a Granel:Largo Fino 50 LB -Bolsa Dos Hermanos.,,2.0,27.85,55.7,4397544.74,Bulk Rice,Keila Alfaro-Visvikis,CAFETERIA y RESTAURANTS,1389035,Jun
2025-06-08,JMN Dely Corp,Invoice,008-05709,Arroz a Granel:Parboiled 50 LB -Bolsa Dos Hermanos.,,2.0,28.25,56.5,4397601.24,Bulk Rice,Keila Alfaro-Visvikis,CAFETERIA y RESTAURANTS,1389036,Jun
2025-06-08,Sedanos Supermarkets #17,Invoice,008-05710,Spanish Style Yellow Rice:AS Spanish Style Yellow Rice,AS Spanish Style Yellow Rice 6 / 3.25 oz,1.0,34.5,34.5,4397635.74,American Spice,Keila Alfaro-Visvikis,RETAIL SEDANOS,1389037,Jun
2025-06-08,Sedanos Supermarkets #17,Invoice,008-05710,,Discount,,,-0.69,4397635.05,,Keila Alfaro-Visvikis,RETAIL SEDANOS,1389038,Jun
2025-06-08,Sedanos Supermarkets #42,Invoice,008-05711,Arroz Envasado:Parboiled 5KG Dos Hermanos.,6  11lbs,5.0,40.5,202.5,4397837.55,Branded Rice,Keila Alfaro-Visvikis,RETAIL SEDANOS,1389039,Jun
2025-06-08,Sedanos Supermarkets #42,Invoice,008-05711,Arroz Envasado:Parboiled 5KG Dos Hermanos.,6  11lbs,1.0,40.5,40.5,4397878.05,Branded Rice,Keila Alfaro-Visvikis,RETAIL SEDANOS,1389040,Jun
2025-06-08,Sedanos Supermarkets #42,Invoice,008-05711,,Discount,,,-4.05,4397874.0,,Keila Alfaro-Visvikis,RETAIL SEDANOS,1389041,Jun
2025-06-09,El Palacio de los jugos /  EMMA FOOD CORP,Invoice,008-05712,Arroz a Granel:Parboiled 50 LB -Bolsa Dos Hermanos.,,8.0,26.75,214.0,4398088.0,Bulk Rice,Lisset Limpio -020,Cafeteria,1389042,Jun
2025-06-09,Bravo   Francisco Diaz,Invoice,008-05713,Liquids:AS Cooking Wine,4 1 Gl.,4.0,17.5,70.0,4398158.0,American Spice,Lisset Limpio -020,RETAIL  DSD,1389043,Jun
2025-06-09,Bravo   Francisco Diaz,Invoice,008-05713,Liquids:AS Marinating Sauce (Mojo),,3.0,18.5,55.5,4398213.5,American Spice,Lisset Limpio -020,RETAIL  DSD,1389044,Jun
2025-06-09,Bravo   Francisco Diaz,Invoice,008-05713,Arroz a Granel:Largo Fino 50 LB -Bolsa Dos Hermanos.,,5.0,27.85,139.25,4398352.75,Bulk Rice,Lisset Limpio -020,RETAIL  DSD,1389045,Jun
2025-06-09,El Palacio de los jugos /  Mires Restaurants,Credit Memo,008-05714,Varios:Promotional Allowance,Arroz a Granel:Parboiled 50 LB -Bolsa Dos Hermanos.,-1.0,27.75,-27.75,4398325.0,Bulk Rice,Lisset Limpio -020,Cafeteria,1389046,Jun
2025-06-09,"Diaz Grocers, Inc",Credit Memo,008-05715,Varios:Promotional Allowance,Arroz Envasado:Parboiled 5KG Dos Hermanos.,-2.0,46.5,-93.0,4398232.0,Branded Rice,Lisset Limpio -020,RETAIL  DSD,1389047,Jun
2025-06-09,Sedanos Supermarkets  #11,Credit Memo,008-05824,Varios:Promotional Allowance,Arroz Envasado:Parboiled 5KG Dos Hermanos.,-2.0,40.5,-81.0,4398151.0,Branded Rice,Keila Alfaro-Visvikis,RETAIL SEDANOS,1389048,Jun
2025-06-09,El Palacio de los Jugos / Bird Road Restaurant,Credit Memo,008-05825,Varios:Promotional Allowance,Arroz a Granel:Largo Fino 50 LB -Bolsa Dos Hermanos.,-1.0,27.75,-27.75,4398123.25,Bulk Rice,Lisset Limpio -020,Cafeteria,1389049,Jun
2025-06-09,Sedanos Supermarkets #42,Credit Memo,008-05826,Varios:Promotional Allowance,Arroz Envasado:Parboiled 5KG Dos Hermanos.,-1.0,40.5,-40.5,4398082.75,Branded Rice,Keila Alfaro-Visvikis,RETAIL SEDANOS,1389050,Jun
2025-06-11,Ideal Food Basket Davie Cafeteria,Invoice,008-05716,Arroz a Granel:Largo Fino 50 LB -Bolsa Dos Hermanos.,,8.0,27.85,222.8,4398305.55,Bulk Rice,Keila Alfaro-Visvikis,CAFETERIA y RESTAURANTS,1389051,Jun
2025-06-11,Sedanos Supermarkets #20,Invoice,008-05717,Arroz Envasado:Parboiled 5KG Dos Hermanos.,6  11lbs,5.0,40.5,202.5,4398508.05,Branded Rice,Keila Alfaro-Visvikis,RETAIL SEDANOS,1389052,Jun
2025-06-11,Sedanos Supermarkets #20,Invoice,008-05717,Arroz Envasado:Parboiled 5KG Dos Hermanos.,6  11lbs,1.0,40.5,40.5,4398548.55,Branded Rice,Keila Alfaro-Visvikis,RETAIL SEDANOS,1389053,Jun
2025-06-11,Sedanos Supermarkets #20,Invoice,008-05717,,Discount,,,-4.05,4398544.5,,Keila Alfaro-Visvikis,RETAIL SEDANOS,1389054,Jun
2025-06-11,Sedanos Supermarkets #34,Invoice,008-05718,Arroz Envasado:Parboiled 5KG Dos Hermanos.,6  11lbs,15.0,40.5,607.5,4399152.0,Branded Rice,Keila Alfaro-Visvikis,RETAIL SEDANOS,1389055,Jun
2025-06-11,Sedanos Supermarkets #34,Invoice,008-05718,Arroz Envasado:Parboiled 5KG Dos Hermanos.,6  11lbs,3.0,40.5,121.5,4399273.5,Branded Rice,Keila Alfaro-Visvikis,RETAIL SEDANOS,1389056,Jun
2025-06-11,Sedanos Supermarkets #34,Invoice,008-05718,,Discount,,,-12.15,4399261.35,,Keila Alfaro-Visvikis,RETAIL SEDANOS,1389057,Jun
2025-06-11,Pacifico Chinese Restaurant,Invoice,008-05719,Arroz a Granel:Parboiled 50 LB -Bolsa Dos Hermanos.,,10.0,28.25,282.5,4399543.85,Bulk Rice,Lisset Limpio -020,CAFETERIA y RESTAURANTS,1389058,Jun
2025-06-11,Sedanos Supermarkets #43,Invoice,008-05720,Arroz a Granel:Parboiled 50 LB -Bolsa Dos Hermanos.,,5.0,28.25,141.25,4399685.1,Bulk Rice,Keila Alfaro-Visvikis,RETAIL SEDANOS,1389059,Jun
2025-06-11,Sedanos Supermarkets #43,Invoice,008-05720,,Discount,,,-2.83,4399682.27,,Keila Alfaro-Visvikis,RETAIL SEDANOS,1389060,Jun
2025-06-11,Sedanos Supermarkets #26,Invoice,008-05721,Arroz a Granel:Parboiled 50 LB -Bolsa Dos Hermanos.,,5.0,28.25,141.25,4399823.52,Bulk Rice,Keila Alfaro-Visvikis,RETAIL SEDANOS,1389061,Jun
2025-06-11,Sedanos Supermarkets #26,Invoice,008-05722,Spanish Style Yellow Rice:AS Spanish Style Yellow Rice,AS Spanish Style Yellow Rice 6 / 3.25 oz,1.0,34.5,34.5,4399858.02,American Spice,Keila Alfaro-Visvikis,RETAIL SEDANOS,1389062,Jun
2025-06-11,Sedanos Supermarkets #26,Invoice,008-05722,Arroz Envasado:Parboiled 5KG Dos Hermanos.,6  11lbs,5.0,40.5,202.5,4400060.52,Branded Rice,Keila Alfaro-Visvikis,RETAIL SEDANOS,1389063,Jun
2025-06-11,Sedanos Supermarkets #26,Invoice,008-05722,Arroz Envasado:Parboiled 5KG Dos Hermanos.,6  11lbs,1.0,40.5,40.5,4400101.02,Branded Rice,Keila Alfaro-Visvikis,RETAIL SEDANOS,1389064,Jun
2025-06-11,Sedanos Supermarkets #16,Invoice,008-05723,Arroz a Granel:Parboiled 50 LB -Bolsa Dos Hermanos.,,5.0,28.25,141.25,4400242.27,Bulk Rice,Keila Alfaro-Visvikis,RETAIL SEDANOS,1389065,Jun
2025-06-11,Sedanos Supermarkets #16,Invoice,008-05723,,Discount,,,-2.83,4400239.44,,Keila Alfaro-Visvikis,RETAIL SEDANOS,1389066,Jun
2025-06-11,Aries Supermarket & Cafeteria,Invoice,008-05724,Arroz a Granel:Parboiled 50 LB -Bolsa Dos Hermanos.,,5.0,28.25,141.25,4400380.69,Bulk Rice,Keila Alfaro-Visvikis,CAFETERIA y RESTAURANTS,1389067,Jun
2025-06-11,Aries Supermarket & Cafeteria,Invoice,008-05724,Spices:AS Chicken Base,1 / 30 lb. (box or pail),3.0,39.0,117.0,4400497.69,American Spice,Keila Alfaro-Visvikis,CAFETERIA y RESTAURANTS,1389068,Jun
2025-06-11,Aries Supermarket & Cafeteria,Invoice,008-05724,Liquids:AS Bitter Orange,,1.0,14.0,14.0,4400511.69,American Spice,Keila Alfaro-Visvikis,CAFETERIA y RESTAURANTS,1389069,Jun
2025-06-11,Sedanos Supermarkets #28,Invoice,008-05725,Spanish Style Yellow Rice:AS Spanish Style Yellow Rice,AS Spanish Style Yellow Rice 6 / 3.25 oz,1.0,34.5,34.5,4400546.19,American Spice,Keila Alfaro-Visvikis,RETAIL SEDANOS,1389070,Jun
2025-06-11,Sedanos Supermarkets #28,Invoice,008-05725,Arroz Envasado:Parboiled 5KG Dos Hermanos.,6  11lbs,15.0,40.5,607.5,4401153.69,Branded Rice,Keila Alfaro-Visvikis,RETAIL SEDANOS,1389071,Jun
2025-06-11,Sedanos Supermarkets #28,Invoice,008-05725,Arroz Envasado:Parboiled 5KG Dos Hermanos.,6  11lbs,3.0,40.5,121.5,4401275.19,Branded Rice,Keila Alfaro-Visvikis,RETAIL SEDANOS,1389072,Jun
2025-06-11,Sedanos Supermarkets #28,Invoice,008-05725,,Discount,,,-12.84,4401262.35,,Keila Alfaro-Visvikis,RETAIL SEDANOS,1389073,Jun
2025-06-11,Sabor Tropical #1 - Supermarket,Invoice,008-05726,Arroz Envasado:Largo Fino 1kg (Long grain rice) Dos Hermanos,,10.0,18.0,180.0,4401442.35,Branded Rice,Keila Alfaro-Visvikis,RETAIL  DSD,1389074,Jun
2025-06-11,Sabor Tropical #1 - Supermarket,Invoice,008-05726,Arroz Envasado:Largo Fino 1kg (Long grain rice) Dos Hermanos,,2.0,18.0,36.0,4401478.35,Branded Rice,Keila Alfaro-Visvikis,RETAIL  DSD,1389075,Jun
2025-06-12,Sedanos Supermarkets #31,Invoice,008-05727,Arroz a Granel:Parboiled 50 LB -Bolsa Dos Hermanos.,,5.0,28.25,141.25,4401619.6,Bulk Rice,Keila Alfaro-Visvikis,RETAIL SEDANOS,1389076,Jun
2025-06-12,Sedanos Supermarkets #31,Invoice,008-05727,,Discount,,,-2.83,4401616.77,,Keila Alfaro-Visvikis,RETAIL SEDANOS,1389077,Jun
2025-06-12,Sedanos Supermarkets #34,Credit Memo,008-05827,Varios:Promotional Allowance,Arroz Envasado:Parboiled 5KG Dos Hermanos.,-3.0,40.5,-121.5,4401495.27,Branded Rice,Keila Alfaro-Visvikis,RETAIL SEDANOS,1389078,Jun
2025-06-12,Sedanos Supermarkets #28,Credit Memo,008-05828,Varios:Promotional Allowance,Arroz Envasado:Parboiled 5KG Dos Hermanos.,-3.0,40.5,-121.5,4401373.77,Branded Rice,Keila Alfaro-Visvikis,RETAIL SEDANOS,1389079,Jun
2025-06-12,Sedanos Supermarkets #20,Credit Memo,008-05829,Varios:Promotional Allowance,Arroz Envasado:Parboiled 5KG Dos Hermanos.,-1.0,40.5,-40.5,4401333.27,Branded Rice,Keila Alfaro-Visvikis,RETAIL SEDANOS,1389080,Jun
2025-06-12,Sedanos Supermarkets #26,Credit Memo,008-05830,Varios:Promotional Allowance,Arroz Envasado:Parboiled 5KG Dos Hermanos.,-1.0,40.5,-40.5,4401292.77,Branded Rice,Keila Alfaro-Visvikis,RETAIL SEDANOS,1389081,Jun
2025-06-12,Sabor Tropical #1 - Supermarket,Credit Memo,008-05831,Varios:Promotional Allowance,Arroz Envasado:Largo Fino 1kg (Long grain rice) Dos Hermanos,-2.0,18.0,-36.0,4401256.77,Branded Rice,Keila Alfaro-Visvikis,RETAIL  DSD,1389082,Jun
2025-06-12,Sedanos Supermarkets #38,Credit Memo,008-05832,Varios:Promotional Allowance,Arroz Envasado:Parboiled 5KG Dos Hermanos.,-20.0,40.5,-810.0,4400446.77,Branded Rice,Keila Alfaro-Visvikis,RETAIL SEDANOS,1389083,Jun
2025-06-13,Soriano Brothers PB,Invoice,008-05728,Spices:AS Sazon (for all),1 / 30 lb (box or pail),2.0,51.0,102.0,4400548.77,American Spice,Lisset Limpio -020,CAFETERIA y RESTAURANTS,1389084,Jun
2025-06-13,Soriano Brothers PB,Invoice,008-05728,Arroz a Granel:Largo Fino 50 LB -Bolsa Dos Hermanos.,,18.0,27.85,501.3,4401050.07,Bulk Rice,Lisset Limpio -020,CAFETERIA y RESTAURANTS,1389085,Jun
2025-06-13,Soriano Brothers PB,Invoice,008-05728,Dry Beans:Dry Beans - Black Beans 50,Dry Black Beans 50 lb,1.0,34.0,34.0,4401084.07,Dry Beans,Lisset Limpio -020,CAFETERIA y RESTAURANTS,1389086,Jun
2025-06-13,Soriano Brothers PB,Invoice,008-05728,Arroz a Granel:Parboiled 50 LB -Bolsa Dos Hermanos.,,20.0,26.75,535.0,4401619.07,Bulk Rice,Lisset Limpio -020,CAFETERIA y RESTAURANTS,1389087,Jun
2025-06-13,HONG KONG,Invoice,008-05729,Arroz a Granel:Parboiled 50 LB -Bolsa Dos Hermanos.,,5.0,27.75,138.75,4401757.82,Bulk Rice,Lisset Limpio -020,CAFETERIA y RESTAURANTS,1389088,Jun
2025-06-13,El Palacio de los jugos / Caribe Tropical,Invoice,008-05730,Arroz a Granel:Parboiled 50 LB -Bolsa Dos Hermanos.,,10.0,26.75,267.5,4402025.32,Bulk Rice,Lisset Limpio -020,Cafeteria,1389089,Jun
2025-06-13,El Palacio de los jugos / Leti Corp.,Invoice,008-05731,Arroz a Granel:Largo Fino 50 LB -Bolsa Dos Hermanos.,,5.0,27.85,139.25,4402164.57,Bulk Rice,Lisset Limpio -020,Cafeteria,1389090,Jun
2025-06-13,El Palacio de los jugos / Leti Corp.,Invoice,008-05731,Arroz a Granel:Parboiled 50 LB -Bolsa Dos Hermanos.,,6.0,26.75,160.5,4402325.07,Bulk Rice,Lisset Limpio -020,Cafeteria,1389091,Jun
2025-06-13,China Tokyo,Invoice,008-05732,Arroz a Granel:Parboiled 50 LB -Bolsa Dos Hermanos.,,9.0,28.25,254.25,4402579.32,Bulk Rice,Lisset Limpio -020,CAFETERIA y RESTAURANTS,1389092,Jun
2025-06-13,El Palacio de Los Jugos / Casa mía Food Restaurant inc,Invoice,008-05733,Spices:AS Chicken Base,1 / 30 lb. (box or pail),1.0,39.0,39.0,4402618.32,American Spice,Lisset Limpio -020,Cafeteria,1389093,Jun
2025-06-13,El Palacio de Los Jugos / Casa mía Food Restaurant inc,Invoice,008-05733,Liquids:AS Lemon Juice 4/1 Gl,,1.0,14.95,14.95,4402633.27,American Spice,Lisset Limpio -020,Cafeteria,1389094,Jun
2025-06-13,El Palacio de Los Jugos / Casa mía Food Restaurant inc,Invoice,008-05733,Liquids:AS Marinating Sauce (Mojo),,1.0,17.0,17.0,4402650.27,American Spice,Lisset Limpio -020,Cafeteria,1389095,Jun
2025-06-13,El Palacio de Los Jugos / Casa mía Food Restaurant inc,Invoice,008-05733,Arroz a Granel:Parboiled 50 LB -Bolsa Dos Hermanos.,,6.0,26.75,160.5,4402810.77,Bulk Rice,Lisset Limpio -020,Cafeteria,1389096,Jun
2025-06-13,El Palacio de Los Jugos / Casa mía Food Restaurant inc,Invoice,008-05733,Spices:AS Sazon (for all),1 / 30 lb (box or pail),1.0,51.0,51.0,4402861.77,American Spice,Lisset Limpio -020,Cafeteria,1389097,Jun
2025-06-13,Sedanos Supermarkets #33,Invoice,008-05734,Arroz a Granel:Parboiled 50 LB -Bolsa Dos Hermanos.,,3.0,28.25,84.75,4402946.52,Bulk Rice,Keila Alfaro-Visvikis,RETAIL SEDANOS,1389098,Jun
2025-06-13,Sedanos Supermarkets #33,Invoice,008-05734,,Discount,,,-1.7,4402944.82,,Keila Alfaro-Visvikis,RETAIL SEDANOS,1389099,Jun
2025-06-13,Sedanos Supermarkets #18,Invoice,008-05735,Spices:AS Chicken Base,1 / 30 lb. (box or pail),1.0,39.0,39.0,4402983.82,American Spice,Keila Alfaro-Visvikis,RETAIL SEDANOS,1389100,Jun
2025-06-13,Sedanos Supermarkets #18,Invoice,008-05735,Arroz a Granel:Parboiled 50 LB -Bolsa Dos Hermanos.,,10.0,28.25,282.5,4403266.32,Bulk Rice,Keila Alfaro-Visvikis,RETAIL SEDANOS,1389101,Jun
2025-06-13,Sedanos Supermarkets #18,Invoice,008-05735,,Discount,,,-6.43,4403259.89,,Keila Alfaro-Visvikis,RETAIL SEDANOS,1389102,Jun
2025-06-13,Sedanos Supermarkets #32,Invoice,008-05736,Arroz a Granel:Largo Fino 50 LB -Bolsa Dos Hermanos.,,1.0,27.85,27.85,4403287.74,Bulk Rice,Keila Alfaro-Visvikis,RETAIL SEDANOS,1389103,Jun
2025-06-13,Sedanos Supermarkets #32,Invoice,008-05736,Arroz a Granel:Parboiled 50 LB -Bolsa Dos Hermanos.,,2.0,28.25,56.5,4403344.24,Bulk Rice,Keila Alfaro-Visvikis,RETAIL SEDANOS,1389104,Jun
2025-06-13,Sedanos Supermarkets #32,Invoice,008-05736,,Discount,,,-1.69,4403342.55,,Keila Alfaro-Visvikis,RETAIL SEDANOS,1389105,Jun
2025-06-13,Sedanos Supermarkets #38,Invoice,008-05737,Arroz Envasado:Parboiled 5KG Dos Hermanos.,6  11lbs,20.0,40.5,810.0,4404152.55,Branded Rice,Keila Alfaro-Visvikis,RETAIL SEDANOS,1389106,Jun
2025-06-13,Sedanos Supermarkets #38,Invoice,008-05737,Arroz Envasado:Parboiled 5KG Dos Hermanos.,6  11lbs,20.0,40.5,810.0,4404962.55,Branded Rice,Keila Alfaro-Visvikis,RETAIL SEDANOS,1389107,Jun
2025-06-13,Sedanos Supermarkets #38,Invoice,008-05737,,Discount,,,-16.2,4404946.35,,Keila Alfaro-Visvikis,RETAIL SEDANOS,1389108,Jun
2025-06-13,ALS Foods,Invoice,008-05738,Liquids:AS Cooking Wine,4 1 Gl.,2.0,17.5,35.0,4404981.35,American Spice,Lisset Limpio -020,CAFETERIA y RESTAURANTS,1389109,Jun
2025-06-13,ALS Foods,Invoice,008-05738,Arroz a Granel:Largo Fino 50 LB -Bolsa Dos Hermanos.,,8.0,27.85,222.8,4405204.15,Bulk Rice,Lisset Limpio -020,CAFETERIA y RESTAURANTS,1389110,Jun
2025-06-13,ALS Foods,Invoice,008-05738,Arroz a Granel:Parboiled 50 LB -Bolsa Dos Hermanos.,,6.0,26.75,160.5,4405364.65,Bulk Rice,Lisset Limpio -020,CAFETERIA y RESTAURANTS,1389111,Jun
2025-06-13,El Palacio de los jugos /  Nanos Latin Foods,Invoice,008-05739,Arroz a Granel:Largo Fino 50 LB -Bolsa Dos Hermanos.,,5.0,27.85,139.25,4405503.9,Bulk Rice,Lisset Limpio -020,Cafeteria,1389112,Jun
2025-06-13,El Palacio de los jugos /  Nanos Latin Foods,Invoice,008-05739,Arroz a Granel:Parboiled 50 LB -Bolsa Dos Hermanos.,,5.0,26.75,133.75,4405637.65,Bulk Rice,Lisset Limpio -020,Cafeteria,1389113,Jun
2025-06-13,El Palacio de los jugos /  EMMA FOOD CORP,Invoice,008-05740,Arroz a Granel:Largo Fino 50 LB -Bolsa Dos Hermanos.,,8.0,27.85,222.8,4405860.45,Bulk Rice,Lisset Limpio -020,Cafeteria,1389114,Jun
2025-06-13,El Palacio de los jugos /  EMMA FOOD CORP,Invoice,008-05740,Arroz a Granel:Parboiled 50 LB -Bolsa Dos Hermanos.,,12.0,26.75,321.0,4406181.45,Bulk Rice,Lisset Limpio -020,Cafeteria,1389115,Jun
2025-06-13,El Palacio de los jugos / J Mena Corp.,Invoice,008-05741,Arroz a Granel:Parboiled 50 LB -Bolsa Dos Hermanos.,,10.0,26.75,267.5,4406448.95,American Spice,Lisset Limpio -020,Cafeteria,1389116,Jun
2025-06-13,El Palacio de los jugos / Rodriguez Foods,Invoice,008-05742,Arroz a Granel:Parboiled 50 LB -Bolsa Dos Hermanos.,,10.0,26.75,267.5,4406716.45,Bulk Rice,Lisset Limpio -020,Cafeteria,1389117,Jun
2025-06-13,El Gallego Supermarket,Invoice,008-05743,Arroz a Granel:Parboiled 50 LB -Bolsa Dos Hermanos.,,5.0,27.75,138.75,4406855.2,Bulk Rice,Lisset Limpio -020,RETAIL  DSD,1389118,Jun
2025-06-13,El Gallego Supermarket,Invoice,008-05743,Liquids:AS Bitter Orange,,2.0,14.0,28.0,4406883.2,American Spice,Lisset Limpio -020,RETAIL  DSD,1389119,Jun
2025-06-13,El Gallego Supermarket,Invoice,008-05743,Liquids:AS Cooking Wine,4 1 Gl.,1.0,17.5,17.5,4406900.7,American Spice,Lisset Limpio -020,RETAIL  DSD,1389120,Jun
2025-06-13,El Gallego Supermarket,Invoice,008-05743,Dry Beans:Dry Beans - Black Beans 50,Dry Black Beans 50 lb,2.0,34.0,68.0,4406968.7,Dry Beans,Lisset Limpio -020,RETAIL  DSD,1389121,Jun
2025-06-13,El Gallego Supermarket,Invoice,008-05743,Liquids:AS White Vinegar,4/1 Gl.,1.0,9.5,9.5,4406978.2,American Spice,Lisset Limpio -020,RETAIL  DSD,1389122,Jun
2025-06-13,El Palacio de los jugos / Lita Foods Inc.,Invoice,008-05744,Dry Beans:Dry Beans - Black Beans 50,Dry Black Beans 50 lb,1.0,34.0,34.0,4407012.2,Dry Beans,Lisset Limpio -020,Cafeteria,1389123,Jun
2025-06-13,El Palacio de los jugos / Lita Foods Inc.,Invoice,008-05744,Arroz a Granel:Parboiled 50 LB -Bolsa Dos Hermanos.,,15.0,26.75,401.25,4407413.45,Bulk Rice,Lisset Limpio -020,Cafeteria,1389124,Jun
2025-06-13,Sedanos Supermarkets #38,Credit Memo,008-05745,Varios:Producto vencido/deteriorado (no impacta en inventario),10 salami 10 ham,-20.0,0.99,-19.8,4407393.65,Puffed Products,Keila Alfaro-Visvikis,RETAIL SEDANOS,1389125,Jun
2025-06-13,Sedanos Supermarkets #38,Credit Memo,008-05745,Varios:Producto vencido/deteriorado (no impacta en inventario),parbo 5k,-4.0,3.37,-13.48,4407380.17,Branded Rice,Keila Alfaro-Visvikis,RETAIL SEDANOS,1389126,Jun
2025-06-15,El Palacio de los jugos / Rodriguez Foods,Invoice,008-05746,Arroz a Granel:Parboiled 50 LB -Bolsa Dos Hermanos.,,8.0,26.75,214.0,4407594.17,Bulk Rice,Lisset Limpio -020,Cafeteria,1389127,Jun
2025-06-15,Bravo   Francisco Diaz,Invoice,008-05747,Liquids:AS Cooking Wine,4 1 Gl.,3.0,17.5,52.5,4407646.67,American Spice,Lisset Limpio -020,RETAIL  DSD,1389128,Jun
2025-06-15,Bravo   Francisco Diaz,Invoice,008-05747,Arroz a Granel:Largo Fino 50 LB -Bolsa Dos Hermanos.,,3.0,27.85,83.55,4407730.22,Bulk Rice,Lisset Limpio -020,RETAIL  DSD,1389129,Jun
2025-06-15,El Palacio de los jugos / J Mena Corp.,Invoice,008-05748,Arroz a Granel:Parboiled 50 LB -Bolsa Dos Hermanos.,,10.0,26.75,267.5,4407997.72,Bulk Rice,Lisset Limpio -020,Cafeteria,1389130,Jun
2025-06-15,El Palacio de los jugos / J Mena Corp.,Invoice,008-05748,Liquids:AS Marinating Sauce (Mojo),,2.0,17.0,34.0,4408031.72,American Spice,Lisset Limpio -020,Cafeteria,1389131,Jun
2025-06-15,El Palacio de los Jugos / Bird Road Restaurant,Invoice,008-05749,Arroz a Granel:Parboiled 50 LB -Bolsa Dos Hermanos.,,10.0,26.75,267.5,4408299.22,Bulk Rice,Lisset Limpio -020,Cafeteria,1389132,Jun
2025-06-15,El Palacio de los jugos /  Nanos Latin Foods,Invoice,008-05750,Arroz a Granel:Parboiled 50 LB -Bolsa Dos Hermanos.,,10.0,26.75,267.5,4408566.72,Bulk Rice,Lisset Limpio -020,Cafeteria,1389133,Jun
2025-06-15,El Palacio de los jugos /  EMMA FOOD CORP,Invoice,008-05751,Arroz a Granel:Largo Fino 50 LB -Bolsa Dos Hermanos.,,3.0,27.85,83.55,4408650.27,Bulk Rice,Lisset Limpio -020,Cafeteria,1389134,Jun
2025-06-15,El Palacio de los jugos /  EMMA FOOD CORP,Invoice,008-05751,Arroz a Granel:Parboiled 50 LB -Bolsa Dos Hermanos.,,3.0,26.75,80.25,4408730.52,Bulk Rice,Lisset Limpio -020,Cafeteria,1389135,Jun
2025-06-15,El Palacio de los jugos / Caribe Tropical,Invoice,008-05752,Arroz a Granel:Parboiled 50 LB -Bolsa Dos Hermanos.,,8.0,26.75,214.0,4408944.52,Bulk Rice,Lisset Limpio -020,Cafeteria,1389136,Jun
2025-06-15,El Palacio de Los Jugos / Casa mía Food Restaurant inc,Invoice,008-05753,Spices:AS Chicken Base,1 / 30 lb. (box or pail),1.0,39.0,39.0,4408983.52,American Spice,Lisset Limpio -020,Cafeteria,1389137,Jun
2025-06-15,El Palacio de Los Jugos / Casa mía Food Restaurant inc,Invoice,008-05753,Spices:AS Sazon (for all),1 / 30 lb (box or pail),1.0,51.0,51.0,4409034.52,American Spice,Lisset Limpio -020,Cafeteria,1389138,Jun
2025-06-15,El Palacio de Los Jugos / Casa mía Food Restaurant inc,Invoice,008-05753,Arroz a Granel:Parboiled 50 LB -Bolsa Dos Hermanos.,,6.0,26.75,160.5,4409195.02,Bulk Rice,Lisset Limpio -020,Cafeteria,1389139,Jun
2025-06-15,El Palacio de los jugos / Delicias Criollas (DIAGO FOOD_MILLER),Invoice,008-05754,Arroz a Granel:Largo Fino 50 LB -Bolsa Dos Hermanos.,,4.0,27.85,111.4,4409306.42,Bulk Rice,Lisset Limpio -020,Cafeteria,1389140,Jun
2025-06-15,El Palacio de los jugos / Delicias Criollas (DIAGO FOOD_MILLER),Invoice,008-05754,Arroz a Granel:Parboiled 50 LB -Bolsa Dos Hermanos.,,12.0,26.75,321.0,4409627.42,Bulk Rice,Lisset Limpio -020,Cafeteria,1389141,Jun
2025-06-15,Los Mejores Tamales de Miami,Invoice,008-05755,Arroz a Granel:Parboiled 50 LB -Bolsa Dos Hermanos.,,6.0,28.25,169.5,4409796.92,Bulk Rice,Lisset Limpio -020,CAFETERIA y RESTAURANTS,1389142,Jun
2025-06-15,Sedanos Supermarkets  #37,Invoice,008-05756,Arroz a Granel:Largo Fino 50 LB -Bolsa Dos Hermanos.,,6.0,27.85,167.1,4409964.02,Bulk Rice,Keila Alfaro-Visvikis,RETAIL SEDANOS,1389143,Jun
2025-06-15,Sedanos Supermarkets  #37,Invoice,008-05756,,Discount,,,-3.07,4409960.95,,Keila Alfaro-Visvikis,RETAIL SEDANOS,1389144,Jun
2025-06-15,"Meat Club Market, LLC.",Invoice,008-05757,Arroz Envasado:Largo Fino 1kg (Long grain rice) Dos Hermanos,,2.0,18.0,36.0,4409996.95,Branded Rice,Lisset Limpio -020,RETAIL  DSD,1389145,Jun
2025-06-15,"Meat Club Market, LLC.",Invoice,008-05757,Arroz Envasado:Parboiled 1kg Bolsa Dos Hermanos.,.,1.0,19.9,19.9,4410016.85,Branded Rice,Lisset Limpio -020,RETAIL  DSD,1389146,Jun
2025-06-15,"Meat Club Market, LLC.",Invoice,008-05757,Arroz Envasado:Sushi Rice Dos Hermanos.,.,2.0,25.5,51.0,4410067.85,Branded Rice,Lisset Limpio -020,RETAIL  DSD,1389147,Jun
2025-06-15,"Meat Club Market, LLC.",Invoice,008-05757,,Discount,,,-0.81,4410067.04,,Lisset Limpio -020,RETAIL  DSD,1389148,Jun
2025-06-16,Fritanga Momotombo,Invoice,008-05758,Spices:AS Chicken Base,1 / 30 lb. (box or pail),1.0,39.0,39.0,4410106.04,American Spice,Lisset Limpio -020,CAFETERIA y RESTAURANTS,1389149,Jun
2025-06-16,Fritanga Momotombo,Invoice,008-05758,Arroz a Granel:Largo Fino 50 LB -Bolsa Dos Hermanos.,,6.0,27.85,167.1,4410273.14,Bulk Rice,Lisset Limpio -020,CAFETERIA y RESTAURANTS,1389150,Jun
2025-06-16,Sedanos Supermarkets #31,Invoice,008-05759,Arroz Envasado:Long Rice 10 LB Dos Hermanos,,2.0,35.5,71.0,4410344.14,Branded Rice,Keila Alfaro-Visvikis,RETAIL SEDANOS,1389151,Jun
2025-06-16,Sedanos Supermarkets #31,Invoice,008-05759,,Discount,,,-1.42,4410342.72,,Keila Alfaro-Visvikis,RETAIL SEDANOS,1389152,Jun
2025-06-16,Bay supermarket,Invoice,008-05760,Arroz Envasado:Largo Fino 1kg (Long grain rice) Dos Hermanos,,5.0,18.0,90.0,4410432.72,Branded Rice,Keila Alfaro-Visvikis,RETAIL  DSD,1389153,Jun
2025-06-16,Bay supermarket,Invoice,008-05760,Arroz Envasado:Largo Fino 1kg (Long grain rice) Dos Hermanos,,1.0,18.0,18.0,4410450.72,Branded Rice,Keila Alfaro-Visvikis,RETAIL  DSD,1389154,Jun
2025-06-16,Sedanos Supermarkets #7,Invoice,008-05761,Spanish Style Yellow Rice:AS Spanish Style Yellow Rice,AS Spanish Style Yellow Rice 6 / 3.25 oz,1.0,34.5,34.5,4410485.22,American Spice,Keila Alfaro-Visvikis,RETAIL SEDANOS,1389155,Jun
2025-06-16,Sedanos Supermarkets #7,Invoice,008-05761,Arroz Envasado:Largo Fino 1kg (Long grain rice) Dos Hermanos,,1.0,17.5,17.5,4410502.72,Branded Rice,Keila Alfaro-Visvikis,RETAIL SEDANOS,1389156,Jun
2025-06-16,Sedanos Supermarkets #7,Invoice,008-05761,,Discount,,,-1.04,4410501.68,,Keila Alfaro-Visvikis,RETAIL SEDANOS,1389157,Jun
2025-06-16,Sedanos Supermarkets #8,Invoice,008-05762,Arroz Envasado:Largo Fino 1kg (Long grain rice) Dos Hermanos,,1.0,17.5,17.5,4410519.18,Branded Rice,Keila Alfaro-Visvikis,RETAIL SEDANOS,1389158,Jun
2025-06-16,Sedanos Supermarkets #8,Invoice,008-05762,Arroz Envasado:Parboiled 1kg Bolsa Dos Hermanos.,.,1.0,19.9,19.9,4410539.08,Branded Rice,Keila Alfaro-Visvikis,RETAIL SEDANOS,1389159,Jun
2025-06-16,Sedanos Supermarkets #8,Invoice,008-05762,Arroz Envasado:Long Rice 10 LB Dos Hermanos,,1.0,35.5,35.5,4410574.58,Branded Rice,Keila Alfaro-Visvikis,RETAIL SEDANOS,1389160,Jun
2025-06-16,Sedanos Supermarkets #8,Invoice,008-05762,,Discount,,,-1.46,4410573.12,,Keila Alfaro-Visvikis,RETAIL SEDANOS,1389161,Jun
2025-06-16,Sedanos Supermarkets #9,Invoice,008-05763,Arroz Envasado:Largo Fino 1kg (Long grain rice) Dos Hermanos,,1.0,17.8,17.8,4410590.92,Branded Rice,Keila Alfaro-Visvikis,RETAIL SEDANOS,1389162,Jun
2025-06-16,Sedanos Supermarkets #9,Invoice,008-05763,Arroz Envasado:Parboiled 1kg Bolsa Dos Hermanos.,.,1.0,19.9,19.9,4410610.82,Branded Rice,Keila Alfaro-Visvikis,RETAIL SEDANOS,1389163,Jun
2025-06-16,Sedanos Supermarkets #9,Invoice,008-05763,Spanish Style Yellow Rice:AS Spanish Style Yellow Rice,AS Spanish Style Yellow Rice 6 / 3.25 oz,1.0,34.5,34.5,4410645.32,American Spice,Keila Alfaro-Visvikis,RETAIL SEDANOS,1389164,Jun
2025-06-16,Sedanos Supermarkets #9,Invoice,008-05763,Arroz Envasado:Long Rice 10 LB Dos Hermanos,,1.0,35.5,35.5,4410680.82,Branded Rice,Keila Alfaro-Visvikis,RETAIL SEDANOS,1389165,Jun
2025-06-16,Sedanos Supermarkets #9,Invoice,008-05763,,Discount,,,-1.4,4410679.42,,Keila Alfaro-Visvikis,RETAIL SEDANOS,1389166,Jun
2025-06-16,Sedanos Supermarkets #10,Invoice,008-05764,Arroz Envasado:Largo Fino 1kg (Long grain rice) Dos Hermanos,,1.0,17.5,17.5,4410696.92,Branded Rice,Keila Alfaro-Visvikis,RETAIL SEDANOS,1389167,Jun
2025-06-16,Sedanos Supermarkets #10,Invoice,008-05764,Arroz Envasado:Long Rice 10 LB Dos Hermanos,,1.0,35.5,35.5,4410732.42,Branded Rice,Keila Alfaro-Visvikis,RETAIL SEDANOS,1389168,Jun
2025-06-16,Sedanos Supermarkets #43,Invoice,008-05765,Spanish Style Yellow Rice:AS Spanish Style Yellow Rice,AS Spanish Style Yellow Rice 6 / 3.25 oz,1.0,34.5,34.5,4410766.92,American Spice,Keila Alfaro-Visvikis,RETAIL SEDANOS,1389169,Jun
2025-06-16,Sedanos Supermarkets #43,Invoice,008-05765,Arroz Envasado:Long Rice 10 LB Dos Hermanos,,1.0,35.5,35.5,4410802.42,Branded Rice,Keila Alfaro-Visvikis,RETAIL SEDANOS,1389170,Jun
2025-06-16,Sedanos Supermarkets #43,Invoice,008-05765,,Discount,,,-1.4,4410801.02,,Keila Alfaro-Visvikis,RETAIL SEDANOS,1389171,Jun
2025-06-16,Sedanos Supermarkets #22,Invoice,008-05766,Spanish Style Yellow Rice:AS Spanish Style Yellow Rice,AS Spanish Style Yellow Rice 6 / 3.25 oz,1.0,34.5,34.5,4410835.52,American Spice,Keila Alfaro-Visvikis,RETAIL SEDANOS,1389172,Jun
2025-06-16,Sedanos Supermarkets #22,Invoice,008-05766,Arroz Envasado:Long Rice 10 LB Dos Hermanos,,1.0,35.5,35.5,4410871.02,Branded Rice,Keila Alfaro-Visvikis,RETAIL SEDANOS,1389173,Jun
2025-06-16,Sedanos Supermarkets #22,Invoice,008-05766,,Discount,,,-1.23,4410869.79,,Keila Alfaro-Visvikis,RETAIL SEDANOS,1389174,Jun
2025-06-16,Sedanos Supermarkets #42,Invoice,008-05767,Arroz Envasado:Long Rice 10 LB Dos Hermanos,,2.0,35.5,71.0,4410940.79,Branded Rice,Keila Alfaro-Visvikis,RETAIL SEDANOS,1389175,Jun
2025-06-16,Sedanos Supermarkets #42,Invoice,008-05767,,Discount,,,-1.42,4410939.37,,Keila Alfaro-Visvikis,RETAIL SEDANOS,1389176,Jun
2025-06-16,Sedanos Supermarkets #42,Invoice,008-05768,Arroz a Granel:Parboiled 50 LB -Bolsa Dos Hermanos.,,6.0,28.25,169.5,4411108.87,Bulk Rice,Keila Alfaro-Visvikis,RETAIL SEDANOS,1389177,Jun
2025-06-16,Sedanos Supermarkets #42,Invoice,008-05768,,Discount,,,-3.39,4411105.48,,Keila Alfaro-Visvikis,RETAIL SEDANOS,1389178,Jun
2025-06-17,Armando Carpio,Invoice,008-05769,Arroz Envasado:Long Rice 10 LB Dos Hermanos,*****SAMPLES*****,1.0,35.5,35.5,4411140.98,Branded Rice,Armando Carpio - 017,OTHER,1389179,Jun
2025-06-18,Sedanos Supermarkets #16,Invoice,008-05770,Arroz a Granel:Parboiled 50 LB -Bolsa Dos Hermanos.,,4.0,28.25,113.0,4411253.98,Bulk Rice,Keila Alfaro-Visvikis,RETAIL SEDANOS,1389180,Jun
2025-06-18,Sedanos Supermarkets #16,Invoice,008-05770,,Discount,,,-2.26,4411251.72,,Keila Alfaro-Visvikis,RETAIL SEDANOS,1389181,Jun
2025-06-18,Ideal Food Basket Davie Cafeteria,Invoice,008-05771,Arroz a Granel:Largo Fino 50 LB -Bolsa Dos Hermanos.,,9.0,27.85,250.65,4411502.37,Bulk Rice,Keila Alfaro-Visvikis,CAFETERIA y RESTAURANTS,1389182,Jun
2025-06-18,Rey Chavez Distributor #2,Invoice,008-05772,Arroz a Granel:Parboiled 50 LB -Bolsa Dos Hermanos.,,25.0,27.75,693.75,4412196.12,Bulk Rice,Lisset Limpio -020,WHOLESALER,1389183,Jun
2025-06-18,Sedanos Supermarkets #27,Invoice,008-05773,Arroz Envasado:Long Rice 10 LB Dos Hermanos,,1.0,35.5,35.5,4412231.62,American Spice,Keila Alfaro-Visvikis,RETAIL SEDANOS,1389184,Jun
2025-06-18,Sedanos Supermarkets #27,Invoice,008-05773,,Discount,,,-0.71,4412230.91,,Keila Alfaro-Visvikis,RETAIL SEDANOS,1389185,Jun
2025-06-18,Sedanos Supermarkets #27,Invoice,008-05774,Arroz a Granel:Parboiled 50 LB -Bolsa Dos Hermanos.,,4.0,28.25,113.0,4412343.91,Bulk Rice,Keila Alfaro-Visvikis,RETAIL SEDANOS,1389186,Jun
2025-06-18,Sedanos Supermarkets #27,Invoice,008-05774,,Discount,,,-2.26,4412341.65,,Keila Alfaro-Visvikis,RETAIL SEDANOS,1389187,Jun
2025-06-18,Sedanos Supermarkets #24,Invoice,008-05775,Arroz Envasado:Long Rice 10 LB Dos Hermanos,,1.0,35.5,35.5,4412377.15,Branded Rice,Keila Alfaro-Visvikis,RETAIL SEDANOS,1389188,Jun
2025-06-18,Sedanos Supermarkets #24,Invoice,008-05775,Rice Snack:Rice Snack Ham Flavored DOS HERMANOS,,1.0,19.9,19.9,4412397.05,Puffed Products,Keila Alfaro-Visvikis,RETAIL SEDANOS,1389189,Jun
2025-06-18,Sedanos Supermarkets #24,Invoice,008-05775,,Discount,,,-0.71,4412396.34,,Keila Alfaro-Visvikis,RETAIL SEDANOS,1389190,Jun
2025-06-18,Los Caringas Latin America  Foods,Invoice,008-05776,Arroz a Granel:Largo Fino 50 LB -Bolsa Dos Hermanos.,,2.0,27.85,55.7,4412452.04,Bulk Rice,Lisset Limpio -020,CAFETERIA y RESTAURANTS,1389191,Jun
2025-06-18,Los Caringas Latin America  Foods,Invoice,008-05776,Arroz a Granel:Parboiled 50 LB -Bolsa Dos Hermanos.,,2.0,28.25,56.5,4412508.54,Bulk Rice,Lisset Limpio -020,CAFETERIA y RESTAURANTS,1389192,Jun
2025-06-18,Key Foods - 10301 Royal Palm Food Corp.,Invoice,008-05777,Arroz Envasado:Parboiled 1kg Bolsa Dos Hermanos.,.,50.0,19.9,995.0,4413503.54,Branded Rice,Keila Alfaro-Visvikis,RETAIL KEY FOOD,1389193,Jun
2025-06-18,Key Foods - 10301 Royal Palm Food Corp.,Invoice,008-05777,Arroz Envasado:Parboiled 1kg Bolsa Dos Hermanos.,.,10.0,19.9,199.0,4413702.54,Branded Rice,Keila Alfaro-Visvikis,RETAIL KEY FOOD,1389194,Jun
2025-06-18,Sabor Tropical Supermarket #7,Invoice,008-05778,Arroz Envasado:Largo Fino 1kg (Long grain rice) Dos Hermanos,,2.0,18.0,36.0,4413738.54,Branded Rice,Keila Alfaro-Visvikis,RETAIL  DSD,1389195,Jun
2025-06-18,Sabor Tropical Supermarket #7,Invoice,008-05778,Arroz Envasado:Parboiled 5KG Dos Hermanos.,6  11lbs,9.0,46.5,418.5,4414157.04,Branded Rice,Keila Alfaro-Visvikis,RETAIL  DSD,1389196,Jun
2025-06-18,Sabor Tropical Supermarket #7,Invoice,008-05778,Arroz Envasado:Long Rice 10 LB Dos Hermanos,,6.0,35.5,213.0,4414370.04,Branded Rice,Keila Alfaro-Visvikis,RETAIL  DSD,1389197,Jun
2025-06-18,Sabor Tropical Supermarket #7,Invoice,008-05778,Rice Snack:Rice Snack Salami Flavored DOS HERMANOS,,3.0,13.2,39.6,4414409.64,Puffed Products,Keila Alfaro-Visvikis,RETAIL  DSD,1389198,Jun
2025-06-18,Sabor Tropical Supermarket #7,Invoice,008-05778,Rice Snack:Rice Snack Ham Flavored DOS HERMANOS,,2.0,13.2,26.4,4414436.04,Puffed Products,Keila Alfaro-Visvikis,RETAIL  DSD,1389199,Jun
2025-06-18,Sabor Tropical Supermarket #7,Invoice,008-05778,Arroz Envasado:Parboiled 5KG Dos Hermanos.,6  11lbs,1.0,46.5,46.5,4414482.54,Branded Rice,Keila Alfaro-Visvikis,RETAIL  DSD,1389200,Jun
2025-06-18,Sabor Tropical Supermarket #7,Invoice,008-05778,Arroz Envasado:Long Rice 10 LB Dos Hermanos,,3.0,35.5,106.5,4414589.04,Branded Rice,Keila Alfaro-Visvikis,RETAIL  DSD,1389201,Jun
2025-06-18,Sabor Tropical Supermarket #7,Invoice,008-05778,Rice Snack:Rice Snack Salami Flavored DOS HERMANOS,,1.0,13.2,13.2,4414602.24,Puffed Products,Keila Alfaro-Visvikis,RETAIL  DSD,1389202,Jun
2025-06-18,Sabor Tropical Supermarket #7,Invoice,008-05778,Varios:Exhibidor de pie DOS HERMANOS PVC -,,1.0,0.01,0.01,4414602.25,Branded Rice,Keila Alfaro-Visvikis,RETAIL  DSD,1389203,Jun
2025-06-18,Sabor Tropical Supermarket #7,Invoice,008-05778,,Discount,,,-0.01,4414602.24,,Keila Alfaro-Visvikis,RETAIL  DSD,1389204,Jun
2025-06-18,Sedanos Supermarkets #16,Invoice,008-05779,Spanish Style Yellow Rice:AS Spanish Style Yellow Rice,AS Spanish Style Yellow Rice 6 / 3.25 oz,1.0,34.5,34.5,4414636.74,American Spice,Keila Alfaro-Visvikis,RETAIL SEDANOS,1389205,Jun
2025-06-18,Sedanos Supermarkets #16,Invoice,008-05779,Arroz Envasado:Largo Fino 1kg (Long grain rice) Dos Hermanos,,1.0,17.5,17.5,4414654.24,Branded Rice,Keila Alfaro-Visvikis,RETAIL SEDANOS,1389206,Jun
2025-06-18,Sedanos Supermarkets #16,Invoice,008-05779,Arroz Envasado:Long Rice 10 LB Dos Hermanos,,5.0,35.5,177.5,4414831.74,Branded Rice,Keila Alfaro-Visvikis,RETAIL SEDANOS,1389207,Jun
2025-06-18,Sedanos Supermarkets #16,Invoice,008-05779,Arroz Envasado:Parboiled 1kg Bolsa Dos Hermanos.,.,1.0,19.9,19.9,4414851.64,Branded Rice,Keila Alfaro-Visvikis,RETAIL SEDANOS,1389208,Jun
2025-06-18,Sedanos Supermarkets #16,Invoice,008-05779,Arroz Envasado:Long Rice 10 LB Dos Hermanos,,1.0,35.5,35.5,4414887.14,Branded Rice,Keila Alfaro-Visvikis,RETAIL SEDANOS,1389209,Jun
2025-06-18,Sedanos Supermarkets #16,Invoice,008-05779,,Discount,,,-4.99,4414882.15,,Keila Alfaro-Visvikis,RETAIL SEDANOS,1389210,Jun
2025-06-18,Sedanos Supermarkets #1,Invoice,008-05780,Arroz Envasado:Largo Fino 1kg (Long grain rice) Dos Hermanos,,1.0,17.5,17.5,4414899.65,Branded Rice,Keila Alfaro-Visvikis,RETAIL SEDANOS,1389211,Jun
2025-06-18,Sedanos Supermarkets #1,Invoice,008-05780,Arroz Envasado:Long Rice 10 LB Dos Hermanos,,1.0,35.5,35.5,4414935.15,Branded Rice,Keila Alfaro-Visvikis,RETAIL SEDANOS,1389212,Jun
2025-06-18,Sedanos Supermarkets #1,Invoice,008-05780,Arroz Envasado:Parboiled 1kg Bolsa Dos Hermanos.,.,1.0,19.9,19.9,4414955.05,Branded Rice,Keila Alfaro-Visvikis,RETAIL SEDANOS,1389213,Jun
2025-06-18,Sedanos Supermarkets #1,Invoice,008-05780,Arroz Envasado:Parboiled 5KG Dos Hermanos.,6  11lbs,1.0,40.5,40.5,4414995.55,Branded Rice,Keila Alfaro-Visvikis,RETAIL SEDANOS,1389214,Jun
2025-06-18,Sedanos Supermarkets #36,Invoice,008-05781,Spanish Style Yellow Rice:AS Spanish Style Yellow Rice,AS Spanish Style Yellow Rice 6 / 3.25 oz,1.0,34.5,34.5,4415030.05,American Spice,Keila Alfaro-Visvikis,RETAIL SEDANOS,1389215,Jun
2025-06-18,Sedanos Supermarkets #36,Invoice,008-05781,Arroz Envasado:Long Rice 10 LB Dos Hermanos,,1.0,35.5,35.5,4415065.55,Branded Rice,Keila Alfaro-Visvikis,RETAIL SEDANOS,1389216,Jun
2025-06-18,Sedanos Supermarkets #36,Invoice,008-05781,,Discount,,,-1.4,4415064.15,,Keila Alfaro-Visvikis,RETAIL SEDANOS,1389217,Jun
2025-06-18,Sedanos Supermarkets #27,Credit Memo,008-05782,Varios:Producto vencido/deteriorado (no impacta en inventario),"15  jamon, 14 salami 1 pizza",-30.0,0.99,-29.7,4415034.45,Puffed Products,Keila Alfaro-Visvikis,RETAIL SEDANOS,1389218,Jun
2025-06-18,Sedanos Supermarkets #24,Credit Memo,008-05783,Varios:Producto vencido/deteriorado (no impacta en inventario),7 jamon 3 salami,-10.0,0.99,-9.9,4415024.55,Puffed Products,Keila Alfaro-Visvikis,RETAIL SEDANOS,1389219,Jun
2025-06-18,Key Foods - 10301 Royal Palm Food Corp.,Credit Memo,008-05833,Varios:Promotional Allowance,Arroz Envasado:Parboiled 1kg Bolsa Dos Hermanos.,-10.0,19.9,-199.0,4414825.55,Branded Rice,Keila Alfaro-Visvikis,RETAIL KEY FOOD,1389220,Jun
2025-06-18,Sabor Tropical Supermarket #7,Credit Memo,008-05834,Varios:Promotional Allowance,Arroz Envasado:Parboiled 5KG Dos Hermanos.,-1.0,46.5,-46.5,4414779.05,Branded Rice,Keila Alfaro-Visvikis,RETAIL  DSD,1389221,Jun
2025-06-18,Sabor Tropical Supermarket #7,Credit Memo,008-05834,Varios:Promotional Allowance,Arroz Envasado:Long Rice 10 LB Dos Hermanos,-3.0,35.5,-106.5,4414672.55,Branded Rice,Keila Alfaro-Visvikis,RETAIL  DSD,1389222,Jun
2025-06-18,Sabor Tropical Supermarket #7,Credit Memo,008-05834,Varios:Promotional Allowance,Rice Snack:Rice Snack Salami Flavored DOS HERMANOS,-1.0,13.2,-13.2,4414659.35,Puffed Products,Keila Alfaro-Visvikis,RETAIL  DSD,1389223,Jun
2025-06-18,Sedanos Supermarkets #16,Credit Memo,008-05835,Varios:Promotional Allowance,Arroz Envasado:Long Rice 10 LB Dos Hermanos,-1.0,35.5,-35.5,4414623.85,Branded Rice,Keila Alfaro-Visvikis,RETAIL SEDANOS,1389224,Jun
2025-06-19,Sedanos Supermarkets #14,Invoice,008-05784,Arroz Envasado:Parboiled 1kg Bolsa Dos Hermanos.,.,3.0,19.9,59.7,4414683.55,Branded Rice,Keila Alfaro-Visvikis,RETAIL SEDANOS,1389225,Jun
2025-06-19,Sedanos Supermarkets #14,Invoice,008-05784,Arroz Envasado:Largo Fino 1kg (Long grain rice) Dos Hermanos,,2.0,17.5,35.0,4414718.55,Branded Rice,Keila Alfaro-Visvikis,RETAIL SEDANOS,1389226,Jun
2025-06-19,Sedanos Supermarkets #14,Invoice,008-05784,Arroz Envasado:Largo Fino 1kg (Long grain rice) Dos Hermanos,,1.0,17.5,17.5,4414736.05,Branded Rice,Keila Alfaro-Visvikis,RETAIL SEDANOS,1389227,Jun
2025-06-19,Sedanos Supermarkets #14,Invoice,008-05784,,Discount,,,-1.89,4414734.16,,Keila Alfaro-Visvikis,RETAIL SEDANOS,1389228,Jun
2025-06-19,Sedanos Supermarkets #14,Invoice,008-05785,Arroz a Granel:Parboiled 50 LB -Bolsa Dos Hermanos.,,2.0,28.25,56.5,4414790.66,Bulk Rice,Keila Alfaro-Visvikis,RETAIL SEDANOS,1389229,Jun
2025-06-19,Sedanos Supermarkets #14,Invoice,008-05785,,Discount,,,-1.13,4414789.53,,Keila Alfaro-Visvikis,RETAIL SEDANOS,1389230,Jun
2025-06-19,Sedanos Supermarkets #23,Invoice,008-05786,Spanish Style Yellow Rice:AS Spanish Style Yellow Rice,AS Spanish Style Yellow Rice 6 / 3.25 oz,1.0,34.5,34.5,4414824.03,American Spice,Keila Alfaro-Visvikis,RETAIL SEDANOS,1389231,Jun
2025-06-19,Sedanos Supermarkets #23,Invoice,008-05786,Arroz Envasado:Largo Fino 1kg (Long grain rice) Dos Hermanos,,1.0,17.5,17.5,4414841.53,Branded Rice,Keila Alfaro-Visvikis,RETAIL SEDANOS,1389232,Jun
2025-06-19,Sedanos Supermarkets #23,Invoice,008-05786,Arroz Envasado:Long Rice 10 LB Dos Hermanos,,5.0,35.5,177.5,4415019.03,Branded Rice,Keila Alfaro-Visvikis,RETAIL SEDANOS,1389233,Jun
2025-06-19,Sedanos Supermarkets #23,Invoice,008-05786,Arroz Envasado:Long Rice 10 LB Dos Hermanos,,1.0,17.5,17.5,4415036.53,Branded Rice,Keila Alfaro-Visvikis,RETAIL SEDANOS,1389234,Jun
2025-06-19,Sedanos Supermarkets #23,Invoice,008-05786,,Discount,,,-4.59,4415031.94,,Keila Alfaro-Visvikis,RETAIL SEDANOS,1389235,Jun
2025-06-19,El Gallego Supermarket,Invoice,008-05787,Arroz a Granel:Parboiled 50 LB -Bolsa Dos Hermanos.,,3.0,27.75,83.25,4415115.19,Bulk Rice,Lisset Limpio -020,RETAIL  DSD,1389236,Jun
2025-06-19,El Gallego Supermarket,Invoice,008-05787,Liquids:AS Bitter Orange,,2.0,14.0,28.0,4415143.19,American Spice,Lisset Limpio -020,RETAIL  DSD,1389237,Jun
2025-06-19,El Gallego Supermarket,Invoice,008-05787,Liquids:AS White Vinegar,4/1 Gl.,2.0,9.5,19.0,4415162.19,American Spice,Lisset Limpio -020,RETAIL  DSD,1389238,Jun
2025-06-19,El Gallego Supermarket,Invoice,008-05787,Dry Beans:Dry Beans - Black Beans 50,Dry Black Beans 50 lb,1.0,34.0,34.0,4415196.19,Dry Beans,Lisset Limpio -020,RETAIL  DSD,1389239,Jun
2025-06-19,El Palacio de los jugos / Delicias Criollas (DIAGO FOOD_MILLER),Invoice,008-05788,Arroz a Granel:Parboiled 50 LB -Bolsa Dos Hermanos.,,10.0,26.75,267.5,4415463.69,Bulk Rice,Lisset Limpio -020,Cafeteria,1389240,Jun
2025-06-19,El Palacio de los jugos / Rodriguez Foods,Invoice,008-05789,Arroz a Granel:Parboiled 50 LB -Bolsa Dos Hermanos.,,6.0,26.75,160.5,4415624.19,Bulk Rice,Lisset Limpio -020,Cafeteria,1389241,Jun
2025-06-19,Panda Depot,Invoice,008-05790,Arroz a Granel:Parboiled 50 LB -Bolsa Dos Hermanos.,,110.0,25.0,2750.0,4418374.19,Bulk Rice,Lisset Limpio -020,WHOLESALER,1389242,Jun
2025-06-19,El Palacio de los jugos /  EMMA FOOD CORP,Invoice,008-05791,Arroz a Granel:Largo Fino 50 LB -Bolsa Dos Hermanos.,,4.0,27.85,111.4,4418485.59,Bulk Rice,Lisset Limpio -020,Cafeteria,1389243,Jun
2025-06-19,El Palacio de los jugos /  EMMA FOOD CORP,Invoice,008-05791,Arroz a Granel:Parboiled 50 LB -Bolsa Dos Hermanos.,,5.0,26.75,133.75,4418619.34,Bulk Rice,Lisset Limpio -020,Cafeteria,1389244,Jun
2025-06-19,Sedanos Supermarkets  #37,Invoice,008-05792,Arroz Envasado:Long Rice 10 LB Dos Hermanos,,5.0,35.5,177.5,4418796.84,Branded Rice,Keila Alfaro-Visvikis,RETAIL SEDANOS,1389245,Jun
2025-06-19,Sedanos Supermarkets  #37,Invoice,008-05792,Arroz Envasado:Long Rice 10 LB Dos Hermanos,,1.0,35.5,35.5,4418832.34,Branded Rice,Keila Alfaro-Visvikis,RETAIL SEDANOS,1389246,Jun
2025-06-19,Sedanos Supermarkets #18,Invoice,008-05793,Arroz a Granel:Parboiled 50 LB -Bolsa Dos Hermanos.,,10.0,28.25,282.5,4419114.84,Bulk Rice,Keila Alfaro-Visvikis,RETAIL SEDANOS,1389247,Jun
2025-06-19,Sedanos Supermarkets #18,Invoice,008-05793,,Discount,,,-5.65,4419109.19,,Keila Alfaro-Visvikis,RETAIL SEDANOS,1389248,Jun
2025-06-19,Sedanos Supermarkets #32,Invoice,008-05794,Arroz Envasado:Long Rice 10 LB Dos Hermanos,,5.0,35.5,177.5,4419286.69,Branded Rice,Keila Alfaro-Visvikis,RETAIL SEDANOS,1389249,Jun
2025-06-19,Sedanos Supermarkets #32,Invoice,008-05794,Rice Snack:Rice Snack Ham Flavored DOS HERMANOS,,3.0,13.2,39.6,4419326.29,Puffed Products,Keila Alfaro-Visvikis,RETAIL SEDANOS,1389250,Jun
2025-06-19,Sedanos Supermarkets #32,Invoice,008-05794,Arroz Envasado:Long Rice 10 LB Dos Hermanos,,1.0,35.5,35.5,4419361.79,Branded Rice,Keila Alfaro-Visvikis,RETAIL SEDANOS,1389251,Jun
2025-06-19,Sedanos Supermarkets #32,Invoice,008-05794,Rice Snack:Rice Snack Salami Flavored DOS HERMANOS,,1.0,19.9,19.9,4419381.69,Puffed Products,Keila Alfaro-Visvikis,RETAIL SEDANOS,1389252,Jun
2025-06-19,Sedanos Supermarkets #32,Invoice,008-05794,Varios:Exhibidor de pie DOS HERMANOS PVC -,,1.0,0.01,0.01,4419381.7,Branded Rice,Keila Alfaro-Visvikis,RETAIL SEDANOS,1389253,Jun
2025-06-19,Sedanos Supermarkets #32,Invoice,008-05794,,Discount,,,-4.75,4419376.95,,Keila Alfaro-Visvikis,RETAIL SEDANOS,1389254,Jun
2025-06-19,Sedanos Supermarkets #32,Invoice,008-05795,Spices:AS Chicken Base,1 / 30 lb. (box or pail),1.0,39.0,39.0,4419415.95,American Spice,Keila Alfaro-Visvikis,RETAIL SEDANOS,1389255,Jun
2025-06-19,Sedanos Supermarkets #32,Invoice,008-05795,Arroz a Granel:Largo Fino 50 LB -Bolsa Dos Hermanos.,,4.0,27.85,111.4,4419527.35,Bulk Rice,Keila Alfaro-Visvikis,RETAIL SEDANOS,1389256,Jun
2025-06-19,Sedanos Supermarkets #32,Invoice,008-05795,Arroz a Granel:Parboiled 50 LB -Bolsa Dos Hermanos.,,4.0,28.25,113.0,4419640.35,Bulk Rice,Keila Alfaro-Visvikis,RETAIL SEDANOS,1389257,Jun
2025-06-19,Sedanos Supermarkets #32,Invoice,008-05795,,Discount,,,-5.27,4419635.08,,Keila Alfaro-Visvikis,RETAIL SEDANOS,1389258,Jun
2025-06-19,El Palacio de los jugos / Lita Foods Inc.,Invoice,008-05796,Dry Beans:Dry Beans - Black Beans 50,Dry Black Beans 50 lb,1.0,34.0,34.0,4419669.08,Dry Beans,Lisset Limpio -020,Cafeteria,1389259,Jun
2025-06-19,El Palacio de los jugos / Lita Foods Inc.,Invoice,008-05796,Arroz a Granel:Parboiled 50 LB -Bolsa Dos Hermanos.,,12.0,26.75,321.0,4419990.08,Bulk Rice,Lisset Limpio -020,Cafeteria,1389260,Jun
2025-06-19,El Palacio de Los Jugos / Casa mía Food Restaurant inc,Invoice,008-05797,Arroz a Granel:Parboiled 50 LB -Bolsa Dos Hermanos.,,6.0,26.75,160.5,4420150.58,Bulk Rice,Lisset Limpio -020,Cafeteria,1389261,Jun
2025-06-19,Futuro Supermarket,Invoice,008-05798,Arroz Envasado:Largo Fino 1kg (Long grain rice) Dos Hermanos,,1.0,18.0,18.0,4420168.58,Branded Rice,Lisset Limpio -020,RETAIL  DSD,1389262,Jun
2025-06-19,Futuro Supermarket,Invoice,008-05798,Arroz Envasado:Long Rice 10 LB Dos Hermanos,,15.0,35.5,532.5,4420701.08,Branded Rice,Lisset Limpio -020,RETAIL  DSD,1389263,Jun
2025-06-19,Futuro Supermarket,Invoice,008-05798,Arroz Envasado:Long Rice 10 LB Dos Hermanos,,3.0,35.5,106.5,4420807.58,Branded Rice,Lisset Limpio -020,RETAIL  DSD,1389264,Jun
2025-06-19,Sedanos Supermarkets #38,Invoice,008-05799,Arroz Envasado:Long Rice 10 LB Dos Hermanos,,15.0,35.5,532.5,4421340.08,Branded Rice,Keila Alfaro-Visvikis,RETAIL SEDANOS,1389265,Jun
2025-06-19,Sedanos Supermarkets #38,Invoice,008-05799,Arroz Envasado:Long Rice 10 LB Dos Hermanos,,3.0,35.5,106.5,4421446.58,Branded Rice,Keila Alfaro-Visvikis,RETAIL SEDANOS,1389266,Jun
2025-06-19,Sedanos Supermarkets #38,Invoice,008-05799,Rice Snack:Rice Snack Ham Flavored DOS HERMANOS,,1.0,13.2,13.2,4421459.78,Puffed Products,Keila Alfaro-Visvikis,RETAIL SEDANOS,1389267,Jun
2025-06-19,Sedanos Supermarkets #38,Invoice,008-05799,Rice Snack:Rice Snack Salami Flavored DOS HERMANOS,,1.0,13.2,13.2,4421472.98,Puffed Products,Keila Alfaro-Visvikis,RETAIL SEDANOS,1389268,Jun
2025-06-19,Sedanos Supermarkets #38,Invoice,008-05799,,Discount,,,-11.18,4421461.8,,Keila Alfaro-Visvikis,RETAIL SEDANOS,1389269,Jun
2025-06-19,Be Your Will LLC,Invoice,008-05800,Arroz a Granel:Largo Fino 50 LB -Bolsa Dos Hermanos.,,7.0,27.85,194.95,4421656.75,Bulk Rice,Lisset Limpio -020,CAFETERIA y RESTAURANTS,1389270,Jun
2025-06-19,Be Your Will LLC,Invoice,008-05800,Arroz a Granel:Parboiled 50 LB -Bolsa Dos Hermanos.,,11.0,26.75,294.25,4421951.0,Bulk Rice,Lisset Limpio -020,CAFETERIA y RESTAURANTS,1389271,Jun
2025-06-19,Be Your Will LLC,Invoice,008-05800,Liquids:AS Cooking Wine,4 1 Gl.,1.0,17.5,17.5,4421968.5,American Spice,Lisset Limpio -020,CAFETERIA y RESTAURANTS,1389272,Jun
2025-06-19,Sedanos Supermarkets  #4,Invoice,008-05801,Arroz Envasado:Parboiled 5KG Dos Hermanos.,6  11lbs,5.0,40.5,202.5,4422171.0,Branded Rice,Keila Alfaro-Visvikis,RETAIL SEDANOS,1389273,Jun
2025-06-19,Sedanos Supermarkets  #4,Invoice,008-05801,Arroz Envasado:Long Rice 10 LB Dos Hermanos,,5.0,35.5,177.5,4422348.5,Branded Rice,Keila Alfaro-Visvikis,RETAIL SEDANOS,1389274,Jun
2025-06-19,Sedanos Supermarkets  #4,Invoice,008-05801,Arroz Envasado:Long Rice 10 LB Dos Hermanos,,1.0,35.5,35.5,4422384.0,Branded Rice,Keila Alfaro-Visvikis,RETAIL SEDANOS,1389275,Jun
2025-06-19,Sedanos Supermarkets  #4,Invoice,008-05801,Arroz Envasado:Parboiled 5KG Dos Hermanos.,6  11lbs,1.0,40.5,40.5,4422424.5,Branded Rice,Keila Alfaro-Visvikis,RETAIL SEDANOS,1389276,Jun
2025-06-19,Sedanos Supermarkets  #4,Invoice,008-05801,,Discount,,,-7.6,4422416.9,,Keila Alfaro-Visvikis,RETAIL SEDANOS,1389277,Jun
2025-06-19,El Palacio de los jugos /  Nanos Latin Foods,Invoice,008-05802,Arroz a Granel:Largo Fino 50 LB -Bolsa Dos Hermanos.,,5.0,27.85,139.25,4422556.15,Bulk Rice,Lisset Limpio -020,Cafeteria,1389278,Jun
2025-06-19,El Palacio de los jugos /  Nanos Latin Foods,Invoice,008-05802,Arroz a Granel:Parboiled 50 LB -Bolsa Dos Hermanos.,,10.0,26.75,267.5,4422823.65,Bulk Rice,Lisset Limpio -020,Cafeteria,1389279,Jun
2025-06-19,Sedanos Supermarkets #33,Invoice,008-05803,Arroz a Granel:Parboiled 50 LB -Bolsa Dos Hermanos.,,4.0,28.25,113.0,4422936.65,Bulk Rice,Keila Alfaro-Visvikis,RETAIL SEDANOS,1389280,Jun
2025-06-19,Sedanos Supermarkets #33,Invoice,008-05803,,Discount,,,-2.26,4422934.39,,Keila Alfaro-Visvikis,RETAIL SEDANOS,1389281,Jun
2025-06-19,El Palacio de los jugos / Caribe Tropical,Invoice,008-05804,Dry Beans:Dry Beans - Black Beans 50,Dry Black Beans 50 lb,3.0,34.0,102.0,4423036.39,Dry Beans,Lisset Limpio -020,Cafeteria,1389282,Jun
2025-06-19,El Palacio de los jugos / Caribe Tropical,Invoice,008-05804,Arroz a Granel:Parboiled 50 LB -Bolsa Dos Hermanos.,,8.0,26.75,214.0,4423250.39,Bulk Rice,Lisset Limpio -020,Cafeteria,1389283,Jun
2025-06-19,El Palacio de los jugos / J Mena Corp.,Invoice,008-05805,Liquids:AS Marinating Sauce (Mojo),,2.0,18.5,37.0,4423287.39,American Spice,Lisset Limpio -020,Cafeteria,1389284,Jun
2025-06-19,El Palacio de los jugos / J Mena Corp.,Invoice,008-05805,Arroz a Granel:Parboiled 50 LB -Bolsa Dos Hermanos.,,10.0,26.75,267.5,4423554.89,Bulk Rice,Lisset Limpio -020,Cafeteria,1389285,Jun
2025-06-19,Sedanos Supermarkets #10,Credit Memo,008-05806,Varios:Producto vencido/deteriorado (no impacta en inventario),"20 Jamon
20 salami",-40.0,0.99,-39.6,4423515.29,Puffed Products,Keila Alfaro-Visvikis,RETAIL SEDANOS,1389286,Jun
2025-06-19,Sedanos Supermarkets #32,Credit Memo,008-05807,Varios:Producto vencido/deteriorado (no impacta en inventario),21 jamon,-21.0,0.99,-20.79,4423494.5,Puffed Products,Keila Alfaro-Visvikis,RETAIL SEDANOS,1389287,Jun
2025-06-19,Sabor Tropical Supermarket #7,Credit Memo,008-05808,Varios:Producto vencido/deteriorado (no impacta en inventario),"22 crédito jamón, salame  y 1 tostadas arroz",-23.0,0.99,-22.77,4423471.73,Puffed Products,Keila Alfaro-Visvikis,RETAIL  DSD,1389288,Jun
2025-06-19,Futuro Supermarket,Credit Memo,008-05836,Varios:Promotional Allowance,Arroz Envasado:Long Rice 10 LB Dos Hermanos,-3.0,35.5,-106.5,4423365.23,Branded Rice,Lisset Limpio -020,RETAIL  DSD,1389289,Jun
2025-06-19,Sedanos Supermarkets  #37,Credit Memo,008-05837,Varios:Promotional Allowance,Arroz Envasado:Long Rice 10 LB Dos Hermanos,-1.0,35.5,-35.5,4423329.73,Branded Rice,Keila Alfaro-Visvikis,RETAIL SEDANOS,1389290,Jun
2025-06-19,Sedanos Supermarkets  #4,Credit Memo,008-05838,Varios:Promotional Allowance,Arroz Envasado:Long Rice 10 LB Dos Hermanos,-1.0,35.5,-35.5,4423294.23,Branded Rice,Keila Alfaro-Visvikis,RETAIL SEDANOS,1389291,Jun
2025-06-19,Sedanos Supermarkets  #4,Credit Memo,008-05838,Varios:Promotional Allowance,Arroz Envasado:Parboiled 5KG Dos Hermanos.,-1.0,40.5,-40.5,4423253.73,Branded Rice,Keila Alfaro-Visvikis,RETAIL SEDANOS,1389292,Jun
2025-06-19,Sedanos Supermarkets #32,Credit Memo,008-05839,Varios:Promotional Allowance,Arroz Envasado:Long Rice 10 LB Dos Hermanos,-1.0,35.5,-35.5,4423218.23,Branded Rice,Keila Alfaro-Visvikis,RETAIL SEDANOS,1389293,Jun
2025-06-20,Bravo   Francisco Diaz,Invoice,008-05809,Arroz a Granel:Largo Fino 50 LB -Bolsa Dos Hermanos.,,5.0,27.85,139.25,4423357.48,Bulk Rice,Lisset Limpio -020,RETAIL  DSD,1389294,Jun
2025-06-20,Bravo   Francisco Diaz,Invoice,008-05809,Liquids:AS Cooking Wine,4 1 Gl.,5.0,17.5,87.5,4423444.98,American Spice,Lisset Limpio -020,RETAIL  DSD,1389295,Jun
2025-06-20,Bravo   Francisco Diaz,Invoice,008-05809,Liquids:AS Marinating Sauce (Mojo),,3.0,18.5,55.5,4423500.48,American Spice,Lisset Limpio -020,RETAIL  DSD,1389296,Jun
2025-06-20,Bravo   Francisco Diaz,Invoice,008-05809,Liquids:AS White Vinegar,4/1 Gl.,2.0,10.0,20.0,4423520.48,American Spice,Lisset Limpio -020,RETAIL  DSD,1389297,Jun
2025-06-20,Sedanos Supermarkets #38,Credit Memo,008-05840,Varios:Promotional Allowance,Arroz Envasado:Long Rice 10 LB Dos Hermanos,-3.0,35.5,-106.5,4423413.98,Branded Rice,Keila Alfaro-Visvikis,RETAIL SEDANOS,1389298,Jun
2025-06-23,El Palacio de los jugos /  Mires Restaurants,Invoice,008-05810,Arroz a Granel:Parboiled 50 LB -Bolsa Dos Hermanos.,,11.0,27.75,305.25,4423719.23,Bulk Rice,Lisset Limpio -020,Cafeteria,1389299,Jun
2025-06-23,El Palacio de los jugos /  Mires Restaurants,Invoice,008-05810,Arroz a Granel:Parboiled 50 LB -Bolsa Dos Hermanos.,,1.0,27.75,27.75,4423746.98,Bulk Rice,Lisset Limpio -020,Cafeteria,1389300,Jun
2025-06-23,El Palacio de los jugos / J Mena Corp.,Invoice,008-05811,Arroz a Granel:Parboiled 50 LB -Bolsa Dos Hermanos.,,10.0,26.75,267.5,4424014.48,Bulk Rice,Lisset Limpio -020,Cafeteria,1389301,Jun
2025-06-23,El Palacio de los jugos /  EMMA FOOD CORP,Invoice,008-05812,Arroz a Granel:Largo Fino 50 LB -Bolsa Dos Hermanos.,,5.0,27.85,139.25,4424153.73,Bulk Rice,Lisset Limpio -020,Cafeteria,1389302,Jun
2025-06-23,El Palacio de los jugos /  EMMA FOOD CORP,Invoice,008-05812,Arroz a Granel:Parboiled 50 LB -Bolsa Dos Hermanos.,,8.0,26.75,214.0,4424367.73,Bulk Rice,Lisset Limpio -020,Cafeteria,1389303,Jun
2025-06-23,El Palacio de los Jugos / Bird Road Restaurant,Invoice,008-05813,Arroz a Granel:Parboiled 50 LB -Bolsa Dos Hermanos.,,10.0,26.75,267.5,4424635.23,Bulk Rice,Lisset Limpio -020,Cafeteria,1389304,Jun
2025-06-23,El Palacio de los Jugos / Bird Road Restaurant,Invoice,008-05813,Dry Beans:Dry Beans - Black Beans 50,Dry Black Beans 50 lb,1.0,34.0,34.0,4424669.23,Dry Beans,Lisset Limpio -020,Cafeteria,1389305,Jun
2025-06-23,El Palacio de Los Jugos / Casa mía Food Restaurant inc,Invoice,008-05814,Arroz a Granel:Parboiled 50 LB -Bolsa Dos Hermanos.,,6.0,26.75,160.5,4424829.73,Bulk Rice,Lisset Limpio -020,Cafeteria,1389306,Jun
2025-06-23,El Palacio de Los Jugos / Casa mía Food Restaurant inc,Invoice,008-05814,Liquids:AS Lemon Juice 4/1 Gl,,1.0,14.95,14.95,4424844.68,American Spice,Lisset Limpio -020,Cafeteria,1389307,Jun
2025-06-23,El Palacio de los jugos /  Nanos Latin Foods,Invoice,008-05815,Arroz a Granel:Largo Fino 50 LB -Bolsa Dos Hermanos.,,5.0,27.85,139.25,4424983.93,Bulk Rice,Lisset Limpio -020,Cafeteria,1389308,Jun
2025-06-23,El Palacio de los jugos /  Nanos Latin Foods,Invoice,008-05815,Arroz a Granel:Parboiled 50 LB -Bolsa Dos Hermanos.,,7.0,26.75,187.25,4425171.18,Bulk Rice,Lisset Limpio -020,Cafeteria,1389309,Jun
2025-06-23,El Palacio de los jugos / Rodriguez Foods,Invoice,008-05816,Arroz a Granel:Parboiled 50 LB -Bolsa Dos Hermanos.,,6.0,26.75,160.5,4425331.68,Bulk Rice,Lisset Limpio -020,Cafeteria,1389310,Jun
2025-06-23,El Palacio de los jugos / Divan and Denise Food,Invoice,008-05817,Dry Beans:Dry Beans - Black Beans 50,Dry Black Beans 50 lb,1.0,34.0,34.0,4425365.68,Dry Beans,Lisset Limpio -020,Cafeteria,1389311,Jun
2025-06-23,El Palacio de los jugos / Divan and Denise Food,Invoice,008-05817,Arroz a Granel:Parboiled 50 LB -Bolsa Dos Hermanos.,,10.0,26.75,267.5,4425633.18,Bulk Rice,Lisset Limpio -020,Cafeteria,1389312,Jun
2025-06-23,El Palacio de los jugos / Caribe Tropical,Invoice,008-05818,Dry Beans:Dry Beans - Black Beans 50,Dry Black Beans 50 lb,2.0,34.0,68.0,4425701.18,Dry Beans,Lisset Limpio -020,Cafeteria,1389313,Jun
2025-06-23,El Palacio de los jugos / Caribe Tropical,Invoice,008-05818,Arroz a Granel:Parboiled 50 LB -Bolsa Dos Hermanos.,,6.0,26.75,160.5,4425861.68,Bulk Rice,Lisset Limpio -020,Cafeteria,1389314,Jun
2025-06-23,JMN Dely Corp,Invoice,008-05819,Dry Beans:Dry Beans - Black Beans 50,Dry Black Beans 50 lb,1.0,45.7,45.7,4425907.38,Dry Beans,Keila Alfaro-Visvikis,CAFETERIA y RESTAURANTS,1389315,Jun
2025-06-23,JMN Dely Corp,Invoice,008-05819,Arroz a Granel:Largo Fino 50 LB -Bolsa Dos Hermanos.,,2.0,27.85,55.7,4425963.08,Bulk Rice,Keila Alfaro-Visvikis,CAFETERIA y RESTAURANTS,1389316,Jun
2025-06-23,JMN Dely Corp,Invoice,008-05819,Arroz a Granel:Parboiled 50 LB -Bolsa Dos Hermanos.,,2.0,28.25,56.5,4426019.58,Bulk Rice,Keila Alfaro-Visvikis,CAFETERIA y RESTAURANTS,1389317,Jun
2025-06-23,Sedanos Supermarkets #31,Invoice,008-05820,Arroz a Granel:Parboiled 50 LB -Bolsa Dos Hermanos.,,4.0,28.25,113.0,4426132.58,Bulk Rice,Keila Alfaro-Visvikis,RETAIL SEDANOS,1389318,Jun
2025-06-23,Sedanos Supermarkets #31,Invoice,008-05820,,Discount,,,-2.26,4426130.32,,Keila Alfaro-Visvikis,RETAIL SEDANOS,1389319,Jun
2025-06-24,Bravo   Francisco Diaz,Invoice,008-05821,Spices:AS Chicken Base,1 / 30 lb. (box or pail),1.0,39.0,39.0,4426169.32,American Spice,Lisset Limpio -020,RETAIL  DSD,1389320,Jun
2025-06-24,Bravo   Francisco Diaz,Invoice,008-05821,Liquids:AS Cooking Wine,4 1 Gl.,2.0,17.5,35.0,4426204.32,American Spice,Lisset Limpio -020,RETAIL  DSD,1389321,Jun
2025-06-24,Bravo   Francisco Diaz,Invoice,008-05821,Arroz a Granel:Largo Fino 50 LB -Bolsa Dos Hermanos.,,5.0,27.85,139.25,4426343.57,Bulk Rice,Lisset Limpio -020,RETAIL  DSD,1389322,Jun
2025-06-24,Bravo   Francisco Diaz,Invoice,008-05821,Dry Beans:Dry Beans - Black Beans 50,Dry Black Beans 50 lb,1.0,35.0,35.0,4426378.57,Dry Beans,Lisset Limpio -020,RETAIL  DSD,1389323,Jun
2025-06-24,El Palacio de Los Jugos / Casa mía Food Restaurant inc,Invoice,008-05822,Liquids:AS Marinating Sauce (Mojo),4 / 1 Gl,1.0,17.5,17.5,4426396.07,American Spice,Lisset Limpio -020,Cafeteria,1389324,Jun
2025-06-24,Soriano Brothers PB,Invoice,008-05823,Arroz a Granel:Largo Fino 50 LB -Bolsa Dos Hermanos.,,10.0,27.85,278.5,4426674.57,Bulk Rice,Lisset Limpio -020,CAFETERIA y RESTAURANTS,1389325,Jun
2025-06-24,Soriano Brothers PB,Invoice,008-05823,Arroz a Granel:Parboiled 50 LB -Bolsa Dos Hermanos.,,12.0,25.44,305.28,4426979.85,Bulk Rice,Lisset Limpio -020,CAFETERIA y RESTAURANTS,1389326,Jun
2025-06-24,Soriano Brothers PB,Invoice,008-05823,Spices:AS Sazon (for all),1 / 30 lb (box or pail),2.0,51.0,102.0,4427081.85,American Spice,Lisset Limpio -020,CAFETERIA y RESTAURANTS,1389327,Jun
2025-06-24,Soriano Brothers PB,Invoice,008-05823,Dry Beans:Dry Beans - Black Beans 50,Dry Black Beans 50 lb,3.0,34.0,102.0,4427183.85,Dry Beans,Lisset Limpio -020,CAFETERIA y RESTAURANTS,1389328,Jun
2025-06-25,Sedanos Supermarkets #26,Credit Memo,008-05841,Varios:Producto vencido/deteriorado (no impacta en inventario),"11/6/2025 19 salame, 12 jamon 1 pizza",-32.0,0.99,-31.68,4427152.17,Puffed Products,Keila Alfaro-Visvikis,RETAIL SEDANOS,1389329,Jun
2025-06-25,Aries Supermarket & Cafeteria,Invoice,008-05842,Dry Beans:Dry Beans - Black Beans 50,Dry Black Beans 50 lb,5.0,35.7,178.5,4427330.67,Dry Beans,Keila Alfaro-Visvikis,CAFETERIA y RESTAURANTS,1389330,Jun
2025-06-25,Aries Supermarket & Cafeteria,Invoice,008-05842,Arroz a Granel:Parboiled 50 LB -Bolsa Dos Hermanos.,,10.0,28.25,282.5,4427613.17,Bulk Rice,Keila Alfaro-Visvikis,CAFETERIA y RESTAURANTS,1389331,Jun
2025-06-25,Sedanos Supermarkets #43,Invoice,008-05843,Arroz a Granel:Parboiled 50 LB -Bolsa Dos Hermanos.,,5.0,28.25,141.25,4427754.42,Bulk Rice,Keila Alfaro-Visvikis,RETAIL SEDANOS,1389332,Jun
2025-06-25,Sedanos Supermarkets #43,Invoice,008-05843,,Discount,,,-2.83,4427751.59,,Keila Alfaro-Visvikis,RETAIL SEDANOS,1389333,Jun
2025-06-25,Sedanos Supermarkets #16,Invoice,008-05844,Arroz a Granel:Parboiled 50 LB -Bolsa Dos Hermanos.,,4.0,28.25,113.0,4427864.59,Bulk Rice,Keila Alfaro-Visvikis,RETAIL SEDANOS,1389334,Jun
2025-06-25,Sedanos Supermarkets #16,Invoice,008-05844,,Discount,,,-2.26,4427862.33,,Keila Alfaro-Visvikis,RETAIL SEDANOS,1389335,Jun
2025-06-25,Sedanos Supermarkets #26,Invoice,008-05845,Rice Snack:Rice Snack Ham Flavored DOS HERMANOS,,2.0,19.9,39.8,4427902.13,Puffed Products,Keila Alfaro-Visvikis,RETAIL SEDANOS,1389336,Jun
2025-06-25,Sedanos Supermarkets #26,Invoice,008-05845,Rice Snack:Rice Snack Salami Flavored DOS HERMANOS,,1.0,19.9,19.9,4427922.03,Puffed Products,Keila Alfaro-Visvikis,RETAIL SEDANOS,1389337,Jun
2025-06-25,Sedanos Supermarkets #26,Invoice,008-05845,Arroz Envasado:Long Rice 10 LB Dos Hermanos,,1.0,35.5,35.5,4427957.53,American Spice,Keila Alfaro-Visvikis,RETAIL SEDANOS,1389338,Jun
2025-06-25,Sedanos Supermarkets #26,Invoice,008-05845,Rice Snack:Rice Snack Salami Flavored DOS HERMANOS,,1.0,19.9,19.9,4427977.43,Puffed Products,Keila Alfaro-Visvikis,RETAIL SEDANOS,1389339,Jun
2025-06-25,Sedanos Supermarkets #26,Invoice,008-05846,Arroz a Granel:Parboiled 50 LB -Bolsa Dos Hermanos.,,5.0,28.25,141.25,4428118.68,Bulk Rice,Keila Alfaro-Visvikis,RETAIL SEDANOS,1389340,Jun
2025-06-25,Ideal Food Basket Davie Cafeteria,Invoice,008-05847,Arroz a Granel:Largo Fino 50 LB -Bolsa Dos Hermanos.,,6.0,27.85,167.1,4428285.78,Bulk Rice,Keila Alfaro-Visvikis,CAFETERIA y RESTAURANTS,1389341,Jun
2025-06-25,Sedanos Supermarkets #34,Invoice,008-05848,Arroz Envasado:Largo Fino 1kg (Long grain rice) Dos Hermanos,,2.0,17.5,35.0,4428320.78,Branded Rice,Keila Alfaro-Visvikis,RETAIL SEDANOS,1389342,Jun
2025-06-25,Sedanos Supermarkets #34,Invoice,008-05848,Arroz Envasado:Parboiled 1kg Bolsa Dos Hermanos.,.,3.0,19.9,59.7,4428380.48,Branded Rice,Keila Alfaro-Visvikis,RETAIL SEDANOS,1389343,Jun
2025-06-25,Sedanos Supermarkets #34,Invoice,008-05848,Arroz Envasado:Largo Fino 1kg (Long grain rice) Dos Hermanos,,1.0,35.5,35.5,4428415.98,Branded Rice,Keila Alfaro-Visvikis,RETAIL SEDANOS,1389344,Jun
2025-06-25,Sedanos Supermarkets #34,Invoice,008-05848,,Discount,,,-1.89,4428414.09,,Keila Alfaro-Visvikis,RETAIL SEDANOS,1389345,Jun
2025-06-25,Sedanos Supermarkets #27,Invoice,008-05849,Arroz Envasado:Parboiled 5KG Dos Hermanos.,6  11lbs,15.0,40.5,607.5,4429021.59,Branded Rice,Keila Alfaro-Visvikis,RETAIL SEDANOS,1389346,Jun
2025-06-25,Sedanos Supermarkets #27,Invoice,008-05849,Rice Snack:Rice Snack Ham Flavored DOS HERMANOS,,2.0,13.2,26.4,4429047.99,Puffed Products,Keila Alfaro-Visvikis,RETAIL SEDANOS,1389347,Jun
2025-06-25,Sedanos Supermarkets #27,Invoice,008-05849,Rice Snack:Rice Snack Salami Flavored DOS HERMANOS,,1.0,13.2,13.2,4429061.19,Puffed Products,Keila Alfaro-Visvikis,RETAIL SEDANOS,1389348,Jun
2025-06-25,Sedanos Supermarkets #27,Invoice,008-05849,Spanish Style Yellow Rice:AS Spanish Style Yellow Rice,AS Spanish Style Yellow Rice 6 / 3.25 oz,1.0,34.5,34.5,4429095.69,American Spice,Keila Alfaro-Visvikis,RETAIL SEDANOS,1389349,Jun
2025-06-25,Sedanos Supermarkets #27,Invoice,008-05849,Arroz Envasado:Parboiled 5KG Dos Hermanos.,6  11lbs,3.0,40.5,121.5,4429217.19,Branded Rice,Keila Alfaro-Visvikis,RETAIL SEDANOS,1389350,Jun
2025-06-25,Sedanos Supermarkets #27,Invoice,008-05849,Rice Snack:Rice Snack Salami Flavored DOS HERMANOS,,1.0,13.2,13.2,4429230.39,Puffed Products,Keila Alfaro-Visvikis,RETAIL SEDANOS,1389351,Jun
2025-06-25,Sedanos Supermarkets #27,Invoice,008-05849,Varios:Exhibidor de pie DOS HERMANOS PVC -,,1.0,0.01,0.01,4429230.4,Branded Rice,Keila Alfaro-Visvikis,RETAIL SEDANOS,1389352,Jun
2025-06-25,Sedanos Supermarkets #27,Invoice,008-05849,,Discount,,,-13.05,4429217.35,,Keila Alfaro-Visvikis,RETAIL SEDANOS,1389353,Jun
2025-06-25,ALS Foods,Invoice,008-05850,Liquids:AS Cooking Wine,4 1 Gl.,1.0,17.5,17.5,4429234.85,American Spice,Lisset Limpio -020,CAFETERIA y RESTAURANTS,1389354,Jun
2025-06-25,ALS Foods,Invoice,008-05850,Arroz a Granel:Largo Fino 50 LB -Bolsa Dos Hermanos.,,7.0,27.85,194.95,4429429.8,Bulk Rice,Lisset Limpio -020,CAFETERIA y RESTAURANTS,1389355,Jun
2025-06-25,ALS Foods,Invoice,008-05850,Arroz a Granel:Parboiled 50 LB -Bolsa Dos Hermanos.,,11.0,27.75,305.25,4429735.05,Bulk Rice,Lisset Limpio -020,CAFETERIA y RESTAURANTS,1389356,Jun
2025-06-25,ALS Foods,Invoice,008-05850,Dry Beans:Dry Beans - Black Beans 50,Dry Black Beans 50 lb,1.0,34.0,34.0,4429769.05,Dry Beans,Lisset Limpio -020,CAFETERIA y RESTAURANTS,1389357,Jun
2025-06-25,ALS Foods,Invoice,008-05850,Arroz a Granel:Parboiled 50 LB -Bolsa Dos Hermanos.,,1.0,27.75,27.75,4429796.8,Bulk Rice,Lisset Limpio -020,CAFETERIA y RESTAURANTS,1389358,Jun
2025-06-25,Sedanos Supermarkets #24,Invoice,008-05851,Arroz a Granel:Parboiled 50 LB -Bolsa Dos Hermanos.,,10.0,28.25,282.5,4430079.3,Bulk Rice,Keila Alfaro-Visvikis,RETAIL SEDANOS,1389359,Jun
2025-06-25,Sedanos Supermarkets #24,Invoice,008-05851,,Discount,,,-5.45,4430073.85,,Keila Alfaro-Visvikis,RETAIL SEDANOS,1389360,Jun
2025-06-25,Mei Chang,Invoice,008-05852,Arroz a Granel:Parboiled 50 LB -Bolsa Dos Hermanos.,,7.0,28.25,197.75,4430271.6,Bulk Rice,Lisset Limpio -020,CAFETERIA y RESTAURANTS,1389361,Jun
2025-06-25,Festival Supermarket Margate,Invoice,008-05853,Arroz Envasado:Long Rice 10 LB Dos Hermanos,,5.0,35.5,177.5,4430449.1,Branded Rice,Keila Alfaro-Visvikis,RETAIL  DSD,1389362,Jun
2025-06-25,Festival Supermarket Margate,Invoice,008-05853,Arroz Envasado:Long Rice 10 LB Dos Hermanos,,1.0,35.5,35.5,4430484.6,Branded Rice,Keila Alfaro-Visvikis,RETAIL  DSD,1389363,Jun
2025-06-25,Festival Supermarket #35- Southgate,Invoice,008-05854,Arroz Envasado:Parboiled 5KG Dos Hermanos.,6  11lbs,15.0,46.5,697.5,4431182.1,Branded Rice,Keila Alfaro-Visvikis,RETAIL  DSD,1389364,Jun
2025-06-25,Festival Supermarket #35- Southgate,Invoice,008-05854,Arroz Envasado:Parboiled 5KG Dos Hermanos.,6  11lbs,8.0,46.5,372.0,4431554.1,Branded Rice,Keila Alfaro-Visvikis,RETAIL  DSD,1389365,Jun
2025-06-26,Sedanos Supermarkets #10,Invoice,008-05855,Rice Snack:Rice Snack Ham Flavored DOS HERMANOS,,2.0,19.9,39.8,4431593.9,Puffed Products,Keila Alfaro-Visvikis,RETAIL SEDANOS,1389366,Jun
2025-06-26,Sedanos Supermarkets #10,Invoice,008-05855,Rice Snack:Rice Snack Salami Flavored DOS HERMANOS,,1.0,19.9,19.9,4431613.8,Puffed Products,Keila Alfaro-Visvikis,RETAIL SEDANOS,1389367,Jun
2025-06-26,Sedanos Supermarkets #10,Invoice,008-05855,Spanish Style Yellow Rice:AS Spanish Style Yellow Rice,AS Spanish Style Yellow Rice 6 / 3.25 oz,1.0,34.5,34.5,4431648.3,American Spice,Keila Alfaro-Visvikis,RETAIL SEDANOS,1389368,Jun
2025-06-26,Sedanos Supermarkets #10,Invoice,008-05855,Rice Snack:Rice Snack Salami Flavored DOS HERMANOS,,1.0,19.9,19.9,4431668.2,Puffed Products,Keila Alfaro-Visvikis,RETAIL SEDANOS,1389369,Jun
2025-06-26,Sedanos Supermarkets #10,Invoice,008-05855,Varios:Exhibidor de pie DOS HERMANOS PVC -,,1.0,0.01,0.01,4431668.21,Branded Rice,Keila Alfaro-Visvikis,RETAIL SEDANOS,1389370,Jun
2025-06-26,Sedanos Supermarkets #10,Invoice,008-05855,,Discount,,,-1.09,4431667.12,,Keila Alfaro-Visvikis,RETAIL SEDANOS,1389371,Jun
2025-06-26,El Palacio de los jugos / Delicias Criollas (DIAGO FOOD_MILLER),Invoice,008-05856,Arroz a Granel:Largo Fino 50 LB -Bolsa Dos Hermanos.,,3.0,27.85,83.55,4431750.67,Bulk Rice,Lisset Limpio -020,Cafeteria,1389372,Jun
2025-06-26,El Palacio de los jugos / Delicias Criollas (DIAGO FOOD_MILLER),Invoice,008-05856,Arroz a Granel:Parboiled 50 LB -Bolsa Dos Hermanos.,,12.0,26.75,321.0,4432071.67,Bulk Rice,Lisset Limpio -020,Cafeteria,1389373,Jun
2025-06-26,Sabor Tropical #1 - Cafeteria,Invoice,008-05857,Arroz Envasado:Parboiled 5KG Dos Hermanos.,6  11lbs,15.0,46.5,697.5,4432769.17,Branded Rice,Keila Alfaro-Visvikis,CAFETERIA y RESTAURANTS,1389374,Jun
2025-06-26,Sabor Tropical #1 - Cafeteria,Invoice,008-05857,Arroz Envasado:Parboiled 5KG Dos Hermanos.,6  11lbs,7.0,46.5,325.5,4433094.67,Branded Rice,Keila Alfaro-Visvikis,CAFETERIA y RESTAURANTS,1389375,Jun
2025-06-26,Sedanos Supermarkets #33,Invoice,008-05858,Arroz a Granel:Parboiled 50 LB -Bolsa Dos Hermanos.,,3.0,28.25,84.75,4433179.42,Bulk Rice,Keila Alfaro-Visvikis,RETAIL SEDANOS,1389376,Jun
2025-06-26,Sedanos Supermarkets #33,Invoice,008-05858,,Discount,,,-1.71,4433177.71,,Keila Alfaro-Visvikis,RETAIL SEDANOS,1389377,Jun
2025-06-26,Sedanos Supermarkets #42,Invoice,008-05859,Spanish Style Yellow Rice:AS Spanish Style Yellow Rice,AS Spanish Style Yellow Rice 6 / 3.25 oz,1.0,34.5,34.5,4433212.21,American Spice,Keila Alfaro-Visvikis,RETAIL SEDANOS,1389378,Jun
2025-06-26,Sedanos Supermarkets #42,Invoice,008-05859,Arroz Envasado:Largo Fino 1kg (Long grain rice) Dos Hermanos,,1.0,17.5,17.5,4433229.71,Branded Rice,Keila Alfaro-Visvikis,RETAIL SEDANOS,1389379,Jun
2025-06-26,Sedanos Supermarkets #42,Invoice,008-05859,Arroz Envasado:Long Rice 10 LB Dos Hermanos,,1.0,35.5,35.5,4433265.21,Branded Rice,Keila Alfaro-Visvikis,RETAIL SEDANOS,1389380,Jun
2025-06-26,Sedanos Supermarkets #42,Invoice,008-05859,Rice Snack:Rice Snack Ham Flavored DOS HERMANOS,,2.0,19.9,39.8,4433305.01,Puffed Products,Keila Alfaro-Visvikis,RETAIL SEDANOS,1389381,Jun
2025-06-26,Sedanos Supermarkets #42,Invoice,008-05859,Rice Snack:Rice Snack Salami Flavored DOS HERMANOS,,1.0,19.9,19.9,4433324.91,Puffed Products,Keila Alfaro-Visvikis,RETAIL SEDANOS,1389382,Jun
2025-06-26,Sedanos Supermarkets #42,Invoice,008-05859,Rice Snack:Rice Snack Salami Flavored DOS HERMANOS,,1.0,19.9,19.9,4433344.81000001,Puffed Products,Keila Alfaro-Visvikis,RETAIL SEDANOS,1389383,Jun
2025-06-26,Sedanos Supermarkets #42,Invoice,008-05859,,Discount,,,-2.23,4433342.58,,Keila Alfaro-Visvikis,RETAIL SEDANOS,1389384,Jun
2025-06-26,Sedanos Supermarkets #42,Invoice,008-05860,Arroz a Granel:Parboiled 50 LB -Bolsa Dos Hermanos.,,5.0,28.25,141.25,4433483.83,Bulk Rice,Keila Alfaro-Visvikis,RETAIL SEDANOS,1389385,Jun
2025-06-26,Sedanos Supermarkets #42,Invoice,008-05860,,Discount,,,-2.83,4433481.0,,Keila Alfaro-Visvikis,RETAIL SEDANOS,1389386,Jun
2025-06-26,Sedanos Supermarkets #32,Invoice,008-05861,Arroz a Granel:Largo Fino 50 LB -Bolsa Dos Hermanos.,,3.0,27.85,83.55,4433564.55,Bulk Rice,Keila Alfaro-Visvikis,RETAIL SEDANOS,1389387,Jun
2025-06-26,Sedanos Supermarkets #32,Invoice,008-05861,Arroz a Granel:Parboiled 50 LB -Bolsa Dos Hermanos.,,3.0,28.25,84.75,4433649.3,Bulk Rice,Keila Alfaro-Visvikis,RETAIL SEDANOS,1389388,Jun
2025-06-26,Sedanos Supermarkets #32,Invoice,008-05861,,Discount,,,-2.95,4433646.35,,Keila Alfaro-Visvikis,RETAIL SEDANOS,1389389,Jun
2025-06-26,El Palacio de los jugos /  Nanos Latin Foods,Invoice,008-05862,Arroz a Granel:Largo Fino 50 LB -Bolsa Dos Hermanos.,,5.0,27.85,139.25,4433785.6,Bulk Rice,Lisset Limpio -020,Cafeteria,1389390,Jun
2025-06-26,El Palacio de los jugos /  Nanos Latin Foods,Invoice,008-05862,Arroz a Granel:Parboiled 50 LB -Bolsa Dos Hermanos.,,10.0,26.75,267.5,4434053.1,Bulk Rice,Lisset Limpio -020,Cafeteria,1389391,Jun
2025-06-26,El Palacio de los jugos / Lita Foods Inc.,Invoice,008-05863,Dry Beans:Dry Beans - Black Beans 50,Dry Black Beans 50 lb,1.0,34.0,34.0,4434087.1,Dry Beans,Lisset Limpio -020,Cafeteria,1389392,Jun
2025-06-26,El Palacio de los jugos / Lita Foods Inc.,Invoice,008-05863,Arroz a Granel:Parboiled 50 LB -Bolsa Dos Hermanos.,,11.0,26.75,294.25,4434381.35,Bulk Rice,Lisset Limpio -020,Cafeteria,1389393,Jun
2025-06-26,El Palacio de los jugos / Caribe Tropical,Invoice,008-05864,Arroz a Granel:Parboiled 50 LB -Bolsa Dos Hermanos.,,6.0,26.75,160.5,4434541.85,Bulk Rice,Lisset Limpio -020,Cafeteria,1389394,Jun
2025-06-26,El Palacio de los jugos / Caribe Tropical,Invoice,008-05864,Dry Beans:Dry Beans - Black Beans 50,Dry Black Beans 50 lb,1.0,34.0,34.0,4434575.85,Dry Beans,Lisset Limpio -020,Cafeteria,1389395,Jun
2025-06-26,El Palacio de Los Jugos / Casa mía Food Restaurant inc,Invoice,008-05865,Arroz a Granel:Parboiled 50 LB -Bolsa Dos Hermanos.,,8.0,26.75,214.0,4434789.85,Bulk Rice,Lisset Limpio -020,Cafeteria,1389396,Jun
2025-06-26,El Palacio de los jugos / Divan and Denise Food,Invoice,008-05866,Arroz a Granel:Parboiled 50 LB -Bolsa Dos Hermanos.,,10.0,26.75,267.5,4435057.35,Bulk Rice,Lisset Limpio -020,Cafeteria,1389397,Jun
2025-06-26,El Palacio de los jugos / Rodriguez Foods,Invoice,008-05867,Arroz a Granel:Parboiled 50 LB -Bolsa Dos Hermanos.,,6.0,26.75,160.5,4435217.85,Bulk Rice,Lisset Limpio -020,Cafeteria,1389398,Jun
2025-06-26,El Palacio de los jugos / Leti Corp.,Invoice,008-05868,Arroz a Granel:Largo Fino 50 LB -Bolsa Dos Hermanos.,,5.0,27.85,139.25,4435357.1,Bulk Rice,Lisset Limpio -020,Cafeteria,1389399,Jun
2025-06-26,El Palacio de los jugos / Leti Corp.,Invoice,008-05868,Arroz a Granel:Parboiled 50 LB -Bolsa Dos Hermanos.,,8.0,26.75,214.0,4435571.1,Bulk Rice,Lisset Limpio -020,Cafeteria,1389400,Jun
2025-06-26,Sedanos Supermarkets #21,Invoice,008-05869,Arroz Envasado:Parboiled 5KG Dos Hermanos.,6  11lbs,5.0,40.5,202.5,4435773.6,Branded Rice,Keila Alfaro-Visvikis,RETAIL SEDANOS,1389401,Jun
2025-06-26,Sedanos Supermarkets #21,Invoice,008-05869,Arroz Envasado:Long Rice 10 LB Dos Hermanos,,5.0,35.5,177.5,4435951.1,Branded Rice,Keila Alfaro-Visvikis,RETAIL SEDANOS,1389402,Jun
2025-06-26,Sedanos Supermarkets #21,Invoice,008-05869,Arroz Envasado:Parboiled 5KG Dos Hermanos.,6  11lbs,1.0,40.5,40.5,4435991.6,Branded Rice,Keila Alfaro-Visvikis,RETAIL SEDANOS,1389403,Jun
2025-06-26,Sedanos Supermarkets #21,Invoice,008-05869,Arroz Envasado:Long Rice 10 LB Dos Hermanos,6  / 10lbs,1.0,35.5,35.5,4436027.1,Branded Rice,Keila Alfaro-Visvikis,RETAIL SEDANOS,1389404,Jun
2025-06-26,Sedanos Supermarkets #21,Invoice,008-05869,,Discount,,,-7.6,4436019.5,,Keila Alfaro-Visvikis,RETAIL SEDANOS,1389405,Jun
2025-06-27,Festival Supermarket Margate,Credit Memo,008-05870,Varios:Promotional Allowance,Arroz Envasado:Long Rice 10 LB Dos Hermanos,-1.0,35.5,-35.5,4435984.0,Branded Rice,Keila Alfaro-Visvikis,RETAIL  DSD,1389406,Jun
2025-06-27,Sedanos Supermarkets #34,Credit Memo,008-05871,Varios:Promotional Allowance,Arroz Envasado:Largo Fino 1kg (Long grain rice) Dos Hermanos,-1.0,35.5,-35.5,4435948.5,Branded Rice,Keila Alfaro-Visvikis,RETAIL SEDANOS,1389407,Jun
2025-06-27,Festival Supermarket #35- Southgate,Credit Memo,008-05872,Varios:Promotional Allowance,Arroz Envasado:Parboiled 5KG Dos Hermanos.,-8.0,46.5,-372.0,4435576.5,Branded Rice,Keila Alfaro-Visvikis,RETAIL  DSD,1389408,Jun
2025-06-27,Sedanos Supermarkets #27,Credit Memo,008-05873,Varios:Promotional Allowance,Arroz Envasado:Parboiled 5KG Dos Hermanos.,-3.0,40.5,-121.5,4435455.0,Branded Rice,Keila Alfaro-Visvikis,RETAIL SEDANOS,1389409,Jun
2025-06-27,Sedanos Supermarkets #27,Credit Memo,008-05873,Varios:Promotional Allowance,Rice Snack: Rice Snack Salami Flavored DOS HERMANOS,-1.0,13.2,-13.2,4435441.8,Puffed Products,Keila Alfaro-Visvikis,RETAIL SEDANOS,1389410,Jun
2025-06-27,ALS Foods,Credit Memo,008-05874,Varios:Promotional Allowance,Arroz a Granel:Parboiled 50 LB -Bolsa Dos Hermanos.,-1.0,27.75,-27.75,4435414.05,Bulk Rice,Lisset Limpio -020,CAFETERIA y RESTAURANTS,1389411,Jun
2025-06-27,Sedanos Supermarkets #26,Credit Memo,008-05875,Varios:Promotional Allowance,Rice Snack:Rice Snack Salami Flavored DOS HERMANOS,-1.0,19.9,-19.9,4435394.15,Puffed Products,Keila Alfaro-Visvikis,RETAIL SEDANOS,1389412,Jun
2025-06-27,Bay supermarket,Credit Memo,008-05876,Varios:Promotional Allowance,Arroz Envasado:Largo Fino 1kg (Long grain rice) Dos Hermanos,-1.0,18.0,-18.0,4435376.15,Branded Rice,Keila Alfaro-Visvikis,RETAIL  DSD,1389413,Jun
2025-06-27,Sedanos Supermarkets #23,Credit Memo,008-05877,Varios:Promotional Allowance,Arroz Envasado:Long Rice 10 LB Dos Hermanos,-1.0,17.5,-17.5,4435358.65,Branded Rice,Keila Alfaro-Visvikis,RETAIL SEDANOS,1389414,Jun
2025-06-27,Sedanos Supermarkets #14,Credit Memo,008-05878,Varios:Promotional Allowance,Arroz Envasado:Long Rice 10 LB Dos Hermanos,-1.0,17.5,-17.5,4435341.15,Branded Rice,Keila Alfaro-Visvikis,RETAIL SEDANOS,1389415,Jun
2025-06-29,Bravo   Francisco Diaz,Invoice,008-05879,Liquids:AS Cooking Wine,4 1 Gl.,4.0,17.5,70.0,4435411.15,American Spice,Lisset Limpio -020,RETAIL  DSD,1389416,Jun
2025-06-29,Bravo   Francisco Diaz,Invoice,008-05879,Liquids:AS Marinating Sauce (Mojo),4 / 1 Gl,3.0,18.5,55.5,4435466.65,American Spice,Lisset Limpio -020,RETAIL  DSD,1389417,Jun
2025-06-29,Bravo   Francisco Diaz,Invoice,008-05879,Liquids:AS White Vinegar,4/1 Gl.,3.0,10.0,30.0,4435496.65,American Spice,Lisset Limpio -020,RETAIL  DSD,1389418,Jun
2025-06-29,Bravo   Francisco Diaz,Invoice,008-05879,Arroz a Granel:Largo Fino 50 LB -Bolsa Dos Hermanos.,,5.0,27.85,139.25,4435635.9,Bulk Rice,Lisset Limpio -020,RETAIL  DSD,1389419,Jun
2025-06-29,Bravo   Francisco Diaz,Invoice,008-05879,,Discount,,,-0.25,4435635.65,,Lisset Limpio -020,RETAIL  DSD,1389420,Jun
2025-06-29,Be Your Will LLC,Invoice,008-05880,Liquids:AS Cooking Wine,4 1 Gl.,1.0,17.5,17.5,4435653.15,American Spice,Lisset Limpio -020,CAFETERIA y RESTAURANTS,1389421,Jun
2025-06-29,Be Your Will LLC,Invoice,008-05880,Arroz a Granel:Largo Fino 50 LB -Bolsa Dos Hermanos.,,7.0,27.85,194.95,4435848.1,Bulk Rice,Lisset Limpio -020,CAFETERIA y RESTAURANTS,1389422,Jun
2025-06-29,Be Your Will LLC,Invoice,008-05880,Arroz a Granel:Parboiled 50 LB -Bolsa Dos Hermanos.,,11.0,27.75,305.25,4436153.35,Bulk Rice,Lisset Limpio -020,CAFETERIA y RESTAURANTS,1389423,Jun
2025-06-29,Be Your Will LLC,Invoice,008-05880,Arroz a Granel:Parboiled 50 LB -Bolsa Dos Hermanos.,,1.0,27.75,27.75,4436181.1,Bulk Rice,Lisset Limpio -020,CAFETERIA y RESTAURANTS,1389424,Jun
2025-06-29,El Palacio de los jugos / Caribe Tropical,Invoice,008-05881,Dry Beans:Dry Beans - Black Beans 50,Dry Black Beans 50 lb,2.0,34.0,68.0,4436249.1,Dry Beans,Lisset Limpio -020,Cafeteria,1389425,Jun
2025-06-29,El Palacio de los jugos / Caribe Tropical,Invoice,008-05881,Arroz a Granel:Parboiled 50 LB -Bolsa Dos Hermanos.,,8.0,26.75,214.0,4436463.1,Bulk Rice,Lisset Limpio -020,Cafeteria,1389426,Jun
2025-06-29,El Palacio de los jugos / J Mena Corp.,Invoice,008-05882,Dry Beans:Dry Beans - Black Beans 50,Dry Black Beans 50 lb,2.0,34.0,68.0,4436531.1,Dry Beans,Lisset Limpio -020,Cafeteria,1389427,Jun
2025-06-29,El Palacio de los jugos / J Mena Corp.,Invoice,008-05882,Arroz a Granel:Parboiled 50 LB -Bolsa Dos Hermanos.,,10.0,26.75,267.5,4436798.6,Bulk Rice,Lisset Limpio -020,Cafeteria,1389428,Jun
2025-06-29,El Palacio de los jugos / J Mena Corp.,Invoice,008-05882,Liquids:AS Marinating Sauce (Mojo),4 / 1 Gl,4.0,17.5,70.0,4436868.6,American Spice,Lisset Limpio -020,Cafeteria,1389429,Jun
2025-06-29,El Palacio de los jugos / J Mena Corp.,Invoice,008-05882,Spices:AS Cumin Ground,4 / 4 lb,1.0,50.25,50.25,4436918.85,American Spice,Lisset Limpio -020,Cafeteria,1389430,Jun
2025-06-29,El Palacio de los Jugos / Bird Road Restaurant,Invoice,008-05883,Arroz a Granel:Parboiled 50 LB -Bolsa Dos Hermanos.,,10.0,27.75,277.5,4437196.35,Bulk Rice,Lisset Limpio -020,Cafeteria,1389431,Jun
2025-06-29,El Palacio de los Jugos / Bird Road Restaurant,Invoice,008-05883,Dry Beans:Dry Beans - Black Beans 50,Dry Black Beans 50 lb,1.0,34.0,34.0,4437230.35,American Spice,Lisset Limpio -020,Cafeteria,1389432,Jun
2025-06-29,El Palacio de Los Jugos / Casa mía Food Restaurant inc,Invoice,008-05884,Liquids:AS Lemon Juice 4/1 Gl,,1.0,14.95,14.95,4437245.3,American Spice,Lisset Limpio -020,Cafeteria,1389433,Jun
2025-06-29,El Palacio de Los Jugos / Casa mía Food Restaurant inc,Invoice,008-05884,Liquids:AS Marinating Sauce (Mojo),4 / 1 Gl,1.0,17.5,17.5,4437262.8,American Spice,Lisset Limpio -020,Cafeteria,1389434,Jun
2025-06-29,El Palacio de Los Jugos / Casa mía Food Restaurant inc,Invoice,008-05884,Arroz a Granel:Parboiled 50 LB -Bolsa Dos Hermanos.,,8.0,26.75,214.0,4437476.8,Bulk Rice,Lisset Limpio -020,Cafeteria,1389435,Jun
2025-06-29,El Gallego Supermarket,Invoice,008-05885,Liquids:AS Bitter Orange,4 / 1 gl.,1.0,14.0,14.0,4437490.8,American Spice,Lisset Limpio -020,RETAIL  DSD,1389436,Jun
2025-06-29,El Gallego Supermarket,Invoice,008-05885,Liquids:AS White Vinegar,4/1 Gl.,2.0,9.5,19.0,4437509.8,American Spice,Lisset Limpio -020,RETAIL  DSD,1389437,Jun
2025-06-29,El Gallego Supermarket,Invoice,008-05885,Arroz a Granel:Parboiled 50 LB -Bolsa Dos Hermanos.,,4.0,27.75,111.0,4437620.8,Bulk Rice,Lisset Limpio -020,RETAIL  DSD,1389438,Jun
2025-06-29,El Gallego Supermarket,Invoice,008-05885,Dry Beans:Dry Beans - Black Beans 50,Dry Black Beans 50 lb,2.0,35.0,70.0,4437690.8,Dry Beans,Lisset Limpio -020,RETAIL  DSD,1389439,Jun
2025-06-29,El Palacio de los jugos / Divan and Denise Food,Invoice,008-05886,Arroz a Granel:Parboiled 50 LB -Bolsa Dos Hermanos.,,5.0,27.75,138.75,4437829.55,Bulk Rice,Lisset Limpio -020,Cafeteria,1389440,Jun
2025-06-29,Fritanga Momotombo,Invoice,008-05887,Spices:AS Chicken Base,1 / 30 lb. (box or pail),2.0,39.0,78.0,4437907.55,American Spice,Lisset Limpio -020,CAFETERIA y RESTAURANTS,1389441,Jun
2025-06-29,Fritanga Momotombo,Invoice,008-05887,Arroz a Granel:Largo Fino 50 LB -Bolsa Dos Hermanos.,,6.0,27.85,167.1,4438074.65,Bulk Rice,Lisset Limpio -020,CAFETERIA y RESTAURANTS,1389442,Jun
2025-06-29,El Palacio de los jugos / Rodriguez Foods,Invoice,008-05888,Arroz a Granel:Parboiled 50 LB -Bolsa Dos Hermanos.,,8.0,26.75,214.0,4438288.65,Bulk Rice,Lisset Limpio -020,Cafeteria,1389443,Jun
2025-06-29,Rey Chavez Distributor Corp,Invoice,008-05889,Arroz a Granel:Parboiled 50 LB -Bolsa Dos Hermanos.,,55.0,27.5,1512.5,4439801.15,Bulk Rice,Lisset Limpio -020,WHOLESALER,1389444,Jun
2025-06-30,Sedanos Supermarkets #20,Credit Memo,008-05890,Varios:Promotional Allowance,salami 4 units + ham 8,-12.0,1.49,-17.88,4439783.27,Puffed Products,Keila Alfaro-Visvikis,RETAIL SEDANOS,1389445,Jun
2025-06-30,Sedanos Supermarkets #20,Invoice,008-05891,Arroz Envasado:Long Rice 10 LB Dos Hermanos,,5.0,35.5,177.5,4439960.77,Branded Rice,Keila Alfaro-Visvikis,RETAIL SEDANOS,1389446,Jun
2025-06-30,Sedanos Supermarkets #20,Invoice,008-05891,Rice Snack:Rice Snack Ham Flavored DOS HERMANOS,,2.0,13.2,26.4,4439987.17,Puffed Products,Keila Alfaro-Visvikis,RETAIL SEDANOS,1389447,Jun
2025-06-30,Sedanos Supermarkets #20,Invoice,008-05891,Rice Snack:Rice Snack Salami Flavored DOS HERMANOS,,1.0,13.2,13.2,4440000.37,Puffed Products,Keila Alfaro-Visvikis,RETAIL SEDANOS,1389448,Jun
2025-06-30,Sedanos Supermarkets #20,Invoice,008-05891,Arroz Envasado:Long Rice 10 LB Dos Hermanos,,1.0,35.5,35.5,4440035.87,Branded Rice,Keila Alfaro-Visvikis,RETAIL SEDANOS,1389449,Jun
2025-06-30,Sedanos Supermarkets #20,Invoice,008-05891,,Discount,,,-3.98,4440031.89,,Keila Alfaro-Visvikis,RETAIL SEDANOS,1389450,Jun
2025-06-30,Sedanos Supermarkets #21,Credit Memo,008-05892,Varios:Promotional Allowance,Arroz Envasado:Parboiled 5KG Dos Hermanos.,-1.0,40.5,-40.5,4439991.39,Branded Rice,Keila Alfaro-Visvikis,RETAIL SEDANOS,1389451,Jun
2025-06-30,Sedanos Supermarkets #21,Credit Memo,008-05892,Varios:Promotional Allowance,Arroz Envasado:Long Rice 10 LB Dos Hermanos,-1.0,35.5,-35.5,4439955.89,Branded Rice,Keila Alfaro-Visvikis,RETAIL SEDANOS,1389452,Jun
2025-06-30,Sedanos Supermarkets #42,Credit Memo,008-05893,Arroz Envasado:Long Rice 10 LB Dos Hermanos,10 lb retorna,-1.0,35.5,-35.5,4439920.39,Branded Rice,Keila Alfaro-Visvikis,RETAIL SEDANOS,1389453,Jun
2025-06-30,Sedanos Supermarkets #42,Credit Memo,008-05893,Varios:Promotional Allowance,Rice Snack:Rice Snack Salami Flavored DOS HERMANOS,-1.0,19.9,-19.9,4439900.49,Puffed Products,Keila Alfaro-Visvikis,RETAIL SEDANOS,1389454,Jun
2025-06-30,Bake Mark USA LLC,Invoice,008-05894,Arroz a Granel:Parboiled 50 LB -Bolsa Dos Hermanos.,PO 207901-37,1100.0,22.9,25190.0,4465090.49,Bulk Rice,Armando Carpio - 017,WHOLESALER MANUFACTURY,1389455,Jun
2025-06-30,Sabor Tropical #1 - Cafeteria,Credit Memo,008-05895,Varios:Promotional Allowance,Arroz Envasado:Parboiled 5KG Dos Hermanos.,-7.0,46.5,-325.5,4464764.99,Branded Rice,Keila Alfaro-Visvikis,CAFETERIA y RESTAURANTS,1389456,Jun
2025-06-30,Bravo   Francisco Diaz,Credit Memo,008-05896,Arroz a Granel:Largo Fino 50 LB -Bolsa Dos Hermanos.,,-3.0,27.85,-83.55,4464681.44,Bulk Rice,Lisset Limpio -020,RETAIL  DSD,1389457,Jun
2025-06-30,Bravo   Francisco Diaz,Credit Memo,008-05896,Liquids:AS Marinating Sauce (Mojo),4 / 1 Gl,-1.0,17.0,-17.0,4464664.44,American Spice,Lisset Limpio -020,RETAIL  DSD,1389458,Jun
2025-06-30,China Tokyo,Credit Memo,008-05897,Arroz a Granel:Parboiled 50 LB -Bolsa Dos Hermanos.,,-7.0,28.25,-197.75,4464466.69,Bulk Rice,Lisset Limpio -020,CAFETERIA y RESTAURANTS,1389459,Jun
2025-06-30,El Palacio de los jugos /  Mires Restaurants,Credit Memo,008-05898,Varios:Promotional Allowance,Arroz a Granel:Parboiled 50 LB -Bolsa Dos Hermanos.,-1.0,27.75,-27.75,4464438.94,Bulk Rice,Lisset Limpio -020,Cafeteria,1389460,Jun
2025-06-30,Sabor Tropical Supermarket #4,Invoice,008-05899,Arroz Envasado:Parboiled 5KG Dos Hermanos.,6  11lbs,15.0,46.5,697.5,4465136.44,Branded Rice,Keila Alfaro-Visvikis,RETAIL  DSD,1389461,Jun
2025-06-30,Sabor Tropical Supermarket #4,Invoice,008-05899,Arroz Envasado:Long Rice 10 LB Dos Hermanos,,1.0,35.5,35.5,4465171.94,Branded Rice,Keila Alfaro-Visvikis,RETAIL  DSD,1389462,Jun
2025-06-30,Sabor Tropical Supermarket #4,Invoice,008-05899,Arroz Envasado:Parboiled 5KG Dos Hermanos.,6  11lbs,7.0,46.5,325.5,4465497.44,Branded Rice,Keila Alfaro-Visvikis,RETAIL  DSD,1389463,Jun
2025-06-30,Be Your Will LLC,Credit Memo,008-05900,Varios:Promotional Allowance,Arroz a Granel:Parboiled 50 LB -Bolsa Dos Hermanos.,-1.0,27.75,-27.75,4465469.69,Bulk Rice,Lisset Limpio -020,CAFETERIA y RESTAURANTS,1389464,Jun
2025-06-30,Sabor Tropical Supermarket #4,Credit Memo,008-05901,Varios:Promotional Allowance,Arroz Envasado:Parboiled 5KG Dos Hermanos.,-7.0,46.5,-325.5,4465144.19,Branded Rice,Keila Alfaro-Visvikis,RETAIL  DSD,1389465,Jun
2025-06-30,Sedanos Supermarkets #10,Credit Memo,008-05902,Varios:Promotional Allowance,Rice Snack:Rice Snack Salami Flavored DOS HERMANOS,-1.0,19.9,-19.9,4465124.29,Puffed Products,Keila Alfaro-Visvikis,RETAIL SEDANOS,1389466,Jun
2025-06-30,Sedanos Supermarkets #20,Credit Memo,008-05903,Varios:Promotional Allowance,Arroz Envasado:Long Rice 10 LB Dos Hermanos,-1.0,35.5,-35.5,4465088.79,Puffed Products,Keila Alfaro-Visvikis,RETAIL SEDANOS,1389467,Jun
2025-07-01,"El Toro Loco Meat Distribution, LLC",Invoice,008-05904,Dry Beans:Dry Beans - Black Beans 50,Dry Black Beans 50 lb,55.0,36.0,1980.0,4467068.79,Dry Beans,Lisset Limpio -020,CAFETERIA y RESTAURANTS,1389468,Jul
2025-07-01,"El Toro Loco Meat Distribution, LLC",Invoice,008-05904,Arroz a Granel:Largo Fino 50 LB -Bolsa Dos Hermanos.,,55.0,27.85,1531.75,4468600.54,Bulk Rice,Lisset Limpio -020,CAFETERIA y RESTAURANTS,1389469,Jul
2025-07-01,BRAVO - Flamingo #3,Invoice,008-05905,Arroz Envasado:Largo Fino 1kg (Long grain rice) Dos Hermanos,,10.0,18.0,180.0,4468780.54,Branded Rice,Keila Alfaro-Visvikis,RETAIL  DSD,1389470,Jul
2025-07-01,BRAVO - Flamingo #3,Invoice,008-05905,Arroz Envasado:Long Rice 10 LB Dos Hermanos,,5.0,35.5,177.5,4468958.04,Branded Rice,Keila Alfaro-Visvikis,RETAIL  DSD,1389471,Jul
2025-07-01,BRAVO - Flamingo #3,Invoice,008-05905,Arroz Envasado:Long Rice 10 LB Dos Hermanos,,1.0,18.0,18.0,4468976.04,Branded Rice,Keila Alfaro-Visvikis,RETAIL  DSD,1389472,Jul
2025-07-01,BRAVO - Flamingo #3,Invoice,008-05905,Arroz Envasado:Largo Fino 1kg (Long grain rice) Dos Hermanos,,2.0,35.5,71.0,4469047.04,Branded Rice,Keila Alfaro-Visvikis,RETAIL  DSD,1389473,Jul
2025-07-01,Ideal Food Basket Davie Cafeteria,Invoice,008-05906,Arroz a Granel:Largo Fino 50 LB -Bolsa Dos Hermanos.,,6.0,27.85,167.1,4469214.14,Bulk Rice,Keila Alfaro-Visvikis,CAFETERIA y RESTAURANTS,1389474,Jul
2025-07-01,Sedanos Supermarkets #43,Invoice,008-05907,Arroz a Granel:Parboiled 50 LB -Bolsa Dos Hermanos.,,5.0,28.25,141.25,4469355.39,Bulk Rice,Keila Alfaro-Visvikis,RETAIL SEDANOS,1389475,Jul
2025-07-01,Aries Supermarket & Cafeteria,Invoice,008-05908,Arroz a Granel:Parboiled 50 LB -Bolsa Dos Hermanos.,,5.0,28.25,141.25,4469496.64,Bulk Rice,Keila Alfaro-Visvikis,CAFETERIA y RESTAURANTS,1389476,Jul
2025-07-01,Aries Supermarket & Cafeteria,Invoice,008-05908,Dry Beans:Dry Beans - Black Beans 50,Dry Black Beans 50 lb,5.0,37.5,187.5,4469684.14,Dry Beans,Keila Alfaro-Visvikis,CAFETERIA y RESTAURANTS,1389477,Jul
2025-07-01,Sedanos Supermarkets #16,Invoice,008-05909,Arroz a Granel:Parboiled 50 LB -Bolsa Dos Hermanos.,,5.0,28.25,141.25,4469825.39,Bulk Rice,Keila Alfaro-Visvikis,RETAIL SEDANOS,1389478,Jul
2025-07-01,Sedanos Supermarkets #16,Invoice,008-05909,,Discount,,,-2.83,4469822.56,,Keila Alfaro-Visvikis,RETAIL SEDANOS,1389479,Jul
2025-07-01,El Palacio de los jugos /  Nanos Latin Foods,Invoice,008-05910,Arroz a Granel:Largo Fino 50 LB -Bolsa Dos Hermanos.,,6.0,27.85,167.1,4469989.66,Bulk Rice,Lisset Limpio -020,Cafeteria,1389480,Jul
2025-07-01,El Palacio de los jugos /  Nanos Latin Foods,Invoice,008-05910,Arroz a Granel:Parboiled 50 LB -Bolsa Dos Hermanos.,,10.0,26.75,267.5,4470257.16,Bulk Rice,Lisset Limpio -020,Cafeteria,1389481,Jul
2025-07-01,JMN Dely Corp,Invoice,008-05911,Dry Beans:Dry Beans - Black Beans 50,Dry Black Beans 50 lb,1.0,45.7,45.7,4470302.86,Dry Beans,Keila Alfaro-Visvikis,CAFETERIA y RESTAURANTS,1389482,Jul
2025-07-01,JMN Dely Corp,Invoice,008-05911,Arroz a Granel:Largo Fino 50 LB -Bolsa Dos Hermanos.,,2.0,27.85,55.7,4470358.56,Bulk Rice,Keila Alfaro-Visvikis,CAFETERIA y RESTAURANTS,1389483,Jul
2025-07-01,JMN Dely Corp,Invoice,008-05911,Arroz a Granel:Parboiled 50 LB -Bolsa Dos Hermanos.,,2.0,27.75,55.5,4470414.06,Bulk Rice,Keila Alfaro-Visvikis,CAFETERIA y RESTAURANTS,1389484,Jul
2025-07-01,BRAVO - Flamingo #3,Credit Memo,008-05912,Varios:Promotional Allowance,Arroz Envasado:Long Rice 10 LB Dos Hermanos,-1.0,18.0,-18.0,4470396.06,Branded Rice,Keila Alfaro-Visvikis,RETAIL  DSD,1389485,Jul
2025-07-01,BRAVO - Flamingo #3,Credit Memo,008-05912,Varios:Promotional Allowance,Arroz Envasado:Largo Fino 1kg (Long grain rice) Dos Hermanos,-2.0,35.5,-71.0,4470325.06,Branded Rice,Keila Alfaro-Visvikis,RETAIL  DSD,1389486,Jul
2025-07-01,Armando Carpio,Credit Memo,008-05913,Varios:Promotional Allowance,Arroz Envasado:Long Rice 10 LB Dos Hermanos,-1.0,35.5,-35.5,4470289.56,Branded Rice,Armando Carpio - 017,OTHER,1389487,Jul
2025-07-02,El Palacio de los jugos / Caribe Tropical,Invoice,008-05914,Dry Beans:Dry Beans - Black Beans 50,Dry Black Beans 50 lb,1.0,34.0,34.0,4470323.56,Dry Beans,Lisset Limpio -020,Cafeteria,1389488,Jul
2025-07-02,El Palacio de los jugos / Caribe Tropical,Invoice,008-05914,Arroz a Granel:Parboiled 50 LB -Bolsa Dos Hermanos.,,10.0,26.75,267.5,4470591.06,Bulk Rice,Lisset Limpio -020,Cafeteria,1389489,Jul
2025-07-02,El Palacio de los jugos / Divan and Denise Food,Invoice,008-05915,Arroz a Granel:Parboiled 50 LB -Bolsa Dos Hermanos.,,5.0,26.75,133.75,4470724.81,Bulk Rice,Lisset Limpio -020,Cafeteria,1389490,Jul
2025-07-02,El Palacio de los jugos / Delicias Criollas (DIAGO FOOD_MILLER),Invoice,008-05916,Arroz a Granel:Parboiled 50 LB -Bolsa Dos Hermanos.,,15.0,26.75,401.25,4471126.06,Bulk Rice,Lisset Limpio -020,Cafeteria,1389491,Jul
2025-07-02,El Palacio de los jugos / Delicias Criollas (DIAGO FOOD_MILLER),Invoice,008-05916,Arroz a Granel:Largo Fino 50 LB -Bolsa Dos Hermanos.,,5.0,27.85,139.25,4471265.31,Bulk Rice,Lisset Limpio -020,Cafeteria,1389492,Jul
2025-07-02,Los Caringas Latin America  Foods,Invoice,008-05917,Arroz a Granel:Parboiled 50 LB -Bolsa Dos Hermanos.,,3.0,28.25,84.75,4471350.06,Bulk Rice,Lisset Limpio -020,CAFETERIA y RESTAURANTS,1389493,Jul
2025-07-02,Los Caringas Latin America  Foods,Invoice,008-05917,Arroz a Granel:Largo Fino 50 LB -Bolsa Dos Hermanos.,,3.0,27.85,83.55,4471433.61,Bulk Rice,Lisset Limpio -020,CAFETERIA y RESTAURANTS,1389494,Jul
2025-07-02,Sedanos Supermarkets #33,Invoice,008-05918,Arroz a Granel:Parboiled 50 LB -Bolsa Dos Hermanos.,,3.0,28.25,84.75,4471518.36,Bulk Rice,Keila Alfaro-Visvikis,RETAIL SEDANOS,1389495,Jul
2025-07-02,Sedanos Supermarkets #33,Invoice,008-05918,,Discount,,,-1.7,4471516.66,,Keila Alfaro-Visvikis,RETAIL SEDANOS,1389496,Jul
2025-07-02,Sedanos Supermarkets #33,Invoice,008-05919,Arroz Envasado:Long Rice 10 LB Dos Hermanos,,5.0,35.5,177.5,4471694.16,Branded Rice,Keila Alfaro-Visvikis,RETAIL SEDANOS,1389497,Jul
2025-07-02,Sedanos Supermarkets #33,Invoice,008-05919,Arroz Envasado:Long Rice 10 LB Dos Hermanos,,1.0,35.5,35.5,4471729.66,Branded Rice,Keila Alfaro-Visvikis,RETAIL SEDANOS,1389498,Jul
2025-07-02,Sedanos Supermarkets #33,Invoice,008-05919,,Discount,,,-3.55,4471726.11,,Keila Alfaro-Visvikis,RETAIL SEDANOS,1389499,Jul
2025-07-02,El Palacio de los jugos / Lita Foods Inc.,Invoice,008-05920,Dry Beans:Dry Beans - Black Beans 50,Dry Black Beans 50 lb,1.0,34.0,34.0,4471760.11,Dry Beans,Lisset Limpio -020,Cafeteria,1389500,Jul
2025-07-02,El Palacio de los jugos / Lita Foods Inc.,Invoice,008-05920,Arroz a Granel:Parboiled 50 LB -Bolsa Dos Hermanos.,,12.0,26.75,321.0,4472081.11,Bulk Rice,Lisset Limpio -020,Cafeteria,1389501,Jul
2025-07-02,Sedanos Supermarkets #5,Invoice,008-05921,Arroz Envasado:Parboiled 5KG Dos Hermanos.,6  11lbs,5.0,40.5,202.5,4472283.61,Branded Rice,Keila Alfaro-Visvikis,RETAIL SEDANOS,1389502,Jul
2025-07-02,Sedanos Supermarkets #5,Invoice,008-05921,Arroz Envasado:Long Rice 10 LB Dos Hermanos,,5.0,35.5,177.5,4472461.11,Branded Rice,Keila Alfaro-Visvikis,RETAIL SEDANOS,1389503,Jul
2025-07-02,Sedanos Supermarkets #5,Invoice,008-05921,Rice Snack:Rice Snack Ham Flavored DOS HERMANOS,,2.0,19.9,39.8,4472500.91,Puffed Products,Keila Alfaro-Visvikis,RETAIL SEDANOS,1389504,Jul
2025-07-02,Sedanos Supermarkets #5,Invoice,008-05921,Rice Snack:Rice Snack Salami Flavored DOS HERMANOS,,1.0,19.9,19.9,4472520.81,Puffed Products,Keila Alfaro-Visvikis,RETAIL SEDANOS,1389505,Jul
2025-07-02,Sedanos Supermarkets #5,Invoice,008-05921,Arroz Envasado:Long Rice 10 LB Dos Hermanos,,1.0,35.5,35.5,4472556.31,Branded Rice,Keila Alfaro-Visvikis,RETAIL SEDANOS,1389506,Jul
2025-07-02,Sedanos Supermarkets #5,Invoice,008-05921,Arroz Envasado:Parboiled 5KG Dos Hermanos.,6  11lbs,2.0,40.5,81.0,4472637.31,Branded Rice,Keila Alfaro-Visvikis,RETAIL SEDANOS,1389507,Jul
2025-07-02,Sedanos Supermarkets #5,Invoice,008-05921,Rice Snack:Rice Snack Ham Flavored DOS HERMANOS,,1.0,19.9,19.9,4472657.21,Puffed Products,Keila Alfaro-Visvikis,RETAIL SEDANOS,1389508,Jul
2025-07-02,Sedanos Supermarkets #5,Invoice,008-05921,,Discount,,,-8.79,4472648.42,,Keila Alfaro-Visvikis,RETAIL SEDANOS,1389509,Jul
2025-07-02,El Palacio de los jugos / Leti Corp.,Invoice,008-05922,Arroz a Granel:Largo Fino 50 LB -Bolsa Dos Hermanos.,,5.0,27.85,139.25,4472787.67,Bulk Rice,Lisset Limpio -020,Cafeteria,1389510,Jul
2025-07-02,El Palacio de los jugos / Leti Corp.,Invoice,008-05922,Arroz a Granel:Parboiled 50 LB -Bolsa Dos Hermanos.,,6.0,26.75,160.5,4472948.17,Bulk Rice,Lisset Limpio -020,Cafeteria,1389511,Jul
2025-07-02,Sabor Tropical Supermarket #3,Invoice,008-05923,Arroz Envasado:Largo Fino 1kg (Long grain rice) Dos Hermanos,,5.0,18.0,90.0,4473038.17,Branded Rice,Keila Alfaro-Visvikis,RETAIL KEY FOOD,1389512,Jul
2025-07-02,Sabor Tropical Supermarket #3,Invoice,008-05923,Arroz Envasado:Long Rice 10 LB Dos Hermanos,,5.0,35.5,177.5,4473215.67,Branded Rice,Keila Alfaro-Visvikis,RETAIL KEY FOOD,1389513,Jul
2025-07-02,Sabor Tropical Supermarket #3,Invoice,008-05923,Arroz Envasado:Largo Fino 1kg (Long grain rice) Dos Hermanos,,1.0,18.0,18.0,4473233.67,Branded Rice,Keila Alfaro-Visvikis,RETAIL KEY FOOD,1389514,Jul
2025-07-02,Sabor Tropical Supermarket #3,Invoice,008-05923,Arroz Envasado:Long Rice 10 LB Dos Hermanos,,1.0,35.5,35.5,4473269.17,Branded Rice,Keila Alfaro-Visvikis,RETAIL KEY FOOD,1389515,Jul
2025-07-02,Sedanos Supermarkets #18,Invoice,008-05924,Arroz a Granel:Parboiled 50 LB -Bolsa Dos Hermanos.,,10.0,28.25,282.5,4473551.67,Bulk Rice,Keila Alfaro-Visvikis,RETAIL SEDANOS,1389516,Jul
2025-07-02,Sedanos Supermarkets #18,Invoice,008-05924,,Discount,,,-5.65,4473546.02,,Keila Alfaro-Visvikis,RETAIL SEDANOS,1389517,Jul
2025-07-02,Soriano Brothers PB,Invoice,008-05925,Arroz a Granel:Parboiled 50 LB -Bolsa Dos Hermanos.,,22.0,27.75,610.5,4474156.52,Bulk Rice,Lisset Limpio -020,CAFETERIA y RESTAURANTS,1389518,Jul
2025-07-02,Soriano Brothers PB,Invoice,008-05925,Arroz a Granel:Largo Fino 50 LB -Bolsa Dos Hermanos.,,11.0,27.85,306.35,4474462.87,Bulk Rice,Lisset Limpio -020,CAFETERIA y RESTAURANTS,1389519,Jul
2025-07-02,Soriano Brothers PB,Invoice,008-05925,Spices:AS Sazon (for all),1 / 30 lb (box or pail),2.0,51.0,102.0,4474564.87,American Spice,Lisset Limpio -020,CAFETERIA y RESTAURANTS,1389520,Jul
2025-07-02,Soriano Brothers PB,Invoice,008-05925,Liquids:AS Cooking Wine,4 1 Gl.,4.0,16.0,64.0,4474628.87,American Spice,Lisset Limpio -020,CAFETERIA y RESTAURANTS,1389521,Jul
2025-07-02,Soriano Brothers PB,Invoice,008-05925,Liquids:AS Lemon Juice 4/1 Gl,,2.0,14.0,28.0,4474656.87,American Spice,Lisset Limpio -020,CAFETERIA y RESTAURANTS,1389522,Jul
2025-07-02,Soriano Brothers PB,Invoice,008-05925,Liquids:AS Bitter Orange,4 / 1 gl.,2.0,14.0,28.0,4474684.87,American Spice,Lisset Limpio -020,CAFETERIA y RESTAURANTS,1389523,Jul
2025-07-02,Soriano Brothers PB,Invoice,008-05925,Spices:AS Chicken Base,1 / 30 lb. (box or pail),1.0,39.0,39.0,4474723.87,American Spice,Lisset Limpio -020,CAFETERIA y RESTAURANTS,1389524,Jul
2025-07-02,Soriano Brothers PB,Invoice,008-05925,Arroz a Granel:Parboiled 50 LB -Bolsa Dos Hermanos.,,2.0,27.75,55.5,4474779.37,Bulk Rice,Lisset Limpio -020,CAFETERIA y RESTAURANTS,1389525,Jul
2025-07-02,Sedanos Supermarkets #31,Invoice,008-05926,Spices:AS Chicken Base,1 / 30 lb. (box or pail),1.0,39.0,39.0,4474818.37,American Spice,Keila Alfaro-Visvikis,RETAIL SEDANOS,1389526,Jul
2025-07-02,Sedanos Supermarkets #31,Invoice,008-05926,Arroz a Granel:Parboiled 50 LB -Bolsa Dos Hermanos.,,6.0,28.25,169.5,4474987.87,Bulk Rice,Keila Alfaro-Visvikis,RETAIL SEDANOS,1389527,Jul
2025-07-02,Sedanos Supermarkets #31,Invoice,008-05926,,Discount,,,-4.17,4474983.7,,Keila Alfaro-Visvikis,RETAIL SEDANOS,1389528,Jul
2025-07-02,El Palacio de los jugos / J Mena Corp.,Invoice,008-05927,Arroz a Granel:Parboiled 50 LB -Bolsa Dos Hermanos.,,9.0,26.75,240.75,4475224.45,Bulk Rice,Lisset Limpio -020,Cafeteria,1389529,Jul
2025-07-02,El Palacio de los jugos / Rodriguez Foods,Invoice,008-05928,Arroz a Granel:Parboiled 50 LB -Bolsa Dos Hermanos.,,8.0,26.75,214.0,4475438.45,Bulk Rice,Lisset Limpio -020,Cafeteria,1389530,Jul
2025-07-02,El Palacio de Los Jugos / Casa mía Food Restaurant inc,Invoice,008-05929,Liquids:AS Marinating Sauce (Mojo),4 / 1 Gl,1.0,17.5,17.5,4475455.95,American Spice,Lisset Limpio -020,Cafeteria,1389531,Jul
2025-07-02,El Palacio de Los Jugos / Casa mía Food Restaurant inc,Invoice,008-05929,Liquids:AS Lemon Juice 4/1 Gl,,1.0,14.95,14.95,4475470.9,American Spice,Lisset Limpio -020,Cafeteria,1389532,Jul
2025-07-02,El Palacio de Los Jugos / Casa mía Food Restaurant inc,Invoice,008-05929,Arroz a Granel:Parboiled 50 LB -Bolsa Dos Hermanos.,,8.0,26.75,214.0,4475684.9,Bulk Rice,Lisset Limpio -020,Cafeteria,1389533,Jul
2025-07-02,Panda Depot,Invoice,008-05930,Arroz a Granel:Parboiled 50 LB -Bolsa Dos Hermanos.,,110.0,24.0,2640.0,4478324.9,Bulk Rice,Lisset Limpio -020,WHOLESALER,1389534,Jul
2025-07-02,Sedanos Supermarkets #33,Credit Memo,008-05946,Varios:Promotional Allowance,Arroz Envasado:Long Rice 10 LB Dos Hermanos,-1.0,35.5,-35.5,4478289.4,Branded Rice,Keila Alfaro-Visvikis,RETAIL SEDANOS,1389535,Jul
2025-07-02,Sedanos Supermarkets #5,Credit Memo,008-05947,Varios:Promotional Allowance,Arroz Envasado:Long Rice 10 LB Dos Hermanos,-1.0,35.5,-35.5,4478253.9,Branded Rice,Keila Alfaro-Visvikis,RETAIL SEDANOS,1389536,Jul
2025-07-02,Sedanos Supermarkets #5,Credit Memo,008-05947,Varios:Promotional Allowance,Arroz Envasado:Parboiled 5KG Dos Hermanos.,-2.0,40.5,-81.0,4478172.9,Branded Rice,Keila Alfaro-Visvikis,RETAIL SEDANOS,1389537,Jul
2025-07-02,Sedanos Supermarkets #5,Credit Memo,008-05947,Varios:Promotional Allowance,Rice Snack:Rice Snack Ham Flavored DOS HERMANOS,-1.0,19.9,-19.9,4478153.0,Puffed Products,Keila Alfaro-Visvikis,RETAIL SEDANOS,1389538,Jul
2025-07-02,Sabor Tropical Supermarket #3,Credit Memo,008-05948,Varios:Promotional Allowance,Arroz Envasado:Largo Fino 1kg (Long grain rice) Dos Hermanos,-1.0,18.0,-18.0,4478135.0,Branded Rice,Keila Alfaro-Visvikis,RETAIL KEY FOOD,1389539,Jul
2025-07-02,Sabor Tropical Supermarket #3,Credit Memo,008-05948,Varios:Promotional Allowance,Arroz Envasado:Long Rice 10 LB Dos Hermanos,-1.0,35.5,-35.5,4478099.5,Branded Rice,Keila Alfaro-Visvikis,RETAIL KEY FOOD,1389540,Jul
2025-07-02,Soriano Brothers PB,Credit Memo,008-05949,Varios:Promotional Allowance,Arroz a Granel:Parboiled 50 LB -Bolsa Dos Hermanos.,-2.0,27.75,-55.5,4478044.0,Bulk Rice,Lisset Limpio -020,CAFETERIA y RESTAURANTS,1389541,Jul
2025-07-03,Los Mejores Tamales de Miami,Invoice,008-05931,Arroz a Granel:Parboiled 50 LB -Bolsa Dos Hermanos.,,6.0,28.25,169.5,4478213.5,Bulk Rice,Lisset Limpio -020,CAFETERIA y RESTAURANTS,1389542,Jul
2025-07-03,El Palacio de los jugos / J Mena Corp.,Invoice,008-05932,Arroz a Granel:Parboiled 50 LB -Bolsa Dos Hermanos.,,6.0,26.75,160.5,4478374.0,Bulk Rice,Lisset Limpio -020,Cafeteria,1389543,Jul
2025-07-06,El Palacio de Los Jugos / Casa mía Food Restaurant inc,Invoice,008-05933,Arroz a Granel:Parboiled 50 LB -Bolsa Dos Hermanos.,,8.0,26.75,214.0,4478588.0,Bulk Rice,Lisset Limpio -020,Cafeteria,1389544,Jul
2025-07-06,Bravo   Francisco Diaz,Invoice,008-05934,Liquids:AS Cooking Wine,4 1 Gl.,3.0,17.5,52.5,4478640.5,American Spice,Lisset Limpio -020,RETAIL  DSD,1389545,Jul
2025-07-06,Bravo   Francisco Diaz,Invoice,008-05934,Liquids:AS Marinating Sauce (Mojo),4 / 1 Gl,1.0,18.5,18.5,4478659.0,American Spice,Lisset Limpio -020,RETAIL  DSD,1389546,Jul
2025-07-06,Bravo   Francisco Diaz,Invoice,008-05934,Liquids:AS White Vinegar,4/1 Gl.,2.0,10.0,20.0,4478679.0,American Spice,Lisset Limpio -020,RETAIL  DSD,1389547,Jul
2025-07-06,Bravo   Francisco Diaz,Invoice,008-05934,Spices:AS Chicken Base,1 / 30 lb. (box or pail),1.0,39.0,39.0,4478718.0,American Spice,Lisset Limpio -020,RETAIL  DSD,1389548,Jul
2025-07-06,Bravo   Francisco Diaz,Invoice,008-05934,Arroz a Granel:Largo Fino 50 LB -Bolsa Dos Hermanos.,,5.0,27.85,139.25,4478857.25,Bulk Rice,Lisset Limpio -020,RETAIL  DSD,1389549,Jul
2025-07-06,Bravo   Francisco Diaz,Invoice,008-05934,Dry Beans:Dry Beans - Black Beans 50,Dry Black Beans 50 lb,1.0,35.5,35.5,4478892.75,Dry Beans,Lisset Limpio -020,RETAIL  DSD,1389550,Jul
2025-07-06,El Palacio de los jugos / Caribe Tropical,Invoice,008-05935,Arroz a Granel:Parboiled 50 LB -Bolsa Dos Hermanos.,,6.0,26.75,160.5,4479053.25,Bulk Rice,Lisset Limpio -020,Cafeteria,1389551,Jul
2025-07-06,ALS Foods,Invoice,008-05936,Liquids:AS Cooking Wine,4 1 Gl.,2.0,17.5,35.0,4479088.25,American Spice,Lisset Limpio -020,CAFETERIA y RESTAURANTS,1389552,Jul
2025-07-06,ALS Foods,Invoice,008-05936,Arroz a Granel:Largo Fino 50 LB -Bolsa Dos Hermanos.,,8.0,27.85,222.8,4479311.05,Bulk Rice,Lisset Limpio -020,CAFETERIA y RESTAURANTS,1389553,Jul
2025-07-06,ALS Foods,Invoice,008-05936,Arroz a Granel:Parboiled 50 LB -Bolsa Dos Hermanos.,,11.0,27.75,305.25,4479616.3,Bulk Rice,Lisset Limpio -020,CAFETERIA y RESTAURANTS,1389554,Jul
2025-07-06,ALS Foods,Invoice,008-05936,Arroz a Granel:Parboiled 50 LB -Bolsa Dos Hermanos.,,1.0,27.75,27.75,4479644.05,Bulk Rice,Lisset Limpio -020,CAFETERIA y RESTAURANTS,1389555,Jul
2025-07-06,El Palacio de los jugos / Divan and Denise Food,Invoice,008-05937,Arroz a Granel:Parboiled 50 LB -Bolsa Dos Hermanos.,,8.0,26.75,214.0,4479858.05,Bulk Rice,Lisset Limpio -020,Cafeteria,1389556,Jul
2025-07-06,Sedanos Supermarkets #14,Invoice,008-05938,Arroz Envasado:Parboiled 5KG Dos Hermanos.,6  11lbs,5.0,40.5,202.5,4480060.55,Branded Rice,Keila Alfaro-Visvikis,RETAIL SEDANOS,1389557,Jul
2025-07-06,Sedanos Supermarkets #14,Invoice,008-05938,Arroz Envasado:Long Rice 10 LB Dos Hermanos,,1.0,35.5,35.5,4480096.05,Branded Rice,Keila Alfaro-Visvikis,RETAIL SEDANOS,1389558,Jul
2025-07-06,Sedanos Supermarkets #14,Invoice,008-05938,Arroz Envasado:Parboiled 5KG Dos Hermanos.,6  11lbs,1.0,40.5,40.5,4480136.55,Branded Rice,Keila Alfaro-Visvikis,RETAIL SEDANOS,1389559,Jul
2025-07-06,Sedanos Supermarkets #14,Invoice,008-05938,,Discount,,,-4.76,4480131.79,,Keila Alfaro-Visvikis,RETAIL SEDANOS,1389560,Jul
2025-07-06,Sedanos Supermarkets #14,Invoice,008-05939,Arroz a Granel:Parboiled 50 LB -Bolsa Dos Hermanos.,,2.0,28.25,56.5,4480188.29,Bulk Rice,Keila Alfaro-Visvikis,RETAIL SEDANOS,1389561,Jul
2025-07-06,Sedanos Supermarkets #14,Invoice,008-05939,,Discount,,,-1.13,4480187.16,,Keila Alfaro-Visvikis,RETAIL SEDANOS,1389562,Jul
2025-07-06,Sedanos Supermarkets #29,Invoice,008-05940,Arroz Envasado:Parboiled 5KG Dos Hermanos.,6  11lbs,15.0,40.5,607.5,4480794.66,Branded Rice,Keila Alfaro-Visvikis,RETAIL SEDANOS,1389563,Jul
2025-07-06,Sedanos Supermarkets #29,Invoice,008-05940,Arroz Envasado:Long Rice 10 LB Dos Hermanos,,5.0,35.5,177.5,4480972.16,Branded Rice,Keila Alfaro-Visvikis,RETAIL SEDANOS,1389564,Jul
2025-07-06,Sedanos Supermarkets #29,Invoice,008-05940,Arroz Envasado:Parboiled 5KG Dos Hermanos.,6  11lbs,3.0,40.5,121.5,4481093.66,Branded Rice,Keila Alfaro-Visvikis,RETAIL SEDANOS,1389565,Jul
2025-07-06,Sedanos Supermarkets #29,Invoice,008-05940,Arroz Envasado:Long Rice 10 LB Dos Hermanos,,1.0,35.5,35.5,4481129.16,Branded Rice,Keila Alfaro-Visvikis,RETAIL SEDANOS,1389566,Jul
2025-07-06,Sedanos Supermarkets #29,Invoice,008-05940,,Discount,,,-15.7,4481113.46,,Keila Alfaro-Visvikis,RETAIL SEDANOS,1389567,Jul
2025-07-06,El Palacio de los jugos /  Mires Restaurants,Invoice,008-05941,Liquids:AS Marinating Sauce (Mojo),4 / 1 Gl,1.0,18.5,18.5,4481131.96,American Spice,Lisset Limpio -020,Cafeteria,1389568,Jul
2025-07-06,El Palacio de los jugos /  Mires Restaurants,Invoice,008-05941,Arroz a Granel:Parboiled 50 LB -Bolsa Dos Hermanos.,,11.0,27.75,305.25,4481437.21,Bulk Rice,Lisset Limpio -020,Cafeteria,1389569,Jul
2025-07-06,El Palacio de los jugos /  Mires Restaurants,Invoice,008-05941,Arroz a Granel:Parboiled 50 LB -Bolsa Dos Hermanos.,,1.0,27.75,27.75,4481464.96,Bulk Rice,Lisset Limpio -020,Cafeteria,1389570,Jul
2025-07-06,ALS Foods,Credit Memo,008-05950,Varios:Promotional Allowance,Arroz a Granel:Parboiled 50 LB -Bolsa Dos Hermanos.,-1.0,27.75,-27.75,4481437.21,Bulk Rice,Lisset Limpio -020,CAFETERIA y RESTAURANTS,1389571,Jul
2025-07-06,El Palacio de los jugos /  Mires Restaurants,Credit Memo,008-05951,Varios:Promotional Allowance,Arroz a Granel:Parboiled 50 LB -Bolsa Dos Hermanos.,-1.0,27.75,-27.75,4481409.46,Bulk Rice,Lisset Limpio -020,Cafeteria,1389572,Jul
2025-07-06,Sedanos Supermarkets #14,Credit Memo,008-05952,Varios:Promotional Allowance,Arroz Envasado:Parboiled 5KG Dos Hermanos.,-1.0,40.5,-40.5,4481368.96,Branded Rice,Keila Alfaro-Visvikis,RETAIL SEDANOS,1389573,Jul
2025-07-06,Sedanos Supermarkets #29,Credit Memo,008-05953,Varios:Promotional Allowance,Arroz Envasado:Parboiled 5KG Dos Hermanos.,-3.0,40.5,-121.5,4481247.46,Branded Rice,Keila Alfaro-Visvikis,RETAIL SEDANOS,1389574,Jul
2025-07-06,Sedanos Supermarkets #29,Credit Memo,008-05953,Varios:Promotional Allowance,Arroz Envasado:Long Rice 10 LB Dos Hermanos,-1.0,35.5,-35.5,4481211.96,Branded Rice,Keila Alfaro-Visvikis,RETAIL SEDANOS,1389575,Jul
2025-07-07,El Palacio de los Jugos / Bird Road Restaurant,Invoice,008-05942,Arroz a Granel:Parboiled 50 LB -Bolsa Dos Hermanos.,,10.0,26.75,267.5,4481479.46,Bulk Rice,Lisset Limpio -020,Cafeteria,1389576,Jul
2025-07-07,El Palacio de los jugos /  Nanos Latin Foods,Invoice,008-05943,Arroz a Granel:Largo Fino 50 LB -Bolsa Dos Hermanos.,,5.0,27.85,139.25,4481618.71,Bulk Rice,Lisset Limpio -020,Cafeteria,1389577,Jul
2025-07-07,El Palacio de los jugos /  Nanos Latin Foods,Invoice,008-05943,Arroz a Granel:Parboiled 50 LB -Bolsa Dos Hermanos.,,12.0,26.75,321.0,4481939.71,Bulk Rice,Lisset Limpio -020,Cafeteria,1389578,Jul
2025-07-07,El Palacio de los jugos / Rodriguez Foods,Invoice,008-05944,Arroz a Granel:Parboiled 50 LB -Bolsa Dos Hermanos.,,6.0,26.75,160.5,4482100.21,Bulk Rice,Lisset Limpio -020,Cafeteria,1389579,Jul
2025-07-07,El Palacio de los jugos / La sabrosa salsa cubana Corp,Invoice,008-05945,Arroz a Granel:Largo Fino 50 LB -Bolsa Dos Hermanos.,,5.0,27.85,139.25,4482239.46,Bulk Rice,Lisset Limpio -020,Cafeteria,1389580,Jul
2025-07-07,"Soriano Brothers Diaz Food Service,Inc",Invoice,008-05954,Arroz a Granel:Parboiled 50 LB -Bolsa Dos Hermanos.,,40.0,26.75,1070.0,4483309.46,Bulk Rice,Lisset Limpio -020,CAFETERIA y RESTAURANTS,1389581,Jul
2025-07-07,"Soriano Brothers Diaz Food Service,Inc",Invoice,008-05954,Dry Beans:Dry Beans - Black Beans 50,Dry Black Beans 50 lb,3.0,34.0,102.0,4483411.46,Dry Beans,Lisset Limpio -020,CAFETERIA y RESTAURANTS,1389582,Jul
2025-07-07,Sedanos Supermarkets  #37,Invoice,008-05955,Arroz a Granel:Largo Fino 50 LB -Bolsa Dos Hermanos.,,6.0,27.85,167.1,4483578.56,Bulk Rice,Keila Alfaro-Visvikis,RETAIL SEDANOS,1389583,Jul
2025-07-07,Sedanos Supermarkets  #37,Invoice,008-05955,Arroz a Granel:Parboiled 50 LB -Bolsa Dos Hermanos.,,6.0,28.25,169.5,4483748.06,Bulk Rice,Keila Alfaro-Visvikis,RETAIL SEDANOS,1389584,Jul
2025-07-07,Sedanos Supermarkets  #37,Invoice,008-05956,Rice Snack:Rice Snack Ham Flavored DOS HERMANOS,,2.0,19.9,39.8,4483787.86,Puffed Products,Keila Alfaro-Visvikis,RETAIL SEDANOS,1389585,Jul
2025-07-07,Sedanos Supermarkets  #37,Invoice,008-05956,Rice Snack:Rice Snack Salami Flavored DOS HERMANOS,,1.0,19.9,19.9,4483807.76,Puffed Products,Keila Alfaro-Visvikis,RETAIL SEDANOS,1389586,Jul
2025-07-07,Sedanos Supermarkets  #37,Invoice,008-05956,Rice Snack:Rice Snack Salami Flavored DOS HERMANOS,,1.0,19.9,19.9,4483827.66,Puffed Products,Keila Alfaro-Visvikis,RETAIL SEDANOS,1389587,Jul
2025-07-10,Sedanos Supermarkets  #37,Credit Memo,008-05957,Varios:Producto vencido/deteriorado (no impacta en inventario),,-9.0,1.49,-13.41,4483814.25,Puffed Products,Keila Alfaro-Visvikis,RETAIL SEDANOS,1389588,Jul
2025-07-10,Aries Supermarket & Cafeteria,Invoice,008-05958,Arroz Envasado:Largo Fino 1kg (Long grain rice) Dos Hermanos,,2.0,18.0,36.0,4483850.25,Branded Rice,Keila Alfaro-Visvikis,CAFETERIA y RESTAURANTS,1389589,Jul
2025-07-10,Aries Supermarket & Cafeteria,Invoice,008-05958,Arroz Envasado:Long Rice 10 LB Dos Hermanos,,1.0,29.58,29.58,4483879.83,Branded Rice,Keila Alfaro-Visvikis,CAFETERIA y RESTAURANTS,1389590,Jul
2025-07-10,Aries Supermarket & Cafeteria,Invoice,008-05958,Arroz Envasado:Parboiled 5KG Dos Hermanos.,6  11lbs,2.0,46.5,93.0,4483972.83,Branded Rice,Keila Alfaro-Visvikis,CAFETERIA y RESTAURANTS,1389591,Jul
2025-07-10,Aries Supermarket & Cafeteria,Invoice,008-05958,Arroz Envasado:Parboiled 5KG Dos Hermanos.,6  11lbs,1.0,46.5,46.5,4484019.33,Branded Rice,Keila Alfaro-Visvikis,CAFETERIA y RESTAURANTS,1389592,Jul
2025-07-10,Price Choice Food Market # 6,Invoice,008-05959,Arroz Envasado:Parboiled 5KG Dos Hermanos.,6  11lbs,15.0,46.5,697.5,4484716.83,Branded Rice,Lisset Limpio -020,RETAIL  DSD,1389593,Jul
2025-07-10,Price Choice Food Market # 6,Invoice,008-05959,Arroz Envasado:Parboiled 5KG Dos Hermanos.,6  11lbs,7.0,46.5,325.5,4485042.33,Branded Rice,Lisset Limpio -020,RETAIL  DSD,1389594,Jul
2025-07-10,Sedanos Supermarkets #26,Invoice,008-05960,Arroz a Granel:Parboiled 50 LB -Bolsa Dos Hermanos.,,5.0,28.25,141.25,4485183.58,Bulk Rice,Keila Alfaro-Visvikis,RETAIL SEDANOS,1389595,Jul
2025-07-10,Sedanos Supermarkets #16,Invoice,008-05961,Arroz a Granel:Parboiled 50 LB -Bolsa Dos Hermanos.,,5.0,28.25,141.25,4485324.83,Bulk Rice,Keila Alfaro-Visvikis,RETAIL SEDANOS,1389596,Jul
2025-07-10,Sedanos Supermarkets #16,Invoice,008-05961,,Discount,,,-2.83,4485322.0,,Keila Alfaro-Visvikis,RETAIL SEDANOS,1389597,Jul
2025-07-10,Sedanos Supermarkets #43,Invoice,008-05962,Arroz a Granel:Parboiled 50 LB -Bolsa Dos Hermanos.,,5.0,28.25,141.25,4485463.25,Bulk Rice,Keila Alfaro-Visvikis,RETAIL SEDANOS,1389598,Jul
2025-07-10,Ideal Food Basket Davie Cafeteria,Invoice,008-05963,Arroz a Granel:Largo Fino 50 LB -Bolsa Dos Hermanos.,,7.0,27.85,194.95,4485658.2,Bulk Rice,Keila Alfaro-Visvikis,CAFETERIA y RESTAURANTS,1389599,Jul
2025-07-10,Ideal Food Basket Davie Grocery,Invoice,008-05964,Arroz Envasado:Largo Fino 1kg (Long grain rice) Dos Hermanos,,5.0,18.0,90.0,4485748.2,Branded Rice,Keila Alfaro-Visvikis,RETAIL  DSD,1389600,Jul
2025-07-10,Ideal Food Basket Davie Grocery,Invoice,008-05964,Arroz Envasado:Largo Fino 1kg (Long grain rice) Dos Hermanos,,1.0,18.0,18.0,4485766.2,Branded Rice,Keila Alfaro-Visvikis,RETAIL  DSD,1389601,Jul
2025-07-10,Key Food / Holywood,Invoice,008-05965,Arroz Envasado:Long Rice 10 LB Dos Hermanos,,4.0,29.58,118.32,4485884.52,Branded Rice,Keila Alfaro-Visvikis,RETAIL  DSD,1389602,Jul
2025-07-10,Aries Supermarket & Cafeteria,Credit Memo,008-05966,Varios:Promotional Allowance,Arroz Envasado:Parboiled 5KG Dos Hermanos.,-1.0,46.5,-46.5,4485838.02,Branded Rice,Keila Alfaro-Visvikis,CAFETERIA y RESTAURANTS,1389603,Jul
2025-07-10,Price Choice Food Market # 6,Credit Memo,008-05967,Varios:Promotional Allowance,Arroz Envasado:Parboiled 5KG Dos Hermanos.,-7.0,46.5,-325.5,4485512.52,Branded Rice,Lisset Limpio -020,RETAIL  DSD,1389604,Jul
2025-07-10,Ideal Food Basket Davie Grocery,Credit Memo,008-05968,Varios:Promotional Allowance,Arroz Envasado:Largo Fino 1kg (Long grain rice) Dos Hermanos,-1.0,18.0,-18.0,4485494.52,Branded Rice,Keila Alfaro-Visvikis,RETAIL  DSD,1389605,Jul
2025-07-10,Sedanos Supermarkets #5,Credit Memo,008-05969,Varios:Producto vencido/deteriorado (no impacta en inventario),10 salami,-1.0,14.92,-14.92,4485479.6,Puffed Products,Keila Alfaro-Visvikis,RETAIL SEDANOS,1389606,Jul
2025-07-10,El Palacio de los jugos /  Nanos Latin Foods,Invoice,008-05970,Arroz a Granel:Largo Fino 50 LB -Bolsa Dos Hermanos.,,5.0,27.85,139.25,4485618.85,Bulk Rice,Lisset Limpio -020,Cafeteria,1389607,Jul
2025-07-10,El Palacio de los jugos /  Nanos Latin Foods,Invoice,008-05970,Arroz a Granel:Parboiled 50 LB -Bolsa Dos Hermanos.,,10.0,26.75,267.5,4485886.35,Bulk Rice,Lisset Limpio -020,Cafeteria,1389608,Jul
2025-07-10,Bravo   Francisco Diaz,Invoice,008-05971,Arroz a Granel:Largo Fino 50 LB -Bolsa Dos Hermanos.,,5.0,27.85,139.25,4486025.6,Bulk Rice,Lisset Limpio -020,RETAIL  DSD,1389609,Jul
2025-07-10,El Palacio de Los Jugos / Casa mía Food Restaurant inc,Invoice,008-05972,Liquids:AS Marinating Sauce (Mojo),4 / 1 Gl,1.0,17.0,17.0,4486042.6,American Spice,Lisset Limpio -020,Cafeteria,1389610,Jul
2025-07-10,El Palacio de Los Jugos / Casa mía Food Restaurant inc,Invoice,008-05972,Liquids:AS Lemon Juice 4/1 Gl,,1.0,14.0,14.0,4486056.6,American Spice,Lisset Limpio -020,Cafeteria,1389611,Jul
2025-07-10,El Palacio de Los Jugos / Casa mía Food Restaurant inc,Invoice,008-05972,Arroz a Granel:Parboiled 50 LB -Bolsa Dos Hermanos.,,6.0,26.75,160.5,4486217.1,Bulk Rice,Lisset Limpio -020,Cafeteria,1389612,Jul
2025-07-10,Sedanos Supermarkets #33,Invoice,008-05973,Arroz a Granel:Parboiled 50 LB -Bolsa Dos Hermanos.,,5.0,28.25,141.25,4486358.35,Bulk Rice,Keila Alfaro-Visvikis,RETAIL SEDANOS,1389613,Jul
2025-07-10,Sedanos Supermarkets #33,Invoice,008-05973,,Discount,,,-2.83,4486355.52,,Keila Alfaro-Visvikis,RETAIL SEDANOS,1389614,Jul
2025-07-10,Sedanos Supermarkets #17,Invoice,008-05974,Rice Snack:Rice Snack Ham Flavored DOS HERMANOS,,3.0,19.9,59.7,4486415.22,Puffed Products,Keila Alfaro-Visvikis,RETAIL SEDANOS,1389615,Jul
2025-07-10,Sedanos Supermarkets #17,Invoice,008-05974,Rice Snack:Rice Snack Salami Flavored DOS HERMANOS,,2.0,19.9,39.8,4486455.02,Puffed Products,Keila Alfaro-Visvikis,RETAIL SEDANOS,1389616,Jul
2025-07-10,Sedanos Supermarkets #17,Invoice,008-05974,Arroz Envasado:Largo Fino 1kg (Long grain rice) Dos Hermanos,,1.0,18.0,18.0,4486473.02,Branded Rice,Keila Alfaro-Visvikis,RETAIL SEDANOS,1389617,Jul
2025-07-10,Sedanos Supermarkets #17,Invoice,008-05974,Rice Snack:Rice Snack Salami Flavored DOS HERMANOS,,1.0,19.9,19.9,4486492.92,Puffed Products,Keila Alfaro-Visvikis,RETAIL SEDANOS,1389618,Jul
2025-07-10,Sedanos Supermarkets #17,Invoice,008-05974,,Discount,,,-1.98,4486490.94,,Keila Alfaro-Visvikis,RETAIL SEDANOS,1389619,Jul
2025-07-10,Sedanos Supermarkets #18,Invoice,008-05975,Rice Snack:Rice Snack Ham Flavored DOS HERMANOS,,2.0,19.9,39.8,4486530.74,Puffed Products,Keila Alfaro-Visvikis,RETAIL SEDANOS,1389620,Jul
2025-07-10,Sedanos Supermarkets #18,Invoice,008-05975,Rice Snack:Rice Snack Salami Flavored DOS HERMANOS,,1.0,19.9,19.9,4486550.64,Puffed Products,Keila Alfaro-Visvikis,RETAIL SEDANOS,1389621,Jul
2025-07-10,Sedanos Supermarkets #18,Invoice,008-05975,Arroz Envasado:Long Rice 10 LB Dos Hermanos,,1.0,35.5,35.5,4486586.14,Branded Rice,Keila Alfaro-Visvikis,RETAIL SEDANOS,1389622,Jul
2025-07-10,Sedanos Supermarkets #18,Invoice,008-05975,Rice Snack:Rice Snack Salami Flavored DOS HERMANOS,,1.0,19.9,19.9,4486606.04,Puffed Products,Keila Alfaro-Visvikis,RETAIL SEDANOS,1389623,Jul
2025-07-10,Sedanos Supermarkets #18,Invoice,008-05976,Arroz a Granel:Parboiled 50 LB -Bolsa Dos Hermanos.,,10.0,28.25,282.5,4486888.54,Bulk Rice,Keila Alfaro-Visvikis,RETAIL SEDANOS,1389624,Jul
2025-07-10,Sedanos Supermarkets #18,Invoice,008-05976,Spices:AS Chicken Base,1 / 30 lb. (box or pail),1.0,39.0,39.0,4486927.54,American Spice,Keila Alfaro-Visvikis,RETAIL SEDANOS,1389625,Jul
2025-07-10,Sedanos Supermarkets #32,Invoice,008-05977,Arroz a Granel:Largo Fino 50 LB -Bolsa Dos Hermanos.,,6.0,27.85,167.1,4487094.64,Bulk Rice,Keila Alfaro-Visvikis,RETAIL SEDANOS,1389626,Jul
2025-07-10,Sedanos Supermarkets #32,Invoice,008-05977,Arroz a Granel:Parboiled 50 LB -Bolsa Dos Hermanos.,,6.0,28.25,169.5,4487264.14,Bulk Rice,Keila Alfaro-Visvikis,RETAIL SEDANOS,1389627,Jul
2025-07-10,Sedanos Supermarkets #32,Invoice,008-05977,,Discount,,,-6.73,4487257.41,,Keila Alfaro-Visvikis,RETAIL SEDANOS,1389628,Jul
2025-07-10,El Palacio de los jugos / Lita Foods Inc.,Invoice,008-05978,Dry Beans:Dry Beans - Black Beans 50,Dry Black Beans 50 lb,1.0,34.0,34.0,4487291.41,Dry Beans,Lisset Limpio -020,Cafeteria,1389629,Jul
2025-07-10,El Palacio de los jugos / Lita Foods Inc.,Invoice,008-05978,Arroz a Granel:Parboiled 50 LB -Bolsa Dos Hermanos.,,12.0,26.75,321.0,4487612.41,Bulk Rice,Lisset Limpio -020,Cafeteria,1389630,Jul
2025-07-10,El Palacio de los jugos / Divan and Denise Food,Invoice,008-05979,Arroz a Granel:Parboiled 50 LB -Bolsa Dos Hermanos.,,6.0,26.75,160.5,4487772.91,Bulk Rice,Lisset Limpio -020,Cafeteria,1389631,Jul
2025-07-10,El Palacio de los jugos / Caribe Tropical,Invoice,008-05980,Arroz a Granel:Parboiled 50 LB -Bolsa Dos Hermanos.,,5.0,26.75,133.75,4487906.66,Bulk Rice,Lisset Limpio -020,Cafeteria,1389632,Jul
2025-07-10,El Palacio de los jugos / Caribe Tropical,Invoice,008-05980,Dry Beans:Dry Beans - Black Beans 50,Dry Black Beans 50 lb,2.0,34.0,68.0,4487974.66,Dry Beans,Lisset Limpio -020,Cafeteria,1389633,Jul
2025-07-10,El Palacio de los jugos / Rodriguez Foods,Invoice,008-05981,Arroz a Granel:Parboiled 50 LB -Bolsa Dos Hermanos.,,6.0,26.75,160.5,4488135.16,Bulk Rice,Lisset Limpio -020,Cafeteria,1389634,Jul
2025-07-10,El Palacio de los jugos / Delicias Criollas (DIAGO FOOD_MILLER),Invoice,008-05982,Arroz a Granel:Parboiled 50 LB -Bolsa Dos Hermanos.,,12.0,26.75,321.0,4488456.16,Bulk Rice,Lisset Limpio -020,Cafeteria,1389635,Jul
2025-07-10,Soriano Brothers PB,Invoice,008-05983,Liquids:AS Bitter Orange,4 / 1 gl.,1.0,14.0,14.0,4488470.16,American Spice,Lisset Limpio -020,CAFETERIA y RESTAURANTS,1389636,Jul
2025-07-10,Soriano Brothers PB,Invoice,008-05983,Liquids:AS Cooking Wine,4 1 Gl.,7.0,16.0,112.0,4488582.16,American Spice,Lisset Limpio -020,CAFETERIA y RESTAURANTS,1389637,Jul
2025-07-10,Soriano Brothers PB,Invoice,008-05983,Spices:AS Sazon (for all),1 / 30 lb (box or pail),3.0,51.0,153.0,4488735.16,American Spice,Lisset Limpio -020,CAFETERIA y RESTAURANTS,1389638,Jul
2025-07-10,Soriano Brothers PB,Invoice,008-05983,Arroz a Granel:Largo Fino 50 LB -Bolsa Dos Hermanos.,,10.0,27.85,278.5,4489013.66,Bulk Rice,Lisset Limpio -020,CAFETERIA y RESTAURANTS,1389639,Jul
2025-07-10,Soriano Brothers PB,Invoice,008-05983,Arroz a Granel:Parboiled 50 LB -Bolsa Dos Hermanos.,,11.0,27.75,305.25,4489318.91,Bulk Rice,Lisset Limpio -020,CAFETERIA y RESTAURANTS,1389640,Jul
2025-07-10,Soriano Brothers PB,Invoice,008-05983,Arroz a Granel:Parboiled 50 LB -Bolsa Dos Hermanos.,,1.0,27.75,27.75,4489346.66,Bulk Rice,Lisset Limpio -020,CAFETERIA y RESTAURANTS,1389641,Jul
2025-07-10,El Palacio de los jugos / Leti Corp.,Invoice,008-05984,Arroz a Granel:Parboiled 50 LB -Bolsa Dos Hermanos.,,6.0,26.75,160.5,4489507.16,Bulk Rice,Lisset Limpio -020,Cafeteria,1389642,Jul
2025-07-10,Soriano Brothers PB,Credit Memo,008-05985,Varios:Promotional Allowance,Arroz a Granel:Parboiled 50 LB -Bolsa Dos Hermanos.,-1.0,27.75,-27.75,4489479.41,Bulk Rice,Lisset Limpio -020,CAFETERIA y RESTAURANTS,1389643,Jul
2025-07-10,Sedanos Supermarkets #17,Credit Memo,008-05986,Varios:Producto vencido/deteriorado (no impacta en inventario),"3 unidades 5K parboiled $5.62

1 unidad rice snack pizza $1.49",-3.0,5.62,-16.86,4489462.55,Branded Rice,Keila Alfaro-Visvikis,RETAIL SEDANOS,1389644,Jul
2025-07-10,Sedanos Supermarkets #17,Credit Memo,008-05986,Varios:Producto vencido/deteriorado (no impacta en inventario),,-1.0,1.49,-1.49,4489461.06,Puffed Products,Keila Alfaro-Visvikis,RETAIL SEDANOS,1389645,Jul
2025-07-10,Sedanos Supermarkets #17,Credit Memo,008-06008,Varios:Promotional Allowance,Rice Snack:Rice Snack Salami Flavored DOS HERMANOS,-1.0,19.9,-19.9,4489441.16,Puffed Products,Keila Alfaro-Visvikis,RETAIL SEDANOS,1389646,Jul
2025-07-11,Sedanos Supermarkets #21,Invoice,008-05987,Rice Snack:Rice Snack Ham Flavored DOS HERMANOS,,2.0,19.9,39.8,4489480.96,Puffed Products,Keila Alfaro-Visvikis,RETAIL SEDANOS,1389647,Jul
2025-07-11,Sedanos Supermarkets #21,Invoice,008-05987,Rice Snack:Rice Snack Salami Flavored DOS HERMANOS,,1.0,19.9,19.9,4489500.86,Puffed Products,Keila Alfaro-Visvikis,RETAIL SEDANOS,1389648,Jul
2025-07-11,Sedanos Supermarkets #21,Invoice,008-05987,Rice Snack:Rice Snack Salami Flavored DOS HERMANOS,,1.0,19.9,19.9,4489520.76,Puffed Products,Keila Alfaro-Visvikis,RETAIL SEDANOS,1389649,Jul
2025-07-11,Sedanos Supermarkets #21,Invoice,008-05987,,Discount,,,-1.19,4489519.57,,Keila Alfaro-Visvikis,RETAIL SEDANOS,1389650,Jul
2025-07-11,Sedanos Supermarkets #21,Credit Memo,008-05988,Varios:Producto vencido/deteriorado (no impacta en inventario),3 units jamón salame y pizza  / a $1.49,-13.0,1.49,-19.37,4489500.2,Puffed Products,Keila Alfaro-Visvikis,RETAIL SEDANOS,1389651,Jul
2025-07-11,Sedanos Supermarkets #21,Credit Memo,008-05989,Varios:Promotional Allowance,Rice Snack:Rice Snack Salami Flavored DOS HERMANOS,-1.0,19.9,-19.9,4489480.3,Puffed Products,Keila Alfaro-Visvikis,RETAIL SEDANOS,1389652,Jul
2025-07-13,Fritanga Momotombo,Invoice,008-05990,Spices:AS Chicken Base,1 / 30 lb. (box or pail),1.0,39.0,39.0,4489519.3,American Spice,Lisset Limpio -020,CAFETERIA y RESTAURANTS,1389653,Jul
2025-07-13,Fritanga Momotombo,Invoice,008-05990,Arroz a Granel:Largo Fino 50 LB -Bolsa Dos Hermanos.,,6.0,27.85,167.1,4489686.4,Bulk Rice,Lisset Limpio -020,CAFETERIA y RESTAURANTS,1389654,Jul
2025-07-13,Los Mejores Tamales de Miami,Invoice,008-05991,Arroz a Granel:Parboiled 50 LB -Bolsa Dos Hermanos.,,5.0,28.25,141.25,4489827.65,Bulk Rice,Lisset Limpio -020,CAFETERIA y RESTAURANTS,1389655,Jul
2025-07-13,El Palacio de los jugos / J Mena Corp.,Invoice,008-05992,Liquids:AS Marinating Sauce (Mojo),4 / 1 Gl,2.0,17.0,34.0,4489861.65,American Spice,Lisset Limpio -020,Cafeteria,1389656,Jul
2025-07-13,El Palacio de los jugos / J Mena Corp.,Invoice,008-05992,Arroz a Granel:Parboiled 50 LB -Bolsa Dos Hermanos.,,11.0,27.75,305.25,4490166.9,Bulk Rice,Lisset Limpio -020,Cafeteria,1389657,Jul
2025-07-13,El Palacio de los jugos / J Mena Corp.,Invoice,008-05992,Arroz a Granel:Parboiled 50 LB -Bolsa Dos Hermanos.,,1.0,27.75,27.75,4490194.65,Bulk Rice,Lisset Limpio -020,Cafeteria,1389658,Jul
2025-07-13,El Palacio de los jugos / Caribe Tropical,Invoice,008-05993,Arroz a Granel:Parboiled 50 LB -Bolsa Dos Hermanos.,,6.0,26.75,160.5,4490355.15,Bulk Rice,Lisset Limpio -020,Cafeteria,1389659,Jul
2025-07-13,El Palacio de Los Jugos / Casa mía Food Restaurant inc,Invoice,008-05994,Spices:AS Chicken Base,1 / 30 lb. (box or pail),1.0,39.0,39.0,4490394.15,American Spice,Lisset Limpio -020,Cafeteria,1389660,Jul
2025-07-13,El Palacio de Los Jugos / Casa mía Food Restaurant inc,Invoice,008-05994,Spices:AS Sazon (for all),1 / 30 lb (box or pail),1.0,51.0,51.0,4490445.15,American Spice,Lisset Limpio -020,Cafeteria,1389661,Jul
2025-07-13,El Palacio de Los Jugos / Casa mía Food Restaurant inc,Invoice,008-05994,Arroz a Granel:Parboiled 50 LB -Bolsa Dos Hermanos.,,6.0,26.75,160.5,4490605.65,Bulk Rice,Lisset Limpio -020,Cafeteria,1389662,Jul
2025-07-13,Be Your Will LLC,Invoice,008-05995,Liquids:AS Cooking Wine,4 1 Gl.,2.0,17.5,35.0,4490640.65,American Spice,Lisset Limpio -020,CAFETERIA y RESTAURANTS,1389663,Jul
2025-07-13,Be Your Will LLC,Invoice,008-05995,Arroz a Granel:Largo Fino 50 LB -Bolsa Dos Hermanos.,,8.0,27.85,222.8,4490863.45,Bulk Rice,Lisset Limpio -020,CAFETERIA y RESTAURANTS,1389664,Jul
2025-07-13,Be Your Will LLC,Invoice,008-05995,Arroz a Granel:Parboiled 50 LB -Bolsa Dos Hermanos.,,11.0,27.75,305.25,4491168.7,Bulk Rice,Lisset Limpio -020,CAFETERIA y RESTAURANTS,1389665,Jul
2025-07-13,Be Your Will LLC,Invoice,008-05995,Arroz a Granel:Largo Fino 50 LB -Bolsa Dos Hermanos.,,1.0,27.85,27.85,4491196.55,Bulk Rice,Lisset Limpio -020,CAFETERIA y RESTAURANTS,1389666,Jul
2025-07-13,El Palacio de los jugos / Rodriguez Foods,Invoice,008-05996,Arroz a Granel:Parboiled 50 LB -Bolsa Dos Hermanos.,,8.0,26.75,214.0,4491410.55,Bulk Rice,Lisset Limpio -020,Cafeteria,1389667,Jul
2025-07-13,El Palacio de los jugos / Divan and Denise Food,Invoice,008-05997,Arroz a Granel:Parboiled 50 LB -Bolsa Dos Hermanos.,,6.0,26.75,160.5,4491571.05,Bulk Rice,Lisset Limpio -020,Cafeteria,1389668,Jul
2025-07-13,El Palacio de los jugos / Delicias Criollas (DIAGO FOOD_MILLER),Invoice,008-05998,Arroz a Granel:Largo Fino 50 LB -Bolsa Dos Hermanos.,,6.0,27.85,167.1,4491738.15,Bulk Rice,Lisset Limpio -020,Cafeteria,1389669,Jul
2025-07-13,El Palacio de los jugos / Delicias Criollas (DIAGO FOOD_MILLER),Invoice,008-05998,Arroz a Granel:Parboiled 50 LB -Bolsa Dos Hermanos.,,6.0,26.75,160.5,4491898.65,Bulk Rice,Lisset Limpio -020,Cafeteria,1389670,Jul
2025-07-13,JMN Dely Corp,Invoice,008-05999,Arroz a Granel:Largo Fino 50 LB -Bolsa Dos Hermanos.,,2.0,27.85,55.7,4491954.35,Bulk Rice,Keila Alfaro-Visvikis,CAFETERIA y RESTAURANTS,1389671,Jul
2025-07-13,JMN Dely Corp,Invoice,008-05999,Arroz a Granel:Parboiled 50 LB -Bolsa Dos Hermanos.,,2.0,27.75,55.5,4492009.85,Bulk Rice,Keila Alfaro-Visvikis,CAFETERIA y RESTAURANTS,1389672,Jul
2025-07-13,JMN Dely Corp,Invoice,008-05999,Dry Beans:Dry Beans - Black Beans 50,Dry Black Beans 50 lb,1.0,45.7,45.7,4492055.55,Dry Beans,Keila Alfaro-Visvikis,CAFETERIA y RESTAURANTS,1389673,Jul
2025-07-13,Sedanos Supermarkets #7,Invoice,008-06000,Arroz Envasado:Parboiled 5KG Dos Hermanos.,6  11lbs,5.0,40.5,202.5,4492258.05,Branded Rice,Keila Alfaro-Visvikis,RETAIL SEDANOS,1389674,Jul
2025-07-13,Sedanos Supermarkets #7,Invoice,008-06000,Arroz Envasado:Parboiled 5KG Dos Hermanos.,6  11lbs,1.0,40.5,40.5,4492298.55,Branded Rice,Keila Alfaro-Visvikis,RETAIL SEDANOS,1389675,Jul
2025-07-13,Sedanos Supermarkets #7,Invoice,008-06000,,Discount,,,-4.05,4492294.5,,Keila Alfaro-Visvikis,RETAIL SEDANOS,1389676,Jul
2025-07-13,Sedanos Supermarkets #42,Invoice,008-06001,Arroz a Granel:Parboiled 50 LB -Bolsa Dos Hermanos.,,0.0,,0.0,4492294.5,Bulk Rice,Keila Alfaro-Visvikis,RETAIL SEDANOS,1389677,Jul
2025-07-13,Aries Supermarket & Cafeteria,Invoice,008-06002,Spices:AS Chicken Base,1 / 30 lb. (box or pail),3.0,39.0,117.0,4492411.5,American Spice,Keila Alfaro-Visvikis,CAFETERIA y RESTAURANTS,1389678,Jul
2025-07-13,Aries Supermarket & Cafeteria,Invoice,008-06002,Arroz a Granel:Parboiled 50 LB -Bolsa Dos Hermanos.,,10.0,28.25,282.5,4492694.0,Bulk Rice,Keila Alfaro-Visvikis,CAFETERIA y RESTAURANTS,1389679,Jul
2025-07-13,Aries Supermarket & Cafeteria,Invoice,008-06002,Dry Beans:Dry Beans - Black Beans 50,Dry Black Beans 50 lb,5.0,36.75,183.75,4492877.75,Dry Beans,Keila Alfaro-Visvikis,CAFETERIA y RESTAURANTS,1389680,Jul
2025-07-14,Sedanos Supermarkets  #37,Credit Memo,008-06003,Varios:Promotional Allowance,Rice Snack:Rice Snack Salami Flavored DOS HERMANOS,-1.0,19.9,-19.9,4492857.85,Puffed Products,Keila Alfaro-Visvikis,RETAIL SEDANOS,1389681,Jul
2025-07-14,Sedanos Supermarkets #18,Credit Memo,008-06004,Varios:Promotional Allowance,Rice Snack:Rice Snack Salami Flavored DOS HERMANOS,-1.0,19.9,-19.9,4492837.95,Puffed Products,Keila Alfaro-Visvikis,RETAIL SEDANOS,1389682,Jul
2025-07-14,El Palacio de los jugos / J Mena Corp.,Credit Memo,008-06005,Varios:Promotional Allowance,Arroz a Granel:Parboiled 50 LB -Bolsa Dos Hermanos.,-1.0,27.75,-27.75,4492810.2,Bulk Rice,Lisset Limpio -020,Cafeteria,1389683,Jul
2025-07-14,Be Your Will LLC,Credit Memo,008-06006,Varios:Promotional Allowance,Arroz a Granel:Largo Fino 50 LB -Bolsa Dos Hermanos.,-1.0,27.85,-27.85,4492782.35,Bulk Rice,Lisset Limpio -020,CAFETERIA y RESTAURANTS,1389684,Jul
2025-07-14,Sedanos Supermarkets #7,Credit Memo,008-06007,Varios:Sales,Arroz Envasado:Parboiled 5KG Dos Hermanos.,-1.0,40.5,-40.5,4492741.85,Bulk Rice,Keila Alfaro-Visvikis,RETAIL SEDANOS,1389685,Jul
2025-07-16,Sedanos Supermarkets #10,Invoice,008-06009,Arroz Envasado:Largo Fino 1kg (Long grain rice) Dos Hermanos,,15.0,17.0,255.0,4492996.85,Branded Rice,Keila Alfaro-Visvikis,RETAIL SEDANOS,1389686,Jul
2025-07-16,Sedanos Supermarkets #10,Invoice,008-06009,Arroz Envasado:Parboiled 5KG Dos Hermanos.,6  11lbs,21.0,40.5,850.5,4493847.35,Branded Rice,Keila Alfaro-Visvikis,RETAIL SEDANOS,1389687,Jul
2025-07-16,Sedanos Supermarkets #10,Invoice,008-06009,Arroz Envasado:Long Rice 10 LB Dos Hermanos,,21.0,35.5,745.5,4494592.85,Branded Rice,Keila Alfaro-Visvikis,RETAIL SEDANOS,1389688,Jul
2025-07-16,Sedanos Supermarkets #10,Invoice,008-06009,Arroz Envasado:Largo Fino 1kg (Long grain rice) Dos Hermanos,,5.0,17.0,85.0,4494677.85,Branded Rice,Keila Alfaro-Visvikis,RETAIL SEDANOS,1389689,Jul
2025-07-16,Sedanos Supermarkets #10,Invoice,008-06009,Arroz Envasado:Long Rice 10 LB Dos Hermanos,,21.0,35.5,745.5,4495423.35,Branded Rice,Keila Alfaro-Visvikis,RETAIL SEDANOS,1389690,Jul
2025-07-16,Sedanos Supermarkets #10,Invoice,008-06009,Arroz Envasado:Parboiled 5KG Dos Hermanos.,6  11lbs,21.0,40.5,850.5,4496273.85,Branded Rice,Keila Alfaro-Visvikis,RETAIL SEDANOS,1389691,Jul
2025-07-16,Sedanos Supermarkets #10,Invoice,008-06009,Rice Snack:Rice Snack Ham Flavored DOS HERMANOS,,2.0,19.9,39.8,4496313.65,Puffed Products,Keila Alfaro-Visvikis,RETAIL SEDANOS,1389692,Jul
2025-07-16,Sedanos Supermarkets #10,Invoice,008-06009,Rice Snack:Rice Snack Salami Flavored DOS HERMANOS,,3.0,19.9,59.7,4496373.35,Puffed Products,Keila Alfaro-Visvikis,RETAIL SEDANOS,1389693,Jul
2025-07-16,Sedanos Supermarkets #10,Invoice,008-06009,Varios:Exhibidor de pie DOS HERMANOS PVC -,,1.0,0.1,0.1,4496373.45,Branded Rice,Keila Alfaro-Visvikis,RETAIL SEDANOS,1389694,Jul
2025-07-16,Sedanos Supermarkets #9,Invoice,008-06010,Rice Snack:Rice Snack Ham Flavored DOS HERMANOS,,2.0,19.9,39.8,4496413.25,Puffed Products,Keila Alfaro-Visvikis,RETAIL SEDANOS,1389695,Jul
2025-07-16,Sedanos Supermarkets #9,Invoice,008-06010,Rice Snack:Rice Snack Salami Flavored DOS HERMANOS,,3.0,19.9,59.7,4496472.95,Puffed Products,Keila Alfaro-Visvikis,RETAIL SEDANOS,1389696,Jul
2025-07-16,Sedanos Supermarkets #9,Invoice,008-06010,Arroz Envasado:Largo Fino 1kg (Long grain rice) Dos Hermanos,,15.0,17.0,255.0,4496727.95,Branded Rice,Keila Alfaro-Visvikis,RETAIL SEDANOS,1389697,Jul
2025-07-16,Sedanos Supermarkets #9,Invoice,008-06010,Arroz Envasado:Parboiled 5KG Dos Hermanos.,6  11lbs,21.0,40.5,850.5,4497578.45,Branded Rice,Keila Alfaro-Visvikis,RETAIL SEDANOS,1389698,Jul
2025-07-16,Sedanos Supermarkets #9,Invoice,008-06010,Arroz Envasado:Long Rice 10 LB Dos Hermanos,,21.0,35.5,745.5,4498323.95,Branded Rice,Keila Alfaro-Visvikis,RETAIL SEDANOS,1389699,Jul
2025-07-16,Sedanos Supermarkets #9,Invoice,008-06010,Arroz Envasado:Largo Fino 1kg (Long grain rice) Dos Hermanos,,5.0,17.0,85.0,4498408.95,Branded Rice,Keila Alfaro-Visvikis,RETAIL SEDANOS,1389700,Jul
2025-07-16,Sedanos Supermarkets #9,Invoice,008-06010,Arroz Envasado:Long Rice 10 LB Dos Hermanos,,21.0,35.5,745.5,4499154.45,Branded Rice,Keila Alfaro-Visvikis,RETAIL SEDANOS,1389701,Jul
2025-07-16,Sedanos Supermarkets #9,Invoice,008-06010,Arroz Envasado:Parboiled 5KG Dos Hermanos.,6  11lbs,21.0,40.5,850.5,4500004.95,Branded Rice,Keila Alfaro-Visvikis,RETAIL SEDANOS,1389702,Jul
2025-07-16,Sedanos Supermarkets #9,Invoice,008-06010,Varios:Exhibidor de pie DOS HERMANOS PVC -,,1.0,0.1,0.1,4500005.05,Branded Rice,Keila Alfaro-Visvikis,RETAIL SEDANOS,1389703,Jul
2025-07-16,Sedanos Supermarkets #42,Invoice,008-06011,Arroz a Granel:Parboiled 50 LB -Bolsa Dos Hermanos.,,5.0,28.25,141.25,4500146.3,Bulk Rice,Keila Alfaro-Visvikis,RETAIL SEDANOS,1389704,Jul
2025-07-16,Sedanos Supermarkets #16,Invoice,008-06012,Arroz a Granel:Parboiled 50 LB -Bolsa Dos Hermanos.,,4.0,28.25,113.0,4500259.3,Bulk Rice,Keila Alfaro-Visvikis,RETAIL SEDANOS,1389705,Jul
2025-07-16,Sedanos Supermarkets #16,Invoice,008-06012,,Discount,,,-2.26,4500257.04,,Keila Alfaro-Visvikis,RETAIL SEDANOS,1389706,Jul
2025-07-16,Sedanos Supermarkets #34,Invoice,008-06013,Arroz Envasado:Long Rice 10 LB Dos Hermanos,,5.0,35.5,177.5,4500434.54,Branded Rice,Keila Alfaro-Visvikis,RETAIL SEDANOS,1389707,Jul
2025-07-16,Sedanos Supermarkets #34,Invoice,008-06013,Arroz Envasado:Long Rice 10 LB Dos Hermanos,,1.0,35.5,35.5,4500470.04,Branded Rice,Keila Alfaro-Visvikis,RETAIL SEDANOS,1389708,Jul
2025-07-16,Ideal Food Basket Davie Cafeteria,Invoice,008-06014,Arroz a Granel:Largo Fino 50 LB -Bolsa Dos Hermanos.,,6.0,27.85,167.1,4500637.14,Bulk Rice,Keila Alfaro-Visvikis,CAFETERIA y RESTAURANTS,1389709,Jul
2025-07-16,Rey Chavez Distributor #2,Invoice,008-06015,Arroz a Granel:Parboiled 50 LB -Bolsa Dos Hermanos.,,25.0,27.5,687.5,4501324.64,Bulk Rice,Lisset Limpio -020,WHOLESALER,1389710,Jul
2025-07-16,Los Caringas Latin America  Foods,Invoice,008-06016,Arroz a Granel:Parboiled 50 LB -Bolsa Dos Hermanos.,,3.0,28.25,84.75,4501409.39,Bulk Rice,Lisset Limpio -020,CAFETERIA y RESTAURANTS,1389711,Jul
2025-07-16,Los Caringas Latin America  Foods,Invoice,008-06016,Arroz a Granel:Largo Fino 50 LB -Bolsa Dos Hermanos.,,3.0,27.85,83.55,4501492.94,Bulk Rice,Lisset Limpio -020,CAFETERIA y RESTAURANTS,1389712,Jul
2025-07-16,Key Food / Holywood,Invoice,008-06017,Arroz Envasado:Long Rice 10 LB Dos Hermanos,,15.0,35.5,532.5,4502025.44,Branded Rice,Keila Alfaro-Visvikis,RETAIL  DSD,1389713,Jul
2025-07-16,Key Food / Holywood,Invoice,008-06017,Arroz Envasado:Long Rice 10 LB Dos Hermanos,,5.0,35.5,177.5,4502202.94,Branded Rice,Keila Alfaro-Visvikis,RETAIL  DSD,1389714,Jul
2025-07-16,Key Food / Holywood,Invoice,008-06018,Arroz Envasado:Long Rice 10 LB Dos Hermanos,,5.0,35.5,177.5,4502380.44,Branded Rice,Keila Alfaro-Visvikis,RETAIL  DSD,1389715,Jul
2025-07-16,Key Food / Holywood,Invoice,008-06018,Arroz Envasado:Long Rice 10 LB Dos Hermanos,,1.0,35.5,35.5,4502415.94,Branded Rice,Keila Alfaro-Visvikis,RETAIL  DSD,1389716,Jul
2025-07-16,Sedanos Supermarkets #28,Invoice,008-06019,Rice Snack:Rice Snack Ham Flavored DOS HERMANOS,,0.0,,0.0,4502415.94,Puffed Products,Keila Alfaro-Visvikis,RETAIL SEDANOS,1389717,Jul
2025-07-16,Sedanos Supermarkets #28,Invoice,008-06019,Rice Snack:Rice Snack Salami Flavored DOS HERMANOS,,0.0,,0.0,4502415.94,Puffed Products,Keila Alfaro-Visvikis,RETAIL SEDANOS,1389718,Jul
2025-07-16,Sedanos Supermarkets #28,Invoice,008-06019,Rice Snack:Rice Snack Salami Flavored DOS HERMANOS,,0.0,,0.0,4502415.94,Puffed Products,Keila Alfaro-Visvikis,RETAIL SEDANOS,1389719,Jul
2025-07-16,Sedanos Supermarkets #28,Credit Memo,008-06020,Varios:Producto vencido/deteriorado (no impacta en inventario),21 HAM Y SALAMI,-21.0,1.49,-31.29,4502384.65,Puffed Products,Keila Alfaro-Visvikis,RETAIL SEDANOS,1389720,Jul
2025-07-16,Sedanos Supermarkets #10,Credit Memo,008-06021,Varios:Promotional Allowance,Arroz Envasado:Largo Fino 1kg (Long grain rice) Dos Hermanos,-5.0,17.0,-85.0,4502299.65,Branded Rice,Keila Alfaro-Visvikis,RETAIL SEDANOS,1389721,Jul
2025-07-16,Sedanos Supermarkets #10,Credit Memo,008-06021,Varios:Promotional Allowance,Arroz Envasado:Parboiled 5KG Dos Hermanos.,-21.0,40.5,-850.5,4501449.15,Branded Rice,Keila Alfaro-Visvikis,RETAIL SEDANOS,1389722,Jul
2025-07-16,Sedanos Supermarkets #10,Credit Memo,008-06021,Varios:Promotional Allowance,Rice Snack:Rice Snack Salami Flavored DOS HERMANOS,-5.0,19.9,-99.5,4501349.65,Puffed Products,Keila Alfaro-Visvikis,RETAIL SEDANOS,1389723,Jul
2025-07-16,Sedanos Supermarkets #10,Credit Memo,008-06021,Varios:Promotional Allowance,Arroz Envasado:Long Rice 10 LB Dos Hermanos,-21.0,35.5,-745.5,4500604.15,Branded Rice,Keila Alfaro-Visvikis,RETAIL SEDANOS,1389724,Jul
2025-07-16,Key Food / Holywood,Credit Memo,008-06022,Varios:Promotional Allowance,Arroz Envasado:Long Rice 10 LB Dos Hermanos,-1.0,35.5,-35.5,4500568.65,Branded Rice,Keila Alfaro-Visvikis,RETAIL  DSD,1389725,Jul
2025-07-16,Key Food / Holywood,Credit Memo,008-06023,Varios:Promotional Allowance,Arroz Envasado:Long Rice 10 LB Dos Hermanos,-5.0,35.5,-177.5,4500391.15,Branded Rice,Keila Alfaro-Visvikis,RETAIL  DSD,1389726,Jul
2025-07-16,Sedanos Supermarkets #28,Credit Memo,008-06024,Varios:Promotional Allowance,Rice Snack:Rice Snack Salami Flavored DOS HERMANOS,-1.0,19.9,-19.9,4500371.25,Puffed Products,Keila Alfaro-Visvikis,RETAIL SEDANOS,1389727,Jul
2025-07-16,Sedanos Supermarkets #34,Credit Memo,008-06025,Varios:Promotional Allowance,Arroz Envasado:Long Rice 10 LB Dos Hermanos,-1.0,35.5,-35.5,4500335.75,Branded Rice,Keila Alfaro-Visvikis,RETAIL SEDANOS,1389728,Jul
2025-07-16,Sedanos Supermarkets #9,Credit Memo,008-06026,Varios:Promotional Allowance,Rice Snack:Rice Snack Salami Flavored DOS HERMANOS,-3.0,19.9,-59.7,4500276.05,Puffed Products,Keila Alfaro-Visvikis,RETAIL SEDANOS,1389729,Jul
2025-07-16,Sedanos Supermarkets #9,Credit Memo,008-06026,Varios:Promotional Allowance,Arroz Envasado:Largo Fino 1kg (Long grain rice) Dos Hermanos,-5.0,17.0,-85.0,4500191.05,Branded Rice,Keila Alfaro-Visvikis,RETAIL SEDANOS,1389730,Jul
2025-07-16,Sedanos Supermarkets #9,Credit Memo,008-06026,Varios:Promotional Allowance,Arroz Envasado:Parboiled 5KG Dos Hermanos.,-21.0,40.5,-850.5,4499340.55,Branded Rice,Keila Alfaro-Visvikis,RETAIL SEDANOS,1389731,Jul
2025-07-16,Sedanos Supermarkets #9,Credit Memo,008-06026,Varios:Promotional Allowance,Arroz Envasado:Long Rice 10 LB Dos Hermanos,-21.0,35.5,-745.5,4498595.05,Branded Rice,Keila Alfaro-Visvikis,RETAIL SEDANOS,1389732,Jul
2025-07-17,El Palacio de Los Jugos / Casa mía Food Restaurant inc,Invoice,008-06027,Arroz a Granel:Parboiled 50 LB -Bolsa Dos Hermanos.,,8.0,26.75,214.0,4498809.05,Bulk Rice,Lisset Limpio -020,Cafeteria,1389733,Jul
2025-07-17,El Palacio de Los Jugos / Casa mía Food Restaurant inc,Invoice,008-06027,Spices:AS Chicken Base,1 / 30 lb. (box or pail),1.0,39.0,39.0,4498848.05,American Spice,Lisset Limpio -020,Cafeteria,1389734,Jul
2025-07-17,El Palacio de Los Jugos / Casa mía Food Restaurant inc,Invoice,008-06027,Liquids:AS Marinating Sauce (Mojo),4 / 1 Gl,1.0,17.0,17.0,4498865.05,American Spice,Lisset Limpio -020,Cafeteria,1389735,Jul
2025-07-17,El Palacio de Los Jugos / Casa mía Food Restaurant inc,Invoice,008-06027,Liquids:AS Lemon Juice 4/1 Gl,,1.0,14.95,14.95,4498880.0,American Spice,Lisset Limpio -020,Cafeteria,1389736,Jul
2025-07-17,El Palacio de Los Jugos / Casa mía Food Restaurant inc,Invoice,008-06027,Spices:AS Sazon (for all),1 / 30 lb (box or pail),1.0,51.0,51.0,4498931.0,American Spice,Lisset Limpio -020,Cafeteria,1389737,Jul
2025-07-17,El Palacio de los jugos / Lita Foods Inc.,Invoice,008-06028,Dry Beans:Dry Beans - Black Beans 50,Dry Black Beans 50 lb,1.0,34.0,34.0,4498965.0,Dry Beans,Lisset Limpio -020,Cafeteria,1389738,Jul
2025-07-17,El Palacio de los jugos / Lita Foods Inc.,Invoice,008-06028,Arroz a Granel:Parboiled 50 LB -Bolsa Dos Hermanos.,,12.0,26.75,321.0,4499286.0,Bulk Rice,Lisset Limpio -020,Cafeteria,1389739,Jul
2025-07-17,El Palacio de los jugos / Divan and Denise Food,Invoice,008-06029,Arroz a Granel:Parboiled 50 LB -Bolsa Dos Hermanos.,,10.0,26.75,267.5,4499553.5,Bulk Rice,Lisset Limpio -020,Cafeteria,1389740,Jul
2025-07-17,El Palacio de los jugos / Caribe Tropical,Invoice,008-06030,Dry Beans:Dry Beans - Black Beans 50,Dry Black Beans 50 lb,2.0,34.0,68.0,4499621.5,Dry Beans,Lisset Limpio -020,Cafeteria,1389741,Jul
2025-07-17,El Palacio de los jugos / Caribe Tropical,Invoice,008-06030,Arroz a Granel:Parboiled 50 LB -Bolsa Dos Hermanos.,,8.0,26.75,214.0,4499835.5,Bulk Rice,Lisset Limpio -020,Cafeteria,1389742,Jul
2025-07-17,El Palacio de los jugos / Rodriguez Foods,Invoice,008-06031,Arroz a Granel:Parboiled 50 LB -Bolsa Dos Hermanos.,,6.0,26.75,160.5,4499996.0,Bulk Rice,Lisset Limpio -020,Cafeteria,1389743,Jul
2025-07-17,El Gallego Supermarket,Invoice,008-06032,Liquids:AS Bitter Orange,4 / 1 gl.,1.0,14.0,14.0,4500010.0,American Spice,Lisset Limpio -020,RETAIL  DSD,1389744,Jul
2025-07-17,El Gallego Supermarket,Invoice,008-06032,Liquids:AS Cooking Wine,4 1 Gl.,1.0,17.5,17.5,4500027.5,American Spice,Lisset Limpio -020,RETAIL  DSD,1389745,Jul
2025-07-17,El Gallego Supermarket,Invoice,008-06032,Dry Beans:Dry Beans - Black Beans 50,Dry Black Beans 50 lb,2.0,35.0,70.0,4500097.5,Dry Beans,Lisset Limpio -020,RETAIL  DSD,1389746,Jul
2025-07-17,El Gallego Supermarket,Invoice,008-06032,Arroz a Granel:Parboiled 50 LB -Bolsa Dos Hermanos.,,5.0,26.75,133.75,4500231.25,Bulk Rice,Lisset Limpio -020,RETAIL  DSD,1389747,Jul
2025-07-17,Bravo   Francisco Diaz,Invoice,008-06033,Liquids:AS Cooking Wine,4 1 Gl.,4.0,17.5,70.0,4500301.25,American Spice,Lisset Limpio -020,RETAIL  DSD,1389748,Jul
2025-07-17,Bravo   Francisco Diaz,Invoice,008-06033,Liquids:AS Marinating Sauce (Mojo),4 / 1 Gl,3.0,18.5,55.5,4500356.75,American Spice,Lisset Limpio -020,RETAIL  DSD,1389749,Jul
2025-07-17,Bravo   Francisco Diaz,Invoice,008-06033,Liquids:AS Lemon Juice 4/1 Gl,,2.0,14.95,29.9,4500386.65,American Spice,Lisset Limpio -020,RETAIL  DSD,1389750,Jul
2025-07-17,Bravo   Francisco Diaz,Invoice,008-06033,Liquids:AS White Vinegar,4/1 Gl.,3.0,10.0,30.0,4500416.65,American Spice,Lisset Limpio -020,RETAIL  DSD,1389751,Jul
2025-07-17,Bravo   Francisco Diaz,Invoice,008-06033,Spices:AS Chicken Base,1 / 30 lb. (box or pail),1.0,39.0,39.0,4500455.65,American Spice,Lisset Limpio -020,RETAIL  DSD,1389752,Jul
2025-07-17,Bravo   Francisco Diaz,Invoice,008-06033,Arroz a Granel:Largo Fino 50 LB -Bolsa Dos Hermanos.,,5.0,27.85,139.25,4500594.9,Bulk Rice,Lisset Limpio -020,RETAIL  DSD,1389753,Jul
2025-07-17,Bravo   Francisco Diaz,Invoice,008-06034,Arroz Envasado:Long Rice 10 LB Dos Hermanos,,15.0,35.5,532.5,4501127.4,Branded Rice,Lisset Limpio -020,RETAIL  DSD,1389754,Jul
2025-07-17,Bravo   Francisco Diaz,Invoice,008-06034,Arroz Envasado:Long Rice 10 LB Dos Hermanos,,3.0,35.5,106.5,4501233.9,Branded Rice,Lisset Limpio -020,RETAIL  DSD,1389755,Jul
2025-07-17,Extra Supermarket,Invoice,008-06035,Arroz Envasado:Largo Fino 1kg (Long grain rice) Dos Hermanos,,5.0,18.0,90.0,4501323.9,Branded Rice,Keila Alfaro-Visvikis,RETAIL  DSD,1389756,Jul
2025-07-17,Extra Supermarket,Invoice,008-06035,Arroz Envasado:Largo Fino 1kg (Long grain rice) Dos Hermanos,,1.0,18.0,18.0,4501341.9,Branded Rice,Keila Alfaro-Visvikis,RETAIL  DSD,1389757,Jul
2025-07-17,Sedanos Supermarkets #31,Invoice,008-06036,Arroz Envasado:Parboiled 5KG Dos Hermanos.,6  11lbs,15.0,40.5,607.5,4501949.4,Branded Rice,Keila Alfaro-Visvikis,RETAIL SEDANOS,1389758,Jul
2025-07-17,Sedanos Supermarkets #31,Invoice,008-06036,Arroz Envasado:Parboiled 5KG Dos Hermanos.,6  11lbs,4.0,40.5,162.0,4502111.4,Branded Rice,Keila Alfaro-Visvikis,RETAIL SEDANOS,1389759,Jul
2025-07-17,Sedanos Supermarkets #31,Invoice,008-06037,Arroz a Granel:Parboiled 50 LB -Bolsa Dos Hermanos.,,5.0,28.25,141.25,4502252.65,Bulk Rice,Keila Alfaro-Visvikis,RETAIL SEDANOS,1389760,Jul
2025-07-17,El Palacio de los jugos /  Nanos Latin Foods,Invoice,008-06038,Arroz a Granel:Parboiled 50 LB -Bolsa Dos Hermanos.,,12.0,26.75,321.0,4502573.65,Bulk Rice,Lisset Limpio -020,Cafeteria,1389761,Jul
2025-07-17,El Palacio de los jugos /  Nanos Latin Foods,Invoice,008-06038,Arroz a Granel:Largo Fino 50 LB -Bolsa Dos Hermanos.,,5.0,27.85,139.25,4502712.9,Bulk Rice,Lisset Limpio -020,Cafeteria,1389762,Jul
2025-07-17,"Soriano Brothers Diaz Food Service,Inc",Invoice,008-06039,Dry Beans:Dry Beans - Black Beans 50,Dry Black Beans 50 lb,10.0,34.0,340.0,4503052.9,Dry Beans,Lisset Limpio -020,CAFETERIA y RESTAURANTS,1389763,Jul
2025-07-17,El Palacio de los jugos / Leti Corp.,Invoice,008-06040,Arroz a Granel:Parboiled 50 LB -Bolsa Dos Hermanos.,,8.0,26.75,214.0,4503266.9,Bulk Rice,Lisset Limpio -020,Cafeteria,1389764,Jul
2025-07-17,El Palacio de los jugos / Leti Corp.,Invoice,008-06040,Arroz a Granel:Largo Fino 50 LB -Bolsa Dos Hermanos.,,4.0,27.85,111.4,4503378.3,Bulk Rice,Lisset Limpio -020,Cafeteria,1389765,Jul
2025-07-17,Sedanos Supermarkets #33,Invoice,008-06041,Arroz a Granel:Parboiled 50 LB -Bolsa Dos Hermanos.,,3.0,28.25,84.75,4503463.05,Bulk Rice,Keila Alfaro-Visvikis,RETAIL SEDANOS,1389766,Jul
2025-07-17,Bravo   Francisco Diaz,Credit Memo,008-06042,Varios:Promotional Allowance,Arroz Envasado:Long Rice 10 LB Dos Hermanos,-3.0,35.5,-106.5,4503356.55,Branded Rice,Lisset Limpio -020,RETAIL  DSD,1389767,Jul
2025-07-17,Sedanos Supermarkets #31,Credit Memo,008-06043,Varios:Promotional Allowance,Arroz Envasado:Parboiled 5KG Dos Hermanos.,-4.0,40.5,-162.0,4503194.55,Branded Rice,Keila Alfaro-Visvikis,RETAIL SEDANOS,1389768,Jul
2025-07-17,Extra Supermarket,Credit Memo,008-06044,Varios:Promotional Allowance,Arroz Envasado:Largo Fino 1kg (Long grain rice) Dos Hermanos,-1.0,18.0,-18.0,4503176.55,Branded Rice,Keila Alfaro-Visvikis,RETAIL  DSD,1389769,Jul
2025-07-18,Sedanos Supermarkets #31,Credit Memo,008-06045,Varios:Producto vencido/deteriorado (no impacta en inventario),Parboiled 5k @ $3.37,-1.0,3.37,-3.37,4503173.18,Branded Rice,Keila Alfaro-Visvikis,RETAIL SEDANOS,1389770,Jul
2025-07-18,Sedanos Supermarkets #38,Invoice,008-06046,Arroz Envasado:Parboiled 5KG Dos Hermanos.,6  11lbs,21.0,40.5,850.5,4504023.68,Branded Rice,Keila Alfaro-Visvikis,RETAIL SEDANOS,1389771,Jul
2025-07-18,Sedanos Supermarkets #38,Invoice,008-06046,Arroz Envasado:Parboiled 5KG Dos Hermanos.,6  11lbs,21.0,40.5,850.5,4504874.18,Branded Rice,Keila Alfaro-Visvikis,RETAIL SEDANOS,1389772,Jul
2025-07-18,Sedanos Supermarkets #28,Invoice,008-06047,Arroz Envasado:Parboiled 5KG Dos Hermanos.,6  11lbs,15.0,40.5,607.5,4505481.68,American Spice,Keila Alfaro-Visvikis,RETAIL SEDANOS,1389773,Jul
2025-07-18,Sedanos Supermarkets #28,Invoice,008-06047,Arroz Envasado:Parboiled 5KG Dos Hermanos.,6  11lbs,3.0,40.5,121.5,4505603.18,Branded Rice,Keila Alfaro-Visvikis,RETAIL SEDANOS,1389774,Jul
2025-07-18,Sedanos Supermarkets #28,Invoice,008-06047,Rice Snack:Rice Snack Ham Flavored DOS HERMANOS,,2.0,19.9,39.8,4505642.98,Puffed Products,Keila Alfaro-Visvikis,RETAIL SEDANOS,1389775,Jul
2025-07-18,Sedanos Supermarkets #28,Invoice,008-06047,Rice Snack:Rice Snack Salami Flavored DOS HERMANOS,,1.0,19.9,19.9,4505662.88,Puffed Products,Keila Alfaro-Visvikis,RETAIL SEDANOS,1389776,Jul
2025-07-18,Sedanos Supermarkets #28,Invoice,008-06047,Rice Snack:Rice Snack Salami Flavored DOS HERMANOS,,1.0,19.9,19.9,4505682.78,Puffed Products,Keila Alfaro-Visvikis,RETAIL SEDANOS,1389777,Jul
2025-07-18,Sedanos Supermarkets #38,Credit Memo,008-06060,Varios:Promotional Allowance,Arroz Envasado:Parboiled 5KG Dos Hermanos.,-21.0,40.5,-850.5,4504832.28,Branded Rice,Keila Alfaro-Visvikis,RETAIL SEDANOS,1389778,Jul
2025-07-18,ALS Foods,Credit Memo,008-06061,Varios:Promotional Allowance,Arroz a Granel:Parboiled 50 LB -Bolsa Dos Hermanos.,-1.0,27.75,-27.75,4504804.53,Branded Rice,Lisset Limpio -020,CAFETERIA y RESTAURANTS,1389779,Jul
2025-07-18,Sedanos Supermarkets #28,Credit Memo,008-06063,Varios:Promotional Allowance,Rice Snack:Rice Snack Salami Flavored DOS HERMANOS,-1.0,19.9,-19.9,4504784.63,Puffed Products,Keila Alfaro-Visvikis,RETAIL SEDANOS,1389780,Jul
2025-07-18,Sedanos Supermarkets #28,Credit Memo,008-06063,Varios:Promotional Allowance,Arroz Envasado:Parboiled 5KG Dos Hermanos.,-3.0,40.5,-121.5,4504663.13,Branded Rice,Keila Alfaro-Visvikis,RETAIL SEDANOS,1389781,Jul
2025-07-20,El Palacio de Los Jugos / Casa mía Food Restaurant inc,Invoice,008-06048,Arroz a Granel:Parboiled 50 LB -Bolsa Dos Hermanos.,,8.0,26.75,214.0,4504877.13,Bulk Rice,Lisset Limpio -020,Cafeteria,1389782,Jul
2025-07-20,El Palacio de los jugos / Caribe Tropical,Invoice,008-06049,Arroz a Granel:Parboiled 50 LB -Bolsa Dos Hermanos.,,6.0,26.75,160.5,4505037.63,Bulk Rice,Lisset Limpio -020,Cafeteria,1389783,Jul
2025-07-20,El Palacio de los jugos /  Nanos Latin Foods,Invoice,008-06050,Arroz a Granel:Parboiled 50 LB -Bolsa Dos Hermanos.,,10.0,26.75,267.5,4505305.13,Bulk Rice,Lisset Limpio -020,Cafeteria,1389784,Jul
2025-07-20,El Palacio de los jugos /  Nanos Latin Foods,Invoice,008-06050,Arroz a Granel:Largo Fino 50 LB -Bolsa Dos Hermanos.,,5.0,27.85,139.25,4505444.38,Bulk Rice,Lisset Limpio -020,Cafeteria,1389785,Jul
2025-07-20,El Palacio de los jugos / Divan and Denise Food,Invoice,008-06051,Arroz a Granel:Parboiled 50 LB -Bolsa Dos Hermanos.,,8.0,26.75,214.0,4505658.38,Bulk Rice,Lisset Limpio -020,Cafeteria,1389786,Jul
2025-07-20,El Palacio de los jugos / Delicias Criollas (DIAGO FOOD_MILLER),Invoice,008-06052,Arroz a Granel:Largo Fino 50 LB -Bolsa Dos Hermanos.,,5.0,27.85,139.25,4505797.63,Bulk Rice,Lisset Limpio -020,Cafeteria,1389787,Jul
2025-07-20,El Palacio de los jugos / Delicias Criollas (DIAGO FOOD_MILLER),Invoice,008-06052,Arroz a Granel:Parboiled 50 LB -Bolsa Dos Hermanos.,,12.0,26.75,321.0,4506118.63,Bulk Rice,Lisset Limpio -020,Cafeteria,1389788,Jul
2025-07-20,Aries Supermarket & Cafeteria,Invoice,008-06053,Arroz a Granel:Parboiled 50 LB -Bolsa Dos Hermanos.,,10.0,28.25,282.5,4506401.13,Bulk Rice,Keila Alfaro-Visvikis,CAFETERIA y RESTAURANTS,1389789,Jul
2025-07-20,Aries Supermarket & Cafeteria,Invoice,008-06053,Dry Beans:Dry Beans - Black Beans 50,Dry Black Beans 50 lb,5.0,36.75,183.75,4506584.88,Dry Beans,Keila Alfaro-Visvikis,CAFETERIA y RESTAURANTS,1389790,Jul
2025-07-20,Aries Supermarket & Cafeteria,Invoice,008-06053,Spices:AS Oregano Ground,4 / 3.5 Lbs.,1.0,37.5,37.5,4506622.38,American Spice,Keila Alfaro-Visvikis,CAFETERIA y RESTAURANTS,1389791,Jul
2025-07-20,Sedanos Supermarkets #8,Invoice,008-06054,Rice Snack:Rice Snack Ham Flavored DOS HERMANOS,,1.0,19.9,19.9,4506642.28,Puffed Products,Keila Alfaro-Visvikis,RETAIL SEDANOS,1389792,Jul
2025-07-20,Sedanos Supermarkets #8,Invoice,008-06054,Rice Snack:Rice Snack Salami Flavored DOS HERMANOS,,1.0,19.9,19.9,4506662.18,Puffed Products,Keila Alfaro-Visvikis,RETAIL SEDANOS,1389793,Jul
2025-07-20,Sedanos Supermarkets #8,Invoice,008-06054,Arroz Envasado:Largo Fino 1kg (Long grain rice) Dos Hermanos,,15.0,17.5,262.5,4506924.68,Branded Rice,Keila Alfaro-Visvikis,RETAIL SEDANOS,1389794,Jul
2025-07-20,Sedanos Supermarkets #8,Invoice,008-06054,Arroz Envasado:Parboiled 5KG Dos Hermanos.,6  11lbs,21.0,40.5,850.5,4507775.18,Branded Rice,Keila Alfaro-Visvikis,RETAIL SEDANOS,1389795,Jul
2025-07-20,Sedanos Supermarkets #8,Invoice,008-06054,Arroz Envasado:Long Rice 10 LB Dos Hermanos,,21.0,35.5,745.5,4508520.68,Branded Rice,Keila Alfaro-Visvikis,RETAIL SEDANOS,1389796,Jul
2025-07-20,Sedanos Supermarkets #8,Invoice,008-06054,Rice Snack:Rice Snack Salami Flavored DOS HERMANOS,,1.0,19.9,19.9,4508540.58,Puffed Products,Keila Alfaro-Visvikis,RETAIL SEDANOS,1389797,Jul
2025-07-20,Sedanos Supermarkets #8,Invoice,008-06054,Rice Snack:Rice Snack Ham Flavored DOS HERMANOS,,2.0,19.9,39.8,4508580.38,Puffed Products,Keila Alfaro-Visvikis,RETAIL SEDANOS,1389798,Jul
2025-07-20,Sedanos Supermarkets #8,Invoice,008-06054,Arroz Envasado:Largo Fino 1kg (Long grain rice) Dos Hermanos,,5.0,17.5,87.5,4508667.88,Branded Rice,Keila Alfaro-Visvikis,RETAIL SEDANOS,1389799,Jul
2025-07-20,Sedanos Supermarkets #8,Invoice,008-06054,Arroz Envasado:Long Rice 10 LB Dos Hermanos,,21.0,35.5,745.5,4509413.38,Branded Rice,Keila Alfaro-Visvikis,RETAIL SEDANOS,1389800,Jul
2025-07-20,Sedanos Supermarkets #8,Invoice,008-06054,Arroz Envasado:Parboiled 5KG Dos Hermanos.,6  11lbs,21.0,40.5,850.5,4510263.88,Branded Rice,Keila Alfaro-Visvikis,RETAIL SEDANOS,1389801,Jul
2025-07-20,Sedanos Supermarkets #8,Invoice,008-06054,Varios:Exhibidor de pie DOS HERMANOS PVC -,,1.0,0.01,0.01,4510263.89,Branded Rice,Keila Alfaro-Visvikis,RETAIL SEDANOS,1389802,Jul
2025-07-20,El Palacio de los jugos /  Mires Restaurants,Invoice,008-06055,Liquids:AS Marinating Sauce (Mojo),4 / 1 Gl,1.0,18.5,18.5,4510282.39,American Spice,Lisset Limpio -020,Cafeteria,1389803,Jul
2025-07-20,El Palacio de los jugos /  Mires Restaurants,Invoice,008-06055,Arroz a Granel:Parboiled 50 LB -Bolsa Dos Hermanos.,,11.0,27.75,305.25,4510587.64,Bulk Rice,Lisset Limpio -020,Cafeteria,1389804,Jul
2025-07-20,El Palacio de los jugos /  Mires Restaurants,Invoice,008-06055,Arroz a Granel:Parboiled 50 LB -Bolsa Dos Hermanos.,,1.0,27.75,27.75,4510615.39,Bulk Rice,Lisset Limpio -020,Cafeteria,1389805,Jul
2025-07-20,Soriano Brothers PB,Invoice,008-06056,Liquids:AS Cooking Wine,4 1 Gl.,3.0,16.0,48.0,4510663.39,American Spice,Lisset Limpio -020,CAFETERIA y RESTAURANTS,1389806,Jul
2025-07-20,Soriano Brothers PB,Invoice,008-06056,Spices:AS Sazon (for all),1 / 30 lb (box or pail),1.0,51.0,51.0,4510714.39,American Spice,Lisset Limpio -020,CAFETERIA y RESTAURANTS,1389807,Jul
2025-07-20,Soriano Brothers PB,Invoice,008-06056,Arroz a Granel:Largo Fino 50 LB -Bolsa Dos Hermanos.,,10.0,27.85,278.5,4510992.89,Bulk Rice,Lisset Limpio -020,CAFETERIA y RESTAURANTS,1389808,Jul
2025-07-20,El Palacio de los jugos / Rodriguez Foods,Invoice,008-06057,Arroz a Granel:Parboiled 50 LB -Bolsa Dos Hermanos.,,6.0,26.75,160.5,4511153.39,Bulk Rice,Lisset Limpio -020,Cafeteria,1389809,Jul
2025-07-20,El Palacio de los Jugos / Bird Road Restaurant,Invoice,008-06058,Arroz a Granel:Parboiled 50 LB -Bolsa Dos Hermanos.,,10.0,26.75,267.5,4511420.89,Bulk Rice,Lisset Limpio -020,Cafeteria,1389810,Jul
2025-07-20,El Palacio de los jugos /  Mires Restaurants,Credit Memo,008-06062,Varios:Promotional Allowance,Arroz a Granel:Parboiled 50 LB -Bolsa Dos Hermanos.,-1.0,27.75,-27.75,4511393.14,Bulk Rice,Lisset Limpio -020,Cafeteria,1389811,Jul
2025-07-20,Sedanos Supermarkets #8,Credit Memo,008-06064,Varios:Promotional Allowance,Rice Snack:Rice Snack Salami Flavored DOS HERMANOS,-1.0,19.9,-19.9,4511373.24,Puffed Products,Keila Alfaro-Visvikis,RETAIL SEDANOS,1389812,Jul
2025-07-20,Sedanos Supermarkets #8,Credit Memo,008-06064,Varios:Promotional Allowance,Rice Snack:Rice Snack Ham Flavored DOS HERMANOS,-2.0,19.9,-39.8,4511333.44,Puffed Products,Keila Alfaro-Visvikis,RETAIL SEDANOS,1389813,Jul
2025-07-20,Sedanos Supermarkets #8,Credit Memo,008-06064,Varios:Promotional Allowance,Arroz Envasado:Largo Fino 1kg (Long grain rice) Dos Hermanos,-5.0,17.5,-87.5,4511245.94,Branded Rice,Keila Alfaro-Visvikis,RETAIL SEDANOS,1389814,Jul
2025-07-20,Sedanos Supermarkets #8,Credit Memo,008-06064,Varios:Promotional Allowance,Arroz Envasado:Long Rice 10 LB Dos Hermanos,-21.0,35.5,-745.5,4510500.44,Branded Rice,Keila Alfaro-Visvikis,RETAIL SEDANOS,1389815,Jul
2025-07-20,Sedanos Supermarkets #8,Credit Memo,008-06064,Varios:Promotional Allowance,Arroz Envasado:Parboiled 5KG Dos Hermanos.,-21.0,40.5,-850.5,4509649.94,Branded Rice,Keila Alfaro-Visvikis,RETAIL SEDANOS,1389816,Jul
2025-07-21,ALS Foods,Invoice,008-06059,Liquids:AS Cooking Wine,4 1 Gl.,2.0,17.5,35.0,4509684.94,American Spice,Lisset Limpio -020,CAFETERIA y RESTAURANTS,1389817,Jul
2025-07-21,ALS Foods,Invoice,008-06059,Arroz a Granel:Largo Fino 50 LB -Bolsa Dos Hermanos.,,7.0,27.85,194.95,4509879.89,Bulk Rice,Lisset Limpio -020,CAFETERIA y RESTAURANTS,1389818,Jul
2025-07-21,ALS Foods,Invoice,008-06059,Arroz a Granel:Parboiled 50 LB -Bolsa Dos Hermanos.,,11.0,27.75,305.25,4510185.14,Bulk Rice,Lisset Limpio -020,CAFETERIA y RESTAURANTS,1389819,Jul
2025-07-21,ALS Foods,Invoice,008-06059,Arroz a Granel:Parboiled 50 LB -Bolsa Dos Hermanos.,,1.0,27.75,27.75,4510212.89,Bulk Rice,Lisset Limpio -020,CAFETERIA y RESTAURANTS,1389820,Jul
2025-07-21,JMN Dely Corp,Invoice,008-06065,Dry Beans:Dry Beans - Black Beans 50,Dry Black Beans 50 lb,1.0,45.7,45.7,4510258.59,Dry Beans,Keila Alfaro-Visvikis,CAFETERIA y RESTAURANTS,1389821,Jul
2025-07-21,JMN Dely Corp,Invoice,008-06065,Arroz a Granel:Largo Fino 50 LB -Bolsa Dos Hermanos.,,2.0,27.85,55.7,4510314.29,Bulk Rice,Keila Alfaro-Visvikis,CAFETERIA y RESTAURANTS,1389822,Jul
2025-07-21,JMN Dely Corp,Invoice,008-06065,Arroz a Granel:Parboiled 50 LB -Bolsa Dos Hermanos.,,2.0,27.75,55.5,4510369.79,Bulk Rice,Keila Alfaro-Visvikis,CAFETERIA y RESTAURANTS,1389823,Jul
2025-07-21,JMN Dely Corp,Invoice,008-06065,,Discount,,,-0.9,4510368.89,,Keila Alfaro-Visvikis,CAFETERIA y RESTAURANTS,1389824,Jul
2025-07-21,Sedanos Supermarkets #43,Invoice,008-06066,Arroz Envasado:Largo Fino 1kg (Long grain rice) Dos Hermanos,,15.0,17.5,262.5,4510631.39,Branded Rice,Keila Alfaro-Visvikis,RETAIL SEDANOS,1389825,Jul
2025-07-21,Sedanos Supermarkets #43,Invoice,008-06066,Arroz Envasado:Parboiled 5KG Dos Hermanos.,6  11lbs,21.0,40.5,850.5,4511481.89,Branded Rice,Keila Alfaro-Visvikis,RETAIL SEDANOS,1389826,Jul
2025-07-21,Sedanos Supermarkets #43,Invoice,008-06066,Arroz Envasado:Long Rice 10 LB Dos Hermanos,,21.0,35.5,745.5,4512227.39,Branded Rice,Keila Alfaro-Visvikis,RETAIL SEDANOS,1389827,Jul
2025-07-21,Sedanos Supermarkets #43,Invoice,008-06066,Rice Snack:Rice Snack Ham Flavored DOS HERMANOS,,1.0,19.9,19.9,4512247.29,Puffed Products,Keila Alfaro-Visvikis,RETAIL SEDANOS,1389828,Jul
2025-07-21,Sedanos Supermarkets #43,Invoice,008-06066,Rice Snack:Rice Snack Salami Flavored DOS HERMANOS,,1.0,19.9,19.9,4512267.19,Puffed Products,Keila Alfaro-Visvikis,RETAIL SEDANOS,1389829,Jul
2025-07-21,Sedanos Supermarkets #43,Invoice,008-06066,Rice Snack:Rice Snack Ham Flavored DOS HERMANOS,,2.0,19.9,39.8,4512306.99,Puffed Products,Keila Alfaro-Visvikis,RETAIL SEDANOS,1389830,Jul
2025-07-21,Sedanos Supermarkets #43,Invoice,008-06066,Rice Snack:Rice Snack Salami Flavored DOS HERMANOS,,1.0,19.9,19.9,4512326.89,Puffed Products,Keila Alfaro-Visvikis,RETAIL SEDANOS,1389831,Jul
2025-07-21,Sedanos Supermarkets #43,Invoice,008-06066,Arroz Envasado:Largo Fino 1kg (Long grain rice) Dos Hermanos,,5.0,17.5,87.5,4512414.39,Branded Rice,Keila Alfaro-Visvikis,RETAIL SEDANOS,1389832,Jul
2025-07-21,Sedanos Supermarkets #43,Invoice,008-06066,Arroz Envasado:Parboiled 5KG Dos Hermanos.,6  11lbs,21.0,40.5,850.5,4513264.89,Branded Rice,Keila Alfaro-Visvikis,RETAIL SEDANOS,1389833,Jul
2025-07-21,Sedanos Supermarkets #43,Invoice,008-06066,Arroz Envasado:Long Rice 10 LB Dos Hermanos,,21.0,35.5,745.5,4514010.39,Branded Rice,Keila Alfaro-Visvikis,RETAIL SEDANOS,1389834,Jul
2025-07-21,Sedanos Supermarkets #43,Invoice,008-06066,Varios:Exhibidor de pie DOS HERMANOS PVC -,,1.0,0.01,0.01,4514010.4,Branded Rice,Keila Alfaro-Visvikis,RETAIL SEDANOS,1389835,Jul
2025-07-21,Sedanos Supermarkets #22,Invoice,008-06067,Arroz Envasado:Largo Fino 1kg (Long grain rice) Dos Hermanos,,15.0,17.5,262.5,4514272.9,Branded Rice,Keila Alfaro-Visvikis,RETAIL SEDANOS,1389836,Jul
2025-07-21,Sedanos Supermarkets #22,Invoice,008-06067,Rice Snack:Rice Snack Ham Flavored DOS HERMANOS,,1.0,19.9,19.9,4514292.8,Puffed Products,Keila Alfaro-Visvikis,RETAIL SEDANOS,1389837,Jul
2025-07-21,Sedanos Supermarkets #22,Invoice,008-06067,Rice Snack:Rice Snack Salami Flavored DOS HERMANOS,,1.0,19.9,19.9,4514312.7,Puffed Products,Keila Alfaro-Visvikis,RETAIL SEDANOS,1389838,Jul
2025-07-21,Sedanos Supermarkets #22,Invoice,008-06067,Arroz Envasado:Parboiled 5KG Dos Hermanos.,6  11lbs,21.0,40.5,850.5,4515163.2,Branded Rice,Keila Alfaro-Visvikis,RETAIL SEDANOS,1389839,Jul
2025-07-21,Sedanos Supermarkets #22,Invoice,008-06067,Arroz Envasado:Long Rice 10 LB Dos Hermanos,,21.0,35.5,745.5,4515908.7,Branded Rice,Keila Alfaro-Visvikis,RETAIL SEDANOS,1389840,Jul
2025-07-21,Sedanos Supermarkets #22,Invoice,008-06067,Rice Snack:Rice Snack Ham Flavored DOS HERMANOS,,2.0,19.9,39.8,4515948.5,Puffed Products,Keila Alfaro-Visvikis,RETAIL SEDANOS,1389841,Jul
2025-07-21,Sedanos Supermarkets #22,Invoice,008-06067,Rice Snack:Rice Snack Salami Flavored DOS HERMANOS,,1.0,19.9,19.9,4515968.4,Puffed Products,Keila Alfaro-Visvikis,RETAIL SEDANOS,1389842,Jul
2025-07-21,Sedanos Supermarkets #22,Invoice,008-06067,Arroz Envasado:Parboiled 5KG Dos Hermanos.,6  11lbs,21.0,40.5,850.5,4516818.9,Branded Rice,Keila Alfaro-Visvikis,RETAIL SEDANOS,1389843,Jul
2025-07-21,Sedanos Supermarkets #22,Invoice,008-06067,Arroz Envasado:Long Rice 10 LB Dos Hermanos,,21.0,35.5,745.5,4517564.4,Branded Rice,Keila Alfaro-Visvikis,RETAIL SEDANOS,1389844,Jul
2025-07-21,Sedanos Supermarkets #22,Invoice,008-06067,Varios:Exhibidor de pie DOS HERMANOS PVC -,,1.0,0.01,0.01,4517564.41,Branded Rice,Keila Alfaro-Visvikis,RETAIL SEDANOS,1389845,Jul
2025-07-21,Sedanos Supermarkets #22,Invoice,008-06067,Arroz Envasado:Largo Fino 1kg (Long grain rice) Dos Hermanos,,5.0,17.5,87.5,4517651.91,Branded Rice,Keila Alfaro-Visvikis,RETAIL SEDANOS,1389846,Jul
2025-07-21,Sedanos Supermarkets #26,Invoice,008-06068,Arroz Envasado:Largo Fino 1kg (Long grain rice) Dos Hermanos,,15.0,17.5,262.5,4517914.41,Branded Rice,Keila Alfaro-Visvikis,RETAIL SEDANOS,1389847,Jul
2025-07-21,Sedanos Supermarkets #26,Invoice,008-06068,Arroz Envasado:Parboiled 5KG Dos Hermanos.,6  11lbs,21.0,40.5,850.5,4518764.91,Branded Rice,Keila Alfaro-Visvikis,RETAIL SEDANOS,1389848,Jul
2025-07-21,Sedanos Supermarkets #26,Invoice,008-06068,Arroz Envasado:Long Rice 10 LB Dos Hermanos,,21.0,35.5,745.5,4519510.41,Branded Rice,Keila Alfaro-Visvikis,RETAIL SEDANOS,1389849,Jul
2025-07-21,Sedanos Supermarkets #26,Invoice,008-06068,Rice Snack:Rice Snack Ham Flavored DOS HERMANOS,,1.0,19.9,19.9,4519530.31,Puffed Products,Keila Alfaro-Visvikis,RETAIL SEDANOS,1389850,Jul
2025-07-21,Sedanos Supermarkets #26,Invoice,008-06068,Rice Snack:Rice Snack Salami Flavored DOS HERMANOS,,1.0,19.9,19.9,4519550.21,Puffed Products,Keila Alfaro-Visvikis,RETAIL SEDANOS,1389851,Jul
2025-07-21,Sedanos Supermarkets #26,Invoice,008-06068,Rice Snack:Rice Snack Ham Flavored DOS HERMANOS,,2.0,19.9,39.8,4519590.01,Puffed Products,Keila Alfaro-Visvikis,RETAIL SEDANOS,1389852,Jul
2025-07-21,Sedanos Supermarkets #26,Invoice,008-06068,Rice Snack:Rice Snack Salami Flavored DOS HERMANOS,,1.0,19.9,19.9,4519609.91,Puffed Products,Keila Alfaro-Visvikis,RETAIL SEDANOS,1389853,Jul
2025-07-21,Sedanos Supermarkets #26,Invoice,008-06068,Arroz Envasado:Largo Fino 1kg (Long grain rice) Dos Hermanos,,5.0,17.5,87.5,4519697.41,Branded Rice,Keila Alfaro-Visvikis,RETAIL SEDANOS,1389854,Jul
2025-07-21,Sedanos Supermarkets #26,Invoice,008-06068,Arroz Envasado:Parboiled 5KG Dos Hermanos.,6  11lbs,21.0,40.5,850.5,4520547.91,Branded Rice,Keila Alfaro-Visvikis,RETAIL SEDANOS,1389855,Jul
2025-07-21,Sedanos Supermarkets #26,Invoice,008-06068,Arroz Envasado:Long Rice 10 LB Dos Hermanos,,21.0,35.5,745.5,4521293.41,Branded Rice,Keila Alfaro-Visvikis,RETAIL SEDANOS,1389856,Jul
2025-07-21,Sedanos Supermarkets #26,Invoice,008-06068,Varios:Exhibidor de pie DOS HERMANOS PVC -,,1.0,0.01,0.01,4521293.42,Branded Rice,Keila Alfaro-Visvikis,RETAIL SEDANOS,1389857,Jul
2025-07-21,Sedanos Supermarkets #1,Invoice,008-06069,Rice Snack:Rice Snack Ham Flavored DOS HERMANOS,,1.0,19.9,19.9,4521313.32,Puffed Products,Keila Alfaro-Visvikis,RETAIL SEDANOS,1389858,Jul
2025-07-21,Sedanos Supermarkets #1,Invoice,008-06069,Rice Snack:Rice Snack Salami Flavored DOS HERMANOS,,1.0,19.9,19.9,4521333.22,Puffed Products,Keila Alfaro-Visvikis,RETAIL SEDANOS,1389859,Jul
2025-07-21,Sedanos Supermarkets #1,Invoice,008-06069,Arroz Envasado:Largo Fino 1kg (Long grain rice) Dos Hermanos,,5.0,17.5,87.5,4521420.72,Branded Rice,Keila Alfaro-Visvikis,RETAIL SEDANOS,1389860,Jul
2025-07-21,Sedanos Supermarkets #1,Invoice,008-06069,Arroz Envasado:Parboiled 5KG Dos Hermanos.,6  11lbs,10.0,40.5,405.0,4521825.72,Branded Rice,Keila Alfaro-Visvikis,RETAIL SEDANOS,1389861,Jul
2025-07-21,Sedanos Supermarkets #1,Invoice,008-06069,Arroz Envasado:Long Rice 10 LB Dos Hermanos,,10.0,35.5,355.0,4522180.72,Branded Rice,Keila Alfaro-Visvikis,RETAIL SEDANOS,1389862,Jul
2025-07-21,Sedanos Supermarkets #1,Invoice,008-06069,Arroz Envasado:Largo Fino 1kg (Long grain rice) Dos Hermanos,,2.0,17.5,35.0,4522215.72,Branded Rice,Keila Alfaro-Visvikis,RETAIL SEDANOS,1389863,Jul
2025-07-21,Sedanos Supermarkets #1,Invoice,008-06069,Arroz Envasado:Long Rice 10 LB Dos Hermanos,,10.0,35.5,355.0,4522570.72,Branded Rice,Keila Alfaro-Visvikis,RETAIL SEDANOS,1389864,Jul
2025-07-21,Sedanos Supermarkets #1,Invoice,008-06069,Arroz Envasado:Parboiled 5KG Dos Hermanos.,6  11lbs,10.0,40.5,405.0,4522975.72,Branded Rice,Keila Alfaro-Visvikis,RETAIL SEDANOS,1389865,Jul
2025-07-21,Sedanos Supermarkets #1,Invoice,008-06069,Rice Snack:Rice Snack Ham Flavored DOS HERMANOS,,2.0,19.9,39.8,4523015.52,Puffed Products,Keila Alfaro-Visvikis,RETAIL SEDANOS,1389866,Jul
2025-07-21,Sedanos Supermarkets #1,Invoice,008-06069,Rice Snack:Rice Snack Salami Flavored DOS HERMANOS,,1.0,19.9,19.9,4523035.42,Puffed Products,Keila Alfaro-Visvikis,RETAIL SEDANOS,1389867,Jul
2025-07-21,Bake Mark USA LLC,Invoice,008-06070,Arroz a Granel:Parboiled 50 LB -Bolsa Dos Hermanos.,,1100.0,22.9,25190.0,4548225.42,Bulk Rice,Armando Carpio - 017,WHOLESALER MANUFACTURY,1389868,Jul
2025-07-21,Sedanos Supermarkets #1,Credit Memo,008-06071,Varios:Promotional Allowance,Arroz Envasado:Largo Fino 1kg (Long grain rice) Dos Hermanos,-2.0,17.5,-35.0,4548190.42,Branded Rice,Keila Alfaro-Visvikis,RETAIL SEDANOS,1389869,Jul
2025-07-21,Sedanos Supermarkets #1,Credit Memo,008-06071,Varios:Promotional Allowance,Arroz Envasado:Long Rice 10 LB Dos Hermanos,-10.0,35.5,-355.0,4547835.42,Branded Rice,Keila Alfaro-Visvikis,RETAIL SEDANOS,1389870,Jul
2025-07-21,Sedanos Supermarkets #1,Credit Memo,008-06071,Varios:Promotional Allowance,Arroz Envasado:Parboiled 5KG Dos Hermanos.,-10.0,40.5,-405.0,4547430.42,Branded Rice,Keila Alfaro-Visvikis,RETAIL SEDANOS,1389871,Jul
2025-07-21,Sedanos Supermarkets #1,Credit Memo,008-06071,Varios:Promotional Allowance,Rice Snack:Rice Snack Ham Flavored DOS HERMANOS,-2.0,19.9,-39.8,4547390.62,Puffed Products,Keila Alfaro-Visvikis,RETAIL SEDANOS,1389872,Jul
2025-07-21,Sedanos Supermarkets #1,Credit Memo,008-06071,Varios:Promotional Allowance,Rice Snack:Rice Snack Salami Flavored DOS HERMANOS,-1.0,19.9,-19.9,4547370.72,Puffed Products,Keila Alfaro-Visvikis,RETAIL SEDANOS,1389873,Jul
2025-07-21,Sedanos Supermarkets #22,Credit Memo,008-06072,Varios:Promotional Allowance,Rice Snack:Rice Snack Ham Flavored DOS HERMANOS,-2.0,19.9,-39.8,4547330.92,Puffed Products,Keila Alfaro-Visvikis,RETAIL SEDANOS,1389874,Jul
2025-07-21,Sedanos Supermarkets #22,Credit Memo,008-06072,Varios:Promotional Allowance,Rice Snack:Rice Snack Salami Flavored DOS HERMANOS,-1.0,19.9,-19.9,4547311.02,Puffed Products,Keila Alfaro-Visvikis,RETAIL SEDANOS,1389875,Jul
2025-07-21,Sedanos Supermarkets #22,Credit Memo,008-06072,Varios:Promotional Allowance,Arroz Envasado:Parboiled 5KG Dos Hermanos.,-21.0,40.5,-850.5,4546460.52,Branded Rice,Keila Alfaro-Visvikis,RETAIL SEDANOS,1389876,Jul
2025-07-21,Sedanos Supermarkets #22,Credit Memo,008-06072,Varios:Promotional Allowance,Arroz Envasado:Long Rice 10 LB Dos Hermanos,-21.0,35.5,-745.5,4545715.02,Branded Rice,Keila Alfaro-Visvikis,RETAIL SEDANOS,1389877,Jul
2025-07-21,Sedanos Supermarkets #22,Credit Memo,008-06072,Varios:Promotional Allowance,Arroz Envasado:Largo Fino 1kg (Long grain rice) Dos Hermanos,-5.0,17.5,-87.5,4545627.52,Branded Rice,Keila Alfaro-Visvikis,RETAIL SEDANOS,1389878,Jul
2025-07-21,Sedanos Supermarkets #26,Credit Memo,008-06073,Varios:Promotional Allowance,Rice Snack:Rice Snack Ham Flavored DOS HERMANOS,-2.0,19.9,-39.8,4545587.72,Puffed Products,Keila Alfaro-Visvikis,RETAIL SEDANOS,1389879,Jul
2025-07-21,Sedanos Supermarkets #26,Credit Memo,008-06073,Varios:Promotional Allowance,Rice Snack:Rice Snack Salami Flavored DOS HERMANOS,-1.0,19.9,-19.9,4545567.82,Puffed Products,Keila Alfaro-Visvikis,RETAIL SEDANOS,1389880,Jul
2025-07-21,Sedanos Supermarkets #26,Credit Memo,008-06073,Varios:Promotional Allowance,Arroz Envasado:Largo Fino 1kg (Long grain rice) Dos Hermanos,-5.0,17.5,-87.5,4545480.32,Branded Rice,Keila Alfaro-Visvikis,RETAIL SEDANOS,1389881,Jul
2025-07-21,Sedanos Supermarkets #26,Credit Memo,008-06073,Varios:Promotional Allowance,Arroz Envasado:Parboiled 5KG Dos Hermanos.,-21.0,40.5,-850.5,4544629.82,Branded Rice,Keila Alfaro-Visvikis,RETAIL SEDANOS,1389882,Jul
2025-07-21,Sedanos Supermarkets #26,Credit Memo,008-06073,Varios:Promotional Allowance,Arroz Envasado:Long Rice 10 LB Dos Hermanos,-21.0,35.5,-745.5,4543884.32,Branded Rice,Keila Alfaro-Visvikis,RETAIL SEDANOS,1389883,Jul
2025-07-21,Sedanos Supermarkets #43,Credit Memo,008-06074,Varios:Promotional Allowance,Rice Snack:Rice Snack Ham Flavored DOS HERMANOS,-2.0,19.9,-39.8,4543844.52,Puffed Products,Keila Alfaro-Visvikis,RETAIL SEDANOS,1389884,Jul
2025-07-21,Sedanos Supermarkets #43,Credit Memo,008-06074,Varios:Promotional Allowance,Rice Snack:Rice Snack Salami Flavored DOS HERMANOS,-1.0,19.9,-19.9,4543824.62,Puffed Products,Keila Alfaro-Visvikis,RETAIL SEDANOS,1389885,Jul
2025-07-21,Sedanos Supermarkets #43,Credit Memo,008-06074,Varios:Promotional Allowance,Arroz Envasado:Largo Fino 1kg (Long grain rice) Dos Hermanos,-5.0,17.5,-87.5,4543737.12,Branded Rice,Keila Alfaro-Visvikis,RETAIL SEDANOS,1389886,Jul
2025-07-21,Sedanos Supermarkets #43,Credit Memo,008-06074,Varios:Promotional Allowance,Arroz Envasado:Parboiled 5KG Dos Hermanos.,-21.0,40.5,-850.5,4542886.62,Branded Rice,Keila Alfaro-Visvikis,RETAIL SEDANOS,1389887,Jul
2025-07-21,Sedanos Supermarkets #43,Credit Memo,008-06074,Varios:Promotional Allowance,Arroz Envasado:Long Rice 10 LB Dos Hermanos,-21.0,35.5,-745.5,4542141.12,Branded Rice,Keila Alfaro-Visvikis,RETAIL SEDANOS,1389888,Jul
2025-07-23,Chavez Distributors Inc.,Invoice,008-06075,Arroz Envasado:Parboiled 5KG Dos Hermanos.,6  11lbs,15.0,46.5,697.5,4542838.62,Branded Rice,Keila Alfaro-Visvikis,WHOLESALER,1389889,Jul
2025-07-23,Chavez Distributors Inc.,Invoice,008-06075,Arroz Envasado:Long Rice 10 LB Dos Hermanos,,15.0,35.5,532.5,4543371.12,Branded Rice,Keila Alfaro-Visvikis,WHOLESALER,1389890,Jul
2025-07-23,Chavez Distributors Inc.,Invoice,008-06075,Arroz Envasado:Parboiled 5KG Dos Hermanos.,6  11lbs,7.0,46.5,325.5,4543696.62,Branded Rice,Keila Alfaro-Visvikis,WHOLESALER,1389891,Jul
2025-07-23,Chavez Distributors Inc.,Invoice,008-06075,Arroz Envasado:Long Rice 10 LB Dos Hermanos,,3.0,35.5,106.5,4543803.12,Branded Rice,Keila Alfaro-Visvikis,WHOLESALER,1389892,Jul
2025-07-23,Key Food / Holywood,Invoice,008-06076,Arroz Envasado:Long Rice 10 LB Dos Hermanos,,5.0,35.5,177.5,4543980.62,Branded Rice,Keila Alfaro-Visvikis,RETAIL  DSD,1389893,Jul
2025-07-23,Key Food / Holywood,Invoice,008-06076,Arroz Envasado:Long Rice 10 LB Dos Hermanos,,1.0,35.5,35.5,4544016.12,Branded Rice,Keila Alfaro-Visvikis,RETAIL  DSD,1389894,Jul
2025-07-23,Key Foods  / Ivan,Invoice,008-06077,Arroz Envasado:Parboiled 5KG Dos Hermanos.,6  11lbs,15.0,46.5,697.5,4544713.62,Branded Rice,Keila Alfaro-Visvikis,RETAIL  DSD,1389895,Jul
2025-07-23,Key Foods  / Ivan,Invoice,008-06077,Arroz Envasado:Parboiled 5KG Dos Hermanos.,6  11lbs,7.0,46.5,325.5,4545039.12,Branded Rice,Keila Alfaro-Visvikis,RETAIL  DSD,1389896,Jul
2025-07-23,Key Foods - 10301 Royal Palm Food Corp.,Invoice,008-06078,Arroz Envasado:Parboiled 1kg Bolsa Dos Hermanos.,.,30.0,19.9,597.0,4545636.12,Branded Rice,Keila Alfaro-Visvikis,RETAIL KEY FOOD,1389897,Jul
2025-07-23,Key Foods - 10301 Royal Palm Food Corp.,Invoice,008-06078,Arroz Envasado:Parboiled 1kg Bolsa Dos Hermanos.,.,6.0,19.9,119.4,4545755.52,Branded Rice,Keila Alfaro-Visvikis,RETAIL KEY FOOD,1389898,Jul
2025-07-23,Ideal Food Basket Davie Cafeteria,Invoice,008-06079,Arroz a Granel:Largo Fino 50 LB -Bolsa Dos Hermanos.,,8.0,27.85,222.8,4545978.32,Bulk Rice,Keila Alfaro-Visvikis,CAFETERIA y RESTAURANTS,1389899,Jul
2025-07-23,Food Fair Plantation Corp,Invoice,008-06080,Arroz Envasado:Parboiled 5KG Dos Hermanos.,6  11lbs,15.0,46.5,697.5,4546675.82,Branded Rice,Keila Alfaro-Visvikis,RETAIL  DSD,1389900,Jul
2025-07-23,Food Fair Plantation Corp,Invoice,008-06080,Arroz Envasado:Long Rice 10 LB Dos Hermanos,,15.0,35.5,532.5,4547208.32,Branded Rice,Keila Alfaro-Visvikis,RETAIL  DSD,1389901,Jul
2025-07-23,Food Fair Plantation Corp,Invoice,008-06080,Arroz Envasado:Parboiled 5KG Dos Hermanos.,6  11lbs,7.0,46.5,325.5,4547533.82,Branded Rice,Keila Alfaro-Visvikis,RETAIL  DSD,1389902,Jul
2025-07-23,Food Fair Plantation Corp,Invoice,008-06080,Arroz Envasado:Long Rice 10 LB Dos Hermanos,,3.0,35.5,106.5,4547640.32,Branded Rice,Keila Alfaro-Visvikis,RETAIL  DSD,1389903,Jul
2025-07-23,Brito Family Corp.,Invoice,008-06081,Arroz a Granel:Parboiled 50 LB -Bolsa Dos Hermanos.,,55.0,24.5,1347.5,4548987.82,Bulk Rice,Lisset Limpio -020,CAFETERIA y RESTAURANTS,1389904,Jul
2025-07-23,Brito Family Corp.,Invoice,008-06081,Arroz a Granel:Largo Fino 50 LB -Bolsa Dos Hermanos.,,55.0,25.0,1375.0,4550362.82,Bulk Rice,Lisset Limpio -020,CAFETERIA y RESTAURANTS,1389905,Jul
2025-07-23,Chavez Distributors Inc.,Credit Memo,008-06082,Varios:Promotional Allowance,Arroz Envasado:Parboiled 5KG Dos Hermanos.,-7.0,46.5,-325.5,4550037.32,Branded Rice,Keila Alfaro-Visvikis,WHOLESALER,1389906,Jul
2025-07-23,Chavez Distributors Inc.,Credit Memo,008-06082,Varios:Promotional Allowance,Arroz Envasado:Long Rice 10 LB Dos Hermanos,-3.0,35.5,-106.5,4549930.82,Branded Rice,Keila Alfaro-Visvikis,WHOLESALER,1389907,Jul
2025-07-23,Food Fair Plantation Corp,Credit Memo,008-06083,Varios:Promotional Allowance,Arroz Envasado:Parboiled 5KG Dos Hermanos.,-7.0,46.5,-325.5,4549605.32,Branded Rice,Keila Alfaro-Visvikis,RETAIL  DSD,1389908,Jul
2025-07-23,Food Fair Plantation Corp,Credit Memo,008-06083,Varios:Promotional Allowance,Arroz Envasado:Long Rice 10 LB Dos Hermanos,-3.0,35.5,-106.5,4549498.82,Branded Rice,Keila Alfaro-Visvikis,RETAIL  DSD,1389909,Jul
2025-07-23,Key Food / Holywood,Credit Memo,008-06084,Varios:Promotional Allowance,Arroz Envasado:Long Rice 10 LB Dos Hermanos,-1.0,35.5,-35.5,4549463.32,Branded Rice,Keila Alfaro-Visvikis,RETAIL  DSD,1389910,Jul
2025-07-23,Key Foods - 10301 Royal Palm Food Corp.,Credit Memo,008-06085,Varios:Promotional Allowance,Arroz Envasado:Parboiled 1kg Bolsa Dos Hermanos.,-6.0,19.9,-119.4,4549343.92,Branded Rice,Keila Alfaro-Visvikis,RETAIL KEY FOOD,1389911,Jul
2025-07-23,Key Foods  / Ivan,Credit Memo,008-06086,Varios:Promotional Allowance,Arroz Envasado:Parboiled 5KG Dos Hermanos.,-7.0,46.5,-325.5,4549018.42,Branded Rice,Keila Alfaro-Visvikis,RETAIL  DSD,1389912,Jul
2025-07-23,Sedanos Supermarkets #16,Invoice,008-06087,Arroz a Granel:Parboiled 50 LB -Bolsa Dos Hermanos.,,3.0,28.25,84.75,4549103.17,Bulk Rice,Keila Alfaro-Visvikis,RETAIL SEDANOS,1389913,Jul
2025-07-24,El Palacio de Los Jugos / Casa mía Food Restaurant inc,Invoice,008-06088,Arroz a Granel:Parboiled 50 LB -Bolsa Dos Hermanos.,,8.0,26.75,214.0,4549317.17,Bulk Rice,Lisset Limpio -020,Cafeteria,1389914,Jul
2025-07-24,Soriano Brothers PB,Invoice,008-06089,Liquids:AS Bitter Orange,4 / 1 gl.,1.0,14.0,14.0,4549331.17,American Spice,Lisset Limpio -020,CAFETERIA y RESTAURANTS,1389915,Jul
2025-07-24,Soriano Brothers PB,Invoice,008-06089,Liquids:AS Cooking Wine,4 1 Gl.,4.0,16.0,64.0,4549395.17,American Spice,Lisset Limpio -020,CAFETERIA y RESTAURANTS,1389916,Jul
2025-07-24,Soriano Brothers PB,Invoice,008-06089,Dry Beans:Dry Beans - Black Beans 50,Dry Black Beans 50 lb,6.0,32.0,192.0,4549587.17,Dry Beans,Lisset Limpio -020,CAFETERIA y RESTAURANTS,1389917,Jul
2025-07-24,Soriano Brothers PB,Invoice,008-06089,Spices:AS Sazon (for all),1 / 30 lb (box or pail),2.0,51.0,102.0,4549689.17,American Spice,Lisset Limpio -020,CAFETERIA y RESTAURANTS,1389918,Jul
2025-07-24,Soriano Brothers PB,Invoice,008-06089,Arroz a Granel:Parboiled 50 LB -Bolsa Dos Hermanos.,,11.0,27.75,305.25,4549994.42,Bulk Rice,Lisset Limpio -020,CAFETERIA y RESTAURANTS,1389919,Jul
2025-07-24,Soriano Brothers PB,Invoice,008-06089,Arroz a Granel:Largo Fino 50 LB -Bolsa Dos Hermanos.,,7.0,27.85,194.95,4550189.37,Bulk Rice,Lisset Limpio -020,CAFETERIA y RESTAURANTS,1389920,Jul
2025-07-24,Soriano Brothers PB,Invoice,008-06089,Arroz a Granel:Parboiled 50 LB -Bolsa Dos Hermanos.,,1.0,27.75,27.75,4550217.12,Bulk Rice,Lisset Limpio -020,CAFETERIA y RESTAURANTS,1389921,Jul
2025-07-24,El Palacio de los jugos /  Nanos Latin Foods,Invoice,008-06090,Arroz a Granel:Largo Fino 50 LB -Bolsa Dos Hermanos.,,3.0,27.85,83.55,4550300.67,Bulk Rice,Lisset Limpio -020,Cafeteria,1389922,Jul
2025-07-24,El Palacio de los jugos /  Nanos Latin Foods,Invoice,008-06090,Arroz a Granel:Parboiled 50 LB -Bolsa Dos Hermanos.,,8.0,26.75,214.0,4550514.67,Bulk Rice,Lisset Limpio -020,Cafeteria,1389923,Jul
2025-07-24,Sedanos Supermarkets #33,Invoice,008-06091,Arroz a Granel:Parboiled 50 LB -Bolsa Dos Hermanos.,,3.0,28.25,84.75,4550599.42,Bulk Rice,Keila Alfaro-Visvikis,RETAIL SEDANOS,1389924,Jul
2025-07-24,Sedanos Supermarkets #42,Invoice,008-06092,Arroz Envasado:Parboiled 1kg Bolsa Dos Hermanos.,.,3.0,19.9,59.7,4550659.12,Branded Rice,Keila Alfaro-Visvikis,RETAIL SEDANOS,1389925,Jul
2025-07-24,Sedanos Supermarkets #42,Invoice,008-06092,Arroz Envasado:Long Rice 10 LB Dos Hermanos,,5.0,35.5,177.5,4550836.62,Branded Rice,Keila Alfaro-Visvikis,RETAIL SEDANOS,1389926,Jul
2025-07-24,Sedanos Supermarkets #42,Invoice,008-06092,Arroz Envasado:Largo Fino 1kg (Long grain rice) Dos Hermanos,,2.0,17.5,35.0,4550871.62,Branded Rice,Keila Alfaro-Visvikis,RETAIL SEDANOS,1389927,Jul
2025-07-24,Sedanos Supermarkets #42,Invoice,008-06092,Arroz Envasado:Largo Fino 1kg (Long grain rice) Dos Hermanos,,1.0,17.5,17.5,4550889.12,Branded Rice,Keila Alfaro-Visvikis,RETAIL SEDANOS,1389928,Jul
2025-07-24,Sedanos Supermarkets #42,Invoice,008-06092,Arroz Envasado:Long Rice 10 LB Dos Hermanos,,2.0,35.5,71.0,4550960.12,Branded Rice,Keila Alfaro-Visvikis,RETAIL SEDANOS,1389929,Jul
2025-07-24,El Palacio de los jugos / Caribe Tropical,Invoice,008-06093,Arroz a Granel:Parboiled 50 LB -Bolsa Dos Hermanos.,,8.0,26.75,214.0,4551174.12,Bulk Rice,Lisset Limpio -020,Cafeteria,1389930,Jul
2025-07-24,Sedanos Supermarkets  #37,Invoice,008-06094,Arroz a Granel:Largo Fino 50 LB -Bolsa Dos Hermanos.,,6.0,27.85,167.1,4551341.22,Bulk Rice,Keila Alfaro-Visvikis,RETAIL SEDANOS,1389931,Jul
2025-07-24,Sedanos Supermarkets  #37,Invoice,008-06094,Arroz a Granel:Parboiled 50 LB -Bolsa Dos Hermanos.,,6.0,28.25,169.5,4551510.72,Bulk Rice,Keila Alfaro-Visvikis,RETAIL SEDANOS,1389932,Jul
2025-07-24,El Palacio de los jugos / Lita Foods Inc.,Invoice,008-06095,Dry Beans:Dry Beans - Black Beans 50,Dry Black Beans 50 lb,1.0,34.0,34.0,4551544.72,Dry Beans,Lisset Limpio -020,Cafeteria,1389933,Jul
2025-07-24,El Palacio de los jugos / Lita Foods Inc.,Invoice,008-06095,Arroz a Granel:Parboiled 50 LB -Bolsa Dos Hermanos.,,12.0,26.75,321.0,4551865.72,Bulk Rice,Lisset Limpio -020,Cafeteria,1389934,Jul
2025-07-24,El Palacio de los jugos / Divan and Denise Food,Invoice,008-06096,Dry Beans:Dry Beans - Black Beans 50,Dry Black Beans 50 lb,2.0,34.0,68.0,4551933.72,Dry Beans,Lisset Limpio -020,Cafeteria,1389935,Jul
2025-07-24,El Palacio de los jugos / Divan and Denise Food,Invoice,008-06096,Arroz a Granel:Parboiled 50 LB -Bolsa Dos Hermanos.,,5.0,26.75,133.75,4552067.47,Bulk Rice,Lisset Limpio -020,Cafeteria,1389936,Jul
2025-07-24,El Palacio de los jugos / Rodriguez Foods,Invoice,008-06097,Arroz a Granel:Parboiled 50 LB -Bolsa Dos Hermanos.,,8.0,26.75,214.0,4552281.47,Bulk Rice,Lisset Limpio -020,Cafeteria,1389937,Jul
2025-07-24,El Palacio de los jugos / J Mena Corp.,Invoice,008-06098,Liquids:AS Marinating Sauce (Mojo),4 / 1 Gl,3.0,17.0,51.0,4552332.47,American Spice,Lisset Limpio -020,Cafeteria,1389938,Jul
2025-07-24,El Palacio de los jugos / J Mena Corp.,Invoice,008-06098,Arroz a Granel:Parboiled 50 LB -Bolsa Dos Hermanos.,,10.0,26.75,267.5,4552599.97,Bulk Rice,Lisset Limpio -020,Cafeteria,1389939,Jul
2025-07-24,Sedanos Supermarkets #32,Invoice,008-06099,Arroz a Granel:Largo Fino 50 LB -Bolsa Dos Hermanos.,,4.0,27.85,111.4,4552711.37,Bulk Rice,Keila Alfaro-Visvikis,RETAIL SEDANOS,1389940,Jul
2025-07-24,Sedanos Supermarkets #32,Invoice,008-06099,Arroz a Granel:Parboiled 50 LB -Bolsa Dos Hermanos.,,4.0,28.25,113.0,4552824.37,Bulk Rice,Keila Alfaro-Visvikis,RETAIL SEDANOS,1389941,Jul
2025-07-24,"Meat Club Market, LLC.",Invoice,008-06100,Arroz Envasado:Sushi Rice Dos Hermanos.,.,6.0,25.5,153.0,4552977.37,Branded Rice,Lisset Limpio -020,RETAIL  DSD,1389942,Jul
2025-07-24,Key Foods 40 St,Invoice,008-06101,Arroz Envasado:Parboiled 5KG Dos Hermanos.,6  11lbs,15.0,46.5,697.5,4553674.87,Branded Rice,Keila Alfaro-Visvikis,RETAIL  DSD,1389943,Jul
2025-07-24,Key Foods 40 St,Invoice,008-06101,Arroz Envasado:Long Rice 10 LB Dos Hermanos,,15.0,35.5,532.5,4554207.37,Branded Rice,Keila Alfaro-Visvikis,RETAIL  DSD,1389944,Jul
2025-07-24,Key Foods 40 St,Invoice,008-06101,Arroz Envasado:Parboiled 5KG Dos Hermanos.,6  11lbs,7.0,46.5,325.5,4554532.87,Branded Rice,Keila Alfaro-Visvikis,RETAIL  DSD,1389945,Jul
2025-07-24,Key Foods 40 St,Invoice,008-06101,Arroz Envasado:Long Rice 10 LB Dos Hermanos,,3.0,35.5,106.5,4554639.37,Branded Rice,Keila Alfaro-Visvikis,RETAIL  DSD,1389946,Jul
2025-07-24,Soriano Brothers PB,Credit Memo,008-06102,Varios:Promotional Allowance,Arroz a Granel:Parboiled 50 LB -Bolsa Dos Hermanos.,-1.0,27.75,-27.75,4554611.62,Branded Rice,Lisset Limpio -020,CAFETERIA y RESTAURANTS,1389947,Jul
2025-07-24,Key Foods 40 St,Credit Memo,008-06103,Varios:Promotional Allowance,Arroz Envasado:Parboiled 5KG Dos Hermanos.,-7.0,46.5,-325.5,4554286.12,Branded Rice,Keila Alfaro-Visvikis,RETAIL  DSD,1389948,Jul
2025-07-24,Key Foods 40 St,Credit Memo,008-06103,Varios:Promotional Allowance,Arroz Envasado:Long Rice 10 LB Dos Hermanos,-3.0,35.5,-106.5,4554179.62,Branded Rice,Keila Alfaro-Visvikis,RETAIL  DSD,1389949,Jul
2025-07-24,Sedanos Supermarkets #42,Credit Memo,008-06104,Varios:Promotional Allowance,Arroz Envasado:Largo Fino 1kg (Long grain rice) Dos Hermanos,-1.0,19.9,-19.9,4554159.72,Branded Rice,Keila Alfaro-Visvikis,RETAIL SEDANOS,1389950,Jul
2025-07-24,Sedanos Supermarkets #42,Credit Memo,008-06104,Varios:Promotional Allowance,Arroz Envasado:Long Rice 10 LB Dos Hermanos,-2.0,35.5,-71.0,4554088.72,Branded Rice,Keila Alfaro-Visvikis,RETAIL SEDANOS,1389951,Jul
2025-07-24,Sedanos Supermarkets #42,Credit Memo,008-06168,Varios:Promotional Allowance,Arroz Envasado:Largo Fino 1kg (Long grain rice) Dos Hermanos,-1.0,17.5,-17.5,4554071.22,Branded Rice,Keila Alfaro-Visvikis,RETAIL SEDANOS,1389952,Jul
2025-07-24,Sedanos Supermarkets #42,Credit Memo,008-06168,Varios:Promotional Allowance,Arroz Envasado:Long Rice 10 LB Dos Hermanos,-2.0,35.5,-71.0,4554000.22,Branded Rice,Keila Alfaro-Visvikis,RETAIL SEDANOS,1389953,Jul
2025-07-24,Soriano Brothers PB,Credit Memo,008-06169,Varios:Promotional Allowance,Arroz a Granel:Parboiled 50 LB -Bolsa Dos Hermanos.,0.0,,0.0,4554000.22,Branded Rice,Lisset Limpio -020,CAFETERIA y RESTAURANTS,1389954,Jul
2025-07-25,Sedanos Supermarkets #24,Credit Memo,008-06105,Varios:Promotional Allowance,Rice Snack:Rice Snack Ham Flavored DOS HERMANOS,-1.0,19.9,-19.9,4553980.32,Puffed Products,Keila Alfaro-Visvikis,RETAIL SEDANOS,1389955,Jul
2025-07-27,El Palacio de los Jugos / Bird Road Restaurant,Invoice,008-06106,Arroz a Granel:Parboiled 50 LB -Bolsa Dos Hermanos.,,10.0,26.75,267.5,4554247.82,Bulk Rice,Lisset Limpio -020,Cafeteria,1389956,Jul
2025-07-27,El Palacio de los jugos / Rodriguez Foods,Invoice,008-06107,Arroz a Granel:Parboiled 50 LB -Bolsa Dos Hermanos.,,6.0,26.75,160.5,4554408.32,Bulk Rice,Lisset Limpio -020,Cafeteria,1389957,Jul
2025-07-27,Bravo   Francisco Diaz,Invoice,008-06108,Liquids:AS Cooking Wine,4 1 Gl.,1.0,17.5,17.5,4554425.82,American Spice,Lisset Limpio -020,RETAIL  DSD,1389958,Jul
2025-07-27,Bravo   Francisco Diaz,Invoice,008-06108,Liquids:AS Marinating Sauce (Mojo),4 / 1 Gl,2.0,18.5,37.0,4554462.82,American Spice,Lisset Limpio -020,RETAIL  DSD,1389959,Jul
2025-07-27,Bravo   Francisco Diaz,Invoice,008-06108,Arroz a Granel:Largo Fino 50 LB -Bolsa Dos Hermanos.,,5.0,27.85,139.25,4554602.07,Bulk Rice,Lisset Limpio -020,RETAIL  DSD,1389960,Jul
2025-07-27,El Palacio de los jugos /  Nanos Latin Foods,Invoice,008-06109,Arroz a Granel:Largo Fino 50 LB -Bolsa Dos Hermanos.,,4.0,27.85,111.4,4554713.47,Bulk Rice,Lisset Limpio -020,Cafeteria,1389961,Jul
2025-07-27,El Palacio de los jugos /  Nanos Latin Foods,Invoice,008-06109,Arroz a Granel:Parboiled 50 LB -Bolsa Dos Hermanos.,,6.0,26.75,160.5,4554873.97,Bulk Rice,Lisset Limpio -020,Cafeteria,1389962,Jul
2025-07-27,El Palacio de los jugos /  Nanos Latin Foods,Invoice,008-06109,Dry Beans:Dry Beans - Black Beans 50,Dry Black Beans 50 lb,1.0,34.0,34.0,4554907.97,Dry Beans,Lisset Limpio -020,Cafeteria,1389963,Jul
2025-07-27,El Palacio de los jugos / Delicias Criollas (DIAGO FOOD_MILLER),Invoice,008-06110,Arroz a Granel:Parboiled 50 LB -Bolsa Dos Hermanos.,,12.0,26.75,321.0,4555228.97,Bulk Rice,Lisset Limpio -020,Cafeteria,1389964,Jul
2025-07-27,Fritanga Momotombo,Invoice,008-06111,Spices:AS Chicken Base,1 / 30 lb. (box or pail),2.0,39.0,78.0,4555306.97,American Spice,Lisset Limpio -020,CAFETERIA y RESTAURANTS,1389965,Jul
2025-07-27,Fritanga Momotombo,Invoice,008-06111,Arroz a Granel:Largo Fino 50 LB -Bolsa Dos Hermanos.,,5.0,27.85,139.25,4555446.22,Bulk Rice,Lisset Limpio -020,CAFETERIA y RESTAURANTS,1389966,Jul
2025-07-27,Be Your Will LLC,Invoice,008-06112,Liquids:AS Cooking Wine,4 1 Gl.,2.0,17.5,35.0,4555481.22,American Spice,Lisset Limpio -020,CAFETERIA y RESTAURANTS,1389967,Jul
2025-07-27,Be Your Will LLC,Invoice,008-06112,Arroz a Granel:Largo Fino 50 LB -Bolsa Dos Hermanos.,,7.0,27.85,194.95,4555676.17,Bulk Rice,Lisset Limpio -020,CAFETERIA y RESTAURANTS,1389968,Jul
2025-07-27,Be Your Will LLC,Invoice,008-06112,Arroz a Granel:Parboiled 50 LB -Bolsa Dos Hermanos.,,11.0,27.75,305.25,4555981.42,Bulk Rice,Lisset Limpio -020,CAFETERIA y RESTAURANTS,1389969,Jul
2025-07-27,Be Your Will LLC,Invoice,008-06112,Arroz a Granel:Parboiled 50 LB -Bolsa Dos Hermanos.,,1.0,27.75,27.75,4556009.17,Bulk Rice,Lisset Limpio -020,CAFETERIA y RESTAURANTS,1389970,Jul
2025-07-27,El Palacio de los jugos / Caribe Tropical,Invoice,008-06113,Arroz a Granel:Parboiled 50 LB -Bolsa Dos Hermanos.,,8.0,26.75,214.0,4556223.17,Bulk Rice,Lisset Limpio -020,Cafeteria,1389971,Jul
2025-07-27,El Palacio de los jugos / Caribe Tropical,Invoice,008-06113,Dry Beans:Dry Beans - Black Beans 50,Dry Black Beans 50 lb,2.0,34.0,68.0,4556291.17,Dry Beans,Lisset Limpio -020,Cafeteria,1389972,Jul
2025-07-27,El Palacio de los jugos / Divan and Denise Food,Invoice,008-06114,Dry Beans:Dry Beans - Black Beans 50,Dry Black Beans 50 lb,2.0,34.0,68.0,4556359.17,Dry Beans,Lisset Limpio -020,Cafeteria,1389973,Jul
2025-07-27,El Palacio de los jugos / Divan and Denise Food,Invoice,008-06114,Arroz a Granel:Parboiled 50 LB -Bolsa Dos Hermanos.,,5.0,26.75,133.75,4556492.92,Bulk Rice,Lisset Limpio -020,Cafeteria,1389974,Jul
2025-07-27,JMN Dely Corp,Invoice,008-06115,Dry Beans:Dry Beans - Black Beans 50,Dry Black Beans 50 lb,1.0,45.7,45.7,4556538.62,Dry Beans,Keila Alfaro-Visvikis,CAFETERIA y RESTAURANTS,1389975,Jul
2025-07-27,JMN Dely Corp,Invoice,008-06115,Arroz a Granel:Parboiled 50 LB -Bolsa Dos Hermanos.,,2.0,28.75,57.5,4556596.12,Bulk Rice,Keila Alfaro-Visvikis,CAFETERIA y RESTAURANTS,1389976,Jul
2025-07-27,Aries Supermarket & Cafeteria,Invoice,008-06116,Liquids:AS Bitter Orange,4 / 1 gl.,2.0,14.0,28.0,4556624.12,American Spice,Keila Alfaro-Visvikis,CAFETERIA y RESTAURANTS,1389977,Jul
2025-07-27,Aries Supermarket & Cafeteria,Invoice,008-06116,Liquids:AS Cooking Wine,4 1 Gl.,2.0,17.5,35.0,4556659.12,American Spice,Keila Alfaro-Visvikis,CAFETERIA y RESTAURANTS,1389978,Jul
2025-07-27,Aries Supermarket & Cafeteria,Invoice,008-06116,Spices:AS Oregano Ground,4 / 3.5 Lbs.,1.0,38.5,38.5,4556697.62,American Spice,Keila Alfaro-Visvikis,CAFETERIA y RESTAURANTS,1389979,Jul
2025-07-27,Aries Supermarket & Cafeteria,Invoice,008-06116,Arroz a Granel:Parboiled 50 LB -Bolsa Dos Hermanos.,,10.0,28.25,282.5,4556980.12,Bulk Rice,Keila Alfaro-Visvikis,CAFETERIA y RESTAURANTS,1389980,Jul
2025-07-27,Sedanos Supermarkets #42,Invoice,008-06117,Arroz a Granel:Parboiled 50 LB -Bolsa Dos Hermanos.,,5.0,28.25,141.25,4557121.37,Bulk Rice,Keila Alfaro-Visvikis,RETAIL SEDANOS,1389981,Jul
2025-07-27,Be Your Will LLC,Credit Memo,008-06118,Varios:Promotional Allowance,Arroz a Granel:Parboiled 50 LB -Bolsa Dos Hermanos.,-1.0,27.75,-27.75,4557093.62,Bulk Rice,Lisset Limpio -020,CAFETERIA y RESTAURANTS,1389982,Jul
2025-07-28,Sedanos Supermarkets #9,Credit Memo,008-06119,Varios:Promotional Allowance,Arroz Envasado:Largo Fino 1kg (Long grain rice) Dos Hermanos,-1.0,17.8,-17.8,4557075.82,Branded Rice,Keila Alfaro-Visvikis,RETAIL SEDANOS,1389983,Jul
2025-07-28,Sedanos Supermarkets #9,Credit Memo,008-06119,Varios:Promotional Allowance,Arroz Envasado:Parboiled 1kg Bolsa Dos Hermanos.,-1.0,19.9,-19.9,4557055.92,Branded Rice,Keila Alfaro-Visvikis,RETAIL SEDANOS,1389984,Jul
2025-07-28,Los Mejores Tamales de Miami,Invoice,008-06120,Arroz a Granel:Parboiled 50 LB -Bolsa Dos Hermanos.,,5.0,28.25,141.25,4557197.17,Bulk Rice,Lisset Limpio -020,CAFETERIA y RESTAURANTS,1389985,Jul
2025-07-28,Chavez Distributors Inc.,Invoice,008-06121,Arroz a Granel:Parboiled 50 LB -Bolsa Dos Hermanos.,,55.0,27.75,1526.25,4558723.42,Bulk Rice,Keila Alfaro-Visvikis,WHOLESALER,1389986,Jul
2025-07-28,Soriano Brothers PB,Invoice,008-06122,Arroz a Granel:Largo Fino 50 LB -Bolsa Dos Hermanos.,,5.0,27.85,139.25,4558862.67,Bulk Rice,Lisset Limpio -020,CAFETERIA y RESTAURANTS,1389987,Jul
2025-07-29,Sedanos Supermarkets #24,Credit Memo,008-06123,Varios:Producto vencido/deteriorado (no impacta en inventario),6 unidades de Ham rice snacks a $1.90,-10.0,1.9,-19.0,4558843.67,Puffed Products,Keila Alfaro-Visvikis,RETAIL SEDANOS,1389988,Jul
2025-07-31,El Palacio de los jugos / Leti Corp.,Invoice,008-06124,Arroz a Granel:Largo Fino 50 LB -Bolsa Dos Hermanos.,,6.0,27.85,167.1,4559010.77,Bulk Rice,Lisset Limpio -020,Cafeteria,1389989,Jul
2025-07-31,Festival Supermarket #35- Southgate,Invoice,008-06125,Arroz Envasado:Parboiled 5KG Dos Hermanos.,6  11lbs,15.0,46.5,697.5,4559708.27,Branded Rice,Keila Alfaro-Visvikis,RETAIL  DSD,1389990,Jul
2025-07-31,Festival Supermarket #35- Southgate,Invoice,008-06125,Arroz Envasado:Parboiled 5KG Dos Hermanos.,6  11lbs,8.0,46.5,372.0,4560080.27,Branded Rice,Keila Alfaro-Visvikis,RETAIL  DSD,1389991,Jul
2025-07-31,El Palacio de los jugos /  Nanos Latin Foods,Invoice,008-06126,Arroz a Granel:Largo Fino 50 LB -Bolsa Dos Hermanos.,,5.0,27.85,139.25,4560219.52,Bulk Rice,Lisset Limpio -020,Cafeteria,1389992,Jul
2025-07-31,El Palacio de los jugos /  Nanos Latin Foods,Invoice,008-06126,Arroz a Granel:Parboiled 50 LB -Bolsa Dos Hermanos.,,10.0,26.75,267.5,4560487.02,Bulk Rice,Lisset Limpio -020,Cafeteria,1389993,Jul
2025-07-31,Sedanos Supermarkets #43,Invoice,008-06127,Arroz a Granel:Parboiled 50 LB -Bolsa Dos Hermanos.,,5.0,28.25,141.25,4560628.27,Bulk Rice,Keila Alfaro-Visvikis,RETAIL SEDANOS,1389994,Jul
2025-07-31,Sedanos Supermarkets #24,Invoice,008-06128,Arroz a Granel:Parboiled 50 LB -Bolsa Dos Hermanos.,,10.0,28.25,282.5,4560910.77,Bulk Rice,Keila Alfaro-Visvikis,RETAIL SEDANOS,1389995,Jul
2025-07-31,Sedanos Supermarkets #24,Invoice,008-06128,Arroz a Granel:Parboiled 50 LB -Bolsa Dos Hermanos.,,1.0,28.25,28.25,4560939.02,Bulk Rice,Keila Alfaro-Visvikis,RETAIL SEDANOS,1389996,Jul
2025-07-31,Key Food / Holywood,Invoice,008-06129,Arroz Envasado:Long Rice 10 LB Dos Hermanos,,5.0,35.5,177.5,4561116.52,Branded Rice,Keila Alfaro-Visvikis,RETAIL  DSD,1389997,Jul
2025-07-31,Key Food / Holywood,Invoice,008-06129,Arroz Envasado:Long Rice 10 LB Dos Hermanos,,1.0,35.5,35.5,4561152.02,Branded Rice,Keila Alfaro-Visvikis,RETAIL  DSD,1389998,Jul
2025-07-31,Los Caringas Latin America  Foods,Invoice,008-06130,Arroz a Granel:Largo Fino 50 LB -Bolsa Dos Hermanos.,,3.0,27.85,83.55,4561235.57,Bulk Rice,Lisset Limpio -020,CAFETERIA y RESTAURANTS,1389999,Jul
2025-07-31,Los Caringas Latin America  Foods,Invoice,008-06130,Arroz a Granel:Parboiled 50 LB -Bolsa Dos Hermanos.,,3.0,28.25,84.75,4561320.32,Bulk Rice,Lisset Limpio -020,CAFETERIA y RESTAURANTS,1390000,Jul
2025-07-31,Mei Chang,Invoice,008-06131,Arroz a Granel:Parboiled 50 LB -Bolsa Dos Hermanos.,,6.0,28.25,169.5,4561489.82,Bulk Rice,Lisset Limpio -020,CAFETERIA y RESTAURANTS,1390001,Jul
2025-07-31,Soriano Brothers PB,Invoice,008-06132,Arroz a Granel:Largo Fino 50 LB -Bolsa Dos Hermanos.,,2.0,27.85,55.7,4561545.52,Bulk Rice,Lisset Limpio -020,CAFETERIA y RESTAURANTS,1390002,Jul
2025-07-31,El Palacio de los jugos / Caribe Tropical,Invoice,008-06133,Arroz a Granel:Parboiled 50 LB -Bolsa Dos Hermanos.,,8.0,26.75,214.0,4561759.52,Bulk Rice,Lisset Limpio -020,Cafeteria,1390003,Jul
2025-07-31,El Palacio de los jugos / Divan and Denise Food,Invoice,008-06134,Arroz a Granel:Parboiled 50 LB -Bolsa Dos Hermanos.,,5.0,26.75,133.75,4561893.27,Bulk Rice,Lisset Limpio -020,Cafeteria,1390004,Jul
2025-07-31,ALS Foods,Invoice,008-06135,Liquids:AS Bitter Orange,4 / 1 gl.,1.0,14.0,14.0,4561907.27,American Spice,Lisset Limpio -020,CAFETERIA y RESTAURANTS,1390005,Jul
2025-07-31,ALS Foods,Invoice,008-06135,Arroz a Granel:Largo Fino 50 LB -Bolsa Dos Hermanos.,,6.0,27.85,167.1,4562074.37,Bulk Rice,Lisset Limpio -020,CAFETERIA y RESTAURANTS,1390006,Jul
2025-07-31,ALS Foods,Invoice,008-06135,Arroz a Granel:Parboiled 50 LB -Bolsa Dos Hermanos.,,8.0,26.75,214.0,4562288.37,Bulk Rice,Lisset Limpio -020,CAFETERIA y RESTAURANTS,1390007,Jul
2025-07-31,El Palacio de Los Jugos / Casa mía Food Restaurant inc,Invoice,008-06136,Arroz a Granel:Parboiled 50 LB -Bolsa Dos Hermanos.,,12.0,26.75,321.0,4562609.37,Bulk Rice,Lisset Limpio -020,Cafeteria,1390008,Jul
2025-07-31,El Palacio de Los Jugos / Casa mía Food Restaurant inc,Invoice,008-06136,Spices:AS Sazon (for all),1 / 30 lb (box or pail),1.0,51.0,51.0,4562660.37,American Spice,Lisset Limpio -020,Cafeteria,1390009,Jul
2025-07-31,El Palacio de los jugos / Lita Foods Inc.,Invoice,008-06137,Dry Beans:Dry Beans - Black Beans 50,Dry Black Beans 50 lb,1.0,34.0,34.0,4562694.37,Dry Beans,Lisset Limpio -020,Cafeteria,1390010,Jul
2025-07-31,El Palacio de los jugos / Lita Foods Inc.,Invoice,008-06137,Arroz a Granel:Parboiled 50 LB -Bolsa Dos Hermanos.,,12.0,26.75,321.0,4563015.37,Bulk Rice,Lisset Limpio -020,Cafeteria,1390011,Jul
2025-07-31,Sedanos Supermarkets #38,Invoice,008-06138,Arroz Envasado:Long Rice 10 LB Dos Hermanos,,15.0,35.5,532.5,4563547.87,Branded Rice,Keila Alfaro-Visvikis,RETAIL SEDANOS,1390012,Jul
2025-07-31,Sedanos Supermarkets #38,Invoice,008-06138,Arroz Envasado:Long Rice 10 LB Dos Hermanos,,3.0,35.5,106.5,4563654.37,Branded Rice,Keila Alfaro-Visvikis,RETAIL SEDANOS,1390013,Jul
2025-07-31,Sedanos Supermarkets #32,Invoice,008-06139,Arroz a Granel:Largo Fino 50 LB -Bolsa Dos Hermanos.,,4.0,27.85,111.4,4563765.77,Bulk Rice,Keila Alfaro-Visvikis,RETAIL SEDANOS,1390014,Jul
2025-07-31,Sedanos Supermarkets #32,Invoice,008-06139,Arroz a Granel:Parboiled 50 LB -Bolsa Dos Hermanos.,,5.0,28.25,141.25,4563907.02,Bulk Rice,Keila Alfaro-Visvikis,RETAIL SEDANOS,1390015,Jul
2025-07-31,Sedanos Supermarkets #18,Invoice,008-06140,Arroz a Granel:Parboiled 50 LB -Bolsa Dos Hermanos.,,12.0,28.25,339.0,4564246.02,Bulk Rice,Keila Alfaro-Visvikis,RETAIL SEDANOS,1390016,Jul
2025-07-31,El Gallego Supermarket,Invoice,008-06141,Arroz a Granel:Parboiled 50 LB -Bolsa Dos Hermanos.,,5.0,27.75,138.75,4564384.77,Bulk Rice,Lisset Limpio -020,RETAIL  DSD,1390017,Jul
2025-07-31,El Gallego Supermarket,Invoice,008-06141,Dry Beans:Dry Beans - Black Beans 50,Dry Black Beans 50 lb,2.0,35.0,70.0,4564454.77,Dry Beans,Lisset Limpio -020,RETAIL  DSD,1390018,Jul
2025-07-31,El Gallego Supermarket,Invoice,008-06141,Liquids:AS Bitter Orange,4 / 1 gl.,2.0,14.0,28.0,4564482.77,American Spice,Lisset Limpio -020,RETAIL  DSD,1390019,Jul
2025-07-31,El Gallego Supermarket,Invoice,008-06141,Liquids:AS Marinating Sauce (Mojo),4 / 1 Gl,2.0,18.5,37.0,4564519.77,American Spice,Lisset Limpio -020,RETAIL  DSD,1390020,Jul
2025-07-31,El Palacio de los jugos / J Mena Corp.,Invoice,008-06142,Liquids:AS Marinating Sauce (Mojo),4 / 1 Gl,3.0,17.5,52.5,4564572.27,American Spice,Lisset Limpio -020,Cafeteria,1390021,Jul
2025-07-31,El Palacio de los jugos / J Mena Corp.,Invoice,008-06142,Arroz a Granel:Parboiled 50 LB -Bolsa Dos Hermanos.,,10.0,26.75,267.5,4564839.77,Bulk Rice,Lisset Limpio -020,Cafeteria,1390022,Jul
2025-07-31,Sedanos Supermarkets #31,Invoice,008-06143,Arroz a Granel:Parboiled 50 LB -Bolsa Dos Hermanos.,,6.0,28.25,169.5,4565009.27,Bulk Rice,Keila Alfaro-Visvikis,RETAIL SEDANOS,1390023,Jul
2025-07-31,"El Toro Loco Meat Distribution, LLC",Invoice,008-06144,Liquids:AS Lemon Juice 4/1 Gl,,1.0,14.95,14.95,4565024.22,American Spice,Lisset Limpio -020,CAFETERIA y RESTAURANTS,1390024,Jul
2025-07-31,"El Toro Loco Meat Distribution, LLC",Invoice,008-06144,Dry Beans:Dry Beans - Black Beans 50,Dry Black Beans 50 lb,55.0,36.0,1980.0,4567004.22,American Spice,Lisset Limpio -020,CAFETERIA y RESTAURANTS,1390025,Jul
2025-07-31,"El Toro Loco Meat Distribution, LLC",Invoice,008-06144,Liquids:AS Bitter Orange,4 / 1 gl.,1.0,14.0,14.0,4567018.22,American Spice,Lisset Limpio -020,CAFETERIA y RESTAURANTS,1390026,Jul
2025-07-31,Bravo   Francisco Diaz,Invoice,008-06145,Liquids:AS Marinating Sauce (Mojo),4 / 1 Gl,3.0,18.5,55.5,4567073.72,American Spice,Lisset Limpio -020,RETAIL  DSD,1390027,Jul
2025-07-31,Bravo   Francisco Diaz,Invoice,008-06145,Arroz a Granel:Largo Fino 50 LB -Bolsa Dos Hermanos.,,5.0,27.85,139.25,4567212.97,Bulk Rice,Lisset Limpio -020,RETAIL  DSD,1390028,Jul
2025-07-31,Soriano Brothers PB,Credit Memo,008-06146,Varios:Producto vencido/deteriorado (no impacta en inventario),Largo fino 50lb,-9.0,27.85,-250.65,4566962.32,Bulk Rice,Lisset Limpio -020,CAFETERIA y RESTAURANTS,1390029,Jul
2025-07-31,Soriano Brothers PB,Invoice,008-06147,Spices:AS Chicken Base,1 / 30 lb. (box or pail),2.0,39.0,78.0,4567040.32,American Spice,Lisset Limpio -020,CAFETERIA y RESTAURANTS,1390030,Jul
2025-07-31,Soriano Brothers PB,Invoice,008-06147,Spices:AS Sazon (for all),1 / 30 lb (box or pail),3.0,51.0,153.0,4567193.32,American Spice,Lisset Limpio -020,CAFETERIA y RESTAURANTS,1390031,Jul
2025-07-31,Soriano Brothers PB,Invoice,008-06147,Arroz a Granel:Largo Fino 50 LB -Bolsa Dos Hermanos.,,10.0,27.85,278.5,4567471.82,Bulk Rice,Lisset Limpio -020,CAFETERIA y RESTAURANTS,1390032,Jul
2025-07-31,Soriano Brothers PB,Invoice,008-06147,Arroz a Granel:Parboiled 50 LB -Bolsa Dos Hermanos.,,11.0,27.75,305.25,4567777.07,Bulk Rice,Lisset Limpio -020,CAFETERIA y RESTAURANTS,1390033,Jul
2025-07-31,Soriano Brothers PB,Invoice,008-06147,Dry Beans:Dry Beans - Black Beans 50,Dry Black Beans 50 lb,4.0,32.5,130.0,4567907.07,Dry Beans,Lisset Limpio -020,CAFETERIA y RESTAURANTS,1390034,Jul
2025-07-31,Soriano Brothers PB,Invoice,008-06147,Arroz a Granel:Parboiled 50 LB -Bolsa Dos Hermanos.,,1.0,27.85,27.85,4567934.92,Bulk Rice,Lisset Limpio -020,CAFETERIA y RESTAURANTS,1390035,Jul
2025-07-31,Sedanos Supermarkets #33,Invoice,008-06148,Arroz a Granel:Parboiled 50 LB -Bolsa Dos Hermanos.,,3.0,28.25,84.75,4568019.67,Bulk Rice,Keila Alfaro-Visvikis,RETAIL SEDANOS,1390036,Jul
2025-07-31,Festival Supermarket #35- Southgate,Credit Memo,008-06149,Varios:Promotional Allowance,Arroz Envasado:Parboiled 5KG Dos Hermanos.,-8.0,46.5,-372.0,4567647.67,Branded Rice,Keila Alfaro-Visvikis,RETAIL  DSD,1390037,Jul
2025-07-31,Key Food / Holywood,Credit Memo,008-06150,Varios:Promotional Allowance,Arroz Envasado:Long Rice 10 LB Dos Hermanos,-1.0,35.5,-35.5,4567612.17,Branded Rice,Keila Alfaro-Visvikis,RETAIL  DSD,1390038,Jul
2025-07-31,Sedanos Supermarkets #24,Credit Memo,008-06151,Varios:Promotional Allowance,Arroz a Granel:Parboiled 50 LB -Bolsa Dos Hermanos.,-1.0,28.25,-28.25,4567583.92,Bulk Rice,Keila Alfaro-Visvikis,RETAIL SEDANOS,1390039,Jul
2025-07-31,Sedanos Supermarkets #38,Credit Memo,008-06152,Varios:Promotional Allowance,Arroz Envasado:Long Rice 10 LB Dos Hermanos,-3.0,35.5,-106.5,4567477.42,Branded Rice,Keila Alfaro-Visvikis,RETAIL SEDANOS,1390040,Jul
2025-07-31,Soriano Brothers PB,Credit Memo,008-06153,Varios:Promotional Allowance,Arroz a Granel:Parboiled 50 LB -Bolsa Dos Hermanos.,-1.0,27.75,-27.75,4567449.67,Bulk Rice,Lisset Limpio -020,CAFETERIA y RESTAURANTS,1390041,Jul
2025-08-01,El Palacio de los jugos / Rodriguez Foods,Invoice,008-06154,Arroz a Granel:Parboiled 50 LB -Bolsa Dos Hermanos.,,6.0,26.75,160.5,4567610.17,Bulk Rice,Lisset Limpio -020,Cafeteria,1390042,Aug
2025-08-03,El Palacio de los jugos / Rodriguez Foods,Invoice,008-06155,Arroz a Granel:Parboiled 50 LB -Bolsa Dos Hermanos.,,7.0,26.75,187.25,4567797.42,Bulk Rice,Lisset Limpio -020,Cafeteria,1390043,Aug
2025-08-03,El Palacio de los jugos /  Nanos Latin Foods,Invoice,008-06156,Dry Beans:Dry Beans - Black Beans 50,Dry Black Beans 50 lb,1.0,34.0,34.0,4567831.42,Dry Beans,Lisset Limpio -020,Cafeteria,1390044,Aug
2025-08-03,El Palacio de los jugos /  Nanos Latin Foods,Invoice,008-06156,Arroz a Granel:Largo Fino 50 LB -Bolsa Dos Hermanos.,,3.0,27.85,83.55,4567914.97,Bulk Rice,Lisset Limpio -020,Cafeteria,1390045,Aug
2025-08-03,El Palacio de los jugos /  Nanos Latin Foods,Invoice,008-06156,Arroz a Granel:Parboiled 50 LB -Bolsa Dos Hermanos.,,8.0,26.75,214.0,4568128.97,Bulk Rice,Lisset Limpio -020,Cafeteria,1390046,Aug
2025-08-03,El Palacio de los jugos / Divan and Denise Food,Invoice,008-06157,Dry Beans:Dry Beans - Black Beans 50,Dry Black Beans 50 lb,1.0,34.0,34.0,4568162.97,Dry Beans,Lisset Limpio -020,Cafeteria,1390047,Aug
2025-08-03,El Palacio de los jugos / Divan and Denise Food,Invoice,008-06157,Arroz a Granel:Parboiled 50 LB -Bolsa Dos Hermanos.,,5.0,26.75,133.75,4568296.72,Bulk Rice,Lisset Limpio -020,Cafeteria,1390048,Aug
2025-08-03,El Palacio de los Jugos / Bird Road Restaurant,Invoice,008-06158,Arroz a Granel:Parboiled 50 LB -Bolsa Dos Hermanos.,,10.0,26.75,267.5,4568564.22,Bulk Rice,Lisset Limpio -020,Cafeteria,1390049,Aug
2025-08-03,El Palacio de los jugos / Caribe Tropical,Invoice,008-06159,Dry Beans:Dry Beans - Black Beans 50,Dry Black Beans 50 lb,2.0,34.0,68.0,4568632.22,Dry Beans,Lisset Limpio -020,Cafeteria,1390050,Aug
2025-08-03,El Palacio de los jugos / Caribe Tropical,Invoice,008-06159,Arroz a Granel:Parboiled 50 LB -Bolsa Dos Hermanos.,,6.0,26.75,160.5,4568792.72,Bulk Rice,Lisset Limpio -020,Cafeteria,1390051,Aug
2025-08-03,El Palacio de los jugos / Delicias Criollas (DIAGO FOOD_MILLER),Invoice,008-06160,Arroz a Granel:Largo Fino 50 LB -Bolsa Dos Hermanos.,,6.0,27.85,167.1,4568959.82,Bulk Rice,Lisset Limpio -020,Cafeteria,1390052,Aug
2025-08-03,El Palacio de los jugos / Delicias Criollas (DIAGO FOOD_MILLER),Invoice,008-06160,Arroz a Granel:Parboiled 50 LB -Bolsa Dos Hermanos.,,12.0,26.75,321.0,4569280.82,Bulk Rice,Lisset Limpio -020,Cafeteria,1390053,Aug
2025-08-03,El Palacio de Los Jugos / Casa mía Food Restaurant inc,Invoice,008-06161,Spices:AS Chicken Base,1 / 30 lb. (box or pail),2.0,39.0,78.0,4569358.82,American Spice,Lisset Limpio -020,Cafeteria,1390054,Aug
2025-08-03,El Palacio de Los Jugos / Casa mía Food Restaurant inc,Invoice,008-06161,Arroz a Granel:Parboiled 50 LB -Bolsa Dos Hermanos.,,8.0,26.75,214.0,4569572.82,Bulk Rice,Lisset Limpio -020,Cafeteria,1390055,Aug
2025-08-03,JMN Dely Corp,Invoice,008-06162,Arroz a Granel:Largo Fino 50 LB -Bolsa Dos Hermanos.,,2.0,27.85,55.7,4569628.52,Bulk Rice,Keila Alfaro-Visvikis,CAFETERIA y RESTAURANTS,1390056,Aug
2025-08-03,JMN Dely Corp,Invoice,008-06162,Arroz a Granel:Parboiled 50 LB -Bolsa Dos Hermanos.,,2.0,28.75,57.5,4569686.02,Bulk Rice,Keila Alfaro-Visvikis,CAFETERIA y RESTAURANTS,1390057,Aug
2025-08-03,JMN Dely Corp,Invoice,008-06162,Dry Beans:Dry Beans - Black Beans 50,Dry Black Beans 50 lb,1.0,45.7,45.7,4569731.72,Dry Beans,Keila Alfaro-Visvikis,CAFETERIA y RESTAURANTS,1390058,Aug
2025-08-03,Sedanos Supermarkets #14,Invoice,008-06163,Arroz Envasado:Largo Fino 1kg (Long grain rice) Dos Hermanos,,1.0,17.5,17.5,4569749.22,Branded Rice,Keila Alfaro-Visvikis,RETAIL SEDANOS,1390059,Aug
2025-08-03,Sedanos Supermarkets #14,Invoice,008-06163,Arroz Envasado:Parboiled 1kg Bolsa Dos Hermanos.,.,1.0,19.9,19.9,4569769.12,Bulk Rice,Keila Alfaro-Visvikis,RETAIL SEDANOS,1390060,Aug
2025-08-03,Sedanos Supermarkets #14,Invoice,008-06163,Arroz Envasado:Long Rice 10 LB Dos Hermanos,,5.0,35.5,177.5,4569946.62,Branded Rice,Keila Alfaro-Visvikis,RETAIL SEDANOS,1390061,Aug
2025-08-03,Sedanos Supermarkets #14,Invoice,008-06163,Arroz Envasado:Long Rice 10 LB Dos Hermanos,,1.0,35.5,35.5,4569982.12,Branded Rice,Keila Alfaro-Visvikis,RETAIL SEDANOS,1390062,Aug
2025-08-03,Sedanos Supermarkets #14,Invoice,008-06164,Arroz a Granel:Parboiled 50 LB -Bolsa Dos Hermanos.,,2.0,28.25,56.5,4570038.62,Bulk Rice,Keila Alfaro-Visvikis,RETAIL SEDANOS,1390063,Aug
2025-08-03,Sedanos Supermarkets #42,Invoice,008-06165,Arroz a Granel:Parboiled 50 LB -Bolsa Dos Hermanos.,,5.0,28.25,141.25,4570179.87,Bulk Rice,Keila Alfaro-Visvikis,RETAIL SEDANOS,1390064,Aug
2025-08-03,Sedanos Supermarkets #14,Credit Memo,008-06167,Varios:Promotional Allowance,Arroz Envasado:Long Rice 10 LB Dos Hermanos,-1.0,35.5,-35.5,4570144.37,Branded Rice,Keila Alfaro-Visvikis,RETAIL SEDANOS,1390065,Aug
2025-08-04,Hings Chinese,Invoice,008-06166,Arroz a Granel:Parboiled 50 LB -Bolsa Dos Hermanos.,,5.0,28.25,141.25,4570285.62,Bulk Rice,Lisset Limpio -020,CAFETERIA y RESTAURANTS,1390066,Aug
2025-08-04,Soriano Brothers PB,Invoice,008-06170,Arroz a Granel:Largo Fino 50 LB -Bolsa Dos Hermanos.,214114,5.0,27.85,139.25,4570424.87,Bulk Rice,Lisset Limpio -020,CAFETERIA y RESTAURANTS,1390067,Aug
2025-08-07,Rey Chavez Distributor Corp,Invoice,008-06171,Arroz a Granel:Parboiled 50 LB -Bolsa Dos Hermanos.,,55.0,27.5,1512.5,4571937.37,Bulk Rice,Lisset Limpio -020,WHOLESALER,1390068,Aug
2025-08-07,Sedanos Supermarkets #34,Invoice,008-06172,Arroz Envasado:Parboiled 5KG Dos Hermanos.,6  11lbs,15.0,40.5,607.5,4572544.87,Branded Rice,Keila Alfaro-Visvikis,RETAIL SEDANOS,1390069,Aug
2025-08-07,Sedanos Supermarkets #34,Invoice,008-06172,Spanish Style Yellow Rice:AS Spanish Style Yellow Rice,AS Spanish Style Yellow Rice 6 / 3.25 oz,1.0,34.5,34.5,4572579.37,American Spice,Keila Alfaro-Visvikis,RETAIL SEDANOS,1390070,Aug
2025-08-07,Sedanos Supermarkets #34,Invoice,008-06172,Arroz Envasado:Parboiled 5KG Dos Hermanos.,6  11lbs,3.0,40.5,121.5,4572700.87,Branded Rice,Keila Alfaro-Visvikis,RETAIL SEDANOS,1390071,Aug
2025-08-07,Food Fair Plantation Corp,Invoice,008-06173,Arroz a Granel:Parboiled 50 LB -Bolsa Dos Hermanos.,,55.0,28.25,1553.75,4574254.62,Bulk Rice,Keila Alfaro-Visvikis,RETAIL  DSD,1390072,Aug
2025-08-07,Food Fair Plantation Corp,Invoice,008-06173,Arroz Envasado:Parboiled 1kg Bolsa Dos Hermanos.,.,1.0,19.9,19.9,4574274.52,Branded Rice,Keila Alfaro-Visvikis,RETAIL  DSD,1390073,Aug
2025-08-07,Food Fair Plantation Corp,Invoice,008-06173,Arroz Envasado:Largo Fino 1kg (Long grain rice) Dos Hermanos,,1.0,18.0,18.0,4574292.52,Branded Rice,Keila Alfaro-Visvikis,RETAIL  DSD,1390074,Aug
2025-08-07,Sedanos Supermarkets #27,Invoice,008-06174,Arroz Envasado:Long Rice 10 LB Dos Hermanos,,5.0,35.5,177.5,4574470.02,Branded Rice,Keila Alfaro-Visvikis,RETAIL SEDANOS,1390075,Aug
2025-08-07,Sedanos Supermarkets #27,Invoice,008-06174,Arroz Envasado:Parboiled 5KG Dos Hermanos.,6  11lbs,10.0,40.5,405.0,4574875.02,Branded Rice,Keila Alfaro-Visvikis,RETAIL SEDANOS,1390076,Aug
2025-08-07,Sedanos Supermarkets #27,Invoice,008-06174,Arroz Envasado:Parboiled 5KG Dos Hermanos.,6  11lbs,2.0,40.5,81.0,4574956.02,Branded Rice,Keila Alfaro-Visvikis,RETAIL SEDANOS,1390077,Aug
2025-08-07,Sedanos Supermarkets #27,Invoice,008-06174,Arroz Envasado:Long Rice 10 LB Dos Hermanos,,1.0,35.5,35.5,4574991.52,Branded Rice,Keila Alfaro-Visvikis,RETAIL SEDANOS,1390078,Aug
2025-08-07,Key Food / Holywood,Invoice,008-06175,Arroz Envasado:Long Rice 10 LB Dos Hermanos,,5.0,35.5,177.5,4575169.02,Branded Rice,Keila Alfaro-Visvikis,RETAIL  DSD,1390079,Aug
2025-08-07,Key Food / Holywood,Invoice,008-06175,Arroz Envasado:Long Rice 10 LB Dos Hermanos,,1.0,35.5,35.5,4575204.52,Branded Rice,Keila Alfaro-Visvikis,RETAIL  DSD,1390080,Aug
2025-08-07,Food Fair Plantation Corp,Credit Memo,008-06176,Varios:Producto vencido/deteriorado (no impacta en inventario),1 unit Parboiled 5k @ $5.28,-1.0,5.28,-5.28,4575199.24,Branded Rice,Keila Alfaro-Visvikis,RETAIL  DSD,1390081,Aug
2025-08-07,Food Fair Plantation Corp,Credit Memo,008-06176,Varios:Producto vencido/deteriorado (no impacta en inventario),1 bolsa 50 lb. Parboiled @ $28.25,-1.0,28.25,-28.25,4575170.99,Bulk Rice,Keila Alfaro-Visvikis,RETAIL  DSD,1390082,Aug
2025-08-07,Sedanos Supermarkets #34,Credit Memo,008-06177,Varios:Promotional Allowance,Arroz Envasado:Parboiled 5KG Dos Hermanos.,-3.0,40.5,-121.5,4575049.49,Branded Rice,Keila Alfaro-Visvikis,RETAIL SEDANOS,1390083,Aug
2025-08-07,Key Food / Holywood,Credit Memo,008-06178,Varios:Promotional Allowance,Arroz Envasado:Long Rice 10 LB Dos Hermanos,-1.0,35.5,-35.5,4575013.99,Branded Rice,Keila Alfaro-Visvikis,RETAIL  DSD,1390084,Aug
2025-08-07,Sedanos Supermarkets #27,Credit Memo,008-06179,Varios:Promotional Allowance,Arroz Envasado:Long Rice 10 LB Dos Hermanos,-1.0,35.5,-35.5,4574978.49,Branded Rice,Keila Alfaro-Visvikis,RETAIL SEDANOS,1390085,Aug
2025-08-07,Sedanos Supermarkets #27,Credit Memo,008-06179,Varios:Promotional Allowance,Arroz Envasado:Parboiled 5KG Dos Hermanos.,-2.0,40.5,-81.0,4574897.49,Branded Rice,Keila Alfaro-Visvikis,RETAIL SEDANOS,1390086,Aug
2025-08-07,"American Spice Trading Co, Inc.",Credit Memo,008-06180,Arroz a Granel:Parboiled 50 LB -Bolsa Dos Hermanos.,,-550.0,26.0,-14300.0,4560597.49,Bulk Rice,Armando Carpio - 017,WHOLESALER MANUFACTURY,1390087,Aug
2025-08-07,"American Spice Trading Co, Inc.",Invoice,008-06181,Arroz a Granel:Parboiled 50 LB -Bolsa Dos Hermanos.,,550.0,26.0,14300.0,4574897.49,Bulk Rice,Armando Carpio - 017,WHOLESALER MANUFACTURY,1390088,Aug
2025-08-08,Soriano Brothers PB,Invoice,008-06182,Spices:AS Sazon (for all),1 / 30 lb (box or pail),1.0,51.0,51.0,4574948.49,American Spice,Lisset Limpio -020,CAFETERIA y RESTAURANTS,1390089,Aug
2025-08-08,Soriano Brothers PB,Invoice,008-06182,Arroz a Granel:Largo Fino 50 LB -Bolsa Dos Hermanos.,,10.0,27.85,278.5,4575226.99,Bulk Rice,Lisset Limpio -020,CAFETERIA y RESTAURANTS,1390090,Aug
2025-08-08,Soriano Brothers PB,Invoice,008-06182,Arroz a Granel:Parboiled 50 LB -Bolsa Dos Hermanos.,,11.0,27.75,305.25,4575532.24,Bulk Rice,Lisset Limpio -020,CAFETERIA y RESTAURANTS,1390091,Aug
2025-08-08,Soriano Brothers PB,Invoice,008-06182,Dry Beans:Dry Beans - Black Beans 50,Dry Black Beans 50 lb,2.0,32.0,64.0,4575596.24,Dry Beans,Lisset Limpio -020,CAFETERIA y RESTAURANTS,1390092,Aug
2025-08-08,Soriano Brothers PB,Invoice,008-06182,Arroz a Granel:Parboiled 50 LB -Bolsa Dos Hermanos.,,1.0,27.75,27.75,4575623.99,Bulk Rice,Lisset Limpio -020,CAFETERIA y RESTAURANTS,1390093,Aug
2025-08-08,Bravo   Francisco Diaz,Invoice,008-06183,Arroz a Granel:Largo Fino 50 LB -Bolsa Dos Hermanos.,,5.0,27.85,139.25,4575763.24,Bulk Rice,Lisset Limpio -020,RETAIL  DSD,1390094,Aug
2025-08-08,El Palacio de los jugos / Leti Corp.,Invoice,008-06184,Arroz a Granel:Largo Fino 50 LB -Bolsa Dos Hermanos.,,3.0,27.85,83.55,4575846.79,Bulk Rice,Lisset Limpio -020,Cafeteria,1390095,Aug
2025-08-08,El Palacio de los jugos / Leti Corp.,Invoice,008-06184,Arroz a Granel:Parboiled 50 LB -Bolsa Dos Hermanos.,,6.0,26.75,160.5,4576007.29,Bulk Rice,Lisset Limpio -020,Cafeteria,1390096,Aug
2025-08-08,El Palacio de los jugos /  Mires Restaurants,Invoice,008-06185,Liquids:AS Marinating Sauce (Mojo),4 / 1 Gl,1.0,18.5,18.5,4576025.79,American Spice,Lisset Limpio -020,Cafeteria,1390097,Aug
2025-08-08,El Palacio de los jugos /  Mires Restaurants,Invoice,008-06185,Arroz a Granel:Parboiled 50 LB -Bolsa Dos Hermanos.,,11.0,27.75,305.25,4576331.04,Bulk Rice,Lisset Limpio -020,Cafeteria,1390098,Aug
2025-08-08,El Palacio de los jugos /  Mires Restaurants,Invoice,008-06185,Arroz a Granel:Parboiled 50 LB -Bolsa Dos Hermanos.,,1.0,27.75,27.75,4576358.79,Bulk Rice,Lisset Limpio -020,Cafeteria,1390099,Aug
2025-08-08,El Palacio de los jugos /  EMMA FOOD CORP,Invoice,008-06186,Arroz a Granel:Parboiled 50 LB -Bolsa Dos Hermanos.,,8.0,26.75,214.0,4576572.79,Bulk Rice,Lisset Limpio -020,Cafeteria,1390100,Aug
2025-08-08,El Palacio de los jugos /  Nanos Latin Foods,Invoice,008-06187,Arroz a Granel:Largo Fino 50 LB -Bolsa Dos Hermanos.,,5.0,27.85,139.25,4576712.04,Bulk Rice,Lisset Limpio -020,Cafeteria,1390101,Aug
2025-08-08,El Palacio de los jugos /  Nanos Latin Foods,Invoice,008-06187,Arroz a Granel:Parboiled 50 LB -Bolsa Dos Hermanos.,,8.0,26.75,214.0,4576926.04,Bulk Rice,Lisset Limpio -020,Cafeteria,1390102,Aug
2025-08-08,El Palacio de los jugos /  Nanos Latin Foods,Invoice,008-06187,Dry Beans:Dry Beans - Black Beans 50,Dry Black Beans 50 lb,1.0,34.0,34.0,4576960.04,Dry Beans,Lisset Limpio -020,Cafeteria,1390103,Aug
2025-08-08,Sedanos Supermarkets #33,Invoice,008-06188,Arroz a Granel:Parboiled 50 LB -Bolsa Dos Hermanos.,,3.0,28.25,84.75,4577044.79,Bulk Rice,Keila Alfaro-Visvikis,RETAIL SEDANOS,1390104,Aug
2025-08-08,Be Your Will LLC,Invoice,008-06189,Arroz a Granel:Largo Fino 50 LB -Bolsa Dos Hermanos.,,6.0,27.85,167.1,4577211.89,Bulk Rice,Lisset Limpio -020,CAFETERIA y RESTAURANTS,1390105,Aug
2025-08-08,Be Your Will LLC,Invoice,008-06189,Arroz a Granel:Parboiled 50 LB -Bolsa Dos Hermanos.,,11.0,27.75,305.25,4577517.14,Bulk Rice,Lisset Limpio -020,CAFETERIA y RESTAURANTS,1390106,Aug
2025-08-08,Be Your Will LLC,Invoice,008-06189,Arroz a Granel:Largo Fino 50 LB -Bolsa Dos Hermanos.,,1.0,27.85,27.85,4577544.99,Bulk Rice,Lisset Limpio -020,CAFETERIA y RESTAURANTS,1390107,Aug
2025-08-08,El Palacio de Los Jugos / Casa mía Food Restaurant inc,Invoice,008-06190,Arroz a Granel:Parboiled 50 LB -Bolsa Dos Hermanos.,,8.0,26.75,214.0,4577758.99,Bulk Rice,Lisset Limpio -020,Cafeteria,1390108,Aug
2025-08-08,El Palacio de Los Jugos / Casa mía Food Restaurant inc,Invoice,008-06190,Spices:AS Sazon (for all),1 / 30 lb (box or pail),1.0,51.0,51.0,4577809.99,American Spice,Lisset Limpio -020,Cafeteria,1390109,Aug
2025-08-08,Sedanos Supermarkets #32,Invoice,008-06191,Arroz a Granel:Largo Fino 50 LB -Bolsa Dos Hermanos.,,2.0,27.85,55.7,4577865.69,Bulk Rice,Keila Alfaro-Visvikis,RETAIL SEDANOS,1390110,Aug
2025-08-08,Sedanos Supermarkets #32,Invoice,008-06191,Arroz a Granel:Parboiled 50 LB -Bolsa Dos Hermanos.,,3.0,28.25,84.75,4577950.44,Bulk Rice,Keila Alfaro-Visvikis,RETAIL SEDANOS,1390111,Aug
2025-08-08,El Palacio de los jugos / Lita Foods Inc.,Invoice,008-06192,Dry Beans:Dry Beans - Black Beans 50,Dry Black Beans 50 lb,1.0,34.0,34.0,4577984.44,Dry Beans,Lisset Limpio -020,Cafeteria,1390112,Aug
2025-08-08,El Palacio de los jugos / Lita Foods Inc.,Invoice,008-06192,Arroz a Granel:Parboiled 50 LB -Bolsa Dos Hermanos.,,11.0,27.75,305.25,4578289.69,Bulk Rice,Lisset Limpio -020,Cafeteria,1390113,Aug
2025-08-08,El Palacio de los jugos / Lita Foods Inc.,Invoice,008-06192,Arroz a Granel:Parboiled 50 LB -Bolsa Dos Hermanos.,,1.0,27.75,27.75,4578317.44,Bulk Rice,Lisset Limpio -020,Cafeteria,1390114,Aug
2025-08-08,El Palacio de los jugos / Divan and Denise Food,Invoice,008-06193,Dry Beans:Dry Beans - Black Beans 50,Dry Black Beans 50 lb,1.0,34.0,34.0,4578351.44,Dry Beans,Lisset Limpio -020,Cafeteria,1390115,Aug
2025-08-08,El Palacio de los jugos / Divan and Denise Food,Invoice,008-06193,Arroz a Granel:Parboiled 50 LB -Bolsa Dos Hermanos.,,10.0,26.75,267.5,4578618.94,Bulk Rice,Lisset Limpio -020,Cafeteria,1390116,Aug
2025-08-08,El Palacio de los jugos / Caribe Tropical,Invoice,008-06194,Dry Beans:Dry Beans - Black Beans 50,Dry Black Beans 50 lb,2.0,34.0,68.0,4578686.94,Dry Beans,Lisset Limpio -020,Cafeteria,1390117,Aug
2025-08-08,El Palacio de los jugos / Caribe Tropical,Invoice,008-06194,Arroz a Granel:Parboiled 50 LB -Bolsa Dos Hermanos.,,10.0,26.75,267.5,4578954.44,Bulk Rice,Lisset Limpio -020,Cafeteria,1390118,Aug
2025-08-08,El Palacio de los jugos / Rodriguez Foods,Invoice,008-06195,Arroz a Granel:Parboiled 50 LB -Bolsa Dos Hermanos.,,8.0,26.75,214.0,4579168.44,Bulk Rice,Lisset Limpio -020,Cafeteria,1390119,Aug
2025-08-08,"Soriano Brothers Diaz Food Service,Inc",Invoice,008-06196,Dry Beans:Dry Beans - Black Beans 50,Dry Black Beans 50 lb,7.0,34.0,238.0,4579406.44,Bulk Rice,Lisset Limpio -020,CAFETERIA y RESTAURANTS,1390120,Aug
2025-08-08,"Soriano Brothers Diaz Food Service,Inc",Invoice,008-06196,Arroz a Granel:Parboiled 50 LB -Bolsa Dos Hermanos.,,40.0,26.75,1070.0,4580476.44,Bulk Rice,Lisset Limpio -020,CAFETERIA y RESTAURANTS,1390121,Aug
2025-08-08,Soriano Brothers PB,Credit Memo,008-06265,Varios:Promotional Allowance,Arroz a Granel:Parboiled 50 LB -Bolsa Dos Hermanos.,-1.0,27.75,-27.75,4580448.69,Bulk Rice,Lisset Limpio -020,CAFETERIA y RESTAURANTS,1390122,Aug
2025-08-08,El Palacio de los jugos /  Mires Restaurants,Credit Memo,008-06266,Varios:Promotional Allowance,Arroz a Granel:Parboiled 50 LB -Bolsa Dos Hermanos.,-1.0,27.75,-27.75,4580420.94,Bulk Rice,Lisset Limpio -020,Cafeteria,1390123,Aug
2025-08-08,Be Your Will LLC,Credit Memo,008-06267,Varios:Promotional Allowance,Arroz a Granel:Largo Fino 50 LB -Bolsa Dos Hermanos.,-1.0,27.85,-27.85,4580393.09,Bulk Rice,Lisset Limpio -020,CAFETERIA y RESTAURANTS,1390124,Aug
2025-08-08,El Palacio de los jugos / Lita Foods Inc.,Credit Memo,008-06268,Varios:Promotional Allowance,Arroz a Granel:Parboiled 50 LB -Bolsa Dos Hermanos.,-1.0,27.75,-27.75,4580365.34,Bulk Rice,Lisset Limpio -020,Cafeteria,1390125,Aug
2025-08-10,Aries Supermarket & Cafeteria,Invoice,008-06197,Arroz a Granel:Parboiled 50 LB -Bolsa Dos Hermanos.,,10.0,28.25,282.5,4580647.84,Bulk Rice,Keila Alfaro-Visvikis,CAFETERIA y RESTAURANTS,1390126,Aug
2025-08-10,Aries Supermarket & Cafeteria,Invoice,008-06197,Dry Beans:Dry Beans - Black Beans 50,Dry Black Beans 50 lb,5.0,37.5,187.5,4580835.34,Dry Beans,Keila Alfaro-Visvikis,CAFETERIA y RESTAURANTS,1390127,Aug
2025-08-10,Aries Supermarket & Cafeteria,Invoice,008-06197,Liquids:AS Bitter Orange,4 / 1 gl.,2.0,14.5,29.0,4580864.34,American Spice,Keila Alfaro-Visvikis,CAFETERIA y RESTAURANTS,1390128,Aug
2025-08-10,Aries Supermarket & Cafeteria,Invoice,008-06197,Spices:AS Oregano Ground,4 / 3.5 Lbs.,1.0,37.5,37.5,4580901.84,American Spice,Keila Alfaro-Visvikis,CAFETERIA y RESTAURANTS,1390129,Aug
2025-08-10,Aries Supermarket & Cafeteria,Invoice,008-06197,Spices:AS Chicken Base,1 / 30 lb. (box or pail),5.0,43.5,217.5,4581119.34,American Spice,Keila Alfaro-Visvikis,CAFETERIA y RESTAURANTS,1390130,Aug
2025-08-10,Aries Supermarket & Cafeteria,Invoice,008-06197,Spices:AS Whole Bay Leaves,4/12 OZ,1.0,27.5,27.5,4581146.84,American Spice,Keila Alfaro-Visvikis,CAFETERIA y RESTAURANTS,1390131,Aug
2025-08-10,Aries Supermarket & Cafeteria,Invoice,008-06197,Spices:AS Cumin Ground,4 / 4 lb,1.0,50.25,50.25,4581197.09,American Spice,Keila Alfaro-Visvikis,CAFETERIA y RESTAURANTS,1390132,Aug
2025-08-10,El Palacio de los jugos / J Mena Corp.,Invoice,008-06198,Arroz a Granel:Parboiled 50 LB -Bolsa Dos Hermanos.,,15.0,26.75,401.25,4581598.34,Bulk Rice,Lisset Limpio -020,Cafeteria,1390133,Aug
2025-08-10,Sedanos Supermarkets #43,Invoice,008-06199,Arroz a Granel:Parboiled 50 LB -Bolsa Dos Hermanos.,,4.0,28.25,113.0,4581711.34,Bulk Rice,Keila Alfaro-Visvikis,RETAIL SEDANOS,1390134,Aug
2025-08-10,Sedanos Supermarkets #16,Invoice,008-06200,Arroz a Granel:Parboiled 50 LB -Bolsa Dos Hermanos.,,4.0,28.25,113.0,4581824.34,Bulk Rice,Keila Alfaro-Visvikis,RETAIL SEDANOS,1390135,Aug
2025-08-11,Fritanga Momotombo,Invoice,008-06201,Spices:AS Chicken Base,1 / 30 lb. (box or pail),1.0,39.0,39.0,4581863.34,American Spice,Lisset Limpio -020,CAFETERIA y RESTAURANTS,1390136,Aug
2025-08-11,Fritanga Momotombo,Invoice,008-06201,Arroz a Granel:Largo Fino 50 LB -Bolsa Dos Hermanos.,,5.0,27.85,139.25,4582002.59,Bulk Rice,Lisset Limpio -020,CAFETERIA y RESTAURANTS,1390137,Aug
2025-08-11,El Palacio de los Jugos / Bird Road Restaurant,Invoice,008-06202,Arroz a Granel:Parboiled 50 LB -Bolsa Dos Hermanos.,,12.0,26.75,321.0,4582323.59,Bulk Rice,Lisset Limpio -020,Cafeteria,1390138,Aug
2025-08-11,El Palacio de los jugos / Rodriguez Foods,Invoice,008-06203,Arroz a Granel:Parboiled 50 LB -Bolsa Dos Hermanos.,,6.0,26.75,160.5,4582484.09,Bulk Rice,Lisset Limpio -020,Cafeteria,1390139,Aug
2025-08-11,El Palacio de los jugos /  Nanos Latin Foods,Invoice,008-06204,Arroz a Granel:Largo Fino 50 LB -Bolsa Dos Hermanos.,,5.0,27.85,139.25,4582623.34,Bulk Rice,Lisset Limpio -020,Cafeteria,1390140,Aug
2025-08-11,El Palacio de los jugos /  Nanos Latin Foods,Invoice,008-06204,Arroz a Granel:Parboiled 50 LB -Bolsa Dos Hermanos.,,8.0,26.75,214.0,4582837.34,Bulk Rice,Lisset Limpio -020,Cafeteria,1390141,Aug
2025-08-11,El Palacio de los jugos /  Nanos Latin Foods,Invoice,008-06204,Dry Beans:Dry Beans - Black Beans 50,Dry Black Beans 50 lb,2.0,34.0,68.0,4582905.34,Dry Beans,Lisset Limpio -020,Cafeteria,1390142,Aug
2025-08-11,El Palacio de los jugos / Caribe Tropical,Invoice,008-06205,Arroz a Granel:Parboiled 50 LB -Bolsa Dos Hermanos.,,6.0,26.75,160.5,4583065.84,Bulk Rice,Lisset Limpio -020,Cafeteria,1390143,Aug
2025-08-11,El Palacio de los jugos / Divan and Denise Food,Invoice,008-06206,Arroz a Granel:Parboiled 50 LB -Bolsa Dos Hermanos.,,5.0,26.75,133.75,4583199.59,Bulk Rice,Lisset Limpio -020,Cafeteria,1390144,Aug
2025-08-11,El Palacio de los jugos / Divan and Denise Food,Invoice,008-06206,Dry Beans:Dry Beans - Black Beans 50,Dry Black Beans 50 lb,2.0,34.0,68.0,4583267.59,Dry Beans,Lisset Limpio -020,Cafeteria,1390145,Aug
2025-08-11,JMN Dely Corp,Invoice,008-06207,Dry Beans:Dry Beans - Black Beans 50,Dry Black Beans 50 lb,1.0,45.7,45.7,4583313.29,Dry Beans,Keila Alfaro-Visvikis,CAFETERIA y RESTAURANTS,1390146,Aug
2025-08-11,JMN Dely Corp,Invoice,008-06207,Arroz a Granel:Largo Fino 50 LB -Bolsa Dos Hermanos.,,2.0,27.85,55.7,4583368.99,Bulk Rice,Keila Alfaro-Visvikis,CAFETERIA y RESTAURANTS,1390147,Aug
2025-08-11,JMN Dely Corp,Invoice,008-06207,Arroz a Granel:Parboiled 50 LB -Bolsa Dos Hermanos.,,2.0,27.75,55.5,4583424.49,Bulk Rice,Keila Alfaro-Visvikis,CAFETERIA y RESTAURANTS,1390148,Aug
2025-08-11,El Palacio de Los Jugos / Casa mía Food Restaurant inc,Invoice,008-06208,Arroz a Granel:Parboiled 50 LB -Bolsa Dos Hermanos.,,4.0,26.75,107.0,4583531.49,Bulk Rice,Lisset Limpio -020,Cafeteria,1390149,Aug
2025-08-11,Sedanos Supermarkets  #4,Invoice,008-06209,Arroz Envasado:Long Rice 10 LB Dos Hermanos,,5.0,35.5,177.5,4583708.99,Branded Rice,Keila Alfaro-Visvikis,RETAIL SEDANOS,1390150,Aug
2025-08-11,Sedanos Supermarkets  #4,Invoice,008-06209,Varios:Promotional Allowance,Long Grain 10 lb,5.0,-3.2,-16.0,4583692.99,Branded Rice,Keila Alfaro-Visvikis,RETAIL SEDANOS,1390151,Aug
2025-08-11,Sedanos Supermarkets #7,Invoice,008-06210,Arroz Envasado:Long Rice 10 LB Dos Hermanos,,10.0,35.5,355.0,4584047.99,Branded Rice,Keila Alfaro-Visvikis,RETAIL SEDANOS,1390152,Aug
2025-08-11,Sedanos Supermarkets #7,Invoice,008-06210,Varios:Promotional Allowance,,10.0,-3.2,-32.0,4584015.99,Branded Rice,Keila Alfaro-Visvikis,RETAIL SEDANOS,1390153,Aug
2025-08-11,Sedanos Supermarkets #42,Invoice,008-06211,Arroz Envasado:Long Rice 10 LB Dos Hermanos,,10.0,35.5,355.0,4584370.99,Branded Rice,Keila Alfaro-Visvikis,RETAIL SEDANOS,1390154,Aug
2025-08-11,Sedanos Supermarkets #42,Invoice,008-06211,Varios:Promotional Allowance,,10.0,-3.2,-32.0,4584338.99,Branded Rice,Keila Alfaro-Visvikis,RETAIL SEDANOS,1390155,Aug
2025-08-11,Sedanos Supermarkets #23,Invoice,008-06212,Arroz Envasado:Long Rice 10 LB Dos Hermanos,,10.0,35.5,355.0,4584693.99,Branded Rice,Keila Alfaro-Visvikis,RETAIL SEDANOS,1390156,Aug
2025-08-11,Sedanos Supermarkets #23,Invoice,008-06212,Varios:Promotional Allowance,DH Long grain 10lb,10.0,-3.2,-32.0,4584661.99,Branded Rice,Keila Alfaro-Visvikis,RETAIL SEDANOS,1390157,Aug
2025-08-11,El Palacio de los jugos / Delicias Criollas (DIAGO FOOD_MILLER),Invoice,008-06213,Arroz a Granel:Largo Fino 50 LB -Bolsa Dos Hermanos.,,4.0,27.85,111.4,4584773.39,Bulk Rice,Lisset Limpio -020,Cafeteria,1390158,Aug
2025-08-11,El Palacio de los jugos / Delicias Criollas (DIAGO FOOD_MILLER),Invoice,008-06213,Arroz a Granel:Parboiled 50 LB -Bolsa Dos Hermanos.,,14.0,26.75,374.5,4585147.89,Bulk Rice,Lisset Limpio -020,Cafeteria,1390159,Aug
2025-08-13,Sabor Tropical Supermarket #4,Invoice,008-06214,Arroz Envasado:Parboiled 5KG Dos Hermanos.,6  11lbs,15.0,46.5,697.5,4585845.39,Branded Rice,Keila Alfaro-Visvikis,RETAIL  DSD,1390160,Aug
2025-08-13,Sabor Tropical Supermarket #4,Invoice,008-06214,Arroz Envasado:Parboiled 5KG Dos Hermanos.,6  11lbs,7.0,46.5,325.5,4586170.89,Branded Rice,Keila Alfaro-Visvikis,RETAIL  DSD,1390161,Aug
2025-08-13,Rey Chavez Distributor #2,Invoice,008-06215,Arroz a Granel:Parboiled 50 LB -Bolsa Dos Hermanos.,,25.0,27.5,687.5,4586858.39,Bulk Rice,Lisset Limpio -020,WHOLESALER,1390162,Aug
2025-08-13,Sedanos Supermarkets  #11,Invoice,008-06216,Arroz Envasado:Largo Fino 1kg (Long grain rice) Dos Hermanos,,1.0,17.5,17.5,4586875.89,Branded Rice,Keila Alfaro-Visvikis,RETAIL SEDANOS,1390163,Aug
2025-08-13,Sedanos Supermarkets  #11,Invoice,008-06216,Varios:Promotional Allowance,,1.0,-2.5,-2.5,4586873.39,Branded Rice,Keila Alfaro-Visvikis,RETAIL SEDANOS,1390164,Aug
2025-08-13,Sedanos Supermarkets  #11,Invoice,008-06216,Arroz Envasado:Parboiled 1kg Bolsa Dos Hermanos.,.,1.0,19.9,19.9,4586893.29,Branded Rice,Keila Alfaro-Visvikis,RETAIL SEDANOS,1390165,Aug
2025-08-13,Sedanos Supermarkets  #11,Invoice,008-06216,Varios:Promotional Allowance,,1.0,-5.0,-5.0,4586888.29,Branded Rice,Keila Alfaro-Visvikis,RETAIL SEDANOS,1390166,Aug
2025-08-13,Sedanos Supermarkets  #11,Invoice,008-06216,Spanish Style Yellow Rice:AS Spanish Style Yellow Rice,AS Spanish Style Yellow Rice 6 / 3.25 oz,1.0,34.5,34.5,4586922.79,American Spice,Keila Alfaro-Visvikis,RETAIL SEDANOS,1390167,Aug
2025-08-13,Sedanos Supermarkets  #11,Invoice,008-06216,Varios:Promotional Allowance,,1.0,-4.5,-4.5,4586918.29,American Spice,Keila Alfaro-Visvikis,RETAIL SEDANOS,1390168,Aug
2025-08-13,Sedanos Supermarkets  #11,Invoice,008-06216,Arroz Envasado:Long Rice 10 LB Dos Hermanos,,10.0,35.5,355.0,4587273.29,Branded Rice,Keila Alfaro-Visvikis,RETAIL SEDANOS,1390169,Aug
2025-08-13,Sedanos Supermarkets  #11,Invoice,008-06216,Varios:Promotional Allowance,,10.0,-3.2,-32.0,4587241.29,Branded Rice,Keila Alfaro-Visvikis,RETAIL SEDANOS,1390170,Aug
2025-08-13,ALS Foods,Invoice,008-06217,Liquids:AS Bitter Orange,4 / 1 gl.,1.0,15.9,15.9,4587257.19,American Spice,Lisset Limpio -020,CAFETERIA y RESTAURANTS,1390171,Aug
2025-08-13,ALS Foods,Invoice,008-06217,Arroz a Granel:Largo Fino 50 LB -Bolsa Dos Hermanos.,,6.0,27.85,167.1,4587424.29,Bulk Rice,Lisset Limpio -020,CAFETERIA y RESTAURANTS,1390172,Aug
2025-08-13,ALS Foods,Invoice,008-06217,Arroz a Granel:Parboiled 50 LB -Bolsa Dos Hermanos.,,11.0,27.75,305.25,4587729.54,Bulk Rice,Lisset Limpio -020,CAFETERIA y RESTAURANTS,1390173,Aug
2025-08-13,ALS Foods,Invoice,008-06217,Arroz a Granel:Parboiled 50 LB -Bolsa Dos Hermanos.,,1.0,27.75,27.75,4587757.29,Bulk Rice,Lisset Limpio -020,CAFETERIA y RESTAURANTS,1390174,Aug
2025-08-13,Sedanos Supermarkets #16,Invoice,008-06218,Arroz a Granel:Parboiled 50 LB -Bolsa Dos Hermanos.,,4.0,28.25,113.0,4587870.29,Bulk Rice,Keila Alfaro-Visvikis,RETAIL SEDANOS,1390175,Aug
2025-08-13,Sedanos Supermarkets #10,Invoice,008-06220,Arroz Envasado:Parboiled 1kg Bolsa Dos Hermanos.,.,2.0,19.9,39.8,4587910.09,Branded Rice,Keila Alfaro-Visvikis,RETAIL SEDANOS,1390176,Aug
2025-08-13,Sedanos Supermarkets #10,Invoice,008-06220,Varios:Promotional Allowance,,2.0,-5.0,-10.0,4587900.09,Branded Rice,Keila Alfaro-Visvikis,RETAIL SEDANOS,1390177,Aug
2025-08-13,Sedanos Supermarkets #10,Invoice,008-06220,Arroz Envasado:Long Rice 10 LB Dos Hermanos,,10.0,35.5,355.0,4588255.09,Branded Rice,Keila Alfaro-Visvikis,RETAIL SEDANOS,1390178,Aug
2025-08-13,Sedanos Supermarkets #10,Invoice,008-06220,Varios:Promotional Allowance,,10.0,-3.2,-32.0,4588223.09,Branded Rice,Keila Alfaro-Visvikis,RETAIL SEDANOS,1390179,Aug
2025-08-13,Sedanos Supermarkets #43,Invoice,008-06221,Arroz a Granel:Parboiled 50 LB -Bolsa Dos Hermanos.,,4.0,28.25,113.0,4588336.09,Bulk Rice,Keila Alfaro-Visvikis,RETAIL SEDANOS,1390180,Aug
2025-08-13,Gala Fresh Farms - Boca Ratón,Invoice,008-06222,Arroz Envasado:Long Rice 10 LB Dos Hermanos,,15.0,35.5,532.5,4588868.59,Branded Rice,Keila Alfaro-Visvikis,RETAIL  DSD,1390181,Aug
2025-08-13,Gala Fresh Farms - Boca Ratón,Invoice,008-06222,Arroz Envasado:Long Rice 10 LB Dos Hermanos,,3.0,35.5,106.5,4588975.09,Branded Rice,Keila Alfaro-Visvikis,RETAIL  DSD,1390182,Aug
2025-08-13,Sedanos Supermarkets #27,Invoice,008-06223,Arroz Envasado:Largo Fino 1kg (Long grain rice) Dos Hermanos,,1.0,18.0,18.0,4588993.09,Branded Rice,Keila Alfaro-Visvikis,RETAIL SEDANOS,1390183,Aug
2025-08-13,Sedanos Supermarkets #27,Invoice,008-06223,Varios:Promotional Allowance,,1.0,-2.5,-2.5,4588990.59,Branded Rice,Keila Alfaro-Visvikis,RETAIL SEDANOS,1390184,Aug
2025-08-13,Sedanos Supermarkets #27,Invoice,008-06223,Spanish Style Yellow Rice:AS Spanish Style Yellow Rice,AS Spanish Style Yellow Rice 6 / 3.25 oz,1.0,34.5,34.5,4589025.09,American Spice,Keila Alfaro-Visvikis,RETAIL SEDANOS,1390185,Aug
2025-08-13,Sedanos Supermarkets #27,Invoice,008-06223,Varios:Promotional Allowance,,1.0,-4.5,-4.5,4589020.59,American Spice,Keila Alfaro-Visvikis,RETAIL SEDANOS,1390186,Aug
2025-08-13,Sedanos Supermarkets #27,Invoice,008-06223,Arroz Envasado:Long Rice 10 LB Dos Hermanos,,10.0,35.5,355.0,4589375.59,Branded Rice,Keila Alfaro-Visvikis,RETAIL SEDANOS,1390187,Aug
2025-08-13,Sedanos Supermarkets #27,Invoice,008-06223,Varios:Promotional Allowance,,10.0,-3.2,-32.0,4589343.59,Branded Rice,Keila Alfaro-Visvikis,RETAIL SEDANOS,1390188,Aug
2025-08-13,Sedanos Supermarkets #24,Invoice,008-06224,Arroz Envasado:Largo Fino 1kg (Long grain rice) Dos Hermanos,,1.0,17.5,17.5,4589361.09,Branded Rice,Keila Alfaro-Visvikis,RETAIL SEDANOS,1390189,Aug
2025-08-13,Sedanos Supermarkets #24,Invoice,008-06224,Varios:Promotional Allowance,,1.0,-2.5,-2.5,4589358.59,Branded Rice,Keila Alfaro-Visvikis,RETAIL SEDANOS,1390190,Aug
2025-08-13,Sedanos Supermarkets #24,Invoice,008-06224,Arroz Envasado:Parboiled 1kg Bolsa Dos Hermanos.,.,1.0,19.9,19.9,4589378.49,Branded Rice,Keila Alfaro-Visvikis,RETAIL SEDANOS,1390191,Aug
2025-08-13,Sedanos Supermarkets #24,Invoice,008-06224,Varios:Promotional Allowance,,1.0,-5.0,-5.0,4589373.49,Branded Rice,Keila Alfaro-Visvikis,RETAIL SEDANOS,1390192,Aug
2025-08-13,Sedanos Supermarkets #24,Invoice,008-06224,Spanish Style Yellow Rice:AS Spanish Style Yellow Rice,AS Spanish Style Yellow Rice 6 / 3.25 oz,1.0,34.5,34.5,4589407.99,American Spice,Keila Alfaro-Visvikis,RETAIL SEDANOS,1390193,Aug
2025-08-13,Sedanos Supermarkets #24,Invoice,008-06224,Varios:Promotional Allowance,,1.0,-4.5,-4.5,4589403.49,American Spice,Keila Alfaro-Visvikis,RETAIL SEDANOS,1390194,Aug
2025-08-13,Sedanos Supermarkets #24,Invoice,008-06224,Arroz Envasado:Long Rice 10 LB Dos Hermanos,,10.0,35.5,355.0,4589758.49,Branded Rice,Keila Alfaro-Visvikis,RETAIL SEDANOS,1390195,Aug
2025-08-13,Sedanos Supermarkets #24,Invoice,008-06224,Varios:Promotional Allowance,,10.0,-3.2,-32.0,4589726.49,Branded Rice,Keila Alfaro-Visvikis,RETAIL SEDANOS,1390196,Aug
2025-08-13,Key Food / Holywood,Invoice,008-06225,Arroz Envasado:Long Rice 10 LB Dos Hermanos,,5.0,35.5,177.5,4589903.99,Branded Rice,Keila Alfaro-Visvikis,RETAIL  DSD,1390197,Aug
2025-08-13,Key Food / Holywood,Invoice,008-06225,Arroz Envasado:Long Rice 10 LB Dos Hermanos,,1.0,35.5,35.5,4589939.49,Branded Rice,Keila Alfaro-Visvikis,RETAIL  DSD,1390198,Aug
2025-08-13,Sabor Tropical Supermarket #4,Credit Memo,008-06269,Varios:Promotional Allowance,Arroz Envasado:Parboiled 5KG Dos Hermanos.,-7.0,46.5,-325.5,4589613.99,Bulk Rice,Keila Alfaro-Visvikis,RETAIL  DSD,1390199,Aug
2025-08-13,ALS Foods,Credit Memo,008-06270,Varios:Promotional Allowance,Arroz a Granel:Parboiled 50 LB -Bolsa Dos Hermanos.,-1.0,27.75,-27.75,4589586.24,Bulk Rice,Lisset Limpio -020,CAFETERIA y RESTAURANTS,1390200,Aug
2025-08-13,Gala Fresh Farms - Boca Ratón,Credit Memo,008-06271,Varios:Promotional Allowance,Arroz Envasado:Long Rice 10 LB Dos Hermanos,-3.0,35.5,-106.5,4589479.74,Bulk Rice,Keila Alfaro-Visvikis,RETAIL  DSD,1390201,Aug
2025-08-13,Key Food / Holywood,Credit Memo,008-06272,Varios:Promotional Allowance,Arroz Envasado:Long Rice 10 LB Dos Hermanos,-1.0,35.5,-35.5,4589444.24,Branded Rice,Keila Alfaro-Visvikis,RETAIL  DSD,1390202,Aug
2025-08-15,Mei Chang,Invoice,008-06226,Arroz a Granel:Parboiled 50 LB -Bolsa Dos Hermanos.,,7.0,28.25,197.75,4589641.99,Bulk Rice,Lisset Limpio -020,CAFETERIA y RESTAURANTS,1390203,Aug
2025-08-15,Soriano Brothers PB,Invoice,008-06227,Liquids:AS Lemon Juice 4/1 Gl,,3.0,14.95,44.85,4589686.84,American Spice,Lisset Limpio -020,CAFETERIA y RESTAURANTS,1390204,Aug
2025-08-15,Soriano Brothers PB,Invoice,008-06227,Liquids:AS White Vinegar,4/1 Gl.,2.0,9.5,19.0,4589705.84,American Spice,Lisset Limpio -020,CAFETERIA y RESTAURANTS,1390205,Aug
2025-08-15,Soriano Brothers PB,Invoice,008-06227,Spices:AS Sazon (for all),1 / 30 lb (box or pail),2.0,59.0,118.0,4589823.84,American Spice,Lisset Limpio -020,CAFETERIA y RESTAURANTS,1390206,Aug
2025-08-15,Soriano Brothers PB,Invoice,008-06227,Arroz a Granel:Parboiled 50 LB -Bolsa Dos Hermanos.,,11.0,27.75,305.25,4590129.09,Bulk Rice,Lisset Limpio -020,CAFETERIA y RESTAURANTS,1390207,Aug
2025-08-15,Soriano Brothers PB,Invoice,008-06227,Arroz a Granel:Largo Fino 50 LB -Bolsa Dos Hermanos.,,10.0,27.85,278.5,4590407.59,Bulk Rice,Lisset Limpio -020,CAFETERIA y RESTAURANTS,1390208,Aug
2025-08-15,Soriano Brothers PB,Invoice,008-06227,Arroz a Granel:Parboiled 50 LB -Bolsa Dos Hermanos.,,1.0,27.75,27.75,4590435.34,Bulk Rice,Lisset Limpio -020,CAFETERIA y RESTAURANTS,1390209,Aug
2025-08-15,Bravo   Francisco Diaz,Invoice,008-06228,Arroz a Granel:Largo Fino 50 LB -Bolsa Dos Hermanos.,,5.0,27.85,139.25,4590574.59,Bulk Rice,Lisset Limpio -020,RETAIL  DSD,1390210,Aug
2025-08-15,El Gallego Supermarket,Invoice,008-06229,Liquids:AS Bitter Orange,4 / 1 gl.,2.0,14.0,28.0,4590602.59,American Spice,Lisset Limpio -020,RETAIL  DSD,1390211,Aug
2025-08-15,El Gallego Supermarket,Invoice,008-06229,Arroz a Granel:Parboiled 50 LB -Bolsa Dos Hermanos.,,5.0,26.75,133.75,4590736.34,Bulk Rice,Lisset Limpio -020,RETAIL  DSD,1390212,Aug
2025-08-15,El Gallego Supermarket,Invoice,008-06229,Dry Beans:Dry Beans - Black Beans 50,Dry Black Beans 50 lb,2.0,35.0,70.0,4590806.34,Dry Beans,Lisset Limpio -020,RETAIL  DSD,1390213,Aug
2025-08-15,El Gallego Supermarket,Invoice,008-06229,Arroz Envasado:Long Rice 10 LB Dos Hermanos,,6.0,35.5,213.0,4591019.34,Branded Rice,Lisset Limpio -020,RETAIL  DSD,1390214,Aug
2025-08-15,El Gallego Supermarket,Invoice,008-06229,Arroz Envasado:Long Rice 10 LB Dos Hermanos,,1.0,35.5,35.5,4591054.84,Branded Rice,Lisset Limpio -020,RETAIL  DSD,1390215,Aug
2025-08-15,El Palacio de los jugos /  Nanos Latin Foods,Invoice,008-06230,Arroz a Granel:Largo Fino 50 LB -Bolsa Dos Hermanos.,,5.0,27.85,139.25,4591194.09,Bulk Rice,Lisset Limpio -020,Cafeteria,1390216,Aug
2025-08-15,El Palacio de los jugos /  Nanos Latin Foods,Invoice,008-06230,Arroz a Granel:Parboiled 50 LB -Bolsa Dos Hermanos.,,7.0,26.75,187.25,4591381.34,Bulk Rice,Lisset Limpio -020,Cafeteria,1390217,Aug
2025-08-15,El Palacio de los jugos / Caribe Tropical,Invoice,008-06231,Arroz a Granel:Parboiled 50 LB -Bolsa Dos Hermanos.,,6.0,26.75,160.5,4591541.84,Bulk Rice,Lisset Limpio -020,Cafeteria,1390218,Aug
2025-08-15,El Palacio de Los Jugos / Casa mía Food Restaurant inc,Invoice,008-06232,Arroz a Granel:Parboiled 50 LB -Bolsa Dos Hermanos.,,10.0,26.75,267.5,4591809.34,Bulk Rice,Lisset Limpio -020,Cafeteria,1390219,Aug
2025-08-15,El Palacio de los jugos / Divan and Denise Food,Invoice,008-06233,Arroz a Granel:Parboiled 50 LB -Bolsa Dos Hermanos.,,5.0,26.75,133.75,4591943.09,Bulk Rice,Lisset Limpio -020,Cafeteria,1390220,Aug
2025-08-15,El Palacio de los jugos / Lita Foods Inc.,Invoice,008-06234,Arroz a Granel:Parboiled 50 LB -Bolsa Dos Hermanos.,,11.0,27.75,305.25,4592248.34,Bulk Rice,Lisset Limpio -020,Cafeteria,1390221,Aug
2025-08-15,El Palacio de los jugos / Lita Foods Inc.,Invoice,008-06234,Dry Beans:Dry Beans - Black Beans 50,Dry Black Beans 50 lb,1.0,34.0,34.0,4592282.34,Dry Beans,Lisset Limpio -020,Cafeteria,1390222,Aug
2025-08-15,El Palacio de los jugos / Lita Foods Inc.,Invoice,008-06234,Arroz a Granel:Parboiled 50 LB -Bolsa Dos Hermanos.,,1.0,27.75,27.75,4592310.09,Bulk Rice,Lisset Limpio -020,Cafeteria,1390223,Aug
2025-08-15,El Palacio de los jugos / Leti Corp.,Invoice,008-06235,Arroz a Granel:Largo Fino 50 LB -Bolsa Dos Hermanos.,,3.0,27.85,83.55,4592393.64,Bulk Rice,Lisset Limpio -020,Cafeteria,1390224,Aug
2025-08-15,El Palacio de los jugos / Leti Corp.,Invoice,008-06235,Arroz a Granel:Parboiled 50 LB -Bolsa Dos Hermanos.,,8.0,26.75,214.0,4592607.64,Bulk Rice,Lisset Limpio -020,Cafeteria,1390225,Aug
2025-08-15,Sedanos Supermarkets #33,Invoice,008-06236,Arroz a Granel:Parboiled 50 LB -Bolsa Dos Hermanos.,,3.0,28.25,84.75,4592692.39,Bulk Rice,Keila Alfaro-Visvikis,RETAIL SEDANOS,1390226,Aug
2025-08-15,Sedanos Supermarkets #33,Invoice,008-06237,Arroz Envasado:Long Rice 10 LB Dos Hermanos,,15.0,35.5,532.5,4593224.89,Branded Rice,Keila Alfaro-Visvikis,RETAIL SEDANOS,1390227,Aug
2025-08-15,Sedanos Supermarkets #33,Invoice,008-06237,Varios:Promotional Allowance,,15.0,-3.2,-48.0,4593176.89,Branded Rice,Keila Alfaro-Visvikis,RETAIL SEDANOS,1390228,Aug
2025-08-15,Bravo supermarket Coral Way 26 th,Invoice,008-06238,Arroz Envasado:Long Rice 10 LB Dos Hermanos,,6.0,35.5,213.0,4593389.89,Branded Rice,Lisset Limpio -020,RETAIL  DSD,1390229,Aug
2025-08-15,Bravo supermarket Coral Way 26 th,Invoice,008-06238,Arroz Envasado:Long Rice 10 LB Dos Hermanos,,1.0,35.5,35.5,4593425.39,Branded Rice,Lisset Limpio -020,RETAIL  DSD,1390230,Aug
2025-08-15,Sedanos Supermarkets #31,Invoice,008-06239,Arroz Envasado:Largo Fino 1kg (Long grain rice) Dos Hermanos,,1.0,17.5,17.5,4593442.89,Branded Rice,Keila Alfaro-Visvikis,RETAIL SEDANOS,1390231,Aug
2025-08-15,Sedanos Supermarkets #31,Invoice,008-06239,Arroz Envasado:Parboiled 1kg Bolsa Dos Hermanos.,.,2.0,19.9,39.8,4593482.69,Branded Rice,Keila Alfaro-Visvikis,RETAIL SEDANOS,1390232,Aug
2025-08-15,Sedanos Supermarkets #31,Invoice,008-06239,Spanish Style Yellow Rice:AS Spanish Style Yellow Rice,AS Spanish Style Yellow Rice 6 / 3.25 oz,1.0,34.5,34.5,4593517.19,American Spice,Keila Alfaro-Visvikis,RETAIL SEDANOS,1390233,Aug
2025-08-15,Sedanos Supermarkets #31,Invoice,008-06239,Arroz Envasado:Long Rice 10 LB Dos Hermanos,,30.0,35.5,1065.0,4594582.19,Branded Rice,Keila Alfaro-Visvikis,RETAIL SEDANOS,1390234,Aug
2025-08-15,Sedanos Supermarkets #31,Invoice,008-06239,Varios:Promotional Allowance,DH Long Grain Rice 10lb.,30.0,-3.2,-96.0,4594486.19,Branded Rice,Keila Alfaro-Visvikis,RETAIL SEDANOS,1390235,Aug
2025-08-15,Sedanos Supermarkets #31,Invoice,008-06239,Varios:Promotional Allowance,Long Grain 1 K,1.0,-2.5,-2.5,4594483.69,Branded Rice,Keila Alfaro-Visvikis,RETAIL SEDANOS,1390236,Aug
2025-08-15,Sedanos Supermarkets #31,Invoice,008-06239,Varios:Promotional Allowance,Parboiled 1 K,2.0,-5.0,-10.0,4594473.69,Branded Rice,Keila Alfaro-Visvikis,RETAIL SEDANOS,1390237,Aug
2025-08-15,Sedanos Supermarkets #31,Invoice,008-06239,Varios:Promotional Allowance,AS SEASONED Yellow Rice,1.0,-4.5,-4.5,4594469.19,American Spice,Keila Alfaro-Visvikis,RETAIL SEDANOS,1390238,Aug
2025-08-15,Food-Star Supermarket,Invoice,008-06240,Arroz Envasado:Long Rice 10 LB Dos Hermanos,,6.0,35.5,213.0,4594682.19,Branded Rice,Lisset Limpio -020,RETAIL  DSD,1390239,Aug
2025-08-15,Food-Star Supermarket,Invoice,008-06240,Arroz Envasado:Long Rice 10 LB Dos Hermanos,,1.0,35.5,35.5,4594717.69,Branded Rice,Lisset Limpio -020,RETAIL  DSD,1390240,Aug
2025-08-15,Los Caringas Latin America  Foods,Invoice,008-06241,Arroz a Granel:Largo Fino 50 LB -Bolsa Dos Hermanos.,,3.0,27.85,83.55,4594801.24,Bulk Rice,Lisset Limpio -020,CAFETERIA y RESTAURANTS,1390241,Aug
2025-08-15,Los Caringas Latin America  Foods,Invoice,008-06241,Arroz a Granel:Parboiled 50 LB -Bolsa Dos Hermanos.,,3.0,28.25,84.75,4594885.99,Bulk Rice,Lisset Limpio -020,CAFETERIA y RESTAURANTS,1390242,Aug
2025-08-15,Sedanos Supermarkets #31,Invoice,008-06242,Arroz a Granel:Parboiled 50 LB -Bolsa Dos Hermanos.,,6.0,28.25,169.5,4595055.49,Bulk Rice,Keila Alfaro-Visvikis,RETAIL SEDANOS,1390243,Aug
2025-08-15,El Palacio de los jugos / Rodriguez Foods,Invoice,008-06243,Arroz a Granel:Parboiled 50 LB -Bolsa Dos Hermanos.,,8.0,26.75,214.0,4595269.49,Bulk Rice,Lisset Limpio -020,Cafeteria,1390244,Aug
2025-08-15,Soriano Brothers PB,Credit Memo,008-06273,Varios:Promotional Allowance,Arroz a Granel:Parboiled 50 LB -Bolsa Dos Hermanos.,-1.0,27.75,-27.75,4595241.74,Bulk Rice,Lisset Limpio -020,CAFETERIA y RESTAURANTS,1390245,Aug
2025-08-15,El Gallego Supermarket,Credit Memo,008-06274,Varios:Promotional Allowance,Arroz Envasado:Long Rice 10 LB Dos Hermanos,-1.0,35.5,-35.5,4595206.24,Branded Rice,Lisset Limpio -020,RETAIL  DSD,1390246,Aug
2025-08-15,El Palacio de los jugos / Lita Foods Inc.,Credit Memo,008-06275,Varios:Promotional Allowance,Arroz a Granel:Parboiled 50 LB -Bolsa Dos Hermanos.,-1.0,27.75,-27.75,4595178.49,Bulk Rice,Lisset Limpio -020,Cafeteria,1390247,Aug
2025-08-15,Bravo supermarket Coral Way 26 th,Credit Memo,008-06276,Varios:Promotional Allowance,Arroz Envasado:Long Rice 10 LB Dos Hermanos,-1.0,35.5,-35.5,4595142.99,Branded Rice,Lisset Limpio -020,RETAIL  DSD,1390248,Aug
2025-08-15,Food-Star Supermarket,Credit Memo,008-06277,Varios:Promotional Allowance,Arroz Envasado:Long Rice 10 LB Dos Hermanos,-1.0,35.5,-35.5,4595107.49,Branded Rice,Lisset Limpio -020,RETAIL  DSD,1390249,Aug
2025-08-15,Bravo Supermarkets Palm Bay,Credit Memo,008-06278,Varios:Promotional Allowance,Arroz a Granel:Largo Fino 50 LB -Bolsa Dos Hermanos.,-1.0,35.5,-35.5,4595071.99,Bulk Rice,# Orlando 0024,RETAIL  DSD,1390250,Aug
2025-08-15,Bravo Supermarkets Palm Bay,Credit Memo,008-06278,Varios:Promotional Allowance,Arroz Envasado:Parboiled 5KG Dos Hermanos.,-7.0,46.5,-325.5,4594746.49,Branded Rice,# Orlando 0024,RETAIL  DSD,1390251,Aug
2025-08-16,Bravo Supermarkets Palm Bay,Invoice,008-06244,Arroz Envasado:Parboiled 5KG Dos Hermanos.,6  11lbs,15.0,46.5,697.5,4595443.99,Branded Rice,# Orlando 0024,RETAIL  DSD,1390252,Aug
2025-08-16,Bravo Supermarkets Palm Bay,Invoice,008-06244,Arroz Envasado:Long Rice 10 LB Dos Hermanos,,1.0,35.5,35.5,4595479.49,Branded Rice,# Orlando 0024,RETAIL  DSD,1390253,Aug
2025-08-16,Bravo Supermarkets Palm Bay,Invoice,008-06244,Arroz a Granel:Largo Fino 50 LB -Bolsa Dos Hermanos.,,1.0,27.85,27.85,4595507.34,Bulk Rice,# Orlando 0024,RETAIL  DSD,1390254,Aug
2025-08-16,Bravo Supermarkets Palm Bay,Invoice,008-06244,Arroz Envasado:Parboiled 5KG Dos Hermanos.,6  11lbs,7.0,46.5,325.5,4595832.84,Branded Rice,# Orlando 0024,RETAIL  DSD,1390255,Aug
2025-08-16,BRAVO 5100 Lake Worth Road,Invoice,008-06245,Arroz Envasado:Parboiled 5KG Dos Hermanos.,6  11lbs,20.0,46.5,930.0,4596762.84,Branded Rice,Keila Alfaro-Visvikis,RETAIL BRAVO,1390256,Aug
2025-08-16,BRAVO 5100 Lake Worth Road,Invoice,008-06245,Arroz Envasado:Parboiled 5KG Dos Hermanos.,6  11lbs,20.0,46.5,930.0,4597692.84,Branded Rice,Keila Alfaro-Visvikis,RETAIL BRAVO,1390257,Aug
2025-08-16,BRAVO 5100 Lake Worth Road,Invoice,008-06245,Arroz Envasado:Long Rice 10 LB Dos Hermanos,,5.0,35.5,177.5,4597870.34,Branded Rice,Keila Alfaro-Visvikis,RETAIL BRAVO,1390258,Aug
2025-08-16,BRAVO 5100 Lake Worth Road,Invoice,008-06245,Arroz Envasado:Long Rice 10 LB Dos Hermanos,,1.0,35.5,35.5,4597905.84,Branded Rice,Keila Alfaro-Visvikis,RETAIL BRAVO,1390259,Aug
2025-08-16,Brother´s Meat Market,Invoice,008-06246,Arroz Envasado:Long Rice 10 LB Dos Hermanos,,1.0,35.5,35.5,4597941.34,Branded Rice,Armando Carpio - 017,RETAIL  DSD,1390260,Aug
2025-08-16,Brother´s Meat Market,Invoice,008-06246,Arroz Envasado:Parboiled 5KG Dos Hermanos.,6  11lbs,10.0,46.5,465.0,4598406.34,Branded Rice,Armando Carpio - 017,RETAIL  DSD,1390261,Aug
2025-08-16,Brother´s Meat Market,Invoice,008-06246,Arroz Envasado:Parboiled 5KG Dos Hermanos.,6  11lbs,5.0,46.5,232.5,4598638.84,Branded Rice,Armando Carpio - 017,RETAIL  DSD,1390262,Aug
2025-08-16,Sedanos Supermarkets #40,Invoice,008-06247,Arroz Envasado:Parboiled 5KG Dos Hermanos.,6  11lbs,21.0,40.5,850.5,4599489.34,Branded Rice,# Orlando 0024,RETAIL SEDANOS,1390263,Aug
2025-08-16,Sedanos Supermarkets #40,Invoice,008-06247,Arroz Envasado:Largo Fino 1kg (Long grain rice) Dos Hermanos,,3.0,17.5,52.5,4599541.84,Branded Rice,# Orlando 0024,RETAIL SEDANOS,1390264,Aug
2025-08-16,Sedanos Supermarkets #40,Invoice,008-06247,Varios:Promotional Allowance,,3.0,-2.5,-7.5,4599534.34,Branded Rice,# Orlando 0024,RETAIL SEDANOS,1390265,Aug
2025-08-16,Sedanos Supermarkets #40,Invoice,008-06247,Arroz Envasado:Parboiled 1kg Bolsa Dos Hermanos.,.,2.0,19.9,39.8,4599574.14,Branded Rice,# Orlando 0024,RETAIL SEDANOS,1390266,Aug
2025-08-16,Sedanos Supermarkets #40,Invoice,008-06247,Varios:Promotional Allowance,,2.0,-5.0,-10.0,4599564.14,Branded Rice,# Orlando 0024,RETAIL SEDANOS,1390267,Aug
2025-08-16,Sedanos Supermarkets #40,Invoice,008-06247,Arroz Envasado:Parboiled 5KG Dos Hermanos.,6  11lbs,20.0,40.5,810.0,4600374.14,Branded Rice,# Orlando 0024,RETAIL SEDANOS,1390268,Aug
2025-08-16,Sedanos Supermarkets #40,Invoice,008-06247,Arroz Envasado:Long Rice 10 LB Dos Hermanos,,35.0,35.5,1242.5,4601616.64,Branded Rice,# Orlando 0024,RETAIL SEDANOS,1390269,Aug
2025-08-16,Sedanos Supermarkets #40,Invoice,008-06247,Varios:Promotional Allowance,,35.0,-3.2,-112.0,4601504.64,Branded Rice,# Orlando 0024,RETAIL SEDANOS,1390270,Aug
2025-08-16,Sedanos Supermarkets #40,Invoice,008-06247,Spanish Style Yellow Rice:AS Spanish Style Yellow Rice,AS Spanish Style Yellow Rice 6 / 3.25 oz,2.0,34.5,69.0,4601573.64,American Spice,# Orlando 0024,RETAIL SEDANOS,1390271,Aug
2025-08-16,Sedanos Supermarkets #40,Invoice,008-06247,Varios:Promotional Allowance,,2.0,-4.5,-9.0,4601564.64,American Spice,# Orlando 0024,RETAIL SEDANOS,1390272,Aug
2025-08-16,Sedanos Supermarkets #41,Invoice,008-06248,Arroz Envasado:Parboiled 5KG Dos Hermanos.,6  11lbs,21.0,40.5,850.5,4602415.14,Branded Rice,# Orlando 0024,RETAIL SEDANOS,1390273,Aug
2025-08-16,Sedanos Supermarkets #41,Invoice,008-06248,Arroz Envasado:Parboiled 5KG Dos Hermanos.,6  11lbs,20.0,40.5,810.0,4603225.14,Branded Rice,# Orlando 0024,RETAIL SEDANOS,1390274,Aug
2025-08-16,Sedanos Supermarkets #41,Invoice,008-06248,Arroz Envasado:Long Rice 10 LB Dos Hermanos,,30.0,35.5,1065.0,4604290.14,Branded Rice,# Orlando 0024,RETAIL SEDANOS,1390275,Aug
2025-08-16,Sedanos Supermarkets #41,Invoice,008-06248,Varios:Promotional Allowance,,30.0,-3.2,-96.0,4604194.14,Branded Rice,# Orlando 0024,RETAIL SEDANOS,1390276,Aug
2025-08-16,Sedanos Supermarkets #41,Invoice,008-06248,Arroz Envasado:Largo Fino 1kg (Long grain rice) Dos Hermanos,,3.0,17.5,52.5,4604246.64,Branded Rice,# Orlando 0024,RETAIL SEDANOS,1390277,Aug
2025-08-16,Sedanos Supermarkets #41,Invoice,008-06248,Varios:Promotional Allowance,,3.0,-2.5,-7.5,4604239.14,Branded Rice,# Orlando 0024,RETAIL SEDANOS,1390278,Aug
2025-08-16,Sedanos Supermarkets #41,Invoice,008-06248,Arroz Envasado:Parboiled 1kg Bolsa Dos Hermanos.,.,2.0,19.9,39.8,4604278.94,Branded Rice,# Orlando 0024,RETAIL SEDANOS,1390279,Aug
2025-08-16,Sedanos Supermarkets #41,Invoice,008-06248,Varios:Promotional Allowance,,2.0,-5.0,-10.0,4604268.94,Branded Rice,# Orlando 0024,RETAIL SEDANOS,1390280,Aug
2025-08-16,Sedanos Supermarkets #41,Invoice,008-06248,Spanish Style Yellow Rice:AS Spanish Style Yellow Rice,AS Spanish Style Yellow Rice 6 / 3.25 oz,2.0,34.5,69.0,4604337.94,American Spice,# Orlando 0024,RETAIL SEDANOS,1390281,Aug
2025-08-16,Sedanos Supermarkets #41,Invoice,008-06248,Varios:Promotional Allowance,,2.0,-4.5,-9.0,4604328.94,American Spice,# Orlando 0024,RETAIL SEDANOS,1390282,Aug
2025-08-16,Festival Supermarket #35- Southgate,Invoice,008-06249,Arroz Envasado:Long Rice 10 LB Dos Hermanos,,1.0,35.5,35.5,4604364.44,Branded Rice,Keila Alfaro-Visvikis,RETAIL  DSD,1390283,Aug
2025-08-16,BRAVO 5100 Lake Worth Road,Credit Memo,008-06279,Varios:Promotional Allowance,Arroz Envasado:Long Rice 10 LB Dos Hermanos,-1.0,35.5,-35.5,4604328.94,Branded Rice,Keila Alfaro-Visvikis,RETAIL BRAVO,1390284,Aug
2025-08-16,Brother´s Meat Market,Credit Memo,008-06280,Varios:Promotional Allowance,Arroz Envasado:Parboiled 10 LB Dos Hermanos,-5.0,46.5,-232.5,4604096.44,Branded Rice,Armando Carpio - 017,RETAIL  DSD,1390285,Aug
2025-08-16,BRAVO 5100 Lake Worth Road,Credit Memo,008-06281,Varios:Promotional Allowance,Arroz Envasado:Parboiled 10 LB Dos Hermanos,-20.0,46.5,-930.0,4603166.44,Branded Rice,Keila Alfaro-Visvikis,RETAIL BRAVO,1390286,Aug
2025-08-16,Sedanos Supermarkets #40,Credit Memo,008-06282,Varios:Promotional Allowance,Arroz Envasado:Parboiled 5KG Dos Hermanos.,-20.0,40.5,-810.0,4602356.44,Branded Rice,# Orlando 0024,RETAIL SEDANOS,1390287,Aug
2025-08-16,Sedanos Supermarkets #41,Credit Memo,008-06283,Varios:Promotional Allowance,Arroz Envasado:Parboiled 5KG Dos Hermanos.,-20.0,40.5,-810.0,4601546.44,Branded Rice,# Orlando 0024,RETAIL SEDANOS,1390288,Aug
2025-08-17,El Palacio de los jugos /  Nanos Latin Foods,Invoice,008-06250,Arroz a Granel:Largo Fino 50 LB -Bolsa Dos Hermanos.,,5.0,27.85,139.25,4601685.69,Bulk Rice,Lisset Limpio -020,Cafeteria,1390289,Aug
2025-08-17,El Palacio de los jugos /  Nanos Latin Foods,Invoice,008-06250,Arroz a Granel:Parboiled 50 LB -Bolsa Dos Hermanos.,,8.0,26.75,214.0,4601899.69,Bulk Rice,Lisset Limpio -020,Cafeteria,1390290,Aug
2025-08-17,El Palacio de los jugos / Lita Foods Inc.,Invoice,008-06251,Arroz a Granel:Parboiled 50 LB -Bolsa Dos Hermanos.,,5.0,26.75,133.75,4602033.44,Bulk Rice,Lisset Limpio -020,Cafeteria,1390291,Aug
2025-08-17,Be Your Will LLC,Invoice,008-06252,Arroz a Granel:Largo Fino 50 LB -Bolsa Dos Hermanos.,,6.0,27.85,167.1,4602200.54,Bulk Rice,Lisset Limpio -020,CAFETERIA y RESTAURANTS,1390292,Aug
2025-08-17,Be Your Will LLC,Invoice,008-06252,Arroz a Granel:Parboiled 50 LB -Bolsa Dos Hermanos.,,11.0,27.75,305.25,4602505.79,Bulk Rice,Lisset Limpio -020,CAFETERIA y RESTAURANTS,1390293,Aug
2025-08-17,Be Your Will LLC,Invoice,008-06252,Arroz a Granel:Parboiled 50 LB -Bolsa Dos Hermanos.,,1.0,27.75,27.75,4602533.54,Bulk Rice,Lisset Limpio -020,CAFETERIA y RESTAURANTS,1390294,Aug
2025-08-17,El Palacio de los jugos / Caribe Tropical,Invoice,008-06253,Dry Beans:Dry Beans - Black Beans 50,Dry Black Beans 50 lb,1.0,34.0,34.0,4602567.54,Dry Beans,Lisset Limpio -020,Cafeteria,1390295,Aug
2025-08-17,El Palacio de los jugos / Caribe Tropical,Invoice,008-06253,Arroz a Granel:Parboiled 50 LB -Bolsa Dos Hermanos.,,10.0,26.75,267.5,4602835.04,Bulk Rice,Lisset Limpio -020,Cafeteria,1390296,Aug
2025-08-17,El Palacio de los jugos / Divan and Denise Food,Invoice,008-06254,Arroz a Granel:Parboiled 50 LB -Bolsa Dos Hermanos.,,7.0,26.75,187.25,4603022.29,Bulk Rice,Lisset Limpio -020,Cafeteria,1390297,Aug
2025-08-17,Los Mejores Tamales de Miami,Invoice,008-06255,Arroz a Granel:Parboiled 50 LB -Bolsa Dos Hermanos.,,5.0,28.25,141.25,4603163.54,Bulk Rice,Lisset Limpio -020,CAFETERIA y RESTAURANTS,1390298,Aug
2025-08-17,Sedanos Supermarkets #38,Invoice,008-06256,Spanish Style Yellow Rice:AS Spanish Style Yellow Rice,AS Spanish Style Yellow Rice 6 / 3.25 oz,1.0,34.5,34.5,4603198.04,American Spice,Keila Alfaro-Visvikis,RETAIL SEDANOS,1390299,Aug
2025-08-17,Sedanos Supermarkets #38,Invoice,008-06256,Varios:Promotional Allowance,,1.0,-4.5,-4.5,4603193.54,American Spice,Keila Alfaro-Visvikis,RETAIL SEDANOS,1390300,Aug
2025-08-17,Sedanos Supermarkets #38,Invoice,008-06256,Arroz Envasado:Largo Fino 1kg (Long grain rice) Dos Hermanos,,2.0,17.5,35.0,4603228.54,Branded Rice,Keila Alfaro-Visvikis,RETAIL SEDANOS,1390301,Aug
2025-08-17,Sedanos Supermarkets #38,Invoice,008-06256,Varios:Promotional Allowance,,2.0,-2.5,-5.0,4603223.54,Branded Rice,Keila Alfaro-Visvikis,RETAIL SEDANOS,1390302,Aug
2025-08-17,Sedanos Supermarkets #38,Invoice,008-06256,Arroz Envasado:Long Rice 10 LB Dos Hermanos,,50.0,35.5,1775.0,4604998.54,Branded Rice,Keila Alfaro-Visvikis,RETAIL SEDANOS,1390303,Aug
2025-08-17,Sedanos Supermarkets #38,Invoice,008-06256,Varios:Promotional Allowance,,50.0,-3.2,-160.0,4604838.54,Branded Rice,Keila Alfaro-Visvikis,RETAIL SEDANOS,1390304,Aug
2025-08-17,Sedanos Supermarkets #5,Invoice,008-06257,Arroz Envasado:Largo Fino 1kg (Long grain rice) Dos Hermanos,,1.0,17.5,17.5,4604856.04,Branded Rice,Keila Alfaro-Visvikis,RETAIL SEDANOS,1390305,Aug
2025-08-17,Sedanos Supermarkets #5,Invoice,008-06257,Varios:Promotional Allowance,,1.0,-2.5,-2.5,4604853.54,Branded Rice,Keila Alfaro-Visvikis,RETAIL SEDANOS,1390306,Aug
2025-08-17,Sedanos Supermarkets #5,Invoice,008-06257,Arroz Envasado:Parboiled 1kg Bolsa Dos Hermanos.,.,1.0,19.9,19.9,4604873.44,Branded Rice,Keila Alfaro-Visvikis,RETAIL SEDANOS,1390307,Aug
2025-08-17,Sedanos Supermarkets #5,Invoice,008-06257,Varios:Promotional Allowance,,1.0,-5.0,-5.0,4604868.44,Branded Rice,Keila Alfaro-Visvikis,RETAIL SEDANOS,1390308,Aug
2025-08-17,Sedanos Supermarkets #5,Invoice,008-06257,Arroz Envasado:Parboiled 5KG Dos Hermanos.,6  11lbs,5.0,40.5,202.5,4605070.94,Branded Rice,Keila Alfaro-Visvikis,RETAIL SEDANOS,1390309,Aug
2025-08-17,Sedanos Supermarkets #5,Invoice,008-06257,Arroz Envasado:Parboiled 5KG Dos Hermanos.,6  11lbs,1.0,40.5,40.5,4605111.44,Branded Rice,Keila Alfaro-Visvikis,RETAIL SEDANOS,1390310,Aug
2025-08-17,Sedanos Supermarkets #5,Invoice,008-06257,Arroz Envasado:Long Rice 10 LB Dos Hermanos,,10.0,35.5,355.0,4605466.44,Branded Rice,Keila Alfaro-Visvikis,RETAIL SEDANOS,1390311,Aug
2025-08-17,Sedanos Supermarkets #5,Invoice,008-06257,Varios:Promotional Allowance,,10.0,-3.2,-32.0,4605434.44,Branded Rice,Keila Alfaro-Visvikis,RETAIL SEDANOS,1390312,Aug
2025-08-17,Sedanos Supermarkets #32,Invoice,008-06258,Arroz a Granel:Parboiled 50 LB -Bolsa Dos Hermanos.,,5.0,28.25,141.25,4605575.69,Bulk Rice,Keila Alfaro-Visvikis,RETAIL SEDANOS,1390313,Aug
2025-08-17,Sedanos Supermarkets #32,Invoice,008-06258,Arroz a Granel:Largo Fino 50 LB -Bolsa Dos Hermanos.,,2.0,27.85,55.7,4605631.39,Bulk Rice,Keila Alfaro-Visvikis,RETAIL SEDANOS,1390314,Aug
2025-08-17,Sedanos Supermarkets #18,Invoice,008-06259,Arroz Envasado:Largo Fino 1kg (Long grain rice) Dos Hermanos,,2.0,17.5,35.0,4605666.39,Branded Rice,Keila Alfaro-Visvikis,RETAIL SEDANOS,1390315,Aug
2025-08-17,Sedanos Supermarkets #18,Invoice,008-06259,Varios:Promotional Allowance,,2.0,-2.5,-5.0,4605661.39,Branded Rice,Keila Alfaro-Visvikis,RETAIL SEDANOS,1390316,Aug
2025-08-17,Sedanos Supermarkets #18,Invoice,008-06259,Arroz Envasado:Parboiled 1kg Bolsa Dos Hermanos.,.,1.0,19.9,19.9,4605681.29,Branded Rice,Keila Alfaro-Visvikis,RETAIL SEDANOS,1390317,Aug
2025-08-17,Sedanos Supermarkets #18,Invoice,008-06259,Varios:Promotional Allowance,,1.0,-5.0,-5.0,4605676.29,Branded Rice,Keila Alfaro-Visvikis,RETAIL SEDANOS,1390318,Aug
2025-08-17,Sedanos Supermarkets #18,Invoice,008-06259,Arroz Envasado:Long Rice 10 LB Dos Hermanos,,10.0,35.5,355.0,4606031.29,Branded Rice,Keila Alfaro-Visvikis,RETAIL SEDANOS,1390319,Aug
2025-08-17,Sedanos Supermarkets #18,Invoice,008-06259,Varios:Promotional Allowance,,10.0,-3.2,-32.0,4605999.29,Branded Rice,Keila Alfaro-Visvikis,RETAIL SEDANOS,1390320,Aug
2025-08-17,Sedanos Supermarkets #18,Invoice,008-06260,Arroz a Granel:Parboiled 50 LB -Bolsa Dos Hermanos.,,12.0,28.25,339.0,4606338.29,Bulk Rice,Keila Alfaro-Visvikis,RETAIL SEDANOS,1390321,Aug
2025-08-17,Sedanos Supermarkets #18,Invoice,008-06260,Spices:AS Chicken Base,1 / 30 lb. (box or pail),1.0,39.0,39.0,4606377.29,American Spice,Keila Alfaro-Visvikis,RETAIL SEDANOS,1390322,Aug
2025-08-17,Sedanos Supermarkets #32,Invoice,008-06261,Arroz Envasado:Parboiled 5KG Dos Hermanos.,6  11lbs,1.0,40.5,40.5,4606417.79,Branded Rice,Keila Alfaro-Visvikis,RETAIL SEDANOS,1390323,Aug
2025-08-17,Sedanos Supermarkets #32,Invoice,008-06261,Arroz Envasado:Long Rice 10 LB Dos Hermanos,,10.0,35.5,355.0,4606772.79,Branded Rice,Keila Alfaro-Visvikis,RETAIL SEDANOS,1390324,Aug
2025-08-17,Sedanos Supermarkets #32,Invoice,008-06261,Varios:Promotional Allowance,DH Lon Grain 10 lb.,10.0,-3.2,-32.0,4606740.79,Branded Rice,Keila Alfaro-Visvikis,RETAIL SEDANOS,1390325,Aug
2025-08-17,El Palacio de los jugos / Rodriguez Foods,Invoice,008-06262,Arroz a Granel:Parboiled 50 LB -Bolsa Dos Hermanos.,,6.0,26.75,160.5,4606901.29,Bulk Rice,Lisset Limpio -020,Cafeteria,1390326,Aug
2025-08-17,El Palacio de los Jugos / Bird Road Restaurant,Invoice,008-06263,Arroz a Granel:Parboiled 50 LB -Bolsa Dos Hermanos.,,10.0,26.75,267.5,4607168.79,Bulk Rice,Lisset Limpio -020,Cafeteria,1390327,Aug
2025-08-17,Be Your Will LLC,Credit Memo,008-06284,Varios:Promotional Allowance,Arroz a Granel:Parboiled 50 LB -Bolsa Dos Hermanos.,-1.0,27.75,-27.75,4607141.04,Bulk Rice,Lisset Limpio -020,CAFETERIA y RESTAURANTS,1390328,Aug
2025-08-17,Sedanos Supermarkets #5,Credit Memo,008-06285,Varios:Promotional Allowance,Arroz Envasado:Parboiled 5KG Dos Hermanos.,-1.0,40.5,-40.5,4607100.54,Branded Rice,Keila Alfaro-Visvikis,RETAIL SEDANOS,1390329,Aug
2025-08-18,El Palacio de Los Jugos / Casa mía Food Restaurant inc,Invoice,008-06264,Arroz a Granel:Parboiled 50 LB -Bolsa Dos Hermanos.,,6.0,26.75,160.5,160.5,Bulk Rice,Lisset Limpio -020,Cafeteria,1390330,Aug
2025-08-18,Sedanos Supermarkets #8,Invoice,008-06286,Arroz Envasado:Long Rice 10 LB Dos Hermanos,,10.0,35.5,355.0,515.5,Branded Rice,Keila Alfaro-Visvikis,RETAIL SEDANOS,1390331,Aug
2025-08-18,Sedanos Supermarkets #8,Invoice,008-06286,Varios:Promotional Allowance,,10.0,-3.2,-32.0,483.5,Branded Rice,Keila Alfaro-Visvikis,RETAIL SEDANOS,1390332,Aug
2025-08-18,Sedanos Supermarkets #9,Invoice,008-06287,Arroz Envasado:Long Rice 10 LB Dos Hermanos,,10.0,35.5,355.0,838.5,Branded Rice,Keila Alfaro-Visvikis,RETAIL SEDANOS,1390333,Aug
2025-08-18,Sedanos Supermarkets #9,Invoice,008-06287,Arroz Envasado:Long Rice 10 LB Dos Hermanos,,10.0,-3.2,-32.0,806.5,Branded Rice,Keila Alfaro-Visvikis,RETAIL SEDANOS,1390334,Aug
2025-08-18,Sedanos Supermarkets #14,Invoice,008-06288,Arroz Envasado:Long Rice 10 LB Dos Hermanos,,10.0,35.5,355.0,1161.5,Branded Rice,Keila Alfaro-Visvikis,RETAIL SEDANOS,1390335,Aug
2025-08-18,Sedanos Supermarkets #14,Invoice,008-06288,Varios:Promotional Allowance,,10.0,-3.2,-32.0,1129.5,Branded Rice,Keila Alfaro-Visvikis,RETAIL SEDANOS,1390336,Aug
2025-08-18,Sedanos Supermarkets #17,Invoice,008-06289,Arroz Envasado:Long Rice 10 LB Dos Hermanos,,15.0,35.5,532.5,1662.0,Branded Rice,Keila Alfaro-Visvikis,RETAIL SEDANOS,1390337,Aug
2025-08-18,Sedanos Supermarkets #17,Invoice,008-06289,Varios:Promotional Allowance,,15.0,-3.2,-48.0,1614.0,Branded Rice,Keila Alfaro-Visvikis,RETAIL SEDANOS,1390338,Aug
2025-08-18,Sedanos Supermarkets #20,Invoice,008-06290,Arroz Envasado:Long Rice 10 LB Dos Hermanos,,10.0,35.5,355.0,1969.0,Branded Rice,Keila Alfaro-Visvikis,RETAIL SEDANOS,1390339,Aug
2025-08-18,Sedanos Supermarkets #20,Invoice,008-06290,Varios:Promotional Allowance,,10.0,-3.2,-32.0,1937.0,Branded Rice,Keila Alfaro-Visvikis,RETAIL SEDANOS,1390340,Aug
2025-08-18,Sedanos Supermarkets #21,Invoice,008-06291,Arroz Envasado:Long Rice 10 LB Dos Hermanos,,10.0,35.5,355.0,2292.0,Branded Rice,Keila Alfaro-Visvikis,RETAIL SEDANOS,1390341,Aug
2025-08-18,Sedanos Supermarkets #21,Invoice,008-06291,Varios:Promotional Allowance,,10.0,-3.2,-32.0,2260.0,Branded Rice,Keila Alfaro-Visvikis,RETAIL SEDANOS,1390342,Aug
2025-08-18,Sedanos Supermarkets #28,Invoice,008-06292,Arroz Envasado:Long Rice 10 LB Dos Hermanos,,30.0,35.5,1065.0,3325.0,Branded Rice,Keila Alfaro-Visvikis,RETAIL SEDANOS,1390343,Aug
2025-08-18,Sedanos Supermarkets #28,Invoice,008-06292,Varios:Promotional Allowance,,30.0,-3.2,-96.0,3229.0,Branded Rice,Keila Alfaro-Visvikis,RETAIL SEDANOS,1390344,Aug
2025-08-18,Sedanos Supermarkets #29,Invoice,008-06293,Arroz Envasado:Long Rice 10 LB Dos Hermanos,,15.0,35.5,532.5,3761.5,Branded Rice,Keila Alfaro-Visvikis,RETAIL SEDANOS,1390345,Aug
2025-08-18,Sedanos Supermarkets #29,Invoice,008-06293,Varios:Promotional Allowance,,15.0,-3.2,-48.0,3713.5,Branded Rice,Keila Alfaro-Visvikis,RETAIL SEDANOS,1390346,Aug
2025-08-18,Sedanos Supermarkets #36,Invoice,008-06294,Arroz Envasado:Long Rice 10 LB Dos Hermanos,,10.0,35.5,355.0,4068.5,Branded Rice,Keila Alfaro-Visvikis,RETAIL SEDANOS,1390347,Aug
2025-08-18,Sedanos Supermarkets #36,Invoice,008-06294,Varios:Promotional Allowance,,10.0,-3.2,-32.0,4036.5,Branded Rice,Keila Alfaro-Visvikis,RETAIL SEDANOS,1390348,Aug
